ID,Rating,Total Ratings,Comments,Kickstarter,Rating Only,Comment Only
13,10,5128,1015,0,4113,1015
13,9,8365,1379,0,6986,1379
13,8,23647,3776,1,19871,3775
13,7,23106,3408,1,19698,3407
13,6,15790,2711,0,13079,2711
13,5,4984,925,0,4059,925
13,4,2286,553,0,1733,553
13,3,905,256,0,649,256
13,2,287,95,0,192,95
68448,10,5759,995,0,4764,995
68448,9,11725,1682,1,10043,1681
68448,8,27101,3760,0,23341,3760
68448,7,15083,1970,0,13113,1970
68448,6,6166,1045,0,5121,1045
68448,5,1571,361,0,1210,361
68448,4,683,180,0,503,180
68448,3,293,95,0,198,95
68448,2,135,32,0,103,32
68448,1,98,23,0,75,23
36218,10,6102,1213,0,4889,1213
36218,9,11119,1736,0,9383,1736
36218,8,23564,3341,0,20223,3341
36218,7,14879,2036,0,12843,2036
36218,6,7862,1345,0,6517,1345
36218,5,2510,500,0,2010,500
36218,4,1063,284,0,779,284
36218,3,491,136,0,355,136
36218,2,232,74,0,158,74
36218,1,133,25,0,108,25
9209,10,3352,638,0,2714,638
9209,9,6860,1193,0,5667,1193
9209,8,21180,3582,0,17598,3582
9209,7,16983,2417,0,14566,2417
9209,6,8286,1323,0,6963,1323
9209,5,2191,427,0,1764,427
9209,4,798,199,0,599,199
9209,3,323,89,0,234,89
9209,2,131,48,0,83,48
9209,1,73,20,0,53,20
31260,10,9499,1964,0,7535,1964
31260,9,12672,2180,1,10492,2179
31260,8,18025,2959,1,15066,2958
31260,7,8512,1368,0,7144,1368
31260,6,4657,960,0,3697,960
31260,5,1510,328,0,1182,328
31260,4,890,236,0,654,236
31260,3,465,130,0,335,130
31260,2,307,98,0,209,98
31260,1,278,54,0,224,54
3076,10,8025,1713,0,6312,1713
3076,9,12580,2238,0,10342,2238
3076,8,20039,3079,0,16960,3079
3076,7,9239,1405,0,7834,1405
3076,6,4120,811,0,3309,811
3076,5,1140,269,0,871,269
3076,4,508,129,0,379,129
3076,3,292,98,0,194,98
3076,2,155,42,0,113,42
3076,1,165,39,0,126,39
40692,10,1965,309,0,1656,309
40692,9,5156,745,0,4411,745
40692,8,18934,2555,2,16379,2553
40692,7,15116,1820,0,13296,1820
40692,6,8249,1214,0,7035,1214
40692,5,2336,393,0,1943,393
40692,4,940,210,0,730,210
40692,3,396,100,0,296,100
40692,2,166,44,0,122,44
40692,1,87,16,0,71,16
178900,10,3827,525,0,3302,525
178900,9,8156,1005,0,7151,1005
178900,8,19784,2218,0,17566,2218
178900,7,11534,1176,0,10358,1176
178900,6,5119,608,0,4511,608
178900,5,1252,181,0,1071,181
178900,4,508,93,0,415,93
178900,3,234,47,0,187,47
178900,2,102,27,0,75,27
178900,1,87,19,0,68,19
2651,10,5053,1129,0,3924,1129
2651,9,10099,1835,0,8264,1835
2651,8,19280,2859,0,16421,2859
2651,7,9108,1289,0,7819,1289
2651,6,4070,718,0,3352,718
2651,5,1123,245,0,878,245
2651,4,555,165,0,390,165
2651,3,267,81,0,186,81
2651,2,123,38,0,85,38
2651,1,108,25,0,83,25
70323,10,1767,304,0,1463,304
70323,9,4471,706,1,3765,705
70323,8,15822,2431,1,13391,2430
70323,7,14108,1838,0,12270,1838
70323,6,8209,1169,0,7040,1169
70323,5,2288,371,0,1917,371
70323,4,991,206,0,785,206
70323,3,367,70,0,297,70
70323,2,178,40,0,138,40
70323,1,72,21,0,51,21
14996,10,2385,368,0,2017,368
14996,9,5787,774,0,5013,774
14996,8,18843,2602,0,16241,2602
14996,7,12775,1665,0,11110,1665
14996,6,5456,777,0,4679,777
14996,5,1269,238,0,1031,238
14996,4,433,105,0,328,105
14996,3,161,39,0,122,39
14996,2,64,14,0,50,14
14996,1,51,7,0,44,7
129622,10,2051,349,0,1702,349
129622,9,4492,686,0,3806,686
129622,8,14628,2092,0,12536,2092
129622,7,13936,1811,1,12125,1810
129622,6,7985,1108,0,6877,1108
129622,5,2120,369,0,1751,369
129622,4,883,169,0,714,169
129622,3,347,92,0,255,92
129622,2,152,44,0,108,44
129622,1,92,23,0,69,23
148228,10,2299,343,0,1956,343
148228,9,5429,741,0,4688,741
148228,8,16793,2084,0,14709,2084
148228,7,11767,1291,0,10476,1291
148228,6,5761,766,0,4995,766
148228,5,1619,265,0,1354,265
148228,4,653,145,0,508,145
148228,3,257,70,0,187,70
148228,2,109,27,0,82,27
148228,1,71,15,0,56,15
478,10,1064,235,0,829,235
478,9,3016,520,1,2496,519
478,8,13411,2389,0,11022,2389
478,7,14151,2238,0,11913,2238
478,6,8416,1573,0,6843,1573
478,5,2127,473,0,1654,473
478,4,884,266,0,618,266
478,3,309,104,0,205,104
478,2,187,71,0,116,71
478,1,60,19,0,41,19
39856,10,2037,340,0,1697,340
39856,9,4177,638,0,3539,638
39856,8,13521,1902,0,11619,1902
39856,7,11537,1501,1,10036,1500
39856,6,6784,952,0,5832,952
39856,5,1780,245,0,1535,245
39856,4,825,141,0,684,141
39856,3,318,62,0,256,62
39856,2,163,39,0,124,39
39856,1,104,17,0,87,17
28143,10,4765,1304,0,3461,1304
28143,9,7275,1480,0,5795,1480
28143,8,13959,2253,0,11706,2253
28143,7,7694,1097,0,6597,1097
28143,6,4080,757,0,3323,757
28143,5,1379,299,0,1080,299
28143,4,675,191,0,484,191
28143,3,346,79,0,267,79
28143,2,179,59,0,120,59
28143,1,107,19,0,88,19
173346,10,4289,558,0,3731,558
173346,9,9956,1194,1,8762,1193
173346,8,17111,1917,0,15194,1917
173346,7,6014,656,1,5358,655
173346,6,2087,284,0,1803,284
173346,5,493,90,0,403,90
173346,4,188,36,0,152,36
173346,3,92,20,0,72,20
173346,2,61,18,0,43,18
173346,1,56,10,0,46,10
169786,10,7996,1242,33,6754,1209
169786,9,10875,1227,56,9648,1171
169786,8,11868,1295,46,10573,1249
169786,7,4528,480,16,4048,464
169786,6,2397,405,12,1992,393
169786,5,762,183,4,579,179
169786,4,372,91,0,281,91
169786,3,189,63,0,126,63
169786,2,95,34,0,61,34
169786,1,141,32,0,109,32
110327,10,2924,484,0,2440,484
110327,9,6526,946,0,5580,946
110327,8,15856,2209,1,13647,2208
110327,7,7982,1045,0,6937,1045
110327,6,3472,566,0,2906,566
110327,5,949,216,0,733,216
110327,4,429,112,0,317,112
110327,3,156,49,0,107,49
110327,2,73,27,0,46,27
110327,1,52,13,0,39,13
167791,10,8390,1186,1,7204,1185
167791,9,11459,1277,0,10182,1277
167791,8,11561,1218,1,10343,1217
167791,7,3885,484,1,3401,483
167791,6,1839,350,0,1489,350
167791,5,572,148,0,424,148
167791,4,316,96,0,220,96
167791,3,186,62,0,124,62
167791,2,95,44,0,51,44
167791,1,97,25,0,72,25
34635,10,2067,402,0,1665,402
34635,9,5116,867,0,4249,867
34635,8,15725,2446,0,13279,2446
34635,7,9198,1201,0,7997,1201
34635,6,4104,697,0,3407,697
34635,5,1108,207,0,901,207
34635,4,415,114,0,301,114
34635,3,181,60,0,121,60
34635,2,72,18,0,54,18
34635,1,59,11,0,48,11
84876,10,4634,804,0,3830,804
84876,9,8775,1284,1,7491,1283
84876,8,14787,2015,0,12772,2015
84876,7,5201,693,0,4508,693
84876,6,2045,364,0,1681,364
84876,5,575,130,0,445,130
84876,4,257,70,0,187,70
84876,3,103,32,0,71,32
84876,2,57,13,0,44,13
84876,1,73,9,0,64,9
1927,10,839,131,0,708,131
1927,9,1411,160,0,1251,160
1927,8,4327,542,1,3785,541
1927,7,6745,814,0,5931,814
1927,6,10080,1501,0,8579,1501
1927,5,5088,885,0,4203,885
1927,4,3484,817,0,2667,817
1927,3,2061,518,0,1543,518
1927,2,1267,410,0,857,410
1927,1,518,169,0,349,169
65244,10,523,105,0,418,105
65244,9,1463,251,0,1212,251
65244,8,7768,1413,0,6355,1413
65244,7,12138,1891,0,10247,1891
65244,6,9603,1561,1,8042,1560
65244,5,2422,415,0,2007,415
65244,4,833,179,0,654,179
65244,3,282,69,0,213,69
65244,2,96,24,0,72,24
65244,1,23,5,0,18,5
12333,10,8792,1825,6,6967,1819
12333,9,8848,1507,4,7341,1503
12333,8,9389,1594,6,7795,1588
12333,7,3550,585,2,2965,583
12333,6,1972,403,1,1569,402
12333,5,664,160,0,504,160
12333,4,404,115,0,289,115
12333,3,279,72,0,207,72
12333,2,157,49,0,108,49
12333,1,235,39,0,196,39
15987,10,2855,677,0,2178,677
15987,9,4677,899,0,3778,899
15987,8,9971,1861,0,8110,1861
15987,7,7270,1249,0,6021,1249
15987,6,5210,1100,0,4110,1100
15987,5,1888,459,0,1429,459
15987,4,1166,324,0,842,324
15987,3,682,219,0,463,219
15987,2,342,131,0,211,131
15987,1,133,44,0,89,44
11,10,874,236,0,638,236
11,9,2296,551,0,1745,551
11,8,9448,2086,0,7362,2086
11,7,10997,1955,0,9042,1955
11,6,6986,1225,0,5761,1225
11,5,1851,375,0,1476,375
11,4,749,181,0,568,181
11,3,296,89,0,207,89
11,2,121,37,0,84,37
11,1,44,11,0,33,11
163412,10,1752,245,0,1507,245
163412,9,4832,608,0,4224,608
163412,8,14688,1664,0,13024,1664
163412,7,8041,781,0,7260,781
163412,6,2992,339,0,2653,339
163412,5,609,72,0,537,72
163412,4,211,33,0,178,33
163412,3,62,10,0,52,10
163412,2,47,9,0,38,9
163412,1,26,3,0,23,3
150376,10,2640,389,0,2251,389
150376,9,5774,667,0,5107,667
150376,8,12293,1332,0,10961,1332
150376,7,6295,610,0,5685,610
150376,6,3587,497,0,3090,497
150376,5,1051,195,0,856,195
150376,4,521,118,0,403,118
150376,3,253,54,0,199,54
150376,2,123,37,0,86,37
150376,1,80,15,0,65,15
120677,10,6343,967,0,5376,967
120677,9,8065,907,0,7158,907
120677,8,10339,1076,1,9263,1075
120677,7,4160,481,0,3679,481
120677,6,2132,342,0,1790,342
120677,5,665,126,0,539,126
120677,4,349,92,0,257,92
120677,3,194,56,0,138,56
120677,2,109,31,0,78,31
120677,1,128,21,0,107,21
98778,10,1353,262,0,1091,262
98778,9,2662,414,0,2248,414
98778,8,9387,1347,0,8040,1347
98778,7,9438,1149,0,8289,1149
98778,6,6046,811,0,5235,811
98778,5,1713,279,0,1434,279
98778,4,769,141,0,628,141
98778,3,290,65,0,225,65
98778,2,159,38,0,121,38
98778,1,65,18,0,47,18
50,10,899,242,0,657,242
50,9,2451,612,0,1839,612
50,8,9888,2277,0,7611,2277
50,7,10256,2072,0,8184,2072
50,6,5733,1237,0,4496,1237
50,5,1588,376,0,1212,376
50,4,583,162,0,421,162
50,3,241,88,0,153,88
50,2,102,34,0,68,34
50,1,50,16,0,34,16
41114,10,1823,349,0,1474,349
41114,9,3807,595,1,3212,594
41114,8,10379,1462,7,8917,1455
41114,7,8046,993,4,7053,989
41114,6,4876,675,0,4201,675
41114,5,1431,234,0,1197,234
41114,4,710,135,0,575,135
41114,3,312,57,0,255,57
41114,2,162,45,0,117,45
41114,1,116,24,0,92,24
161936,10,10954,1478,0,9476,1478
161936,9,9029,1016,0,8013,1016
161936,8,6485,723,0,5762,723
161936,7,2094,304,0,1790,304
161936,6,1073,183,0,890,183
161936,5,362,69,0,293,69
161936,4,226,51,0,175,51
161936,3,175,45,1,130,44
161936,2,173,65,0,108,65
161936,1,376,86,1,290,85
10547,10,1573,287,0,1286,287
10547,9,2938,442,0,2496,442
10547,8,8338,1389,0,6949,1389
10547,7,8030,1367,0,6663,1367
10547,6,5734,1198,0,4536,1198
10547,5,1686,399,0,1287,399
10547,4,1076,303,0,773,303
10547,3,487,151,0,336,151
10547,2,281,110,0,171,110
10547,1,110,39,0,71,39
37111,10,3755,790,0,2965,790
37111,9,5390,920,0,4470,920
37111,8,9914,1645,0,8269,1645
37111,7,5229,772,1,4457,771
37111,6,3208,599,0,2609,599
37111,5,1058,216,0,842,216
37111,4,610,188,0,422,188
37111,3,314,88,0,226,88
37111,2,162,61,0,101,61
37111,1,98,26,0,72,26
131357,10,973,157,1,816,156
131357,9,2332,379,11,1953,368
131357,8,8099,1176,36,6923,1140
131357,7,8608,1044,18,7564,1026
131357,6,5786,886,14,4900,872
131357,5,1771,314,4,1457,310
131357,4,869,192,3,677,189
131357,3,330,92,2,238,90
131357,2,164,43,0,121,43
131357,1,69,19,0,50,19
147020,10,1792,299,1,1493,298
147020,9,3945,546,5,3399,541
147020,8,10954,1502,5,9452,1497
147020,7,6926,802,1,6124,801
147020,6,3331,497,0,2834,497
147020,5,763,130,0,633,130
147020,4,272,59,0,213,59
147020,3,132,32,0,100,32
147020,2,62,17,0,45,17
147020,1,48,11,0,37,11
54043,10,976,181,0,795,181
54043,9,2951,459,0,2492,459
54043,8,11709,1761,0,9948,1761
54043,7,8005,1076,0,6929,1076
54043,6,3256,501,0,2755,501
54043,5,641,124,0,517,124
54043,4,201,41,0,160,41
54043,3,64,13,0,51,13
54043,2,28,7,0,21,7
54043,1,31,3,0,28,3
70919,10,893,142,0,751,142
70919,9,2253,297,0,1956,297
70919,8,9880,1258,0,8622,1258
70919,7,8847,958,1,7889,957
70919,6,4403,600,0,3803,600
70919,5,991,170,0,821,170
70919,4,366,69,0,297,69
70919,3,129,21,0,108,21
70919,2,50,19,0,31,19
70919,1,19,5,0,14,5
463,10,4410,1068,0,3342,1068
463,9,3797,764,0,3033,764
463,8,6719,1275,0,5444,1275
463,7,5515,962,0,4553,962
463,6,4099,767,0,3332,767
463,5,1500,330,0,1170,330
463,4,770,195,0,575,195
463,3,467,157,0,310,157
463,2,260,84,0,176,84
463,1,266,76,0,190,76
230802,10,2030,300,0,1730,300
230802,9,5354,623,0,4731,623
230802,8,12477,1290,0,11187,1290
230802,7,5105,525,0,4580,525
230802,6,1786,231,0,1555,231
230802,5,427,75,0,352,75
230802,4,133,26,0,107,26
230802,3,50,13,0,37,13
230802,2,24,6,0,18,6
230802,1,38,8,0,30,8
40834,10,2232,280,0,1952,280
40834,9,4820,553,0,4267,553
40834,8,10343,1144,0,9199,1144
40834,7,5681,588,0,5093,588
40834,6,2541,343,0,2198,343
40834,5,758,127,0,631,127
40834,4,325,66,0,259,66
40834,3,126,25,0,101,25
40834,2,90,17,0,73,17
40834,1,96,13,0,83,13
121921,10,3124,523,1,2601,522
121921,9,5592,713,0,4879,713
121921,8,9906,1193,0,8713,1193
121921,7,4390,463,0,3927,463
121921,6,2337,366,0,1971,366
121921,5,645,113,0,532,113
121921,4,353,72,0,281,72
121921,3,169,47,0,122,47
121921,2,86,20,0,66,20
121921,1,62,10,0,52,10
133473,10,513,88,0,425,88
133473,9,1496,174,0,1322,174
133473,8,7553,1082,1,6471,1081
133473,7,9681,1187,0,8494,1187
133473,6,5496,738,2,4758,736
133473,5,1150,176,0,974,176
133473,4,391,88,0,303,88
133473,3,117,23,0,94,23
133473,2,46,9,0,37,9
133473,1,31,2,0,29,2
181,10,424,110,0,314,110
181,9,512,101,0,411,101
181,8,1882,343,0,1539,343
181,7,3803,669,0,3134,669
181,6,7941,1391,0,6550,1391
181,5,5387,1017,0,4370,1017
181,4,3439,812,0,2627,812
181,3,1702,485,0,1217,485
181,2,835,255,0,580,255
181,1,208,70,0,138,70
157354,10,1901,300,0,1601,300
157354,9,4384,574,0,3810,574
157354,8,10887,1301,0,9586,1301
157354,7,5009,512,0,4497,512
157354,6,2265,316,1,1949,315
157354,5,634,109,0,525,109
157354,4,267,62,0,205,62
157354,3,117,29,0,88,29
157354,2,63,28,0,35,28
157354,1,39,11,0,28,11
31481,10,1500,317,0,1183,317
31481,9,3390,650,0,2740,650
31481,8,9180,1559,0,7621,1559
31481,7,6032,932,0,5100,932
31481,6,3397,552,0,2845,552
31481,5,959,186,0,773,186
31481,4,556,153,0,403,153
31481,3,254,72,0,182,72
31481,2,165,47,0,118,47
31481,1,70,16,0,54,16
170216,10,3501,565,22,2936,543
170216,9,5910,710,37,5200,673
170216,8,9164,1041,34,8123,1007
170216,7,3760,421,8,3339,413
170216,6,1934,262,3,1672,259
170216,5,562,100,3,462,97
170216,4,291,63,1,228,62
170216,3,150,36,2,114,34
170216,2,65,17,0,48,17
170216,1,69,12,0,57,12
6249,10,413,94,0,319,94
6249,9,1344,293,0,1051,293
6249,8,7424,1482,0,5942,1482
6249,7,8808,1556,2,7252,1554
6249,6,5082,1018,1,4064,1017
6249,5,1273,298,0,975,298
6249,4,498,161,0,337,161
6249,3,203,71,0,132,71
6249,2,72,35,0,37,35
6249,1,24,5,0,19,5
2655,10,1191,326,0,865,326
2655,9,2467,538,0,1929,538
2655,8,8269,1679,0,6590,1679
2655,7,7116,1242,0,5874,1242
2655,6,4118,729,0,3389,729
2655,5,1073,221,0,852,221
2655,4,391,97,0,294,97
2655,3,140,38,0,102,38
2655,2,59,14,0,45,14
2655,1,36,6,0,30,6
18602,10,2974,729,0,2245,729
18602,9,4660,960,0,3700,960
18602,8,8576,1539,0,7037,1539
18602,7,4567,796,0,3771,796
18602,6,2349,530,0,1819,530
18602,5,720,171,0,549,171
18602,4,368,122,0,246,122
18602,3,206,73,0,133,73
18602,2,99,43,0,56,43
18602,1,82,17,0,65,17
174430,10,12213,1990,80,10223,1910
174430,9,5906,734,38,5172,696
174430,8,3479,456,21,3023,435
174430,7,1227,190,4,1037,186
174430,6,759,178,4,581,174
174430,5,324,104,2,220,102
174430,4,175,52,1,123,51
174430,3,158,55,0,103,55
174430,2,111,41,0,70,41
174430,1,257,57,3,200,54
126163,10,2348,354,0,1994,354
126163,9,4863,647,0,4216,647
126163,8,10151,1184,0,8967,1184
126163,7,4269,449,0,3820,449
126163,6,1873,282,0,1591,282
126163,5,462,74,0,388,74
126163,4,210,62,0,148,62
126163,3,93,19,0,74,19
126163,2,50,16,0,34,16
126163,1,45,2,0,43,2
124742,10,4468,880,0,3588,880
124742,9,4601,754,1,3847,753
124742,8,6988,1040,0,5948,1040
124742,7,4021,540,0,3481,540
124742,6,2407,381,0,2026,381
124742,5,872,154,0,718,154
124742,4,412,79,0,333,79
124742,3,222,44,0,178,44
124742,2,119,39,0,80,39
124742,1,142,20,0,122,20
171,10,3403,885,0,2518,885
171,9,2100,373,0,1727,373
171,8,4254,787,0,3467,787
171,7,5266,958,0,4308,958
171,6,5053,994,0,4059,994
171,5,2270,485,0,1785,485
171,4,1127,308,0,819,308
171,3,457,149,0,308,149
171,2,201,61,0,140,61
171,1,71,22,0,49,22
72125,10,3355,604,2,2751,602
72125,9,5198,742,0,4456,742
72125,8,8272,1137,3,7135,1134
72125,7,3817,499,0,3318,499
72125,6,1952,360,0,1592,360
72125,5,635,134,0,501,134
72125,4,336,99,0,237,99
72125,3,191,62,0,129,62
72125,2,101,33,0,68,33
72125,1,86,8,0,78,8
103343,10,2369,329,0,2040,329
103343,9,4152,510,0,3642,510
103343,8,8181,818,0,7363,818
103343,7,4818,516,0,4302,516
103343,6,2714,326,0,2388,326
103343,5,776,105,0,671,105
103343,4,486,98,0,388,98
103343,3,232,49,0,183,49
103343,2,117,27,0,90,27
103343,1,77,11,0,66,11
39463,10,3258,744,0,2514,744
39463,9,3566,641,0,2925,641
39463,8,6962,1113,0,5849,1113
39463,7,4614,630,0,3984,630
39463,6,3051,463,0,2588,463
39463,5,1126,212,0,914,212
39463,4,678,160,0,518,160
39463,3,386,98,0,288,98
39463,2,182,49,0,133,49
39463,1,95,27,0,68,27
157969,10,669,106,0,563,106
157969,9,2016,269,0,1747,269
157969,8,8102,990,0,7112,990
157969,7,6903,761,1,6142,760
157969,6,4093,538,0,3555,538
157969,5,1068,153,0,915,153
157969,4,498,113,0,385,113
157969,3,177,36,0,141,36
157969,2,63,17,0,46,17
157969,1,35,6,0,29,6
102794,10,3146,473,0,2673,473
102794,9,5565,709,0,4856,709
102794,8,8952,1084,0,7868,1084
102794,7,3502,395,0,3107,395
102794,6,1497,226,0,1271,226
102794,5,421,75,0,346,75
102794,4,210,55,0,155,55
102794,3,107,32,0,75,32
102794,2,61,15,0,46,15
102794,1,94,21,0,73,21
146021,10,2919,434,0,2485,434
146021,9,4902,652,0,4250,652
146021,8,8176,976,0,7200,976
146021,7,3920,465,0,3455,465
146021,6,2156,305,0,1851,305
146021,5,678,123,0,555,123
146021,4,369,88,0,281,88
146021,3,197,53,0,144,53
146021,2,115,26,0,89,26
146021,1,78,14,0,64,14
1406,10,266,65,0,201,65
1406,9,198,38,0,160,38
1406,8,697,144,0,553,144
1406,7,1376,252,0,1124,252
1406,6,3682,664,0,3018,664
1406,5,4418,817,0,3601,817
1406,4,5313,976,0,4337,976
1406,3,3729,843,0,2886,843
1406,2,2606,666,0,1940,666
1406,1,1179,350,0,829,350
15062,10,801,190,0,611,190
15062,9,2018,423,0,1595,423
15062,8,7439,1396,0,6043,1396
15062,7,6704,1171,0,5533,1171
15062,6,4166,903,0,3263,903
15062,5,1235,301,0,934,301
15062,4,642,210,0,432,210
15062,3,279,95,0,184,95
15062,2,122,48,0,74,48
15062,1,51,19,0,32,19
96848,10,5012,1006,0,4006,1006
96848,9,5350,862,0,4488,862
96848,8,6702,1005,0,5697,1005
96848,7,3004,406,0,2598,406
96848,6,1894,329,0,1565,329
96848,5,633,128,0,505,128
96848,4,353,88,0,265,88
96848,3,243,64,0,179,64
96848,2,126,46,0,80,46
96848,1,100,16,0,84,16
3955,10,452,80,0,372,80
3955,9,1039,199,0,840,199
3955,8,4152,846,0,3306,846
3955,7,6544,1152,0,5392,1152
3955,6,6749,1282,0,5467,1282
3955,5,2270,543,0,1727,543
3955,4,1149,337,0,812,337
3955,3,561,180,0,381,180
3955,2,264,98,0,166,98
3955,1,78,24,0,54,24
181304,10,1115,146,0,969,146
181304,9,2798,344,0,2454,344
181304,8,8389,982,0,7407,982
181304,7,5899,586,0,5313,586
181304,6,3219,341,0,2878,341
181304,5,932,116,0,816,116
181304,4,430,70,0,360,70
181304,3,213,46,0,167,46
181304,2,65,20,0,45,20
181304,1,50,8,0,42,8
42,10,2490,867,0,1623,867
42,9,3937,1041,0,2896,1041
42,8,8007,1638,0,6369,1638
42,7,4587,754,0,3833,754
42,6,2525,461,0,2064,461
42,5,768,172,0,596,172
42,4,400,122,0,278,122
42,3,188,58,0,130,58
42,2,103,30,0,73,30
42,1,67,15,0,52,15
42,0,1,1,0,0,1
35677,10,2696,539,0,2157,539
35677,9,4754,786,0,3968,786
35677,8,8641,1342,0,7299,1342
35677,7,3775,544,0,3231,544
35677,6,1890,316,0,1574,316
35677,5,615,140,0,475,140
35677,4,336,99,0,237,99
35677,3,154,32,0,122,32
35677,2,77,31,0,46,31
35677,1,87,7,0,80,7
320,10,787,199,0,588,199
320,9,938,197,0,741,197
320,8,2969,618,0,2351,618
320,7,4996,858,0,4138,858
320,6,7148,1152,0,5996,1152
320,5,3247,621,0,2626,621
320,4,1767,396,0,1371,396
320,3,639,170,0,469,170
320,2,299,112,0,187,112
320,1,128,35,0,93,35
10630,10,1638,478,0,1160,478
10630,9,3182,729,0,2453,729
10630,8,8262,1758,1,6504,1757
10630,7,5262,1092,0,4170,1092
10630,6,2800,655,0,2145,655
10630,5,822,231,0,591,231
10630,4,367,127,0,240,127
10630,3,170,63,0,107,63
10630,2,75,23,0,52,23
10630,1,46,14,0,32,14
128882,10,2273,354,4,1919,350
128882,9,3459,454,1,3005,453
128882,8,7698,854,7,6844,847
128882,7,4826,521,4,4305,517
128882,6,2628,317,5,2311,312
128882,5,755,72,0,683,72
128882,4,382,70,0,312,70
128882,3,214,39,0,175,39
128882,2,110,27,0,83,27
128882,1,96,17,0,79,17
132531,10,1520,248,0,1272,248
132531,9,3733,502,0,3231,502
132531,8,8727,994,0,7733,994
132531,7,4222,509,0,3713,509
132531,6,2006,306,0,1700,306
132531,5,591,95,0,496,95
132531,4,293,63,0,230,63
132531,3,120,38,0,82,38
132531,2,55,16,0,39,16
132531,1,41,4,0,37,4
18,10,1006,288,0,718,288
18,9,1966,438,0,1528,438
18,8,6179,1348,0,4831,1348
18,7,5835,1103,0,4732,1103
18,6,3841,766,0,3075,766
18,5,1090,229,0,861,229
18,4,664,194,0,470,194
18,3,335,104,0,231,104
18,2,171,67,0,104,67
18,1,106,34,0,72,34
18,0,1,1,0,0,1
93,10,1921,581,0,1340,581
93,9,3697,844,0,2853,844
93,8,8173,1496,0,6677,1496
93,7,4353,671,0,3682,671
93,6,2008,385,0,1623,385
93,5,562,130,0,432,130
93,4,251,78,0,173,78
93,3,102,29,0,73,29
93,2,59,18,0,41,18
93,1,42,7,0,35,7
9220,10,282,48,0,234,48
9220,9,706,107,0,599,107
9220,8,3789,672,1,3117,671
9220,7,6617,926,0,5691,926
9220,6,6623,979,0,5644,979
9220,5,1861,288,0,1573,288
9220,4,780,167,0,613,167
9220,3,286,63,0,223,63
9220,2,103,25,0,78,25
9220,1,30,11,0,19,11
143884,10,272,35,0,237,35
143884,9,857,111,0,746,111
143884,8,4542,619,0,3923,619
143884,7,6619,828,0,5791,828
143884,6,5612,832,0,4780,832
143884,5,1714,313,0,1401,313
143884,4,820,207,0,613,207
143884,3,382,91,0,291,91
143884,2,167,71,0,96,71
143884,1,63,20,0,43,20
136063,10,446,83,0,363,83
136063,9,1405,238,0,1167,238
136063,8,7214,1021,0,6193,1021
136063,7,6897,812,0,6085,812
136063,6,3652,487,0,3165,487
136063,5,841,123,0,718,123
136063,4,302,56,0,246,56
136063,3,84,17,0,67,17
136063,2,31,9,0,22,9
136063,1,23,4,0,19,4
103885,10,2286,364,0,1922,364
103885,9,3602,476,0,3126,476
103885,8,7186,933,0,6253,933
103885,7,4321,492,0,3829,492
103885,6,2214,289,0,1925,289
103885,5,620,93,0,527,93
103885,4,232,38,0,194,38
103885,3,102,30,0,72,30
103885,2,73,19,0,54,19
103885,1,71,17,0,54,17
8217,10,499,154,0,345,154
8217,9,1742,456,0,1286,456
8217,8,7278,1662,0,5616,1662
8217,7,6651,1320,0,5331,1320
8217,6,3286,728,0,2558,728
8217,5,829,219,0,610,219
8217,4,276,90,0,186,90
8217,3,84,27,0,57,27
8217,2,32,10,0,22,10
8217,1,23,3,0,20,3
122522,10,683,105,0,578,105
122522,9,1277,165,0,1112,165
122522,8,4821,624,0,4197,624
122522,7,5737,662,0,5075,662
122522,6,4864,670,0,4194,670
122522,5,1654,261,0,1393,261
122522,4,846,169,0,677,169
122522,3,370,81,0,289,81
122522,2,173,48,0,125,48
122522,1,54,18,0,36,18
2453,10,449,115,0,334,115
2453,9,1027,244,0,783,244
2453,8,4712,1093,0,3619,1093
2453,7,6667,1297,0,5370,1297
2453,6,5011,920,0,4091,920
2453,5,1369,247,0,1122,247
2453,4,468,115,0,353,115
2453,3,113,22,0,91,22
2453,2,36,8,0,28,8
2453,1,25,2,0,23,2
16992,10,363,51,0,312,51
16992,9,857,150,0,707,150
16992,8,3792,704,0,3088,704
16992,7,6234,1025,0,5209,1025
16992,6,5746,1042,0,4704,1042
16992,5,1752,382,0,1370,382
16992,4,709,184,0,525,184
16992,3,252,73,0,179,73
16992,2,111,46,0,65,46
16992,1,42,18,0,24,18
148949,10,815,124,0,691,124
148949,9,2484,351,0,2133,351
148949,8,8742,1026,0,7716,1026
148949,7,5049,509,1,4540,508
148949,6,2028,255,0,1773,255
148949,5,418,90,0,328,90
148949,4,152,31,0,121,31
148949,3,53,15,0,38,15
148949,2,26,6,0,20,6
148949,1,23,3,0,20,3
124361,10,2213,446,0,1767,446
124361,9,4614,688,0,3926,688
124361,8,8324,1066,0,7258,1066
124361,7,2975,341,0,2634,341
124361,6,1115,173,0,942,173
124361,5,260,53,0,207,53
124361,4,112,35,0,77,35
124361,3,47,11,0,36,11
124361,2,26,6,0,20,6
124361,1,32,10,0,22,10
172,10,428,151,0,277,151
172,9,1329,397,0,932,397
172,8,6869,1809,0,5060,1809
172,7,6472,1343,0,5129,1343
172,6,3426,630,0,2796,630
172,5,767,157,0,610,157
172,4,262,70,0,192,70
172,3,81,15,0,66,15
172,2,24,8,0,16,8
172,1,20,4,0,16,4
204583,10,609,111,0,498,111
204583,9,1729,218,0,1511,218
204583,8,7406,909,0,6497,909
204583,7,6202,685,0,5517,685
204583,6,2819,341,0,2478,341
204583,5,581,98,0,483,98
204583,4,179,37,0,142,37
204583,3,60,13,0,47,13
204583,2,19,4,0,15,4
204583,1,15,5,0,10,5
50381,10,823,100,0,723,100
50381,9,1154,145,1,1009,144
50381,8,2646,364,0,2282,364
50381,7,3445,495,1,2950,494
50381,6,4761,738,1,4023,737
50381,5,2383,413,0,1970,413
50381,4,1715,376,0,1339,376
50381,3,1101,275,0,826,275
50381,2,718,201,0,517,201
50381,1,612,191,0,421,191
100423,10,534,96,0,438,96
100423,9,1409,224,0,1185,224
100423,8,5490,906,0,4584,906
100423,7,5916,861,0,5055,861
100423,6,3814,649,0,3165,649
100423,5,1191,241,0,950,241
100423,4,558,148,0,410,148
100423,3,257,75,0,182,75
100423,2,105,35,0,70,35
100423,1,43,19,0,24,19
104162,10,2023,291,0,1732,291
104162,9,3456,461,0,2995,461
104162,8,6759,792,0,5967,792
104162,7,3726,434,0,3292,434
104162,6,2068,315,0,1753,315
104162,5,656,121,0,535,121
104162,4,296,70,0,226,70
104162,3,145,45,0,100,45
104162,2,79,22,0,57,22
104162,1,50,8,0,42,8
193738,10,2986,410,0,2576,410
193738,9,5491,556,0,4935,556
193738,8,7055,696,0,6359,696
193738,7,2044,195,0,1849,195
193738,6,923,135,0,788,135
193738,5,262,53,0,209,53
193738,4,132,35,0,97,35
193738,3,66,16,0,50,16
193738,2,31,7,0,24,7
193738,1,40,4,0,36,4
123260,10,901,168,0,733,168
123260,9,2573,382,1,2191,381
123260,8,7778,1070,1,6708,1069
123260,7,4503,572,0,3931,572
123260,6,2204,339,0,1865,339
123260,5,579,120,0,459,120
123260,4,205,57,0,148,57
123260,3,79,21,0,58,21
123260,2,50,10,0,40,10
123260,1,36,9,0,27,9
146508,10,2521,305,0,2216,305
146508,9,3914,435,0,3479,435
146508,8,6010,621,0,5389,621
146508,7,2991,323,0,2668,323
146508,6,1765,270,0,1495,270
146508,5,749,137,0,612,137
146508,4,404,85,0,319,85
146508,3,269,64,0,205,64
146508,2,147,44,0,103,44
146508,1,111,33,0,78,33
158899,10,448,60,0,388,60
158899,9,1404,190,0,1214,190
158899,8,6155,782,0,5373,782
158899,7,6035,717,0,5318,717
158899,6,3381,423,0,2958,423
158899,5,807,117,0,690,117
158899,4,356,61,0,295,61
158899,3,147,32,0,115,32
158899,2,48,10,0,38,10
158899,1,19,2,0,17,2
155426,10,962,176,0,786,176
155426,9,2648,387,1,2261,386
155426,8,7869,1022,0,6847,1022
155426,7,4398,532,0,3866,532
155426,6,2073,303,0,1770,303
155426,5,483,74,0,409,74
155426,4,176,41,0,135,41
155426,3,86,18,0,68,18
155426,2,27,6,0,21,6
155426,1,26,3,0,23,3
153938,10,421,65,0,356,65
153938,9,1145,176,0,969,176
153938,8,5503,762,0,4741,762
153938,7,6266,724,0,5542,724
153938,6,3791,491,0,3300,491
153938,5,867,114,0,753,114
153938,4,398,62,0,336,62
153938,3,139,38,0,101,38
153938,2,55,20,0,35,20
153938,1,25,8,0,17,8
77423,10,2078,411,0,1667,411
77423,9,2922,514,0,2408,514
77423,8,5775,860,0,4915,860
77423,7,3625,542,0,3083,542
77423,6,2256,402,0,1854,402
77423,5,759,147,0,612,147
77423,4,338,96,0,242,96
77423,3,186,63,0,123,63
77423,2,77,21,0,56,21
77423,1,51,8,0,43,8
100901,10,542,109,3,433,106
100901,9,1460,271,7,1189,264
100901,8,6231,1042,20,5189,1022
100901,7,5380,734,12,4646,722
100901,6,3103,516,7,2587,509
100901,5,773,131,1,642,130
100901,4,293,70,0,223,70
100901,3,131,32,1,99,31
100901,2,41,16,0,25,16
100901,1,18,3,0,15,3
116,10,236,69,0,167,69
116,9,568,122,0,446,122
116,8,2883,638,0,2245,638
116,7,5398,1053,0,4345,1053
116,6,5746,1216,0,4530,1216
116,5,1797,424,0,1373,424
116,4,718,209,0,509,209
116,3,230,72,0,158,72
116,2,101,38,0,63,38
116,1,30,13,0,17,13
8203,10,170,50,0,120,50
8203,9,467,144,0,323,144
8203,8,3505,1017,0,2488,1017
8203,7,6229,1356,0,4873,1356
8203,6,5350,1087,0,4263,1087
8203,5,1277,257,0,1020,257
8203,4,378,90,0,288,90
8203,3,112,29,0,83,29
8203,2,37,5,0,32,5
8203,1,12,1,0,11,1
108745,10,942,182,0,760,182
108745,9,2061,302,0,1759,302
108745,8,6670,831,0,5839,831
108745,7,4250,502,0,3748,502
108745,6,2335,348,0,1987,348
108745,5,712,113,0,599,113
108745,4,310,63,0,247,63
108745,3,122,40,0,82,40
108745,2,63,17,0,46,17
108745,1,42,6,0,36,6
12942,10,335,86,0,249,86
12942,9,1014,282,0,732,282
12942,8,4948,1197,0,3751,1197
12942,7,6090,1273,0,4817,1273
12942,6,3795,742,0,3053,742
12942,5,845,172,0,673,172
12942,4,298,87,0,211,87
12942,3,102,28,0,74,28
12942,2,48,12,0,36,12
12942,1,23,4,0,19,4
12,10,888,388,0,500,388
12,9,2210,734,0,1476,734
12,8,6594,1598,0,4996,1598
12,7,4491,818,0,3673,818
12,6,2135,430,0,1705,430
12,5,623,133,0,490,133
12,4,269,82,0,187,82
12,3,115,36,0,79,36
12,2,71,20,0,51,20
12,1,42,7,0,35,7
154203,10,804,135,0,669,135
154203,9,2200,288,0,1912,288
154203,8,6852,808,0,6044,808
154203,7,4218,452,0,3766,452
154203,6,2233,304,0,1929,304
154203,5,625,106,0,519,106
154203,4,267,55,0,212,55
154203,3,127,38,0,89,38
154203,2,45,18,0,27,18
154203,1,33,3,0,30,3
37046,10,882,199,0,683,199
37046,9,1937,388,0,1549,388
37046,8,6259,1155,0,5104,1155
37046,7,4313,676,0,3637,676
37046,6,2546,464,0,2082,464
37046,5,721,148,0,573,148
37046,4,379,103,0,276,103
37046,3,173,48,0,125,48
37046,2,87,25,0,62,25
37046,1,52,10,0,42,10
183394,10,2133,334,0,1799,334
183394,9,4353,485,1,3868,484
183394,8,7101,726,0,6375,726
183394,7,2325,232,1,2093,231
183394,6,967,134,0,833,134
183394,5,249,45,0,204,45
183394,4,111,29,0,82,29
183394,3,57,8,1,49,7
183394,2,28,4,0,24,4
183394,1,41,5,1,36,4
104006,10,664,113,0,551,113
104006,9,2134,306,0,1828,306
104006,8,7406,877,0,6529,877
104006,7,4391,481,0,3910,481
104006,6,1922,290,0,1632,290
104006,5,510,102,0,408,102
104006,4,186,30,0,156,30
104006,3,74,21,0,53,21
104006,2,28,5,0,23,5
104006,1,20,3,0,17,3
205637,10,3222,471,1,2751,470
205637,9,4670,526,0,4144,526
205637,8,5470,579,0,4891,579
205637,7,2125,241,0,1884,241
205637,6,1065,143,0,922,143
205637,5,374,70,0,304,70
205637,4,160,45,0,115,45
205637,3,95,26,0,69,26
205637,2,47,12,0,35,12
205637,1,63,14,0,49,14
194655,10,1266,235,9,1031,226
194655,9,2466,365,22,2101,343
194655,8,6813,844,42,5969,802
194655,7,3976,433,17,3543,416
194655,6,1931,226,4,1705,222
194655,5,512,81,0,431,81
194655,4,171,33,1,138,32
194655,3,81,13,0,68,13
194655,2,34,7,0,27,7
194655,1,35,8,0,27,8
2653,10,583,153,0,430,153
2653,9,1455,329,0,1126,329
2653,8,6065,1190,0,4875,1190
2653,7,5344,906,0,4438,906
2653,6,2833,529,0,2304,529
2653,5,638,125,0,513,125
2653,4,200,38,0,162,38
2653,3,74,16,0,58,16
2653,2,28,9,0,19,9
2653,1,12,2,0,10,2
12493,10,3060,672,0,2388,672
12493,9,3480,632,0,2848,632
12493,8,4928,916,0,4012,916
12493,7,2708,512,0,2196,512
12493,6,1696,400,0,1296,400
12493,5,549,148,0,401,148
12493,4,350,112,0,238,112
12493,3,217,73,0,144,73
12493,2,128,40,0,88,40
12493,1,99,31,0,68,31
27162,10,397,79,0,318,79
27162,9,1279,243,0,1036,243
27162,8,6165,1082,0,5083,1082
27162,7,5272,817,0,4455,817
27162,6,2825,638,0,2187,638
27162,5,757,193,0,564,193
27162,4,287,88,0,199,88
27162,3,116,44,0,72,44
27162,2,57,21,0,36,21
27162,1,23,5,0,18,5
5,10,935,365,0,570,365
5,9,1715,534,0,1181,534
5,8,5638,1459,0,4179,1459
5,7,4820,1004,0,3816,1004
5,6,2657,649,0,2008,649
5,5,735,193,0,542,193
5,4,251,78,0,173,78
5,3,127,44,0,83,44
5,2,37,18,0,19,18
5,1,32,6,0,26,6
129437,10,1652,274,0,1378,274
129437,9,2621,384,0,2237,384
129437,8,5677,772,0,4905,772
129437,7,3635,497,0,3138,497
129437,6,2128,338,0,1790,338
129437,5,666,123,0,543,123
129437,4,318,77,0,241,77
129437,3,140,37,0,103,37
129437,2,68,19,0,49,19
129437,1,36,8,0,28,8
201808,10,1142,206,0,936,206
201808,9,2992,363,0,2629,363
201808,8,7388,837,0,6551,837
201808,7,3447,380,0,3067,380
201808,6,1384,191,0,1193,191
201808,5,331,62,0,269,62
201808,4,134,31,0,103,31
201808,3,57,15,0,42,15
201808,2,21,6,0,15,6
201808,1,20,3,0,17,3
25613,10,3184,655,0,2529,655
25613,9,3766,679,0,3087,679
25613,8,5059,842,0,4217,842
25613,7,2327,390,1,1937,389
25613,6,1335,315,0,1020,315
25613,5,486,120,0,366,120
25613,4,272,88,0,184,88
25613,3,176,55,0,121,55
25613,2,106,28,0,78,28
25613,1,155,21,0,134,21
147949,10,1132,192,1,940,191
147949,9,1915,249,2,1666,247
147949,8,5029,653,2,4376,651
147949,7,4100,496,4,3604,492
147949,6,2733,354,1,2379,353
147949,5,940,128,0,812,128
147949,4,527,106,1,421,105
147949,3,261,40,0,221,40
147949,2,148,34,0,114,34
147949,1,89,15,0,74,15
2223,10,199,38,0,161,38
2223,9,279,47,0,232,47
2223,8,942,124,0,818,124
2223,7,1957,275,0,1682,275
2223,6,4686,705,0,3981,705
2223,5,4102,660,0,3442,660
2223,4,2722,539,0,2183,539
2223,3,1170,301,0,869,301
2223,2,539,171,0,368,171
2223,1,192,67,0,125,67
107529,10,490,115,0,375,115
107529,9,1218,244,0,974,244
107529,8,4778,785,0,3993,785
107529,7,4847,670,1,4177,669
107529,6,3338,508,0,2830,508
107529,5,1092,205,0,887,205
107529,4,504,110,0,394,110
107529,3,224,59,0,165,59
107529,2,105,36,0,69,36
107529,1,61,15,1,46,14
21790,10,273,62,0,211,62
21790,9,996,197,0,799,197
21790,8,5392,1074,0,4318,1074
21790,7,5712,989,0,4723,989
21790,6,3059,637,0,2422,637
21790,5,777,188,0,589,188
21790,4,272,93,0,179,93
21790,3,117,49,0,68,49
21790,2,47,14,0,33,14
21790,1,17,3,0,14,3
164153,10,2570,362,0,2208,362
164153,9,3893,422,0,3471,422
164153,8,5642,577,0,5065,577
164153,7,2556,257,0,2299,257
164153,6,1117,163,0,954,163
164153,5,383,61,0,322,61
164153,4,159,39,0,120,39
164153,3,82,23,0,59,23
164153,2,40,11,0,29,11
164153,1,62,8,0,54,8
187645,10,3882,630,0,3252,630
187645,9,4935,624,0,4311,624
187645,8,4811,521,0,4290,521
187645,7,1638,183,0,1455,183
187645,6,728,114,0,614,114
187645,5,208,39,0,169,39
187645,4,107,22,0,85,22
187645,3,71,20,0,51,20
187645,2,34,10,0,24,10
187645,1,77,9,0,68,9
205059,10,2737,350,0,2387,350
205059,9,4353,455,0,3898,455
205059,8,5459,504,0,4955,504
205059,7,2081,197,0,1884,197
205059,6,1042,154,0,888,154
205059,5,354,54,0,300,54
205059,4,189,46,0,143,46
205059,3,96,35,0,61,35
205059,2,57,16,0,41,16
205059,1,58,14,0,44,14
74,10,252,70,0,182,70
74,9,487,152,0,335,152
74,8,1811,522,0,1289,522
74,7,2984,755,0,2229,755
74,6,4758,1191,0,3567,1191
74,5,2867,692,0,2175,692
74,4,1730,490,0,1240,490
74,3,768,243,0,525,243
74,2,422,142,0,280,142
74,1,211,77,0,134,77
54,10,514,136,0,378,136
54,9,1467,355,0,1112,355
54,8,5942,1194,0,4748,1194
54,7,4907,831,0,4076,831
54,6,2332,445,0,1887,445
54,5,594,141,0,453,141
54,4,228,57,0,171,57
54,3,70,20,0,50,20
54,2,25,5,0,20,5
54,1,17,2,0,15,2
123540,10,442,53,0,389,53
123540,9,1116,160,3,956,157
123540,8,4689,597,1,4092,596
123540,7,4996,626,0,4370,626
123540,6,3153,464,0,2689,464
123540,5,938,176,1,762,175
123540,4,393,92,0,301,92
123540,3,181,47,0,134,47
123540,2,74,19,0,55,19
123540,1,37,9,0,28,9
5782,10,215,56,0,159,56
5782,9,721,200,0,521,200
5782,8,4198,1165,0,3033,1165
5782,7,5922,1194,0,4728,1194
5782,6,3586,701,0,2885,701
5782,5,880,179,0,701,179
5782,4,249,66,0,183,66
5782,3,80,22,0,58,22
5782,2,44,11,0,33,11
5782,1,12,1,0,11,1
122515,10,1453,330,2,1123,328
122515,9,2964,464,5,2500,459
122515,8,6550,874,4,5676,870
122515,7,2920,305,4,2615,301
122515,6,1308,182,0,1126,182
122515,5,337,48,0,289,48
122515,4,181,33,0,148,33
122515,3,75,18,0,57,18
122515,2,34,14,0,20,14
122515,1,39,6,0,33,6
143741,10,327,59,0,268,59
143741,9,915,128,0,787,128
143741,8,4616,737,1,3879,736
143741,7,5024,717,0,4307,717
143741,6,3336,482,0,2854,482
143741,5,907,147,0,760,147
143741,4,413,101,0,312,101
143741,3,156,28,0,128,28
143741,2,60,16,0,44,16
143741,1,33,13,0,20,13
164928,10,1549,227,9,1322,218
164928,9,3730,437,8,3293,429
164928,8,6967,718,7,6249,711
164928,7,2217,252,2,1965,250
164928,6,915,167,0,748,167
164928,5,236,50,1,186,49
164928,4,96,29,0,67,29
164928,3,28,8,0,20,8
164928,2,20,10,0,10,10
164928,1,23,4,0,19,4
62219,10,2006,499,0,1507,499
62219,9,3115,566,1,2549,565
62219,8,5549,898,0,4651,898
62219,7,2522,394,0,2128,394
62219,6,1484,312,0,1172,312
62219,5,463,118,0,345,118
62219,4,258,91,0,167,91
62219,3,135,37,0,98,37
62219,2,86,22,0,64,22
62219,1,49,7,0,42,7
182028,10,4799,624,0,4175,624
182028,9,4282,438,0,3844,438
182028,8,3873,382,0,3491,382
182028,7,1305,132,0,1173,132
182028,6,718,113,0,605,113
182028,5,238,36,0,202,36
182028,4,128,26,0,102,26
182028,3,89,15,0,74,15
182028,2,55,17,0,38,17
182028,1,87,12,0,75,12
176494,10,473,84,0,389,84
176494,9,1585,206,0,1379,206
176494,8,6475,795,0,5680,795
176494,7,4350,437,0,3913,437
176494,6,1947,266,0,1681,266
176494,5,412,63,0,349,63
176494,4,183,43,0,140,43
176494,3,65,18,0,47,18
176494,2,17,5,0,12,5
176494,1,13,3,0,10,3
432,10,328,67,0,261,67
432,9,780,180,0,600,180
432,8,3540,805,0,2735,805
432,7,5253,1058,0,4195,1058
432,6,3968,808,0,3160,808
432,5,967,189,0,778,189
432,4,358,91,0,267,91
432,3,124,41,0,83,41
432,2,54,21,0,33,21
432,1,25,6,0,19,6
54998,10,939,199,0,740,199
54998,9,2075,345,0,1730,345
54998,8,5716,856,0,4860,856
54998,7,3644,471,0,3173,471
54998,6,2073,319,0,1754,319
54998,5,490,93,0,397,93
54998,4,231,67,0,164,67
54998,3,109,29,0,80,29
54998,2,40,9,0,31,9
54998,1,18,1,0,17,1
171623,10,1433,247,0,1186,247
171623,9,3128,394,0,2734,394
171623,8,6582,700,0,5882,700
171623,7,2520,239,0,2281,239
171623,6,1122,148,0,974,148
171623,5,294,51,0,243,51
171623,4,126,32,0,94,32
171623,3,77,17,0,60,17
171623,2,23,3,0,20,3
171623,1,28,7,0,21,7
166384,10,381,65,0,316,65
166384,9,1110,162,0,948,162
166384,8,4450,560,0,3890,560
166384,7,4408,511,0,3897,511
166384,6,3111,382,0,2729,382
166384,5,916,137,0,779,137
166384,4,487,87,0,400,87
166384,3,218,48,0,170,48
166384,2,70,15,0,55,15
166384,1,44,8,0,36,8
73439,10,1166,262,0,904,262
73439,9,2731,465,0,2266,465
73439,8,6131,909,0,5222,909
73439,7,2904,384,0,2520,384
73439,6,1372,223,0,1149,223
73439,5,368,75,0,293,75
73439,4,205,61,0,144,61
73439,3,91,29,0,62,29
73439,2,38,11,0,27,11
73439,1,46,9,0,37,9
1294,10,231,44,0,187,44
1294,9,245,43,0,202,43
1294,8,885,191,0,694,191
1294,7,2256,409,0,1847,409
1294,6,5023,885,0,4138,885
1294,5,3336,624,0,2712,624
1294,4,1968,507,0,1461,507
1294,3,733,196,0,537,196
1294,2,253,84,0,169,84
1294,1,66,15,0,51,15
24480,10,395,76,0,319,76
24480,9,1299,261,0,1038,261
24480,8,5644,974,0,4670,974
24480,7,4533,731,0,3802,731
24480,6,2183,411,0,1772,411
24480,5,545,133,0,412,133
24480,4,255,90,0,165,90
24480,3,87,35,0,52,35
24480,2,30,11,0,19,11
24480,1,15,2,0,13,2
37904,10,393,84,0,309,84
37904,9,971,160,0,811,160
37904,8,4409,698,0,3711,698
37904,7,4760,613,0,4147,613
37904,6,3053,484,0,2569,484
37904,5,793,143,0,650,143
37904,4,343,69,0,274,69
37904,3,167,45,0,122,45
37904,2,65,17,0,48,17
37904,1,31,10,0,21,10
28720,10,2219,532,11,1687,521
28720,9,3714,664,16,3050,648
28720,8,5465,897,30,4568,867
28720,7,2027,309,5,1718,304
28720,6,880,170,0,710,170
28720,5,300,61,0,239,61
28720,4,149,37,0,112,37
28720,3,78,21,0,57,21
28720,2,48,10,0,38,10
28720,1,60,5,0,55,5
15512,10,167,64,0,103,64
15512,9,593,186,0,407,186
15512,8,3550,1003,0,2547,1003
15512,7,4924,1188,0,3736,1188
15512,6,3872,895,0,2977,895
15512,5,1004,227,0,777,227
15512,4,343,97,0,246,97
15512,3,118,36,0,82,36
15512,2,43,12,0,31,12
15512,1,17,2,0,15,2
161970,10,1195,176,0,1019,176
161970,9,2464,299,0,2165,299
161970,8,5772,652,0,5120,652
161970,7,2793,296,0,2497,296
161970,6,1524,185,0,1339,185
161970,5,421,69,0,352,69
161970,4,218,51,0,167,51
161970,3,95,27,0,68,27
161970,2,70,22,0,48,22
161970,1,42,10,0,32,10
199561,10,607,89,4,518,85
199561,9,1808,232,8,1576,224
199561,8,6263,708,19,5555,689
199561,7,3668,426,4,3242,422
199561,6,1516,210,4,1306,206
199561,5,376,68,1,308,67
199561,4,131,41,0,90,41
199561,3,44,11,0,33,11
199561,2,25,5,0,20,5
199561,1,16,3,1,13,2
62871,10,220,35,0,185,35
62871,9,395,60,0,335,60
62871,8,1728,254,0,1474,254
62871,7,3397,548,0,2849,548
62871,6,5092,912,0,4180,912
62871,5,2056,335,0,1721,335
62871,4,893,210,0,683,210
62871,3,350,88,0,262,88
62871,2,151,44,0,107,44
62871,1,87,28,0,59,28
9674,10,327,102,0,225,102
9674,9,927,250,0,677,250
9674,8,4579,1131,0,3448,1131
9674,7,4748,971,0,3777,971
9674,6,2785,524,0,2261,524
9674,5,635,150,0,485,150
9674,4,223,69,0,154,69
9674,3,80,23,0,57,23
9674,2,33,11,0,22,11
9674,1,17,4,0,13,4
258,10,245,51,0,194,51
258,9,404,82,0,322,82
258,8,1357,225,0,1132,225
258,7,2484,454,0,2030,454
258,6,4167,793,0,3374,793
258,5,2359,505,0,1854,505
258,4,1543,445,0,1098,445
258,3,850,275,0,575,275
258,2,578,251,0,327,251
258,1,320,155,0,165,155
124708,10,817,125,0,692,125
124708,9,1623,229,1,1394,228
124708,8,5012,686,0,4326,686
124708,7,3500,466,0,3034,466
124708,6,2141,361,0,1780,361
124708,5,659,135,0,524,135
124708,4,282,72,0,210,72
124708,3,125,28,0,97,28
124708,2,67,23,0,44,23
124708,1,29,7,0,22,7
118,10,643,217,0,426,217
118,9,1590,459,1,1131,458
118,8,5149,1237,0,3912,1237
118,7,3725,716,0,3009,716
118,6,2061,442,0,1619,442
118,5,597,142,0,455,142
118,4,256,75,0,181,75
118,3,84,25,0,59,25
118,2,66,19,0,47,19
118,1,36,6,0,30,6
113924,10,840,136,10,704,126
113924,9,1618,225,8,1393,217
113924,8,4241,502,18,3739,484
113924,7,3479,380,12,3099,368
113924,6,2413,307,6,2106,301
113924,5,773,95,2,678,93
113924,4,404,67,4,337,63
113924,3,205,51,4,154,47
113924,2,107,23,1,84,22
113924,1,69,16,0,53,16
760,10,617,230,0,387,230
760,9,1511,487,0,1024,487
760,8,5141,1458,0,3683,1458
760,7,4047,908,1,3139,907
760,6,1969,460,0,1509,460
760,5,475,121,0,354,121
760,4,173,50,0,123,50
760,3,72,20,0,52,20
760,2,26,5,0,21,5
760,1,28,3,0,25,3
555,10,880,307,0,573,307
555,9,2009,544,0,1465,544
555,8,5258,1107,0,4151,1107
555,7,3393,600,0,2793,600
555,6,1603,360,0,1243,360
555,5,466,127,0,339,127
555,4,239,87,0,152,87
555,3,96,28,0,68,28
555,2,46,12,0,34,12
555,1,35,6,0,29,6
113294,10,397,90,1,307,89
113294,9,1029,213,5,816,208
113294,8,4216,804,10,3412,794
113294,7,4129,676,3,3453,673
113294,6,2759,448,2,2311,446
113294,5,750,139,1,611,138
113294,4,374,86,1,288,85
113294,3,185,47,0,138,47
113294,2,93,33,0,60,33
113294,1,47,7,0,40,7
28023,10,306,76,0,230,76
28023,9,873,159,0,714,159
28023,8,4274,717,0,3557,717
28023,7,4360,693,0,3667,693
28023,6,2804,517,0,2287,517
28023,5,731,158,0,573,158
28023,4,310,83,0,227,83
28023,3,110,28,0,82,28
28023,2,52,19,0,33,19
28023,1,13,2,0,11,2
172225,10,366,63,2,303,61
172225,9,534,67,1,467,66
172225,8,1586,171,4,1415,167
172225,7,2598,275,11,2323,264
172225,6,3863,481,23,3382,458
172225,5,2081,288,12,1793,276
172225,4,1220,231,15,989,216
172225,3,720,164,5,556,159
172225,2,454,125,3,329,122
172225,1,231,82,4,149,78
2471,10,865,220,0,645,220
2471,9,269,53,0,216,53
2471,8,1074,228,0,846,228
2471,7,2028,366,0,1662,366
2471,6,4041,789,0,3252,789
2471,5,2334,516,0,1818,516
2471,4,1426,394,0,1032,394
2471,3,908,305,0,603,305
2471,2,494,192,0,302,192
2471,1,175,64,0,111,64
38453,10,1127,268,0,859,268
38453,9,2001,387,0,1614,387
38453,8,4516,791,0,3725,791
38453,7,2931,441,0,2490,441
38453,6,1792,293,0,1499,293
38453,5,579,95,0,484,95
38453,4,339,68,0,271,68
38453,3,166,43,0,123,43
38453,2,106,35,0,71,35
38453,1,48,10,0,38,10
21763,10,252,63,0,189,63
21763,9,826,198,0,628,198
21763,8,4135,858,0,3277,858
21763,7,4452,795,0,3657,795
21763,6,2739,482,0,2257,482
21763,5,744,140,0,604,140
21763,4,278,75,0,203,75
21763,3,104,25,0,79,25
21763,2,39,14,0,25,14
21763,1,20,5,0,15,5
192291,10,542,91,0,451,91
192291,9,1489,181,0,1308,181
192291,8,5557,671,0,4886,671
192291,7,3853,416,0,3437,416
192291,6,1554,190,0,1364,190
192291,5,332,41,0,291,41
192291,4,119,28,0,91,28
192291,3,34,4,0,30,4
192291,2,15,3,0,12,3
192291,1,20,3,0,17,3
3,10,476,167,0,309,167
3,9,1395,422,0,973,422
3,8,5308,1266,0,4042,1266
3,7,3842,721,0,3121,721
3,6,1782,369,0,1413,369
3,5,408,103,0,305,103
3,4,149,41,0,108,41
3,3,56,25,0,31,25
3,2,22,7,0,15,7
3,1,20,1,0,19,1
9217,10,479,125,0,354,125
9217,9,1322,299,0,1023,299
9217,8,4894,991,1,3903,990
9217,7,3826,688,0,3138,688
9217,6,1911,431,0,1480,431
9217,5,550,152,0,398,152
9217,4,258,96,0,162,96
9217,3,102,50,0,52,50
9217,2,46,23,0,23,23
9217,1,33,8,0,25,8
25669,10,233,47,0,186,47
25669,9,558,109,0,449,109
25669,8,2906,508,0,2398,508
25669,7,4544,678,0,3866,678
25669,6,3609,602,0,3007,602
25669,5,1026,202,0,824,202
25669,4,369,94,0,275,94
25669,3,102,37,0,65,37
25669,2,47,13,0,34,13
25669,1,25,3,0,22,3
2511,10,1390,235,0,1155,235
2511,9,2549,316,0,2233,316
2511,8,4960,639,0,4321,639
2511,7,2496,318,0,2178,318
2511,6,1320,225,0,1095,225
2511,5,373,76,0,297,76
2511,4,173,43,0,130,43
2511,3,80,22,0,58,22
2511,2,43,8,0,35,8
2511,1,41,8,0,33,8
92828,10,789,88,0,701,88
92828,9,1623,180,0,1443,180
92828,8,4799,486,0,4313,486
92828,7,3630,344,0,3286,344
92828,6,1770,199,0,1571,199
92828,5,403,52,0,351,52
92828,4,156,18,0,138,18
92828,3,81,7,0,74,7
92828,2,45,9,0,36,9
92828,1,47,5,0,42,5
102652,10,1234,263,2,971,261
102652,9,1583,274,1,1309,273
102652,8,3749,647,6,3102,641
102652,7,2909,488,1,2421,487
102652,6,2166,395,0,1771,395
102652,5,780,169,0,611,169
102652,4,469,128,0,341,128
102652,3,239,75,0,164,75
102652,2,88,32,0,56,32
102652,1,55,19,0,36,19
77130,10,953,151,0,802,151
77130,9,1865,259,0,1606,259
77130,8,4493,550,0,3943,550
77130,7,2954,358,0,2596,358
77130,6,1832,300,0,1532,300
77130,5,605,105,0,500,105
77130,4,303,77,0,226,77
77130,3,133,30,0,103,30
77130,2,60,18,0,42,18
77130,1,32,5,0,27,5
43111,10,1225,290,0,935,290
43111,9,2276,460,0,1816,460
43111,8,4729,744,0,3985,744
43111,7,2576,347,0,2229,347
43111,6,1462,252,0,1210,252
43111,5,485,106,0,379,106
43111,4,234,61,0,173,61
43111,3,100,31,0,69,31
43111,2,40,14,0,26,14
43111,1,53,11,0,42,11
188,10,3132,878,0,2254,878
188,9,1474,300,0,1174,300
188,8,2707,506,0,2201,506
188,7,2419,409,0,2010,409
188,6,1841,308,0,1533,308
188,5,838,151,0,687,151
188,4,390,82,0,308,82
188,3,202,59,0,143,59
188,2,96,29,0,67,29
188,1,81,19,0,62,19
43570,10,329,76,0,253,76
43570,9,963,199,0,764,199
43570,8,4330,824,0,3506,824
43570,7,4258,714,0,3544,714
43570,6,2422,389,0,2033,389
43570,5,543,112,0,431,112
43570,4,151,35,0,116,35
43570,3,78,23,0,55,23
43570,2,29,8,0,21,8
43570,1,22,4,0,18,4
48726,10,594,135,6,459,129
48726,9,1577,340,3,1237,337
48726,8,5146,1024,23,4122,1001
48726,7,3294,580,8,2714,572
48726,6,1651,398,2,1253,396
48726,5,490,156,1,334,155
48726,4,201,74,1,127,73
48726,3,93,43,0,50,43
48726,2,43,21,0,22,21
48726,1,28,3,0,25,3
823,10,365,136,0,229,136
823,9,746,249,0,497,249
823,8,2957,808,0,2149,808
823,7,3887,856,0,3031,856
823,6,3142,711,0,2431,711
823,5,1092,251,0,841,251
823,4,513,159,0,354,159
823,3,250,92,0,158,92
823,2,103,42,0,61,42
823,1,53,17,0,36,17
127023,10,1086,232,0,854,232
127023,9,2281,322,0,1959,322
127023,8,5198,630,0,4568,630
127023,7,2647,317,0,2330,317
127023,6,1247,173,0,1074,173
127023,5,329,34,0,295,34
127023,4,177,43,0,134,43
127023,3,88,21,0,67,21
127023,2,39,12,0,27,12
127023,1,19,1,0,18,1
29368,10,536,135,0,401,135
29368,9,1031,244,0,787,244
29368,8,3517,795,0,2722,795
29368,7,3495,675,0,2820,675
29368,6,2731,512,0,2219,512
29368,5,885,175,0,710,175
29368,4,458,114,0,344,114
29368,3,204,54,0,150,54
29368,2,127,46,0,81,46
29368,1,39,11,0,28,11
27588,10,171,36,0,135,36
27588,9,494,114,0,380,114
27588,8,3105,710,0,2395,710
27588,7,4679,893,0,3786,893
27588,6,3214,636,0,2578,636
27588,5,815,197,0,618,197
27588,4,316,94,0,222,94
27588,3,98,35,0,63,35
27588,2,34,12,0,22,12
27588,1,13,3,0,10,3
63888,10,803,252,0,551,252
63888,9,1528,365,2,1163,363
63888,8,4080,739,2,3341,737
63888,7,3006,491,0,2515,491
63888,6,2040,371,1,1669,370
63888,5,686,162,0,524,162
63888,4,397,127,0,270,127
63888,3,203,60,0,143,60
63888,2,130,57,0,73,57
63888,1,58,19,0,39,19
34219,10,294,77,0,217,77
34219,9,876,216,1,660,215
34219,8,4543,1053,4,3490,1049
34219,7,4110,793,0,3317,793
34219,6,2287,429,0,1858,429
34219,5,521,110,0,411,110
34219,4,181,53,0,128,53
34219,3,70,18,0,52,18
34219,2,28,13,0,15,13
43443,10,207,46,0,161,46
43443,9,462,98,0,364,98
43443,8,2591,574,0,2017,574
43443,7,3944,754,0,3190,754
43443,6,3643,734,0,2909,734
43443,5,1075,245,0,830,245
43443,4,466,118,0,348,118
43443,3,163,47,0,116,47
43443,2,63,24,0,39,24
43443,1,20,7,0,13,7
198773,10,421,56,0,365,56
198773,9,1290,147,0,1143,147
198773,8,4427,467,0,3960,467
198773,7,3759,395,0,3364,395
198773,6,1886,243,0,1643,243
198773,5,480,55,0,425,55
198773,4,190,28,0,162,28
198773,3,54,8,0,46,8
198773,2,21,4,0,17,4
102680,10,1056,201,0,855,201
102680,9,2313,362,0,1951,362
102680,8,5039,688,0,4351,688
102680,7,2291,289,0,2002,289
102680,6,1156,201,0,955,201
102680,5,315,58,0,257,58
102680,4,177,38,0,139,38
102680,3,87,35,0,52,35
102680,2,38,14,0,24,14
102680,1,32,5,0,27,5
91536,10,280,48,0,232,48
91536,9,688,104,0,584,104
91536,8,3077,500,0,2577,500
91536,7,3590,567,0,3023,567
91536,6,2987,604,0,2383,604
91536,5,1023,229,0,794,229
91536,4,495,151,0,344,151
91536,3,215,58,0,157,58
91536,2,81,28,0,53,28
91536,1,43,21,0,22,21
209685,10,440,73,0,367,73
209685,9,1270,157,0,1113,157
209685,8,4851,576,0,4275,576
209685,7,3455,372,0,3083,372
209685,6,1742,249,0,1493,249
209685,5,411,81,0,330,81
209685,4,181,54,0,127,54
209685,3,65,24,0,41,24
209685,2,32,11,0,21,11
209685,1,20,7,0,13,7
438,10,128,27,0,101,27
438,9,355,71,0,284,71
438,8,1942,410,0,1532,410
438,7,3773,689,0,3084,689
438,6,4156,736,0,3420,736
438,5,1241,221,0,1020,221
438,4,476,118,0,358,118
438,3,174,39,0,135,39
438,2,59,17,0,42,17
438,1,26,6,0,20,6
278,10,245,68,0,177,68
278,9,657,134,0,523,134
278,8,2731,562,0,2169,562
278,7,3568,640,0,2928,640
278,6,3136,642,0,2494,642
278,5,990,250,0,740,250
278,4,463,144,0,319,144
278,3,211,74,0,137,74
278,2,74,29,0,45,29
278,1,33,5,0,28,5
144733,10,848,131,0,717,131
144733,9,2213,265,0,1948,265
144733,8,5161,621,0,4540,621
144733,7,2283,271,0,2012,271
144733,6,1044,168,0,876,168
144733,5,296,57,0,239,57
144733,4,132,39,0,93,39
144733,3,60,16,0,44,16
144733,2,26,12,0,14,12
144733,1,28,6,0,22,6
19857,10,791,236,2,555,234
19857,9,1599,382,4,1217,378
19857,8,4416,872,9,3544,863
19857,7,2847,523,9,2324,514
19857,6,1552,295,1,1257,294
19857,5,477,95,0,382,95
19857,4,224,53,0,171,53
19857,3,87,29,1,58,28
19857,2,53,19,0,34,19
19857,1,27,4,0,23,4
1917,10,177,37,0,140,37
1917,9,284,55,0,229,55
1917,8,1126,221,0,905,221
1917,7,2414,429,0,1985,429
1917,6,4525,867,0,3658,867
1917,5,2152,450,0,1702,450
1917,4,938,242,0,696,242
1917,3,307,92,0,215,92
1917,2,96,34,0,62,34
1917,1,19,7,0,12,7
215,10,1663,493,0,1170,493
215,9,1707,359,0,1348,359
215,8,3635,694,0,2941,694
215,7,2406,406,0,2000,406
215,6,1486,248,0,1238,248
215,5,523,93,0,430,93
215,4,265,74,0,191,74
215,3,147,29,0,118,29
215,2,85,25,0,60,25
215,1,89,19,0,70,19
45315,10,677,130,0,547,130
45315,9,1540,293,0,1247,293
45315,8,4303,674,1,3629,673
45315,7,2873,425,0,2448,425
45315,6,1686,324,0,1362,324
45315,5,468,105,0,363,105
45315,4,274,85,0,189,85
45315,3,90,24,0,66,24
45315,2,60,20,0,40,20
45315,1,33,8,0,25,8
147151,10,243,38,0,205,38
147151,9,752,72,0,680,72
147151,8,3071,407,0,2664,407
147151,7,3681,412,0,3269,412
147151,6,2828,351,0,2477,351
147151,5,838,112,0,726,112
147151,4,325,60,0,265,60
147151,3,155,28,0,127,28
147151,2,67,16,0,51,16
147151,1,27,3,0,24,3
83330,10,786,91,0,695,91
83330,9,1557,221,0,1336,221
83330,8,3820,505,0,3315,505
83330,7,2779,356,0,2423,356
83330,6,1758,287,0,1471,287
83330,5,639,121,0,518,121
83330,4,296,84,0,212,84
83330,3,175,44,0,131,44
83330,2,79,21,0,58,21
83330,1,43,15,0,28,15
21241,10,823,169,0,654,169
21241,9,1386,293,0,1093,293
21241,8,3920,665,0,3255,665
21241,7,3104,485,0,2619,485
21241,6,1839,339,0,1500,339
21241,5,502,84,0,418,84
21241,4,213,55,0,158,55
21241,3,82,25,0,57,25
21241,2,35,10,0,25,10
21241,1,17,3,0,14,3
160499,10,255,39,0,216,39
160499,9,768,102,0,666,102
160499,8,3536,419,0,3117,419
160499,7,3775,451,0,3324,451
160499,6,2412,291,0,2121,291
160499,5,701,111,0,590,111
160499,4,298,47,0,251,47
160499,3,111,23,0,88,23
160499,2,33,4,0,29,4
160499,1,26,6,0,20,6
12692,10,156,35,0,121,35
12692,9,408,70,0,338,70
12692,8,1793,275,0,1518,275
12692,7,3061,474,0,2587,474
12692,6,3951,664,1,3287,663
12692,5,1409,297,0,1112,297
12692,4,684,167,0,517,167
12692,3,290,86,0,204,86
12692,2,128,44,0,84,44
12692,1,32,13,0,19,13
20551,10,642,141,0,501,141
20551,9,1696,320,1,1376,319
20551,8,4747,771,1,3976,770
20551,7,2734,369,0,2365,369
20551,6,1344,242,0,1102,242
20551,5,397,92,0,305,92
20551,4,181,51,0,130,51
20551,3,92,23,0,69,23
20551,2,40,12,0,28,12
20551,1,30,4,0,26,4
20100,10,243,67,0,176,67
20100,9,674,178,0,496,178
20100,8,3219,778,0,2441,778
20100,7,3831,772,0,3059,772
20100,6,2717,493,0,2224,493
20100,5,741,151,0,590,151
20100,4,303,72,0,231,72
20100,3,97,23,0,74,23
20100,2,57,18,0,39,18
20100,1,17,3,0,14,3
171131,10,866,144,0,722,144
171131,9,1926,282,0,1644,282
171131,8,4479,520,0,3959,520
171131,7,2534,282,0,2252,282
171131,6,1356,177,0,1179,177
171131,5,364,71,0,293,71
171131,4,155,24,0,131,24
171131,3,81,21,0,60,21
171131,2,43,18,0,25,18
171131,1,30,6,0,24,6
503,10,245,103,0,142,103
503,9,701,271,0,430,271
503,8,3586,1113,0,2473,1113
503,7,3887,905,0,2982,905
503,6,2361,577,0,1784,577
503,5,600,144,0,456,144
503,4,245,68,0,177,68
503,3,77,26,0,51,26
503,2,47,19,0,28,19
503,1,16,3,0,13,3
59959,10,573,125,0,448,125
59959,9,1446,212,0,1234,212
59959,8,4478,628,0,3850,628
59959,7,2896,347,0,2549,347
59959,6,1524,201,0,1323,201
59959,5,425,85,0,340,85
59959,4,202,38,0,164,38
59959,3,101,22,0,79,22
59959,2,61,21,0,40,21
59959,1,33,7,0,26,7
163967,10,390,71,5,319,66
163967,9,1087,145,14,942,131
163967,8,4582,613,39,3969,574
163967,7,3363,408,21,2955,387
163967,6,1502,230,5,1272,225
163967,5,372,64,4,308,60
163967,4,158,34,0,124,34
163967,3,68,28,0,40,28
163967,2,25,11,1,14,10
163967,1,9,3,1,6,2
127398,10,494,87,0,407,87
127398,9,1291,186,0,1105,186
127398,8,3792,453,0,3339,453
127398,7,3056,359,0,2697,359
127398,6,1823,271,0,1552,271
127398,5,552,96,0,456,96
127398,4,287,45,0,242,45
127398,3,161,30,0,131,30
127398,2,60,13,0,47,13
127398,1,27,5,0,22,5
27627,10,592,131,0,461,131
27627,9,799,142,0,657,142
27627,8,2152,364,0,1788,364
27627,7,2586,364,0,2222,364
27627,6,2684,458,0,2226,458
27627,5,1144,214,0,930,214
27627,4,716,160,0,556,160
27627,3,428,97,0,331,97
27627,2,270,80,0,190,80
27627,1,111,31,0,80,31
25292,10,716,171,0,545,171
25292,9,1523,332,0,1191,332
25292,8,4161,702,0,3459,702
25292,7,2564,380,0,2184,380
25292,6,1531,279,0,1252,279
25292,5,486,95,0,391,95
25292,4,276,71,0,205,71
25292,3,124,42,0,82,42
25292,2,57,16,0,41,16
25292,1,33,8,0,25,8
131835,10,164,22,0,142,22
131835,9,347,49,2,298,47
131835,8,1655,200,7,1455,193
131835,7,2918,336,8,2582,328
131835,6,3666,550,17,3116,533
131835,5,1356,226,7,1130,219
131835,4,696,144,7,552,137
131835,3,322,72,3,250,69
131835,2,138,48,3,90,45
131835,1,41,13,1,28,12
25554,10,309,92,0,217,92
25554,9,1084,249,0,835,249
25554,8,4432,932,0,3500,932
25554,7,3234,578,0,2656,578
25554,6,1495,324,0,1171,324
25554,5,433,114,0,319,114
25554,4,154,49,0,105,49
25554,3,51,18,0,33,18
25554,2,25,5,0,20,5
25554,1,21,1,0,20,1
188834,10,1069,170,8,899,162
188834,9,1929,242,7,1687,235
188834,8,3746,474,15,3272,459
188834,7,2274,252,6,2022,246
188834,6,1308,173,2,1135,171
188834,5,399,70,0,329,70
188834,4,239,56,1,183,55
188834,3,125,21,1,104,20
188834,2,70,17,0,53,17
188834,1,77,21,1,56,20
71721,10,314,75,0,239,75
71721,9,731,175,0,556,175
71721,8,3147,642,0,2505,642
71721,7,3417,639,0,2778,639
71721,6,2398,437,0,1961,437
71721,5,678,134,0,544,134
71721,4,286,76,0,210,76
71721,3,135,36,0,99,36
71721,2,61,17,0,44,17
71721,1,24,9,0,15,9
133038,10,703,134,0,569,134
133038,9,1470,245,0,1225,245
133038,8,3466,539,0,2927,539
133038,7,2516,388,0,2128,388
133038,6,1786,283,0,1503,283
133038,5,618,148,0,470,148
133038,4,318,90,0,228,90
133038,3,191,50,0,141,50
133038,2,72,21,0,51,21
133038,1,47,12,0,35,12
483,10,1146,398,0,748,398
483,9,1279,335,0,944,335
483,8,2429,584,0,1845,584
483,7,2440,532,0,1908,532
483,6,1993,465,0,1528,465
483,5,767,194,0,573,194
483,4,458,157,0,301,157
483,3,295,107,0,188,107
483,2,229,99,0,130,99
483,1,102,52,0,50,52
45,10,358,137,0,221,137
45,9,761,231,0,530,231
45,8,2697,700,0,1997,700
45,7,3359,720,0,2639,720
45,6,2620,567,0,2053,567
45,5,778,171,1,607,170
45,4,333,88,0,245,88
45,3,131,40,0,91,40
45,2,55,13,0,42,13
45,1,36,12,0,24,12
209010,10,1542,255,0,1287,255
209010,9,2791,346,0,2445,346
209010,8,4204,468,1,3736,467
209010,7,1501,153,0,1348,153
209010,6,679,95,0,584,95
209010,5,177,17,0,160,17
209010,4,84,20,0,64,20
209010,3,39,5,0,34,5
209010,2,24,6,0,18,6
209010,1,50,7,0,43,7
156129,10,610,115,1,495,114
156129,9,1548,223,1,1325,222
156129,8,4275,566,13,3709,553
156129,7,2606,317,5,2289,312
156129,6,1356,182,0,1174,182
156129,5,389,64,2,325,62
156129,4,194,45,0,149,45
156129,3,72,24,0,48,24
156129,2,16,4,0,12,4
156129,1,16,5,0,11,5
177736,10,1756,283,0,1473,283
177736,9,2907,336,0,2571,336
177736,8,3877,398,0,3479,398
177736,7,1420,160,0,1260,160
177736,6,688,103,1,585,102
177736,5,203,34,0,169,34
177736,4,91,24,0,67,24
177736,3,62,19,0,43,19
177736,2,25,10,1,15,9
177736,1,25,2,0,23,2
125618,10,258,49,0,209,49
125618,9,879,157,1,722,156
125618,8,3918,546,0,3372,546
125618,7,3298,381,0,2917,381
125618,6,1848,255,0,1593,255
125618,5,473,77,0,396,77
125618,4,201,38,0,163,38
125618,3,100,24,0,76,24
125618,2,33,17,0,16,17
125618,1,22,2,0,20,2
140620,10,463,86,0,377,86
140620,9,1467,258,0,1209,258
140620,8,4540,557,0,3983,557
140620,7,2617,340,1,2277,339
140620,6,1289,202,1,1087,201
140620,5,341,69,0,272,69
140620,4,148,39,0,109,39
140620,3,73,16,0,57,16
140620,2,38,13,0,25,13
140620,1,25,5,0,20,5
119890,10,382,95,0,287,95
119890,9,1077,197,0,880,197
119890,8,4441,789,0,3652,789
119890,7,3102,509,0,2593,509
119890,6,1417,221,0,1196,221
119890,5,309,63,0,246,63
119890,4,118,21,0,97,21
119890,3,57,12,0,45,12
119890,2,27,2,0,25,2
119890,1,28,2,0,26,2
97207,10,585,102,0,483,102
97207,9,1500,240,0,1260,240
97207,8,4288,647,0,3641,647
97207,7,2538,356,0,2182,356
97207,6,1344,203,0,1141,203
97207,5,364,63,0,301,63
97207,4,182,45,0,137,45
97207,3,92,16,0,76,16
97207,2,37,13,0,24,13
97207,1,26,3,0,23,3
17226,10,724,164,0,560,164
17226,9,1368,272,0,1096,272
17226,8,3317,688,0,2629,688
17226,7,2663,589,0,2074,589
17226,6,1732,378,0,1354,378
17226,5,577,163,0,414,163
17226,4,281,95,0,186,95
17226,3,136,48,0,88,48
17226,2,54,24,0,30,24
17226,1,35,7,0,28,7
37380,10,88,23,1,65,22
37380,9,395,68,0,327,68
37380,8,2958,664,0,2294,664
37380,7,3899,748,0,3151,748
37380,6,2477,545,0,1932,545
37380,5,658,163,0,495,163
37380,4,237,68,0,169,68
37380,3,81,26,0,55,26
37380,2,41,14,0,27,14
37380,1,23,5,0,18,5
41,10,260,88,0,172,88
41,9,523,168,0,355,168
41,8,2483,714,0,1769,714
41,7,3512,887,1,2625,886
41,6,2828,657,0,2171,657
41,5,727,168,0,559,168
41,4,306,84,0,222,84
41,3,105,29,0,76,29
41,2,50,16,0,34,16
41,1,15,6,0,9,6
155703,10,343,73,2,270,71
155703,9,950,159,7,791,152
155703,8,3518,528,22,2990,506
155703,7,3167,400,19,2767,381
155703,6,1881,262,5,1619,257
155703,5,501,95,1,406,94
155703,4,224,55,0,169,55
155703,3,89,21,0,68,21
155703,2,27,8,0,19,8
155703,1,22,6,0,16,6
162886,10,2627,496,9,2131,487
162886,9,2937,381,2,2556,379
162886,8,3024,384,2,2640,382
162886,7,1073,126,0,947,126
162886,6,635,111,1,524,110
162886,5,192,32,1,160,31
162886,4,96,28,1,68,27
162886,3,71,23,0,48,23
162886,2,25,12,0,13,12
162886,1,40,11,0,29,11
66188,10,258,36,0,222,36
66188,9,749,162,0,587,162
66188,8,4148,696,0,3452,696
66188,7,3290,484,0,2806,484
66188,6,1543,264,0,1279,264
66188,5,373,71,0,302,71
66188,4,131,39,0,92,39
66188,3,38,8,0,30,8
66188,2,17,4,0,13,4
66188,1,14,4,0,10,4
34119,10,667,138,0,529,138
34119,9,1145,230,0,915,230
34119,8,3329,640,0,2689,640
34119,7,2532,474,0,2058,474
34119,6,1690,377,0,1313,377
34119,5,482,115,0,367,115
34119,4,287,98,0,189,98
34119,3,185,67,0,118,67
34119,2,102,39,0,63,39
34119,1,72,29,0,43,29
69789,10,377,69,0,308,69
69789,9,808,183,0,625,183
69789,8,2933,570,0,2363,570
69789,7,3066,576,0,2490,576
69789,6,2114,483,0,1631,483
69789,5,667,188,0,479,188
69789,4,325,113,0,212,113
69789,3,127,54,0,73,54
69789,2,52,17,0,35,17
69789,1,18,3,0,15,3
205896,10,1719,300,31,1419,269
205896,9,2533,321,52,2212,269
205896,8,3341,364,36,2977,328
205896,7,1379,157,13,1222,144
205896,6,829,132,6,697,126
205896,5,291,59,3,232,56
205896,4,140,35,1,105,34
205896,3,93,24,0,69,24
205896,2,57,18,0,39,18
205896,1,85,31,0,54,31
9216,10,534,184,0,350,184
9216,9,1571,457,0,1114,457
9216,8,4362,951,0,3411,951
9216,7,2337,443,0,1894,443
9216,6,1085,254,0,831,254
9216,5,326,102,0,224,102
9216,4,119,49,0,70,49
9216,3,59,26,0,33,26
9216,2,26,8,0,18,8
9216,1,36,5,0,31,5
17133,10,768,252,2,516,250
17133,9,1719,404,1,1315,403
17133,8,4148,908,1,3240,907
17133,7,2189,484,0,1705,484
17133,6,1053,267,0,786,267
17133,5,288,82,0,206,82
17133,4,126,47,0,79,47
17133,3,50,18,0,32,18
17133,2,38,11,0,27,11
17133,1,36,4,0,32,4
811,10,185,34,0,151,34
811,9,368,52,0,316,52
811,8,1333,193,0,1140,193
811,7,2516,380,0,2136,380
811,6,3577,571,0,3006,571
811,5,1485,244,0,1241,244
811,4,604,140,0,464,140
811,3,188,50,0,138,50
811,2,76,26,0,50,26
811,1,29,9,0,20,9
155362,10,151,24,0,127,24
155362,9,519,68,0,451,68
155362,8,3038,442,0,2596,442
155362,7,3364,445,0,2919,445
155362,6,2298,290,0,2008,290
155362,5,594,74,0,520,74
155362,4,239,59,0,180,59
155362,3,84,25,0,59,25
155362,2,47,15,0,32,15
155362,1,17,7,0,10,7
4390,10,283,95,0,188,95
4390,9,793,243,0,550,243
4390,8,3157,868,0,2289,868
4390,7,3227,739,0,2488,739
4390,6,1992,463,0,1529,463
4390,5,531,137,0,394,137
4390,4,191,60,0,131,60
4390,3,69,16,0,53,16
4390,2,25,8,0,17,8
4390,1,14,1,0,13,1
2397,10,500,161,0,339,161
2397,9,559,138,0,421,138
2397,8,1506,350,0,1156,350
2397,7,2426,513,0,1913,513
2397,6,2932,592,0,2340,592
2397,5,1367,286,0,1081,286
2397,4,652,189,0,463,189
2397,3,225,51,0,174,51
2397,2,69,24,0,45,24
2397,1,26,7,0,19,7
209778,10,299,44,0,255,44
209778,9,884,116,0,768,116
209778,8,3435,349,0,3086,349
209778,7,3039,303,0,2736,303
209778,6,1714,192,0,1522,192
209778,5,412,70,0,342,70
209778,4,217,45,0,172,45
209778,3,77,15,0,62,15
209778,2,48,17,0,31,17
209778,1,30,3,0,27,3
43015,10,726,200,0,526,200
43015,9,1575,330,0,1245,330
43015,8,3978,659,0,3319,659
43015,7,2142,344,0,1798,344
43015,6,1033,177,0,856,177
43015,5,343,78,0,265,78
43015,4,166,47,0,119,47
43015,3,65,23,0,42,23
43015,2,33,9,0,24,9
43015,1,35,8,0,27,8
172818,10,435,89,5,346,84
172818,9,1279,205,5,1074,200
172818,8,4057,569,21,3488,548
172818,7,2448,350,15,2098,335
172818,6,1278,219,6,1059,213
172818,5,330,82,2,248,80
172818,4,129,32,0,97,32
172818,3,56,19,1,37,18
172818,2,19,5,0,14,5
172818,1,13,3,1,10,2
126042,10,741,151,0,590,151
126042,9,1726,252,0,1474,252
126042,8,3905,536,0,3369,536
126042,7,1991,253,0,1738,253
126042,6,1045,173,0,872,173
126042,5,324,66,0,258,66
126042,4,164,42,0,122,42
126042,3,76,19,0,57,19
126042,2,31,8,0,23,8
126042,1,34,6,0,28,6
160477,10,428,86,0,342,86
160477,9,1136,208,0,928,208
160477,8,3846,481,0,3365,481
160477,7,2805,329,0,2476,329
160477,6,1282,206,0,1076,206
160477,5,304,50,0,254,50
160477,4,107,33,0,74,33
160477,3,45,17,0,28,17
160477,2,16,6,0,10,6
218603,10,249,37,0,212,37
218603,9,793,111,0,682,111
218603,8,3658,388,0,3270,388
218603,7,3017,338,0,2679,338
218603,6,1587,202,0,1385,202
218603,5,383,65,0,318,65
218603,4,185,51,0,134,51
218603,3,63,19,0,44,19
218603,2,24,9,0,15,9
218603,1,13,2,0,11,2
46213,10,602,121,0,481,121
46213,9,1211,185,0,1026,185
46213,8,3280,513,1,2767,512
46213,7,2589,352,0,2237,352
46213,6,1531,203,0,1328,203
46213,5,392,56,0,336,56
46213,4,167,41,0,126,41
46213,3,62,11,0,51,11
46213,2,33,7,0,26,7
46213,1,27,3,0,24,3
31627,10,560,104,0,456,104
31627,9,1309,243,0,1066,243
31627,8,4166,726,0,3440,726
31627,7,2524,371,0,2153,371
31627,6,888,156,0,732,156
31627,5,214,32,0,182,32
31627,4,85,13,0,72,13
31627,3,37,3,0,34,3
31627,2,33,4,0,29,4
31627,1,29,4,0,25,4
161417,10,180,22,0,158,22
161417,9,558,95,0,463,95
161417,8,2700,413,0,2287,413
161417,7,3283,477,0,2806,477
161417,6,2148,291,0,1857,291
161417,5,562,89,0,473,89
161417,4,251,49,0,202,49
161417,3,112,17,0,95,17
161417,2,28,7,0,21,7
161417,1,18,4,0,14,4
2243,10,103,30,0,73,30
2243,9,123,32,0,91,32
2243,8,440,73,0,367,73
2243,7,1138,187,0,951,187
2243,6,2837,574,0,2263,574
2243,5,2517,530,0,1987,530
2243,4,1605,377,0,1228,377
2243,3,655,202,0,453,202
2243,2,287,95,0,192,95
2243,1,115,44,0,71,44
171668,10,301,58,0,243,58
171668,9,820,121,0,699,121
171668,8,3547,467,1,3080,466
171668,7,2906,395,0,2511,395
171668,6,1550,219,0,1331,219
171668,5,411,73,0,338,73
171668,4,173,46,0,127,46
171668,3,89,20,0,69,20
171668,2,19,6,0,13,6
171668,1,8,1,0,7,1
6472,10,562,145,0,417,145
6472,9,1224,298,0,926,298
6472,8,3058,674,0,2384,674
6472,7,2323,447,0,1876,447
6472,6,1550,362,0,1188,362
6472,5,526,134,0,392,134
6472,4,262,81,0,181,81
6472,3,148,51,0,97,51
6472,2,87,33,0,54,33
6472,1,47,10,0,37,10
8098,10,261,54,0,207,54
8098,9,462,76,0,386,76
8098,8,1660,310,0,1350,310
8098,7,2616,356,0,2260,356
8098,6,2964,446,0,2518,446
8098,5,970,150,0,820,150
8098,4,458,95,0,363,95
8098,3,198,44,0,154,44
8098,2,108,33,0,75,33
8098,1,55,18,0,37,18
115746,10,2824,538,0,2286,538
115746,9,2416,322,0,2094,322
115746,8,2537,283,0,2254,283
115746,7,1020,101,0,919,101
115746,6,529,61,0,468,61
115746,5,195,21,0,174,21
115746,4,89,11,0,78,11
115746,3,47,7,0,40,7
115746,2,39,4,0,35,4
115746,1,56,4,0,52,4
93260,10,944,208,0,736,208
93260,9,1313,242,0,1071,242
93260,8,3389,493,0,2896,493
93260,7,2052,230,0,1822,230
93260,6,1267,151,1,1116,150
93260,5,418,71,0,347,71
93260,4,181,32,0,149,32
93260,3,83,11,0,72,11
93260,2,42,7,0,35,7
93260,1,35,2,0,33,2
31594,10,393,110,0,283,110
31594,9,1047,253,0,794,253
31594,8,3814,774,0,3040,774
31594,7,2470,443,0,2027,443
31594,6,1292,250,0,1042,250
31594,5,368,95,0,273,95
31594,4,170,52,0,118,52
31594,3,86,28,0,58,28
31594,2,35,12,0,23,12
31594,1,33,8,0,25,8
699,10,808,184,0,624,184
699,9,852,183,0,669,183
699,8,2164,467,0,1697,467
699,7,2432,487,1,1945,486
699,6,2194,471,1,1723,470
699,5,746,185,0,561,185
699,4,307,97,0,210,97
699,3,105,25,0,80,25
699,2,40,13,0,27,13
699,1,14,6,0,8,6
92415,10,443,69,0,374,69
92415,9,941,158,0,783,158
92415,8,2847,404,0,2443,404
92415,7,2697,348,0,2349,348
92415,6,1796,271,0,1525,271
92415,5,537,85,0,452,85
92415,4,234,52,0,182,52
92415,3,88,16,0,72,16
92415,2,54,13,0,41,13
92415,1,32,13,0,19,13
98,10,364,115,0,249,115
98,9,494,116,0,378,116
98,8,1674,411,0,1263,411
98,7,2396,560,0,1836,560
98,6,2826,732,0,2094,732
98,5,1018,324,0,694,324
98,4,461,173,0,288,173
98,3,246,107,0,139,107
98,2,125,53,0,72,53
98,1,26,9,0,17,9
53953,10,256,56,0,200,56
53953,9,775,135,0,640,135
53953,8,2746,523,0,2223,523
53953,7,2661,457,0,2204,457
53953,6,1949,388,0,1561,388
53953,5,703,146,0,557,146
53953,4,308,92,0,216,92
53953,3,131,36,0,95,36
53953,2,65,21,0,44,21
53953,1,29,3,0,26,3
175914,10,1911,359,0,1552,359
175914,9,2504,347,0,2157,347
175914,8,2980,380,0,2600,380
175914,7,1048,145,0,903,145
175914,6,631,106,0,525,106
175914,5,206,38,0,168,38
175914,4,131,39,0,92,39
175914,3,82,31,0,51,31
175914,2,43,13,0,30,13
175914,1,52,11,0,41,11
176189,10,894,123,7,771,116
176189,9,1721,211,17,1510,194
176189,8,3506,385,27,3121,358
176189,7,1953,214,17,1739,197
176189,6,905,114,8,791,106
176189,5,272,35,1,237,34
176189,4,123,15,0,108,15
176189,3,72,19,0,53,19
176189,2,43,6,0,37,6
176189,1,39,3,0,36,3
22545,10,609,194,0,415,194
22545,9,1350,369,1,981,368
22545,8,3650,753,2,2897,751
22545,7,2156,425,0,1731,425
22545,6,1099,250,0,849,250
22545,5,332,101,0,231,101
22545,4,163,64,0,99,64
22545,3,76,30,0,46,30
22545,2,24,8,0,16,8
22545,1,22,4,0,18,4
42215,10,188,41,0,147,41
42215,9,569,132,0,437,132
42215,8,3137,641,0,2496,641
42215,7,3103,520,0,2583,520
42215,6,1802,348,0,1454,348
42215,5,425,106,0,319,106
42215,4,169,43,0,126,43
42215,3,59,16,0,43,16
42215,2,21,7,0,14,7
9609,10,1317,437,0,880,437
9609,9,1814,486,0,1328,486
9609,8,3026,696,0,2330,696
9609,7,1662,368,0,1294,368
9609,6,913,194,0,719,194
9609,5,320,80,0,240,80
9609,4,192,59,0,133,59
9609,3,94,41,0,53,41
9609,2,52,14,0,38,14
9609,1,74,14,0,60,14
1198,10,289,63,0,226,63
1198,9,446,77,0,369,77
1198,8,1494,282,0,1212,282
1198,7,2445,435,0,2010,435
1198,6,2855,529,0,2326,529
1198,5,973,204,0,769,204
1198,4,526,128,0,398,128
1198,3,233,62,0,171,62
1198,2,112,45,0,67,45
1198,1,47,14,0,33,14
521,10,1505,463,3,1042,460
521,9,1597,375,0,1222,375
521,8,2946,628,2,2318,626
521,7,1684,275,2,1409,273
521,6,959,156,1,803,155
521,5,343,62,0,281,62
521,4,170,33,0,137,33
521,3,72,9,0,63,9
521,2,47,10,0,37,10
521,1,87,10,0,77,10
90137,10,376,80,0,296,80
90137,9,925,176,0,749,176
90137,8,3633,571,0,3062,571
90137,7,2552,346,0,2206,346
90137,6,1283,202,0,1081,202
90137,5,360,60,0,300,60
90137,4,155,37,0,118,37
90137,3,70,11,0,59,11
90137,2,30,6,0,24,6
90137,1,15,3,0,12,3
2452,10,90,17,0,73,17
2452,9,127,26,0,101,26
2452,8,567,97,0,470,97
2452,7,1282,208,0,1074,208
2452,6,3130,525,0,2605,525
2452,5,2240,395,0,1845,395
2452,4,1289,272,0,1017,272
2452,3,412,93,0,319,93
2452,2,194,58,0,136,58
2452,1,51,13,0,38,13
156009,10,197,41,0,156,41
156009,9,642,101,0,541,101
156009,8,2891,400,0,2491,400
156009,7,3285,399,0,2886,399
156009,6,1803,238,0,1565,238
156009,5,380,63,0,317,63
156009,4,119,26,0,93,26
156009,3,53,17,0,36,17
156009,2,11,6,0,5,6
156009,1,12,1,0,11,1
19237,10,128,35,0,93,35
19237,9,331,86,0,245,86
19237,8,1951,561,0,1390,561
19237,7,2783,605,0,2178,605
19237,6,2719,601,0,2118,601
19237,5,832,181,0,651,181
19237,4,370,94,0,276,94
19237,3,142,37,0,105,37
19237,2,76,26,0,50,26
19237,1,36,6,0,30,6
150312,10,80,8,0,72,8
150312,9,227,36,0,191,36
150312,8,1875,280,0,1595,280
150312,7,3263,432,0,2831,432
150312,6,2734,357,0,2377,357
150312,5,710,82,0,628,82
150312,4,298,60,0,238,60
150312,3,96,11,0,85,11
150312,2,40,13,0,27,13
150312,1,15,4,0,11,4
63268,10,252,45,0,207,45
63268,9,470,68,0,402,68
63268,8,1655,267,0,1388,267
63268,7,2632,379,0,2253,379
63268,6,2750,369,0,2381,369
63268,5,882,110,0,772,110
63268,4,376,52,0,324,52
63268,3,131,24,0,107,24
63268,2,58,14,0,44,14
63268,1,21,4,0,17,4
146652,10,784,162,0,622,162
146652,9,1785,286,0,1499,286
146652,8,3584,485,0,3099,485
146652,7,1759,225,0,1534,225
146652,6,815,120,0,695,120
146652,5,237,46,0,191,46
146652,4,112,27,0,85,27
146652,3,51,13,0,38,13
146652,2,24,2,0,22,2
146652,1,27,1,0,26,1
220308,10,2714,397,0,2317,397
220308,9,2505,246,0,2259,246
220308,8,2436,225,0,2211,225
220308,7,788,80,0,708,80
220308,6,392,50,0,342,50
220308,5,123,24,0,99,24
220308,4,53,13,0,40,13
220308,3,32,8,0,24,8
220308,2,25,6,0,19,6
220308,1,55,7,0,48,7
138161,10,714,158,0,556,158
138161,9,1162,185,0,977,185
138161,8,2926,483,0,2443,483
138161,7,2145,356,0,1789,356
138161,6,1264,226,0,1038,226
138161,5,391,80,0,311,80
138161,4,227,59,0,168,59
138161,3,136,36,0,100,36
138161,2,60,16,0,44,16
138161,1,32,10,0,22,10
1111,10,156,32,0,124,32
1111,9,375,88,0,287,88
1111,8,1207,273,0,934,273
1111,7,2117,382,0,1735,382
1111,6,2867,458,0,2409,458
1111,5,1205,178,0,1027,178
1111,4,632,121,0,511,121
1111,3,224,42,0,182,42
1111,2,110,29,0,81,29
1111,1,42,16,0,26,16
25417,10,520,158,0,362,158
25417,9,1096,314,0,782,314
25417,8,2955,715,0,2240,715
25417,7,2294,560,0,1734,560
25417,6,1324,371,0,953,371
25417,5,414,109,0,305,109
25417,4,166,65,0,101,65
25417,3,81,33,0,48,33
25417,2,31,11,0,20,11
25417,1,35,8,0,27,8
118048,10,334,69,0,265,69
118048,9,1098,176,0,922,176
118048,8,4008,536,0,3472,536
118048,7,2318,267,0,2051,267
118048,6,866,125,0,741,125
118048,5,178,41,0,137,41
118048,4,62,16,0,46,16
118048,3,27,7,0,20,7
118048,2,10,2,0,8,2
118048,1,8,1,0,7,1
27833,10,578,141,0,437,141
27833,9,1409,282,0,1127,282
27833,8,3469,562,0,2907,562
27833,7,1948,310,0,1638,310
27833,6,987,194,0,793,194
27833,5,270,64,0,206,64
27833,4,124,25,0,99,25
27833,3,55,17,0,38,17
27833,2,31,7,0,24,7
27833,1,26,6,0,20,6
70149,10,665,113,0,552,113
70149,9,1566,203,0,1363,203
70149,8,3522,473,0,3049,473
70149,7,1742,237,0,1505,237
70149,6,871,147,0,724,147
70149,5,243,48,0,195,48
70149,4,117,26,0,91,26
70149,3,57,9,0,48,9
70149,2,23,3,0,20,3
70149,1,42,7,0,35,7
180263,10,2494,437,39,2057,398
180263,9,2485,381,48,2104,333
180263,8,2158,276,36,1882,240
180263,7,801,103,10,698,93
180263,6,463,89,7,374,82
180263,5,190,46,4,144,42
180263,4,85,27,2,58,25
180263,3,69,19,0,50,19
180263,2,44,24,0,20,24
180263,1,67,18,0,49,18
136888,10,357,77,0,280,77
136888,9,956,169,0,787,169
136888,8,3668,576,0,3092,576
136888,7,2239,286,0,1953,286
136888,6,1097,213,0,884,213
136888,5,279,58,0,221,58
136888,4,131,46,0,85,46
136888,3,65,18,0,47,18
136888,2,27,11,0,16,11
136888,1,22,9,0,13,9
216132,10,839,135,11,704,124
216132,9,2109,261,25,1848,236
216132,8,3776,428,25,3348,403
216132,7,1374,160,7,1214,153
216132,6,541,87,2,454,85
216132,5,122,18,1,104,17
216132,4,39,12,0,27,12
216132,3,15,2,0,13,2
216132,2,12,4,0,8,4
216132,1,18,3,0,15,3
2921,10,156,32,0,124,32
2921,9,41,10,0,31,10
2921,8,154,30,0,124,30
2921,7,431,75,0,356,75
2921,6,1167,206,0,961,206
2921,5,1713,285,0,1428,285
2921,4,2110,437,0,1673,437
2921,3,1461,352,0,1109,352
2921,2,1044,318,0,726,318
2921,1,506,180,0,326,180
180974,10,226,37,0,189,37
180974,9,574,71,0,503,71
180974,8,2916,341,0,2575,341
180974,7,2888,296,0,2592,296
180974,6,1569,199,0,1370,199
180974,5,344,64,0,280,64
180974,4,137,36,0,101,36
180974,3,39,5,0,34,5
180974,2,20,2,0,18,2
180974,1,7,2,0,5,2
172287,10,630,130,1,500,129
172287,9,1452,212,10,1240,202
172287,8,3830,538,14,3292,524
172287,7,1716,210,7,1506,203
172287,6,758,125,1,633,124
172287,5,195,43,0,152,43
172287,4,69,19,0,50,19
172287,3,37,12,0,25,12
172287,2,14,4,0,10,4
172287,1,13,4,0,9,4
20963,10,307,88,0,219,88
20963,9,843,203,0,640,203
20963,8,2751,597,0,2154,597
20963,7,2361,456,0,1905,456
20963,6,1533,345,0,1188,345
20963,5,476,137,0,339,137
20963,4,232,73,0,159,73
20963,3,107,42,0,65,42
20963,2,46,19,0,27,19
20963,1,27,6,0,21,6
33160,10,267,63,1,204,62
33160,9,940,209,0,731,209
33160,8,3569,664,1,2905,663
33160,7,2312,397,1,1915,396
33160,6,1093,243,0,850,243
33160,5,298,80,0,218,80
33160,4,124,36,0,88,36
33160,3,43,15,0,28,15
33160,2,17,4,0,13,4
33160,1,17,2,0,15,2
150,10,368,97,0,271,97
150,9,834,225,0,609,225
150,8,2737,716,0,2021,716
150,7,2533,561,0,1972,561
150,6,1505,329,0,1176,329
150,5,408,90,0,318,90
150,4,167,40,0,127,40
150,3,56,14,0,42,14
150,2,37,8,0,29,8
150,1,17,7,0,10,7
97786,10,316,30,0,286,30
97786,9,809,96,0,713,96
97786,8,3061,340,0,2721,340
97786,7,2571,265,0,2306,265
97786,6,1309,161,0,1148,161
97786,5,339,50,0,289,50
97786,4,131,22,0,109,22
97786,3,63,16,0,47,16
97786,2,27,6,0,21,6
97786,1,23,2,0,21,2
1219,10,131,38,0,93,38
1219,9,232,55,0,177,55
1219,8,1055,259,0,796,259
1219,7,2252,478,0,1774,478
1219,6,3363,751,0,2612,751
1219,5,1068,224,0,844,224
1219,4,390,87,0,303,87
1219,3,101,25,0,76,25
1219,2,36,10,0,26,10
1219,1,9,1,0,8,1
176396,10,182,26,0,156,26
176396,9,655,91,0,564,91
176396,8,3518,414,0,3104,414
176396,7,2648,295,0,2353,295
176396,6,1226,168,0,1058,168
176396,5,253,50,0,203,50
176396,4,89,16,0,73,16
176396,3,35,8,0,27,8
176396,2,16,2,0,14,2
68425,10,212,62,2,150,60
68425,9,672,142,3,530,139
68425,8,2691,486,19,2205,467
68425,7,2593,428,11,2165,417
68425,6,1594,330,7,1264,323
68425,5,506,122,2,384,120
68425,4,214,73,5,141,68
68425,3,60,19,0,41,19
68425,2,38,17,1,21,16
68425,1,26,10,1,16,9
172386,10,664,110,0,554,110
172386,9,1797,215,0,1582,215
172386,8,3754,378,1,3376,377
172386,7,1423,137,0,1286,137
172386,6,597,88,0,509,88
172386,5,166,32,0,134,32
172386,4,68,18,0,50,18
172386,3,30,10,0,20,10
172386,2,15,2,0,13,2
172386,1,22,4,0,18,4
194594,10,265,36,0,229,36
194594,9,784,107,0,677,107
194594,8,3195,369,0,2826,369
194594,7,2539,261,0,2278,261
194594,6,1266,180,1,1086,179
194594,5,299,42,0,257,42
194594,4,144,31,0,113,31
194594,3,33,8,0,25,8
194594,2,15,3,0,12,3
194594,1,13,3,0,10,3
30869,10,159,44,0,115,44
30869,9,545,153,1,392,152
30869,8,2992,770,0,2222,770
30869,7,2692,539,1,2153,538
30869,6,1526,390,1,1136,389
30869,5,359,98,0,261,98
30869,4,153,53,0,100,53
30869,3,56,21,0,35,21
30869,2,19,5,0,14,5
30869,1,18,4,0,14,4
170042,10,515,93,3,422,90
170042,9,1524,195,8,1329,187
170042,8,3792,448,19,3344,429
170042,7,1734,203,4,1531,199
170042,6,689,108,2,581,106
170042,5,153,32,0,121,32
170042,4,67,16,1,51,15
170042,3,24,10,0,14,10
170042,2,9,2,0,7,2
25821,10,378,55,0,323,55
25821,9,653,105,0,548,105
25821,8,1877,281,0,1596,281
25821,7,2198,291,0,1907,291
25821,6,2030,285,0,1745,285
25821,5,644,100,0,544,100
25821,4,336,58,0,278,58
25821,3,186,40,0,146,40
25821,2,96,22,0,74,22
25821,1,89,13,0,76,13
191862,10,147,25,0,122,25
191862,9,574,92,0,482,92
191862,8,2980,401,0,2579,401
191862,7,2881,344,0,2537,344
191862,6,1369,188,0,1181,188
191862,5,295,67,0,228,67
191862,4,91,20,0,71,20
191862,3,36,9,0,27,9
191862,2,14,2,0,12,2
191862,1,8,2,0,6,2
244992,10,327,68,0,259,68
244992,9,780,116,0,664,116
244992,8,2554,355,0,2199,355
244992,7,2326,251,0,2075,251
244992,6,1417,171,0,1246,171
244992,5,396,61,0,335,61
244992,4,233,44,0,189,44
244992,3,124,29,0,95,29
244992,2,103,29,0,74,29
244992,1,134,67,0,67,67
39683,10,327,84,0,243,84
39683,9,920,214,0,706,214
39683,8,3184,689,0,2495,689
39683,7,2160,388,0,1772,388
39683,6,1169,266,0,903,266
39683,5,334,93,0,241,93
39683,4,150,45,0,105,45
39683,3,57,19,0,38,19
39683,2,24,9,0,15,9
39683,1,16,2,0,14,2
155821,10,954,215,0,739,215
155821,9,1615,207,0,1408,207
155821,8,2968,319,0,2649,319
155821,7,1442,155,0,1287,155
155821,6,808,110,0,698,110
155821,5,281,52,0,229,52
155821,4,154,36,0,118,36
155821,3,76,20,0,56,20
155821,2,31,8,0,23,8
155821,1,17,6,0,11,6
21348,10,317,63,0,254,63
21348,9,829,176,0,653,176
21348,8,3247,708,0,2539,708
21348,7,2402,461,0,1941,461
21348,6,1029,242,0,787,242
21348,5,277,86,0,191,86
21348,4,110,30,0,80,30
21348,3,49,17,0,32,17
21348,2,27,9,0,18,9
21348,1,22,1,0,21,1
182874,10,589,122,0,467,122
182874,9,1391,223,0,1168,223
182874,8,3670,470,0,3200,470
182874,7,1586,174,0,1412,174
182874,6,704,134,0,570,134
182874,5,192,41,0,151,41
182874,4,85,27,0,58,27
182874,3,43,15,0,28,15
182874,2,29,8,0,21,8
182874,1,13,1,0,12,1
63628,10,307,65,0,242,65
63628,9,882,154,1,728,153
63628,8,3378,516,6,2862,510
63628,7,2115,295,1,1820,294
63628,6,1093,199,2,894,197
63628,5,299,67,1,232,66
63628,4,133,36,1,97,35
63628,3,44,14,2,30,12
63628,2,25,7,0,18,7
63628,1,17,4,0,13,4
128621,10,605,103,3,502,100
128621,9,1342,181,6,1161,175
128621,8,3291,396,25,2895,371
128621,7,1691,184,5,1507,179
128621,6,862,131,2,731,129
128621,5,251,48,1,203,47
128621,4,122,34,1,88,33
128621,3,63,20,1,43,19
128621,2,26,9,0,17,9
128621,1,37,5,0,32,5
91312,10,372,67,0,305,67
91312,9,704,116,0,588,116
91312,8,2607,411,0,2196,411
91312,7,2480,373,0,2107,373
91312,6,1408,231,0,1177,231
91312,5,405,92,0,313,92
91312,4,180,48,0,132,48
91312,3,73,22,0,51,22
91312,2,38,14,0,24,14
91312,1,12,3,0,9,3
181279,10,555,114,0,441,114
181279,9,1264,150,0,1114,150
181279,8,3146,388,0,2758,388
181279,7,1727,175,0,1552,175
181279,6,952,111,0,841,111
181279,5,287,49,0,238,49
181279,4,142,25,0,117,25
181279,3,72,23,0,49,23
181279,2,42,9,0,33,9
181279,1,25,7,0,18,7
15363,10,240,91,0,149,91
15363,9,646,215,0,431,215
15363,8,2820,927,0,1893,927
15363,7,2506,653,0,1853,653
15363,6,1357,356,0,1001,356
15363,5,342,101,0,241,101
15363,4,137,36,0,101,36
15363,3,54,24,0,30,24
15363,2,23,4,0,19,4
97842,10,143,19,0,124,19
97842,9,525,89,0,436,89
97842,8,3012,461,0,2551,461
97842,7,2576,381,0,2195,381
97842,6,1312,229,0,1083,229
97842,5,305,68,0,237,68
97842,4,133,35,0,98,35
97842,3,46,19,0,27,19
97842,2,21,5,0,16,5
97842,1,14,1,0,13,1
5404,10,232,89,0,143,89
5404,9,745,283,0,462,283
5404,8,2996,825,0,2171,825
5404,7,2418,571,0,1847,571
5404,6,1171,296,0,875,296
5404,5,284,80,0,204,80
5404,4,111,44,0,67,44
5404,3,46,18,0,28,18
5404,2,13,5,0,8,5
1115,10,685,186,0,499,186
1115,9,660,149,0,511,149
1115,8,1404,304,0,1100,304
1115,7,1711,304,0,1407,304
1115,6,1675,311,0,1364,311
1115,5,915,188,0,727,188
1115,4,527,147,0,380,147
1115,3,246,64,0,182,64
1115,2,122,37,0,85,37
1115,1,91,21,0,70,21
66362,10,168,48,0,120,48
66362,9,660,152,0,508,152
66362,8,3264,626,0,2638,626
66362,7,2378,437,0,1941,437
66362,6,1112,207,1,905,206
66362,5,281,69,0,212,69
66362,4,96,30,0,66,30
66362,3,47,16,0,31,16
66362,2,13,6,0,7,6
66362,1,9,1,0,8,1
127060,10,405,80,0,325,80
127060,9,1180,190,0,990,190
127060,8,3360,544,0,2816,544
127060,7,1698,265,0,1433,265
127060,6,892,175,0,717,175
127060,5,253,56,0,197,56
127060,4,119,33,0,86,33
127060,3,54,17,0,37,17
127060,2,31,5,0,26,5
127060,1,30,5,0,25,5
13823,10,82,30,0,52,30
13823,9,319,102,0,217,102
13823,8,1816,544,1,1272,543
13823,7,2661,635,0,2026,635
13823,6,2104,500,0,1604,500
13823,5,618,165,0,453,165
13823,4,235,72,0,163,72
13823,3,87,30,0,57,30
13823,2,48,17,0,31,17
13823,1,10,3,0,7,3
88,10,236,71,0,165,71
88,9,638,174,0,464,174
88,8,2422,578,0,1844,578
88,7,2539,482,0,2057,482
88,6,1464,334,0,1130,334
88,5,432,92,0,340,92
88,4,143,54,0,89,54
88,3,46,15,0,31,15
88,2,23,6,0,17,6
88,1,12,2,0,10,2
27708,10,491,135,0,356,135
27708,9,1192,313,0,879,313
27708,8,3150,811,0,2339,811
27708,7,1721,460,0,1261,460
27708,6,918,316,0,602,316
27708,5,260,96,0,164,96
27708,4,128,54,0,74,54
27708,3,52,22,0,30,22
27708,2,24,9,0,15,9
27746,10,209,56,0,153,56
27746,9,674,139,0,535,139
27746,8,2733,571,5,2162,566
27746,7,2405,434,2,1971,432
27746,6,1323,338,2,985,336
27746,5,363,116,1,247,115
27746,4,150,52,0,98,52
27746,3,58,23,0,35,23
27746,2,20,8,0,12,8
139030,10,117,26,0,91,26
139030,9,371,50,0,321,50
139030,8,1703,251,0,1452,251
139030,7,2346,294,0,2052,294
139030,6,2133,290,0,1843,290
139030,5,691,123,0,568,123
139030,4,358,76,0,282,76
139030,3,148,41,0,107,41
139030,2,57,11,0,46,11
139030,1,19,7,0,12,7
198994,10,496,87,4,409,83
198994,9,1114,137,5,977,132
198994,8,3349,362,16,2987,346
198994,7,1919,230,10,1689,220
198994,6,755,101,4,654,97
198994,5,184,34,2,150,32
198994,4,61,16,0,45,16
198994,3,21,6,0,15,6
198994,2,13,5,1,8,4
198994,1,9,2,0,7,2
197376,10,841,147,0,694,147
197376,9,1523,184,0,1339,184
197376,8,2642,311,0,2331,311
197376,7,1436,167,0,1269,167
197376,6,791,140,0,651,140
197376,5,282,69,0,213,69
197376,4,148,42,0,106,42
197376,3,116,32,0,84,32
197376,2,49,23,0,26,23
197376,1,48,15,0,33,15
150658,10,226,43,0,183,43
150658,9,726,125,0,601,125
150658,8,3026,474,0,2552,474
150658,7,2281,275,0,2006,275
150658,6,1141,180,0,961,180
150658,5,287,46,0,241,46
150658,4,111,21,0,90,21
150658,3,37,13,0,24,13
150658,2,19,8,0,11,8
150658,1,12,2,0,10,2
224037,10,448,59,0,389,59
224037,9,1204,168,0,1036,168
224037,8,3414,432,0,2982,432
224037,7,1793,184,0,1609,184
224037,6,749,85,0,664,85
224037,5,138,19,0,119,19
224037,4,69,13,0,56,13
224037,3,23,7,0,16,7
224037,2,10,2,0,8,2
224037,1,11,1,0,10,1
168435,10,144,26,0,118,26
168435,9,455,90,8,365,82
168435,8,2465,406,22,2059,384
168435,7,2537,380,18,2157,362
168435,6,1590,244,6,1346,238
168435,5,435,90,1,345,89
168435,4,142,38,0,104,38
168435,3,56,13,0,43,13
168435,2,18,8,0,10,8
168435,1,7,1,0,6,1
24181,10,727,214,0,513,214
24181,9,1259,316,0,943,316
24181,8,2781,616,0,2165,616
24181,7,1600,307,0,1293,307
24181,6,864,227,0,637,227
24181,5,294,76,0,218,76
24181,4,170,43,0,127,43
24181,3,57,11,0,46,11
24181,2,50,16,0,34,16
24181,1,29,5,0,24,5
143693,10,284,74,0,210,74
143693,9,887,169,0,718,169
143693,8,3225,517,0,2708,517
143693,7,1979,267,0,1712,267
143693,6,996,170,0,826,170
143693,5,271,53,0,218,53
143693,4,105,25,0,80,25
143693,3,44,12,0,32,12
143693,2,16,5,0,11,5
143693,1,12,3,0,9,3
59946,10,274,57,0,217,57
59946,9,551,116,0,435,116
59946,8,2122,425,0,1697,425
59946,7,2275,399,0,1876,399
59946,6,1629,324,0,1305,324
59946,5,512,125,0,387,125
59946,4,259,92,1,167,91
59946,3,102,31,0,71,31
59946,2,44,16,0,28,16
59946,1,23,5,0,18,5
15818,10,90,19,0,71,19
15818,9,227,55,0,172,55
15818,8,1279,287,0,992,287
15818,7,2400,453,0,1947,453
15818,6,2597,505,0,2092,505
15818,5,715,157,0,558,157
15818,4,303,98,0,205,98
15818,3,100,33,0,67,33
15818,2,51,18,0,33,18
15818,1,7,3,0,4,3
155068,10,948,168,3,780,165
155068,9,1414,225,12,1189,213
155068,8,2834,345,14,2489,331
155068,7,1381,166,6,1215,160
155068,6,716,93,2,623,91
155068,5,224,27,1,197,26
155068,4,127,26,0,101,26
155068,3,63,14,0,49,14
155068,2,28,4,0,24,4
155068,1,27,5,0,22,5
73761,10,165,27,0,138,27
73761,9,494,100,0,394,100
73761,8,2543,398,0,2145,398
73761,7,2453,346,0,2107,346
73761,6,1468,210,0,1258,210
73761,5,368,52,0,316,52
73761,4,162,37,0,125,37
73761,3,65,13,0,52,13
73761,2,25,10,0,15,10
73761,1,12,3,0,9,3
133848,10,320,46,6,274,40
133848,9,807,105,9,702,96
133848,8,2776,392,39,2384,353
133848,7,1970,288,21,1682,267
133848,6,1162,219,11,943,208
133848,5,387,93,10,294,83
133848,4,196,61,8,135,53
133848,3,72,21,0,51,21
133848,2,29,11,1,18,10
133848,1,20,8,0,12,8
160851,10,141,31,1,110,30
160851,9,360,59,0,301,59
160851,8,2071,294,12,1777,282
160851,7,2702,319,1,2383,318
160851,6,1767,281,0,1486,281
160851,5,440,81,0,359,81
160851,4,157,41,0,116,41
160851,3,47,10,0,37,10
160851,2,16,7,0,9,7
160851,1,9,2,0,7,2
891,10,78,19,0,59,19
891,9,156,38,0,118,38
891,8,604,119,0,485,119
891,7,1289,255,0,1034,255
891,6,2507,508,0,1999,508
891,5,1470,292,0,1178,292
891,4,916,261,0,655,261
891,3,389,112,0,277,112
891,2,202,84,0,118,84
891,1,74,33,0,41,33
12002,10,158,54,0,104,54
12002,9,420,153,0,267,153
12002,8,2305,658,0,1647,658
12002,7,2564,632,0,1932,632
12002,6,1566,421,0,1145,421
12002,5,413,119,0,294,119
12002,4,161,57,0,104,57
12002,3,58,26,0,32,26
12002,2,24,10,0,14,10
12002,1,11,4,0,7,4
155987,10,248,47,0,201,47
155987,9,685,121,0,564,121
155987,8,2803,396,0,2407,396
155987,7,2218,299,0,1919,299
155987,6,1172,191,0,981,191
155987,5,314,55,0,259,55
155987,4,127,21,0,106,21
155987,3,48,12,0,36,12
155987,2,22,4,0,18,4
155987,1,16,2,0,14,2
2987,10,91,30,0,61,30
2987,9,274,81,0,193,81
2987,8,1519,436,0,1083,436
2987,7,2362,564,0,1798,564
2987,6,2091,537,0,1554,537
2987,5,698,223,0,475,223
2987,4,371,134,0,237,134
2987,3,124,60,0,64,60
2987,2,66,31,0,35,31
2987,1,18,5,0,13,5
327,10,277,86,0,191,86
327,9,493,147,0,346,147
327,8,1622,486,0,1136,486
327,7,2152,516,0,1636,516
327,6,1905,443,0,1462,443
327,5,616,127,0,489,127
327,4,279,57,0,222,57
327,3,110,24,0,86,24
327,2,42,14,0,28,14
327,1,24,3,0,21,3
27173,10,176,40,0,136,40
27173,9,612,142,0,470,142
27173,8,2795,600,0,2195,600
27173,7,2314,379,0,1935,379
27173,6,1120,226,0,894,226
27173,5,280,68,0,212,68
27173,4,124,42,0,82,42
27173,3,51,20,0,31,20
27173,2,15,7,0,8,7
27173,1,12,2,0,10,2
30380,10,162,33,0,129,33
30380,9,559,119,0,440,119
30380,8,2516,509,0,2007,509
30380,7,2359,450,0,1909,450
30380,6,1281,311,0,970,311
30380,5,389,88,0,301,88
30380,4,136,50,0,86,50
30380,3,62,22,0,40,22
30380,2,15,2,0,13,2
30380,1,14,2,0,12,2
117959,10,163,41,0,122,41
117959,9,504,104,0,400,104
117959,8,2291,427,0,1864,427
117959,7,2491,353,0,2138,353
117959,6,1485,226,0,1259,226
117959,5,340,54,0,286,54
117959,4,118,27,0,91,27
117959,3,48,10,0,38,10
117959,2,26,9,0,17,9
117959,1,10,4,0,6,4
140,10,164,54,0,110,54
140,9,302,83,0,219,83
140,8,1190,343,0,847,343
140,7,1782,424,0,1358,424
140,6,2408,523,0,1885,523
140,5,866,205,0,661,205
140,4,432,115,0,317,115
140,3,179,43,0,136,43
140,2,100,37,0,63,37
140,1,37,13,0,24,13
21523,10,262,73,0,189,73
21523,9,527,128,0,399,128
21523,8,1914,440,0,1474,440
21523,7,2070,408,0,1662,408
21523,6,1606,396,0,1210,396
21523,5,574,147,0,427,147
21523,4,283,86,0,197,86
21523,3,134,49,0,85,49
21523,2,63,26,0,37,26
21523,1,25,7,0,18,7
173,10,253,71,0,182,71
173,9,566,153,0,413,153
173,8,1922,509,0,1413,509
173,7,2285,492,0,1793,492
173,6,1556,382,0,1174,382
173,5,493,149,0,344,149
173,4,223,80,0,143,80
173,3,87,34,0,53,34
173,2,41,23,0,18,23
173,1,22,7,0,15,7
22345,10,131,35,0,96,35
22345,9,423,134,0,289,134
22345,8,2424,610,0,1814,610
22345,7,2530,483,0,2047,483
22345,6,1376,322,0,1054,322
22345,5,344,112,0,232,112
22345,4,137,59,0,78,59
22345,3,44,13,0,31,13
22345,2,18,5,0,13,5
22345,1,18,4,0,14,4
11170,10,814,288,0,526,288
11170,9,831,275,0,556,275
11170,8,2122,635,0,1487,635
11170,7,1815,506,0,1309,506
11170,6,1174,396,0,778,396
11170,5,395,115,0,280,115
11170,4,169,73,0,96,73
11170,3,70,31,0,39,31
11170,2,24,10,0,14,10
11170,1,21,6,0,15,6
112,10,125,36,0,89,36
112,9,385,104,0,281,104
112,8,1712,428,0,1284,428
112,7,2340,506,0,1834,506
112,6,1886,389,0,1497,389
112,5,562,139,0,423,139
112,4,262,93,0,169,93
112,3,111,35,0,76,35
112,2,29,11,0,18,11
112,1,14,2,0,12,2
14105,10,735,289,0,446,289
14105,9,1332,433,0,899,433
14105,8,2787,722,0,2065,722
14105,7,1459,363,0,1096,363
14105,6,692,204,0,488,204
14105,5,214,74,0,140,74
14105,4,77,27,0,50,27
14105,3,52,18,0,34,18
14105,2,24,7,0,17,7
14105,1,38,4,0,34,4
4098,10,953,364,2,589,362
4098,9,1318,356,2,962,354
4098,8,2385,580,1,1805,579
4098,7,1329,312,0,1017,312
4098,6,815,218,0,597,218
4098,5,237,76,0,161,76
4098,4,160,52,0,108,52
4098,3,85,30,0,55,30
4098,2,59,19,0,40,19
4098,1,52,9,0,43,9
10,10,84,25,0,59,25
10,9,295,77,0,218,77
10,8,1564,373,0,1191,373
10,7,2528,508,0,2020,508
10,6,1988,416,0,1572,416
10,5,542,142,0,400,142
10,4,261,76,0,185,76
10,3,81,25,0,56,25
10,2,28,6,0,22,6
10,1,13,3,0,10,3
36946,10,51,15,0,36,15
36946,9,143,35,0,108,35
36946,8,1132,259,0,873,259
36946,7,2091,428,0,1663,428
36946,6,2470,525,0,1945,525
36946,5,831,201,0,630,201
36946,4,374,125,0,249,125
36946,3,168,57,0,111,57
36946,2,94,38,0,56,38
36946,1,25,5,0,20,5
24068,10,241,50,0,191,50
24068,9,435,88,0,347,88
24068,8,1861,392,0,1469,392
24068,7,2018,342,0,1676,342
24068,6,1729,313,0,1416,313
24068,5,540,124,0,416,124
24068,4,288,89,0,199,89
24068,3,141,44,0,97,44
24068,2,60,19,0,41,19
24068,1,22,5,0,17,5
1234,10,153,40,0,113,40
1234,9,337,78,0,259,78
1234,8,1202,268,0,934,268
1234,7,1897,323,0,1574,323
1234,6,2236,417,0,1819,417
1234,5,789,163,0,626,163
1234,4,419,96,0,323,96
1234,3,165,43,0,122,43
1234,2,78,24,0,54,24
1234,1,52,24,0,28,24
13308,10,54,13,0,41,13
13308,9,163,42,0,121,42
13308,8,1208,311,0,897,311
13308,7,2331,533,0,1798,533
13308,6,2409,546,0,1863,546
13308,5,737,156,0,581,156
13308,4,282,89,0,193,89
13308,3,83,28,0,55,28
13308,2,35,10,0,25,10
13308,1,13,3,0,10,3
915,10,85,30,0,55,30
915,9,269,71,0,198,71
915,8,1432,388,0,1044,388
915,7,2145,491,0,1654,491
915,6,2127,503,0,1624,503
915,5,696,213,0,483,213
915,4,310,112,0,198,112
915,3,151,63,0,88,63
915,2,72,38,0,34,38
915,1,23,7,0,16,7
141572,10,172,33,0,139,33
141572,9,600,101,1,499,100
141572,8,2745,473,12,2272,461
141572,7,2107,346,4,1761,342
141572,6,1205,231,4,974,227
141572,5,276,52,0,224,52
141572,4,132,28,0,104,28
141572,3,41,11,0,30,11
141572,2,13,6,0,7,6
141572,1,6,2,0,4,2
2842,10,103,35,0,68,35
2842,9,304,96,0,208,96
2842,8,1445,386,0,1059,386
2842,7,2330,593,0,1737,593
2842,6,2041,552,0,1489,552
2842,5,605,195,0,410,195
2842,4,272,98,0,174,98
2842,3,104,57,0,47,57
2842,2,53,24,0,29,24
2842,1,15,7,0,8,7
394,10,81,24,0,57,24
394,9,280,66,0,214,66
394,8,1390,302,0,1088,302
394,7,2344,421,0,1923,421
394,6,2179,441,0,1738,441
394,5,592,132,0,460,132
394,4,275,84,0,191,84
394,3,89,32,0,57,32
394,2,31,12,0,19,12
59294,10,735,139,0,596,139
59294,9,1264,227,0,1037,227
59294,8,2504,369,0,2135,369
59294,7,1357,204,0,1153,204
59294,6,895,132,0,763,132
59294,5,226,41,0,185,41
59294,4,143,33,0,110,33
59294,3,49,10,0,39,10
59294,2,39,13,0,26,13
59294,1,32,4,0,28,4
66589,10,250,51,0,199,51
66589,9,934,189,0,745,189
66589,8,3106,513,0,2593,513
66589,7,1833,268,0,1565,268
66589,6,806,166,0,640,166
66589,5,178,42,0,136,42
66589,4,70,17,0,53,17
66589,3,22,9,0,13,9
66589,2,15,5,0,10,5
66589,1,20,4,0,16,4
51,10,408,104,0,304,104
51,9,654,134,0,520,134
51,8,1833,369,0,1464,369
51,7,1936,363,0,1573,363
51,6,1405,268,0,1137,268
51,5,458,96,0,362,96
51,4,254,77,0,177,77
51,3,114,36,0,78,36
51,2,94,39,0,55,39
51,1,57,21,0,36,21
2381,10,119,29,0,90,29
2381,9,211,39,0,172,39
2381,8,791,138,0,653,138
2381,7,1584,269,0,1315,269
2381,6,2590,472,0,2118,472
2381,5,1103,215,0,888,215
2381,4,537,129,0,408,129
2381,3,175,56,0,119,56
2381,2,73,26,0,47,26
2381,1,27,9,0,18,9
163968,10,179,28,0,151,28
163968,9,574,86,0,488,86
163968,8,2753,344,0,2409,344
163968,7,2127,284,0,1843,284
163968,6,1078,158,0,920,158
163968,5,285,51,0,234,51
163968,4,125,30,0,95,30
163968,3,52,10,0,42,10
163968,2,11,3,0,8,3
163968,1,10,3,0,7,3
21882,10,135,47,0,88,47
21882,9,404,143,0,261,143
21882,8,2214,641,0,1573,641
21882,7,2343,524,0,1819,524
21882,6,1457,332,0,1125,332
21882,5,382,106,0,276,106
21882,4,151,49,0,102,49
21882,3,55,25,0,30,25
21882,2,16,3,0,13,3
140934,10,284,75,0,209,75
140934,9,736,159,0,577,159
140934,8,2786,500,0,2286,500
140934,7,1980,315,0,1665,315
140934,6,997,157,0,840,157
140934,5,232,49,0,183,49
140934,4,102,29,0,73,29
140934,3,42,10,0,32,10
140934,2,14,6,0,8,6
140934,1,9,2,0,7,2
176920,10,235,36,0,199,36
176920,9,772,116,0,656,116
176920,8,3175,403,0,2772,403
176920,7,1812,198,0,1614,198
176920,6,787,97,0,690,97
176920,5,205,31,0,174,31
176920,4,79,16,0,63,16
176920,3,27,4,0,23,4
176920,2,14,3,0,11,3
176920,1,7,1,0,6,1
2425,10,29,6,0,23,6
2425,9,34,8,0,26,8
2425,8,149,41,0,108,41
2425,7,369,79,0,290,79
2425,6,1257,249,0,1008,249
2425,5,1878,373,0,1505,373
2425,4,1882,461,0,1421,461
2425,3,949,290,0,659,290
2425,2,432,138,0,294,138
2425,1,132,42,0,90,42
221107,10,1883,263,0,1620,263
221107,9,1801,173,0,1628,173
221107,8,1836,190,0,1646,190
221107,7,753,89,0,664,89
221107,6,371,71,0,300,71
221107,5,150,23,0,127,23
221107,4,94,21,0,73,21
221107,3,69,29,0,40,29
221107,2,70,25,0,45,25
221107,1,84,19,0,65,19
826,10,77,29,0,48,29
826,9,224,58,0,166,58
826,8,1361,391,0,970,391
826,7,2460,650,0,1810,650
826,6,2140,489,0,1651,489
826,5,547,124,0,423,124
826,4,193,71,0,122,71
826,3,64,19,0,45,19
826,2,28,9,0,19,9
826,1,9,2,0,7,2
2398,10,511,177,0,334,177
2398,9,596,158,0,438,158
2398,8,1570,382,0,1188,382
2398,7,1926,416,0,1510,416
2398,6,1529,312,0,1217,312
2398,5,572,120,0,452,120
2398,4,234,60,0,174,60
2398,3,69,17,0,52,17
2398,2,45,13,0,32,13
2398,1,24,2,0,22,2
40398,10,104,20,0,84,20
40398,9,210,44,0,166,44
40398,8,924,198,0,726,198
40398,7,1701,331,0,1370,331
40398,6,2526,504,0,2022,504
40398,5,867,151,0,716,151
40398,4,413,97,0,316,97
40398,3,193,58,0,135,58
40398,2,69,20,0,49,20
40398,1,50,13,0,37,13
24508,10,230,67,0,163,67
24508,9,540,149,0,391,149
24508,8,2261,529,0,1732,529
24508,7,2196,442,0,1754,442
24508,6,1218,252,0,966,252
24508,5,328,77,0,251,77
24508,4,159,49,0,110,49
24508,3,49,22,0,27,22
24508,2,15,4,0,11,4
24508,1,11,2,0,9,2
237182,10,1028,174,6,854,168
237182,9,1862,262,15,1600,247
237182,8,2463,336,11,2127,325
237182,7,907,129,3,778,126
237182,6,462,85,0,377,85
237182,5,152,37,0,115,37
237182,4,70,23,1,47,22
237182,3,48,16,0,32,16
237182,2,13,6,0,7,6
237182,1,50,17,0,33,17
121408,10,136,37,0,99,37
121408,9,607,106,0,501,106
121408,8,2469,460,0,2009,460
121408,7,2076,335,0,1741,335
121408,6,1143,186,0,957,186
121408,5,315,65,0,250,65
121408,4,146,44,0,102,44
121408,3,49,12,0,37,12
121408,2,19,4,0,15,4
121408,1,22,7,0,15,7
7717,10,165,53,0,112,53
7717,9,506,153,0,353,153
7717,8,2114,630,0,1484,630
7717,7,2229,573,0,1656,573
7717,6,1336,319,0,1017,319
7717,5,384,103,0,281,103
7717,4,153,48,0,105,48
7717,3,52,15,0,37,15
7717,2,21,10,0,11,10
7717,1,16,2,0,14,2
185343,10,1051,189,8,862,181
185343,9,1765,262,17,1503,245
185343,8,2473,320,19,2153,301
185343,7,919,115,7,804,108
185343,6,447,77,4,370,73
185343,5,153,25,1,128,24
185343,4,70,14,1,56,13
185343,3,39,10,1,29,9
185343,2,11,4,1,7,3
185343,1,20,4,1,16,3
47,10,269,77,0,192,77
47,9,642,175,0,467,175
47,8,2358,553,0,1805,553
47,7,1945,370,0,1575,370
47,6,1148,263,0,885,263
47,5,348,99,0,249,99
47,4,128,47,0,81,47
47,3,56,20,0,36,20
47,2,19,7,0,12,7
47,1,13,4,0,9,4
7805,10,76,12,0,64,12
7805,9,209,60,0,149,60
7805,8,1389,399,0,990,399
7805,7,2305,588,0,1717,588
7805,6,1979,458,0,1521,458
7805,5,580,174,0,406,174
7805,4,257,78,0,179,78
7805,3,76,25,0,51,25
7805,2,24,8,0,16,8
7805,1,10,1,0,9,1
131260,10,98,13,0,85,13
131260,9,319,43,0,276,43
131260,8,1680,305,0,1375,305
131260,7,2404,338,0,2066,338
131260,6,1798,280,0,1518,280
131260,5,375,48,0,327,48
131260,4,149,36,0,113,36
131260,3,38,11,0,27,11
131260,2,30,5,0,25,5
131260,1,9,2,0,7,2
2952,10,83,14,0,69,14
2952,9,125,21,0,104,21
2952,8,412,89,0,323,89
2952,7,819,135,0,684,135
2952,6,1709,296,0,1413,296
2952,5,1498,310,0,1188,310
2952,4,1111,294,0,817,294
2952,3,603,189,0,414,189
2952,2,382,156,0,226,156
2952,1,153,57,0,96,57
79828,10,326,81,0,245,81
79828,9,997,199,0,798,199
79828,8,2578,495,0,2083,495
79828,7,1569,268,0,1301,268
79828,6,797,177,0,620,177
79828,5,283,64,0,219,64
79828,4,146,48,0,98,48
79828,3,72,27,0,45,27
79828,2,68,32,0,36,32
79828,1,40,24,0,16,24
137297,10,64,12,0,52,12
137297,9,229,46,0,183,46
137297,8,1620,344,1,1276,343
137297,7,2330,381,0,1949,381
137297,6,1809,307,0,1502,307
137297,5,481,107,0,374,107
137297,4,204,59,0,145,59
137297,3,75,27,0,48,27
137297,2,36,15,0,21,15
137297,1,14,4,0,10,4
27225,10,122,39,0,83,39
27225,9,249,56,0,193,56
27225,8,928,194,0,734,194
27225,7,1782,368,0,1414,368
27225,6,2251,441,0,1810,441
27225,5,875,188,0,687,188
27225,4,400,88,0,312,88
27225,3,150,42,0,108,42
27225,2,62,20,0,42,20
27225,1,29,10,0,19,10
169426,10,266,54,3,212,51
169426,9,810,132,3,678,129
169426,8,2937,372,13,2565,359
169426,7,1703,195,5,1508,190
169426,6,809,116,2,693,114
169426,5,195,40,0,155,40
169426,4,82,16,0,66,16
169426,3,30,6,0,24,6
169426,2,11,4,0,7,4
169426,1,5,1,0,4,1
163602,10,244,45,0,199,45
163602,9,603,75,0,528,75
163602,8,2157,266,0,1891,266
163602,7,1852,192,0,1660,192
163602,6,1177,161,0,1016,161
163602,5,402,58,0,344,58
163602,4,191,33,0,158,33
163602,3,87,25,0,62,25
163602,2,49,7,0,42,7
163602,1,51,17,0,34,17
101721,10,948,198,0,750,198
101721,9,1109,175,0,934,175
101721,8,2093,325,1,1768,324
101721,7,1316,180,0,1136,180
101721,6,786,127,0,659,127
101721,5,271,46,0,225,46
101721,4,121,20,0,101,20
101721,3,78,15,0,63,15
101721,2,46,13,0,33,13
101721,1,36,3,0,33,3
138788,10,67,18,0,49,18
138788,9,148,28,1,120,27
138788,8,796,151,16,645,135
138788,7,1605,313,26,1292,287
138788,6,2464,448,44,2016,404
138788,5,932,194,19,738,175
138788,4,477,121,12,356,109
138788,3,191,58,3,133,55
138788,2,85,30,2,55,28
138788,1,34,16,1,18,15
31730,10,238,96,0,142,96
31730,9,620,215,0,405,215
31730,8,2329,600,0,1729,600
31730,7,1887,369,2,1518,367
31730,6,1157,261,0,896,261
31730,5,340,79,0,261,79
31730,4,133,49,0,84,49
31730,3,53,12,0,41,12
31730,2,28,11,0,17,11
31730,1,14,3,0,11,3
199042,10,456,100,0,356,100
199042,9,913,155,0,758,155
199042,8,2356,334,0,2022,334
199042,7,1790,231,0,1559,231
199042,6,896,170,0,726,170
199042,5,232,45,0,187,45
199042,4,97,24,0,73,24
199042,3,40,11,0,29,11
199042,2,14,6,0,8,6
199042,1,12,4,0,8,4
1465,10,201,40,0,161,40
1465,9,452,89,0,363,89
1465,8,1642,287,0,1355,287
1465,7,2061,333,0,1728,333
1465,6,1600,283,0,1317,283
1465,5,491,100,0,391,100
1465,4,202,58,0,144,58
1465,3,72,19,0,53,19
1465,2,36,9,0,27,9
1465,1,24,5,0,19,5
13004,10,140,41,0,99,41
13004,9,357,113,0,244,113
13004,8,2155,574,0,1581,574
13004,7,2410,577,0,1833,577
13004,6,1289,350,0,939,350
13004,5,277,80,0,197,80
13004,4,98,37,0,61,37
13004,3,28,14,0,14,14
13004,2,11,3,0,8,3
13004,1,7,1,0,6,1
105134,10,621,128,0,493,128
105134,9,1045,202,0,843,202
105134,8,2123,320,0,1803,320
105134,7,1421,198,0,1223,198
105134,6,873,144,0,729,144
105134,5,293,52,0,241,52
105134,4,158,43,0,115,43
105134,3,95,24,0,71,24
105134,2,37,8,0,29,8
105134,1,57,14,0,43,14
146886,10,391,63,0,328,63
146886,9,1027,144,0,883,144
146886,8,2993,401,0,2592,401
146886,7,1361,194,0,1167,194
146886,6,664,125,0,539,125
146886,5,164,33,0,131,33
146886,4,61,19,0,42,19
146886,3,34,11,0,23,11
146886,2,11,3,0,8,3
146886,1,12,3,0,9,3
105,10,92,33,0,59,33
105,9,271,111,0,160,111
105,8,1484,482,0,1002,482
105,7,2304,652,0,1652,652
105,6,1782,446,0,1336,446
105,5,477,132,0,345,132
105,4,203,58,0,145,58
105,3,59,18,0,41,18
105,2,28,11,0,17,11
105,1,9,2,0,7,2
125153,10,845,136,4,709,132
125153,9,1556,196,6,1360,190
125153,8,2569,322,16,2247,306
125153,7,955,122,6,833,116
125153,6,490,80,1,410,79
125153,5,142,37,0,105,37
125153,4,78,19,0,59,19
125153,3,41,9,0,32,9
125153,2,22,7,0,15,7
125153,1,19,6,0,13,6
71,10,739,217,0,522,217
71,9,1002,244,0,758,244
71,8,1917,458,0,1459,458
71,7,1527,335,0,1192,335
71,6,892,213,0,679,213
71,5,328,85,0,243,85
71,4,172,60,0,112,60
71,3,62,20,0,42,20
71,2,41,13,0,28,13
71,1,25,4,0,21,4
16986,10,81,15,0,66,15
16986,9,277,56,0,221,56
16986,8,1421,286,0,1135,286
16986,7,2185,335,0,1850,335
16986,6,1852,280,0,1572,280
16986,5,537,75,0,462,75
16986,4,219,40,0,179,40
16986,3,68,15,0,53,15
16986,2,33,11,0,22,11
16986,1,10,2,0,8,2
22827,10,501,109,0,392,109
22827,9,836,167,0,669,167
22827,8,2096,397,0,1699,397
22827,7,1512,256,0,1256,256
22827,6,1016,214,0,802,214
22827,5,355,68,0,287,68
22827,4,199,62,0,137,62
22827,3,92,30,0,62,30
22827,2,34,13,0,21,13
22827,1,26,3,0,23,3
97903,10,98,15,0,83,15
97903,9,335,68,0,267,68
97903,8,1784,370,0,1414,370
97903,7,2128,379,1,1749,378
97903,6,1644,285,1,1359,284
97903,5,368,77,0,291,77
97903,4,187,50,0,137,50
97903,3,68,15,0,53,15
97903,2,33,7,0,26,7
475,10,253,114,0,139,114
475,9,686,264,0,422,264
475,8,2345,634,0,1711,634
475,7,1856,375,0,1481,375
475,6,985,230,0,755,230
475,5,307,81,0,226,81
475,4,126,46,0,80,46
475,3,54,22,0,32,22
475,2,26,12,0,14,12
475,1,12,1,0,11,1
183251,10,124,23,0,101,23
183251,9,471,77,0,394,77
183251,8,2283,357,0,1926,357
183251,7,2245,279,0,1966,279
183251,6,1159,176,0,983,176
183251,5,247,55,0,192,55
183251,4,76,23,0,53,23
183251,3,20,7,0,13,7
183251,2,5,1,0,4,1
183251,1,3,1,0,2,1
169654,10,165,36,0,129,36
169654,9,425,77,0,348,77
169654,8,2018,334,0,1684,334
169654,7,2129,320,0,1809,320
169654,6,1341,212,0,1129,212
169654,5,295,51,0,244,51
169654,4,141,40,0,101,40
169654,3,56,12,0,44,12
169654,2,28,10,0,18,10
169654,1,5,2,0,3,2
199478,10,383,76,0,307,76
199478,9,903,136,0,767,136
199478,8,2607,329,0,2278,329
199478,7,1597,173,0,1424,173
199478,6,804,118,0,686,118
199478,5,169,27,0,142,27
199478,4,82,26,0,56,26
199478,3,36,5,0,31,5
199478,2,10,2,0,8,2
199478,1,15,3,0,12,3
131366,10,47,8,0,39,8
131366,9,165,28,1,137,27
131366,8,1143,189,6,954,183
131366,7,2282,334,8,1948,326
131366,6,2120,271,5,1849,266
131366,5,541,79,2,462,77
131366,4,198,46,2,152,44
131366,3,68,16,1,52,15
131366,2,27,7,0,20,7
219513,10,152,21,0,131,21
219513,9,486,62,0,424,62
219513,8,2744,335,0,2409,335
219513,7,2038,273,0,1765,273
219513,6,912,131,0,781,131
219513,5,192,44,0,148,44
219513,4,52,10,0,42,10
219513,3,15,1,0,14,1
219513,2,4,1,0,3,1
46,10,176,66,0,110,66
46,9,483,162,0,321,162
46,8,2070,599,4,1471,595
46,7,2157,516,2,1641,514
46,6,1160,302,1,858,301
46,5,322,94,1,228,93
46,4,121,47,0,74,47
46,3,53,20,0,33,20
46,2,19,8,0,11,8
46,1,12,2,0,10,2
590,10,73,16,0,57,16
590,9,117,29,0,88,29
590,8,469,109,0,360,109
590,7,1093,256,0,837,256
590,6,2216,469,0,1747,469
590,5,1331,342,0,989,342
590,4,697,193,0,504,193
590,3,344,126,0,218,126
590,2,173,72,0,101,72
590,1,53,26,0,27,26
206718,10,219,34,0,185,34
206718,9,833,141,1,692,140
206718,8,2874,407,1,2467,406
206718,7,1567,195,0,1372,195
206718,6,730,119,0,611,119
206718,5,186,38,0,148,38
206718,4,98,25,0,73,25
206718,3,36,13,0,23,13
206718,2,17,8,0,9,8
206718,1,9,1,0,8,1
72287,10,117,16,0,101,16
72287,9,303,70,0,233,70
72287,8,1717,297,0,1420,297
72287,7,2245,368,0,1877,368
72287,6,1601,240,0,1361,240
72287,5,360,76,0,284,76
72287,4,131,21,0,110,21
72287,3,37,6,0,31,6
72287,2,19,3,0,16,3
72287,1,10,2,0,8,2
233078,10,2668,390,0,2278,390
233078,9,1711,173,0,1538,173
233078,8,1200,129,0,1071,129
233078,7,444,40,0,404,40
233078,6,268,43,0,225,43
233078,5,93,25,0,68,25
233078,4,44,16,0,28,16
233078,3,37,12,0,25,12
233078,2,61,24,0,37,24
233078,1,31,4,0,27,4
183840,10,101,16,0,85,16
183840,9,316,61,0,255,61
183840,8,1943,271,0,1672,271
183840,7,2318,261,0,2057,261
183840,6,1309,167,0,1142,167
183840,5,335,59,0,276,59
183840,4,133,32,0,101,32
183840,3,58,17,0,41,17
183840,2,18,4,0,14,4
183840,1,6,1,0,5,1
85256,10,70,10,0,60,10
85256,9,211,27,0,184,27
85256,8,1213,160,0,1053,160
85256,7,2286,291,0,1995,291
85256,6,2019,243,0,1776,243
85256,5,454,72,0,382,72
85256,4,151,27,0,124,27
85256,3,50,17,0,33,17
85256,2,18,4,0,14,4
85256,1,15,5,0,10,5
194607,10,240,36,0,204,36
194607,9,655,96,0,559,96
194607,8,2300,335,0,1965,335
194607,7,1747,231,0,1516,231
194607,6,1025,170,0,855,170
194607,5,318,72,0,246,72
194607,4,110,29,0,81,29
194607,3,45,19,0,26,19
194607,2,16,5,0,11,5
105551,10,419,93,0,326,93
105551,9,917,137,0,780,137
105551,8,2142,336,0,1806,336
105551,7,1444,234,0,1210,234
105551,6,883,161,0,722,161
105551,5,298,85,0,213,85
105551,4,167,56,0,111,56
105551,3,94,30,0,64,30
105551,2,39,12,0,27,12
105551,1,38,8,0,30,8
55670,10,291,78,0,213,78
55670,9,760,172,0,588,172
55670,8,2517,476,0,2041,476
55670,7,1607,297,0,1310,297
55670,6,823,177,0,646,177
55670,5,230,66,0,164,66
55670,4,111,41,0,70,41
55670,3,55,21,0,34,21
55670,2,22,10,0,12,10
55670,1,18,6,0,12,6
54625,10,815,191,0,624,191
54625,9,1024,241,0,783,241
54625,8,1952,360,0,1592,360
54625,7,1275,221,0,1054,221
54625,6,715,103,0,612,103
54625,5,214,39,0,175,39
54625,4,96,21,0,75,21
54625,3,62,14,0,48,14
54625,2,53,14,0,39,14
54625,1,169,56,0,113,56
171499,10,93,21,0,72,21
171499,9,306,47,0,259,47
171499,8,2036,292,0,1744,292
171499,7,2347,280,0,2067,280
171499,6,1229,168,0,1061,168
171499,5,260,45,0,215,45
171499,4,66,13,0,53,13
171499,3,20,3,0,17,3
171499,2,9,4,0,5,4
7854,10,460,143,0,317,143
7854,9,1002,276,0,726,276
7854,8,2483,575,0,1908,575
7854,7,1482,317,0,1165,317
7854,6,638,137,0,501,137
7854,5,153,28,0,125,28
7854,4,74,22,0,52,22
7854,3,28,7,0,21,7
220,10,118,38,0,80,38
220,9,349,126,0,223,126
220,8,1670,457,1,1213,456
220,7,2081,528,0,1553,528
220,6,1450,369,0,1081,369
220,5,419,105,0,314,105
220,4,167,42,0,125,42
220,3,54,17,0,37,17
220,2,25,7,0,18,7
220,1,4,1,0,3,1
39938,10,232,73,1,159,72
39938,9,585,131,1,454,130
39938,8,2312,471,1,1841,470
39938,7,1689,309,2,1380,307
39938,6,962,204,0,758,204
39938,5,318,83,0,235,83
39938,4,150,46,0,104,46
39938,3,44,17,0,27,17
39938,2,23,8,0,15,8
39938,1,14,2,0,12,2
90419,10,168,43,0,125,43
90419,9,519,128,0,391,128
90419,8,2496,521,0,1975,521
90419,7,1875,347,0,1528,347
90419,6,921,201,0,720,201
90419,5,202,48,0,154,48
90419,4,83,32,0,51,32
90419,3,29,8,0,21,8
90419,2,14,3,0,11,3
90419,1,15,2,0,13,2
91514,10,113,23,0,90,23
91514,9,319,52,0,267,52
91514,8,1623,271,0,1352,271
91514,7,2180,312,0,1868,312
91514,6,1586,242,0,1344,242
91514,5,328,52,0,276,52
91514,4,119,18,0,101,18
91514,3,32,5,0,27,5
91514,2,14,1,0,13,1
91514,1,7,2,0,5,2
173090,10,97,15,0,82,15
173090,9,239,36,0,203,36
173090,8,1398,217,0,1181,217
173090,7,2007,253,1,1754,252
173090,6,1770,245,0,1525,245
173090,5,465,89,0,376,89
173090,4,192,48,0,144,48
173090,3,89,23,0,66,23
173090,2,41,13,0,28,13
173090,1,16,5,0,11,5
1829,10,197,64,0,133,64
1829,9,373,114,0,259,114
1829,8,1291,311,0,980,311
1829,7,1681,368,0,1313,368
1829,6,1730,383,0,1347,383
1829,5,557,122,0,435,122
1829,4,281,84,0,197,84
1829,3,115,39,0,76,39
1829,2,61,21,0,40,21
1829,1,22,5,0,17,5
36932,10,346,91,0,255,91
36932,9,933,248,0,685,248
36932,8,2465,522,0,1943,522
36932,7,1399,237,0,1162,237
36932,6,739,118,0,621,118
36932,5,219,44,0,175,44
36932,4,87,18,0,69,18
36932,3,47,15,0,32,15
36932,2,27,4,0,23,4
36932,1,25,2,0,23,2
40628,10,111,27,1,84,26
40628,9,343,90,0,253,90
40628,8,1909,455,3,1454,452
40628,7,2193,399,1,1794,398
40628,6,1241,249,0,992,249
40628,5,302,82,0,220,82
40628,4,103,27,0,76,27
40628,3,41,14,0,27,14
40628,2,13,3,0,10,3
40628,1,10,5,0,5,5
144344,10,240,44,0,196,44
144344,9,759,111,0,648,111
144344,8,2805,385,0,2420,385
144344,7,1515,165,0,1350,165
144344,6,684,95,0,589,95
144344,5,142,26,0,116,26
144344,4,49,12,0,37,12
144344,3,29,6,0,23,6
144344,2,12,3,0,9,3
1258,10,69,7,0,62,7
1258,9,87,12,0,75,12
1258,8,354,54,0,300,54
1258,7,775,115,0,660,115
1258,6,1556,240,0,1316,240
1258,5,1259,243,0,1016,243
1258,4,886,183,0,703,183
1258,3,524,150,0,374,150
1258,2,457,183,0,274,183
1258,1,253,106,0,147,106
3201,10,252,133,0,119,133
3201,9,620,254,0,366,254
3201,8,1908,582,0,1326,582
3201,7,1765,461,0,1304,461
3201,6,1118,286,0,832,286
3201,5,331,99,0,232,99
3201,4,132,38,0,94,38
3201,3,55,19,0,36,19
3201,2,19,4,0,15,4
3201,1,17,2,0,15,2
169124,10,137,25,0,112,25
169124,9,374,64,0,310,64
169124,8,1838,270,0,1568,270
169124,7,1960,245,0,1715,245
169124,6,1373,192,0,1181,192
169124,5,319,52,0,267,52
169124,4,137,34,0,103,34
169124,3,51,15,0,36,15
169124,2,22,4,0,18,4
929,10,174,43,0,131,43
929,9,331,79,0,252,79
929,8,1133,247,0,886,247
929,7,1602,310,0,1292,310
929,6,1755,342,0,1413,342
929,5,613,162,0,451,162
929,4,302,89,0,213,89
929,3,153,51,0,102,51
929,2,74,33,0,41,33
929,1,35,19,0,16,19
172308,10,158,37,0,121,37
172308,9,441,87,0,354,87
172308,8,2224,342,0,1882,342
172308,7,1921,210,0,1711,210
172308,6,978,147,0,831,147
172308,5,259,42,0,217,42
172308,4,111,30,0,81,30
172308,3,46,14,0,32,14
172308,2,16,5,0,11,5
172308,1,8,3,0,5,3
8051,10,126,64,0,62,64
8051,9,340,142,0,198,142
8051,8,1807,573,0,1234,573
8051,7,2065,529,0,1536,529
8051,6,1258,385,0,873,385
8051,5,343,139,0,204,139
8051,4,130,57,0,73,57
8051,3,56,27,0,29,27
8051,2,25,7,0,18,7
8051,1,10,2,0,8,2
128671,10,495,100,0,395,100
128671,9,876,156,0,720,156
128671,8,2040,304,0,1736,304
128671,7,1352,155,0,1197,155
128671,6,856,126,0,730,126
128671,5,275,39,0,236,39
128671,4,140,26,0,114,26
128671,3,65,12,0,53,12
128671,2,42,10,0,32,10
128671,1,17,4,0,13,4
24310,10,201,37,1,164,36
24310,9,297,55,0,242,55
24310,8,1165,208,0,957,208
24310,7,1584,268,0,1316,268
24310,6,1740,337,0,1403,337
24310,5,593,124,0,469,124
24310,4,304,70,0,234,70
24310,3,158,48,0,110,48
24310,2,80,33,0,47,33
24310,1,25,9,0,16,9
1293,10,169,55,0,114,55
1293,9,230,53,0,177,53
1293,8,736,169,0,567,169
1293,7,1330,335,0,995,335
1293,6,1937,455,0,1482,455
1293,5,961,240,0,721,240
1293,4,471,117,0,354,117
1293,3,187,67,0,120,67
1293,2,94,37,0,57,37
1293,1,24,6,0,18,6
162082,10,164,34,0,130,34
162082,9,555,95,1,460,94
162082,8,2453,353,0,2100,353
162082,7,1713,236,0,1477,236
162082,6,875,152,0,723,152
162082,5,215,43,0,172,43
162082,4,97,22,0,75,22
162082,3,30,12,0,18,12
162082,2,13,4,0,9,4
162082,1,13,1,0,12,1
110277,10,110,28,0,82,28
110277,9,383,78,3,305,75
110277,8,2143,392,10,1751,382
110277,7,1927,337,12,1590,325
110277,6,1082,240,6,842,234
110277,5,313,74,0,239,74
110277,4,100,31,1,69,30
110277,3,41,14,0,27,14
110277,2,19,7,0,12,7
110277,1,7,3,0,4,3
148951,10,83,23,0,60,23
148951,9,187,30,4,157,26
148951,8,1197,172,19,1025,153
148951,7,2012,258,27,1754,231
148951,6,1738,268,12,1470,256
148951,5,554,100,5,454,95
148951,4,214,67,4,147,63
148951,3,96,22,4,74,18
148951,2,28,12,0,16,12
148951,1,11,3,1,8,2
40793,10,71,17,0,54,17
40793,9,244,55,0,189,55
40793,8,1697,354,0,1343,354
40793,7,1956,329,0,1627,329
40793,6,1438,262,0,1176,262
40793,5,387,81,0,306,81
40793,4,193,56,0,137,56
40793,3,74,29,0,45,29
40793,2,28,10,0,18,10
40793,1,12,1,0,11,1
2083,10,49,19,0,30,19
2083,9,51,13,0,38,13
2083,8,171,48,0,123,48
2083,7,447,112,0,335,112
2083,6,1170,245,0,925,245
2083,5,1656,359,0,1297,359
2083,4,1568,362,0,1206,362
2083,3,672,174,0,498,174
2083,2,262,79,0,183,79
2083,1,52,16,0,36,16
2389,10,106,23,0,83,23
2389,9,184,46,0,138,46
2389,8,596,127,0,469,127
2389,7,1230,246,0,984,246
2389,6,2091,422,0,1669,422
2389,5,1123,247,0,876,247
2389,4,516,122,0,394,122
2389,3,180,56,0,124,56
2389,2,55,17,0,38,17
2389,1,11,3,0,8,3
2281,10,87,13,0,74,13
2281,9,141,23,0,118,23
2281,8,566,139,0,427,139
2281,7,1033,224,0,809,224
2281,6,2003,385,0,1618,385
2281,5,1150,214,0,936,214
2281,4,645,132,0,513,132
2281,3,284,70,0,214,70
2281,2,128,57,0,71,57
2281,1,43,15,0,28,15
2281,0,1,1,0,0,1
172081,10,257,60,3,197,57
172081,9,805,129,8,676,121
172081,8,2660,401,19,2259,382
172081,7,1493,201,9,1292,192
172081,6,631,106,6,525,100
172081,5,132,20,1,112,19
172081,4,48,17,0,31,17
172081,3,32,12,1,20,11
172081,2,9,2,0,7,2
172081,1,6,3,0,3,3
198928,10,513,93,0,420,93
198928,9,1256,180,0,1076,180
198928,8,2778,341,0,2437,341
198928,7,1036,98,0,938,98
198928,6,347,52,0,295,52
198928,5,72,12,0,60,12
198928,4,25,4,0,21,4
198928,3,17,2,0,15,2
198928,2,9,1,0,8,1
198928,1,17,2,0,15,2
11971,10,128,35,0,93,35
11971,9,283,53,0,230,53
11971,8,1263,269,0,994,269
11971,7,1618,287,0,1331,287
11971,6,1714,276,0,1438,276
11971,5,541,87,0,454,87
11971,4,267,47,0,220,47
11971,3,124,27,0,97,27
11971,2,64,18,0,46,18
11971,1,22,5,0,17,5
175117,10,121,26,0,95,26
175117,9,306,44,0,262,44
175117,8,1785,243,0,1542,243
175117,7,2075,262,0,1813,262
175117,6,1264,175,0,1089,175
175117,5,301,47,0,254,47
175117,4,98,21,0,77,21
175117,3,45,11,0,34,11
175117,2,19,3,0,16,3
175117,1,8,2,0,6,2
257,10,70,15,0,55,15
257,9,180,48,0,132,48
257,8,778,171,1,607,170
257,7,1433,301,0,1132,301
257,6,1941,437,1,1504,436
257,5,832,206,0,626,206
257,4,422,131,0,291,131
257,3,216,82,0,134,82
257,2,109,51,0,58,51
257,1,28,14,0,14,14
175155,10,819,153,0,666,153
175155,9,1377,210,0,1167,210
175155,8,2096,263,0,1833,263
175155,7,921,94,0,827,94
175155,6,497,71,0,426,71
175155,5,168,27,0,141,27
175155,4,58,17,0,41,17
175155,3,40,10,0,30,10
175155,2,15,3,0,12,3
175155,1,21,3,0,18,3
96913,10,182,48,0,134,48
96913,9,602,111,1,491,110
96913,8,2537,415,0,2122,415
96913,7,1644,233,1,1411,232
96913,6,740,126,0,614,126
96913,5,170,35,0,135,35
96913,4,73,23,0,50,23
96913,3,23,8,0,15,8
96913,2,14,7,0,7,7
96913,1,13,2,0,11,2
122298,10,144,45,0,99,45
122298,9,322,72,0,250,72
122298,8,1747,339,0,1408,339
122298,7,1945,338,3,1607,335
122298,6,1297,229,0,1068,229
122298,5,370,67,0,303,67
122298,4,125,36,0,89,36
122298,3,39,12,0,27,12
122298,2,8,1,0,7,1
122298,1,3,1,0,2,1
22141,10,60,19,0,41,19
22141,9,179,54,0,125,54
22141,8,1445,373,0,1072,373
22141,7,2150,522,0,1628,522
22141,6,1522,394,0,1128,394
22141,5,396,117,0,279,117
22141,4,158,55,0,103,55
22141,3,46,14,0,32,14
22141,2,18,7,0,11,7
22141,1,7,1,0,6,1
221194,10,572,123,18,449,105
221194,9,1244,186,22,1058,164
221194,8,2472,344,52,2128,292
221194,7,948,147,14,801,133
221194,6,456,97,5,359,92
221194,5,150,44,3,106,41
221194,4,68,16,0,52,16
221194,3,40,17,2,23,15
221194,2,20,9,0,11,9
221194,1,16,7,1,9,6
65781,10,172,46,0,126,46
65781,9,618,139,0,479,139
65781,8,2418,494,0,1924,494
65781,7,1590,296,0,1294,296
65781,6,784,188,0,596,188
65781,5,218,62,0,156,62
65781,4,94,34,0,60,34
65781,3,40,11,0,29,11
65781,2,13,3,0,10,3
65781,1,19,2,0,17,2
134726,10,269,24,0,245,24
134726,9,596,49,0,547,49
134726,8,1900,144,0,1756,144
134726,7,1828,131,0,1697,131
134726,6,942,81,0,861,81
134726,5,258,25,0,233,25
134726,4,87,10,0,77,10
134726,3,41,7,0,34,7
134726,2,19,5,0,14,5
134726,1,15,3,0,12,3
17329,10,107,33,0,74,33
17329,9,265,82,0,183,82
17329,8,1233,354,0,879,354
17329,7,2078,501,0,1577,501
17329,6,1707,411,0,1296,411
17329,5,393,95,0,298,95
17329,4,117,29,0,88,29
17329,3,30,9,0,21,9
17329,2,9,2,0,7,2
158600,10,250,54,0,196,54
158600,9,702,129,0,573,129
158600,8,2454,367,0,2087,367
158600,7,1611,196,0,1415,196
158600,6,665,95,0,570,95
158600,5,161,26,0,135,26
158600,4,46,8,0,38,8
158600,3,20,6,0,14,6
156336,10,221,57,0,164,57
156336,9,545,116,0,429,116
156336,8,1707,301,0,1406,301
156336,7,1712,247,0,1465,247
156336,6,1211,171,0,1040,171
156336,5,324,56,1,268,55
156336,4,108,17,0,91,17
156336,3,50,19,0,31,19
156336,2,15,6,0,9,6
156336,1,13,3,0,10,3
2375,10,71,15,0,56,15
2375,9,125,27,0,98,27
2375,8,536,98,0,438,98
2375,7,1186,218,0,968,218
2375,6,2082,390,0,1692,390
2375,5,1017,202,0,815,202
2375,4,535,161,0,374,161
2375,3,209,65,0,144,65
2375,2,80,34,0,46,34
2375,1,22,12,0,10,12
192153,10,256,41,0,215,41
192153,9,661,104,0,557,104
192153,8,2208,273,0,1935,273
192153,7,1661,196,0,1465,196
192153,6,743,102,0,641,102
192153,5,187,30,0,157,30
192153,4,77,20,0,57,20
192153,3,26,4,0,22,4
192153,2,10,4,0,6,4
196340,10,369,74,4,295,70
196340,9,1142,154,15,988,139
196340,8,2791,362,25,2429,337
196340,7,1008,138,5,870,133
196340,6,372,69,4,303,65
196340,5,106,14,1,92,13
196340,4,31,9,0,22,9
196340,3,14,4,0,10,4
196340,1,9,4,0,5,4
266192,10,830,126,0,704,126
266192,9,1490,193,0,1297,193
266192,8,2288,251,0,2037,251
266192,7,755,104,0,651,104
266192,6,359,89,0,270,89
266192,5,103,36,0,67,36
266192,4,49,22,0,27,22
266192,3,17,6,0,11,6
266192,2,10,5,0,5,5
266192,1,31,6,0,25,6
15364,10,113,42,0,71,42
15364,9,372,134,0,238,134
15364,8,2027,591,0,1436,591
15364,7,1991,505,0,1486,505
15364,6,946,257,0,689,257
15364,5,240,84,0,156,84
15364,4,81,31,0,50,31
15364,3,31,14,0,17,14
15364,2,12,2,0,10,2
15364,1,10,1,0,9,1
55690,10,3135,692,32,2443,660
55690,9,1137,170,8,967,162
55690,8,685,97,5,588,92
55690,7,258,33,1,225,32
55690,6,207,35,1,172,34
55690,5,98,21,0,77,21
55690,4,63,16,2,47,14
55690,3,45,11,1,34,10
55690,2,74,17,1,57,16
55690,1,110,26,2,84,24
203420,10,257,39,0,218,39
203420,9,946,119,0,827,119
203420,8,2508,282,0,2226,282
203420,7,1332,134,0,1198,134
203420,6,490,70,0,420,70
203420,5,148,24,0,124,24
203420,4,45,8,0,37,8
203420,3,29,6,0,23,6
203420,2,17,2,0,15,2
203420,1,20,3,0,17,3
172242,10,191,14,0,177,14
172242,9,276,30,2,246,28
172242,8,781,74,2,707,72
172242,7,1208,86,5,1122,81
172242,6,1617,165,11,1452,154
172242,5,774,104,2,670,102
172242,4,468,94,7,374,87
172242,3,239,33,2,206,31
172242,2,144,40,1,104,39
172242,1,70,22,0,48,22
58281,10,463,108,0,355,108
58281,9,664,132,0,532,132
58281,8,1671,248,0,1423,248
58281,7,1380,184,0,1196,184
58281,6,949,141,0,808,141
58281,5,331,72,0,259,72
58281,4,167,31,0,136,31
58281,3,67,16,0,51,16
58281,2,32,8,0,24,8
58281,1,29,4,0,25,4
159675,10,742,133,0,609,133
159675,9,1424,203,0,1221,203
159675,8,2269,305,0,1964,305
159675,7,808,117,0,691,117
159675,6,303,55,0,248,55
159675,5,89,18,0,71,18
159675,4,41,8,0,33,8
159675,3,18,3,0,15,3
159675,2,7,1,0,6,1
159675,1,21,5,0,16,5
1345,10,169,63,0,106,63
1345,9,487,180,0,307,180
1345,8,1828,515,0,1313,515
1345,7,1627,379,0,1248,379
1345,6,998,268,0,730,268
1345,5,316,100,0,216,100
1345,4,157,59,0,98,59
1345,3,75,32,0,43,32
1345,2,39,17,0,22,17
1345,1,19,5,1,14,4
2093,10,464,104,0,360,104
2093,9,513,98,0,415,98
2093,8,1212,193,0,1019,193
2093,7,1447,238,0,1209,238
2093,6,1227,207,0,1020,207
2093,5,489,86,0,403,86
2093,4,210,42,0,168,42
2093,3,68,18,0,50,18
2093,2,51,9,0,42,9
2093,1,19,3,0,16,3
372,10,177,43,0,134,43
372,9,503,124,0,379,124
372,8,2004,386,0,1618,386
372,7,1781,288,0,1493,288
372,6,911,144,0,767,144
372,5,188,38,0,150,38
372,4,71,11,0,60,11
372,3,24,1,0,23,1
372,2,12,1,0,11,1
372,1,13,2,0,11,2
176229,10,48,7,0,41,7
176229,9,151,21,0,130,21
176229,8,1204,157,0,1047,157
176229,7,1996,308,0,1688,308
176229,6,1611,243,0,1368,243
176229,5,434,80,0,354,80
176229,4,140,36,0,104,36
176229,3,64,19,0,45,19
176229,2,14,4,0,10,4
176229,1,10,1,0,9,1
39953,10,277,55,0,222,55
39953,9,496,79,0,417,79
39953,8,1373,213,0,1160,213
39953,7,1383,179,0,1204,179
39953,6,1227,181,0,1046,181
39953,5,492,76,0,416,76
39953,4,235,45,0,190,45
39953,3,98,21,0,77,21
39953,2,59,16,0,43,16
39953,1,27,5,0,22,5
29387,10,78,12,0,66,12
29387,9,188,22,0,166,22
29387,8,680,93,0,587,93
29387,7,1214,159,0,1055,159
29387,6,1770,285,0,1485,285
29387,5,788,140,0,648,140
29387,4,501,122,0,379,122
29387,3,233,61,0,172,61
29387,2,147,54,0,93,54
29387,1,68,24,0,44,24
193037,10,474,37,0,437,37
193037,9,1015,97,0,918,97
193037,8,2255,203,0,2052,203
193037,7,1128,105,0,1023,105
193037,6,506,45,0,461,45
193037,5,150,23,0,127,23
193037,4,75,18,0,57,18
193037,3,40,3,0,37,3
193037,2,12,1,0,11,1
193037,1,13,3,0,10,3
143519,10,299,63,0,236,63
143519,9,580,99,0,481,99
143519,8,1961,287,0,1674,287
143519,7,1391,173,1,1218,172
143519,6,928,143,0,785,143
143519,5,287,52,0,235,52
143519,4,130,24,0,106,24
143519,3,53,12,0,41,12
143519,2,18,8,0,10,8
143519,1,10,2,0,8,2
2719,10,44,9,0,35,9
2719,9,42,8,0,34,8
2719,8,171,41,0,130,41
2719,7,427,111,0,316,111
2719,6,1114,236,0,878,236
2719,5,1500,319,0,1181,319
2719,4,1344,332,0,1012,332
2719,3,651,170,0,481,170
2719,2,254,74,0,180,74
2719,1,80,29,0,51,29
20437,10,241,61,0,180,61
20437,9,626,141,0,485,141
20437,8,2024,375,0,1649,375
20437,7,1424,217,0,1207,217
20437,6,832,134,0,698,134
20437,5,256,68,0,188,68
20437,4,118,38,0,80,38
20437,3,50,17,0,33,17
20437,2,35,13,0,22,13
20437,1,11,5,0,6,5
10093,10,119,21,0,98,21
10093,9,220,54,0,166,54
10093,8,783,164,0,619,164
10093,7,1002,184,0,818,184
10093,6,993,191,0,802,191
10093,5,363,77,0,286,77
10093,4,197,63,0,134,63
10093,3,98,29,0,69,29
10093,2,40,15,0,25,15
10093,1,17,5,0,12,5
44163,10,88,12,0,76,12
44163,9,304,56,0,248,56
44163,8,1532,260,0,1272,260
44163,7,1734,275,0,1459,275
44163,6,1232,255,0,977,255
44163,5,392,82,0,310,82
44163,4,169,55,0,114,55
44163,3,77,29,0,48,29
44163,2,31,11,0,20,11
44163,1,14,5,0,9,5
50750,10,147,29,1,118,28
50750,9,467,111,0,356,111
50750,8,2110,378,2,1732,376
50750,7,1591,293,0,1298,293
50750,6,865,162,0,703,162
50750,5,231,63,0,168,63
50750,4,99,36,0,63,36
50750,3,29,13,0,16,13
50750,2,18,6,0,12,6
50750,1,8,2,0,6,2
38054,10,73,16,0,57,16
38054,9,250,69,1,181,68
38054,8,1657,385,0,1272,385
38054,7,1911,389,0,1522,389
38054,6,1215,257,0,958,257
38054,5,266,58,0,208,58
38054,4,118,28,0,90,28
38054,3,37,11,0,26,11
38054,2,16,4,0,12,4
38054,1,11,1,0,10,1
177639,10,183,46,0,137,46
177639,9,571,100,0,471,100
177639,8,2153,298,0,1855,298
177639,7,1573,178,0,1395,178
177639,6,792,100,0,692,100
177639,5,188,21,0,167,21
177639,4,63,10,0,53,10
177639,3,22,5,0,17,5
177639,2,12,3,0,9,3
12995,10,213,92,0,121,92
12995,9,390,131,0,259,131
12995,8,1259,346,0,913,346
12995,7,1541,358,0,1183,358
12995,6,1286,301,0,985,301
12995,5,437,124,0,313,124
12995,4,239,78,0,161,78
12995,3,112,44,0,68,44
12995,2,36,15,0,21,15
12995,1,10,2,0,8,2
203993,10,395,74,0,321,74
203993,9,1002,120,0,882,120
203993,8,2508,277,1,2231,276
203993,7,1013,117,0,896,117
203993,6,418,61,0,357,61
203993,5,111,20,0,91,20
203993,4,49,10,0,39,10
203993,3,20,6,0,14,6
203993,2,8,2,0,6,2
526,10,92,20,0,72,20
526,9,240,44,0,196,44
526,8,849,136,0,713,136
526,7,1435,249,0,1186,249
526,6,1778,341,0,1437,341
526,5,666,154,0,512,154
526,4,292,82,0,210,82
526,3,103,41,0,62,41
526,2,46,20,0,26,20
526,1,14,6,0,8,6
194879,10,111,16,0,95,16
194879,9,404,76,0,328,76
194879,8,1692,195,0,1497,195
194879,7,1774,174,0,1600,174
194879,6,1047,128,0,919,128
194879,5,280,28,0,252,28
194879,4,120,17,0,103,17
194879,3,48,10,0,38,10
194879,2,18,5,0,13,5
194879,1,13,3,0,10,3
159508,10,159,25,0,134,25
159508,9,578,78,0,500,78
159508,8,2092,316,5,1776,311
159508,7,1387,187,1,1200,186
159508,6,819,126,1,693,125
159508,5,261,44,0,217,44
159508,4,115,28,0,87,28
159508,3,49,14,0,35,14
159508,2,15,5,0,10,5
159508,1,11,4,0,7,4
30539,10,23,5,0,18,5
30539,9,93,19,0,74,19
30539,8,547,96,3,451,93
30539,7,1328,248,6,1080,242
30539,6,2257,419,7,1838,412
30539,5,747,161,0,586,161
30539,4,274,66,1,208,65
30539,3,124,32,0,92,32
30539,2,41,13,0,28,13
30539,1,15,2,0,13,2
257501,10,598,116,0,482,116
257501,9,1016,151,0,865,151
257501,8,1796,205,0,1591,205
257501,7,1092,124,0,968,124
257501,6,580,82,0,498,82
257501,5,173,31,0,142,31
257501,4,93,26,0,67,26
257501,3,68,29,0,39,29
257501,2,26,7,0,19,7
257501,1,37,10,0,27,10
770,10,38,8,0,30,8
770,9,96,26,0,70,26
770,8,639,199,0,440,199
770,7,1539,376,0,1163,376
770,6,2026,504,0,1522,504
770,5,704,185,0,519,185
770,4,276,76,0,200,76
770,3,88,29,0,59,29
770,2,35,16,0,19,16
770,1,6,3,0,3,3
177524,10,120,14,0,106,14
177524,9,256,38,0,218,38
177524,8,1335,204,0,1131,204
177524,7,1750,237,0,1513,237
177524,6,1436,182,0,1254,182
177524,5,336,53,0,283,53
177524,4,131,18,0,113,18
177524,3,58,5,0,53,5
177524,2,19,4,0,15,4
177524,1,9,1,0,8,1
47185,10,302,65,0,237,65
47185,9,575,93,0,482,93
47185,8,1666,262,0,1404,262
47185,7,1407,203,0,1204,203
47185,6,984,140,0,844,140
47185,5,294,52,0,242,52
47185,4,111,25,0,86,25
47185,3,50,12,0,38,12
47185,2,20,3,0,17,3
47185,1,34,3,0,31,3
83195,10,109,22,0,87,22
83195,9,263,59,0,204,59
83195,8,1079,173,0,906,173
83195,7,1712,238,0,1474,238
83195,6,1585,213,0,1372,213
83195,5,420,54,0,366,54
83195,4,161,31,0,130,31
83195,3,63,14,0,49,14
83195,2,32,7,0,25,7
83195,1,14,1,0,13,1
236457,10,401,64,8,337,56
236457,9,1125,148,9,977,139
236457,8,2551,288,22,2263,266
236457,7,824,95,2,729,93
236457,6,400,66,0,334,66
236457,5,93,28,1,65,27
236457,4,49,12,0,37,12
236457,3,18,10,0,8,10
236457,1,10,2,0,8,2
82222,10,750,190,15,560,175
82222,9,1103,188,15,915,173
82222,8,1836,290,27,1546,263
82222,7,826,124,7,702,117
82222,6,504,82,1,422,81
82222,5,168,29,4,139,25
82222,4,111,42,0,69,42
82222,3,62,21,1,41,20
82222,2,33,19,0,14,19
82222,1,21,7,0,14,7
171273,10,110,27,0,83,27
171273,9,348,70,0,278,70
171273,8,1694,264,0,1430,264
171273,7,1745,245,0,1500,245
171273,6,1140,166,0,974,166
171273,5,218,32,0,186,32
171273,4,100,23,0,77,23
171273,3,29,9,0,20,9
171273,2,15,8,0,7,8
224517,10,1350,187,13,1163,174
224517,9,1771,227,18,1544,209
224517,8,1640,190,10,1450,180
224517,7,422,60,1,362,59
224517,6,133,19,1,114,18
224517,5,43,10,0,33,10
224517,4,27,1,0,26,1
224517,3,14,5,0,9,5
5716,10,59,20,0,39,20
5716,9,157,60,0,97,60
5716,8,1166,386,0,780,386
5716,7,1806,525,0,1281,525
5716,6,1502,447,0,1055,447
5716,5,415,149,0,266,149
5716,4,158,68,0,90,68
5716,3,73,39,0,34,39
5716,2,26,17,0,9,17
5716,1,13,7,0,6,7
244522,10,233,38,0,195,38
244522,9,730,100,0,630,100
244522,8,2381,318,0,2063,318
244522,7,1346,174,0,1172,174
244522,6,536,90,0,446,90
244522,5,105,33,0,72,33
244522,4,32,10,0,22,10
244522,3,19,7,0,12,7
244522,2,4,1,0,3,1
244522,1,8,2,0,6,2
140933,10,53,7,0,46,7
140933,9,157,22,0,135,22
140933,8,1349,218,0,1131,218
140933,7,1978,297,0,1681,297
140933,6,1381,234,0,1147,234
140933,5,290,59,0,231,59
140933,4,110,26,0,84,26
140933,3,33,7,0,26,7
140933,2,8,4,0,4,4
140933,1,3,1,0,2,1
49,10,54,17,0,37,17
49,9,137,23,0,114,23
49,8,829,220,0,609,220
49,7,1620,332,0,1288,332
49,6,1792,386,0,1406,386
49,5,540,109,0,431,109
49,4,236,72,0,164,72
49,3,74,26,0,48,26
49,2,30,11,0,19,11
49,1,11,3,0,8,3
624,10,128,28,0,100,28
624,9,255,62,0,193,62
624,8,1030,226,0,804,226
624,7,1537,255,0,1282,255
624,6,1543,272,0,1271,272
624,5,510,119,0,391,119
624,4,223,46,0,177,46
624,3,68,17,0,51,17
624,2,21,6,0,15,6
624,1,8,1,0,7,1
233867,10,234,42,1,192,41
233867,9,736,73,3,663,70
233867,8,2442,234,1,2208,233
233867,7,1286,142,0,1144,142
233867,6,480,72,0,408,72
233867,5,121,24,0,97,24
233867,4,36,5,0,31,5
233867,3,12,1,0,11,1
233867,2,5,2,0,3,2
233867,1,9,3,0,6,3
137269,10,65,16,0,49,16
137269,9,297,51,0,246,51
137269,8,1810,289,0,1521,289
137269,7,1761,251,1,1510,250
137269,6,995,177,0,818,177
137269,5,268,54,0,214,54
137269,4,72,15,0,57,15
137269,3,33,12,0,21,12
137269,2,3,3,0,0,3
137269,1,6,2,0,4,2
125678,10,231,42,0,189,42
125678,9,458,82,0,376,82
125678,8,1402,274,0,1128,274
125678,7,1489,214,0,1275,214
125678,6,1049,195,0,854,195
125678,5,353,70,0,283,70
125678,4,168,50,0,118,50
125678,3,73,16,0,57,16
125678,2,42,14,0,28,14
125678,1,18,6,0,12,6
66356,10,220,42,0,178,42
66356,9,478,85,0,393,85
66356,8,1609,257,0,1352,257
66356,7,1548,221,0,1327,221
66356,6,933,162,0,771,162
66356,5,277,71,0,206,71
66356,4,128,38,0,90,38
66356,3,45,14,0,31,14
66356,2,26,6,0,20,6
66356,1,16,5,0,11,5
42452,10,57,10,0,47,10
42452,9,169,40,0,129,40
42452,8,1300,259,0,1041,259
42452,7,1839,311,0,1528,311
42452,6,1357,230,0,1127,230
42452,5,349,86,0,263,86
42452,4,125,30,0,95,30
42452,3,53,16,0,37,16
42452,2,18,2,0,16,2
42452,1,8,1,0,7,1
9446,10,158,81,0,77,81
9446,9,328,130,0,198,130
9446,8,1157,388,0,769,388
9446,7,1383,341,0,1042,341
9446,6,1302,370,0,932,370
9446,5,555,160,0,395,160
9446,4,241,81,0,160,81
9446,3,91,32,0,59,32
9446,2,48,16,0,32,16
9446,1,11,3,0,8,3
204027,10,91,17,0,74,17
204027,9,267,46,0,221,46
204027,8,1454,212,0,1242,212
204027,7,1834,236,0,1598,236
204027,6,1177,186,0,991,186
204027,5,288,42,0,246,42
204027,4,110,31,0,79,31
204027,3,45,11,0,34,11
204027,2,5,3,0,2,3
148575,10,278,45,0,233,45
148575,9,584,69,0,515,69
148575,8,1601,217,0,1384,217
148575,7,1350,171,0,1179,171
148575,6,873,143,0,730,143
148575,5,316,65,0,251,65
148575,4,128,21,0,107,21
148575,3,66,18,0,48,18
148575,2,30,9,0,21,9
148575,1,24,9,0,15,9
559,10,21,4,0,17,4
559,9,103,26,0,77,26
559,8,741,166,1,575,165
559,7,1593,386,1,1207,385
559,6,1794,377,0,1417,377
559,5,593,154,0,439,154
559,4,262,97,0,165,97
559,3,64,28,0,36,28
559,2,42,19,0,23,19
559,1,8,3,0,5,3
3699,10,94,29,0,65,29
3699,9,155,45,0,110,45
3699,8,502,128,0,374,128
3699,7,781,179,0,602,179
3699,6,1413,346,0,1067,346
3699,5,780,212,0,568,212
3699,4,574,183,0,391,183
3699,3,435,151,0,284,151
3699,2,309,123,0,186,123
3699,1,153,81,0,72,81
3699,0,1,1,0,0,1
13642,10,85,29,0,56,29
13642,9,346,116,0,230,116
13642,8,1665,476,0,1189,476
13642,7,1679,398,0,1281,398
13642,6,968,273,0,695,273
13642,5,247,75,0,172,75
13642,4,126,36,0,90,36
13642,3,47,15,0,32,15
13642,2,14,6,0,8,6
18833,10,199,68,0,131,68
18833,9,422,109,0,313,109
18833,8,1439,346,0,1093,346
18833,7,922,165,0,757,165
18833,6,476,86,0,390,86
18833,5,118,30,0,88,30
18833,4,36,8,0,28,8
18833,3,18,5,0,13,5
18833,2,10,1,0,9,1
2448,10,76,15,0,61,15
2448,9,99,30,0,69,30
2448,8,384,86,0,298,86
2448,7,927,199,0,728,199
2448,6,1826,383,0,1443,383
2448,5,1110,266,0,844,266
2448,4,511,124,0,387,124
2448,3,148,43,0,105,43
2448,2,59,12,0,47,12
2448,1,23,7,0,16,7
2392,10,46,11,0,35,11
2392,9,66,11,0,55,11
2392,8,285,59,0,226,59
2392,7,687,126,0,561,126
2392,6,1668,337,0,1331,337
2392,5,1240,279,0,961,279
2392,4,755,201,0,554,201
2392,3,267,94,0,173,94
2392,2,119,42,0,77,42
2392,1,29,15,0,14,15
146278,10,252,57,0,195,57
146278,9,586,108,0,478,108
146278,8,1617,256,0,1361,256
146278,7,1262,178,0,1084,178
146278,6,872,123,0,749,123
146278,5,279,48,0,231,48
146278,4,143,29,0,114,29
146278,3,81,16,0,65,16
146278,2,38,10,0,28,10
146278,1,16,2,0,14,2
155695,10,57,14,0,43,14
155695,9,109,20,0,89,20
155695,8,758,165,0,593,165
155695,7,1514,265,0,1249,265
155695,6,1807,325,0,1482,325
155695,5,529,113,0,416,113
155695,4,214,62,0,152,62
155695,3,105,25,0,80,25
155695,2,38,14,0,24,14
155695,1,14,3,0,11,3
143986,10,65,8,0,57,8
143986,9,205,46,0,159,46
143986,8,1128,166,0,962,166
143986,7,1669,235,0,1434,235
143986,6,1365,207,0,1158,207
143986,5,379,73,0,306,73
143986,4,166,37,0,129,37
143986,3,81,20,0,61,20
143986,2,41,8,0,33,8
143986,1,21,7,0,14,7
33604,10,98,26,0,72,26
33604,9,241,70,0,171,70
33604,8,1240,263,0,977,263
33604,7,1514,289,0,1225,289
33604,6,1322,238,0,1084,238
33604,5,438,85,0,353,85
33604,4,173,45,0,128,45
33604,3,52,12,0,40,12
33604,2,25,9,0,16,9
33604,1,13,2,0,11,2
2394,10,71,21,0,50,21
2394,9,93,27,0,66,27
2394,8,321,101,0,220,101
2394,7,637,173,0,464,173
2394,6,1400,295,0,1105,295
2394,5,1252,281,0,971,281
2394,4,786,198,0,588,198
2394,3,358,90,0,268,90
2394,2,135,35,0,100,35
2394,1,45,13,0,32,13
39351,10,194,51,0,143,51
39351,9,618,136,0,482,136
39351,8,1890,408,0,1482,408
39351,7,1250,261,0,989,261
39351,6,721,144,0,577,144
39351,5,213,60,0,153,60
39351,4,117,40,0,77,40
39351,3,43,15,0,28,15
39351,2,31,12,0,19,12
39351,1,15,3,0,12,3
121,10,718,267,0,451,267
121,9,775,237,0,538,237
121,8,1491,383,0,1108,383
121,7,1007,235,0,772,235
121,6,635,161,0,474,161
121,5,222,62,0,160,62
121,4,120,30,0,90,30
121,3,60,14,0,46,14
121,2,29,13,0,16,13
121,1,28,5,0,23,5
102548,10,132,20,0,112,20
102548,9,318,43,0,275,43
102548,8,1334,209,0,1125,209
102548,7,1433,164,0,1269,164
102548,6,1191,171,0,1020,171
102548,5,329,46,0,283,46
102548,4,187,35,0,152,35
102548,3,91,14,0,77,14
102548,2,48,11,0,37,11
102548,1,19,6,0,13,6
217372,10,160,30,0,130,30
217372,9,575,95,0,480,95
217372,8,2224,356,0,1868,356
217372,7,1366,186,0,1180,186
217372,6,591,90,0,501,90
217372,5,97,19,0,78,19
217372,4,41,6,0,35,6
217372,3,11,4,0,7,4
217372,2,7,3,0,4,3
15817,10,103,35,0,68,35
15817,9,299,82,0,217,82
15817,8,1461,349,0,1112,349
15817,7,1662,310,0,1352,310
15817,6,1055,227,0,828,227
15817,5,279,66,0,213,66
15817,4,123,41,0,82,41
15817,3,47,19,0,28,19
15817,2,15,4,0,11,4
15817,1,10,1,0,9,1
34585,10,42,9,0,33,9
34585,9,144,34,0,110,34
34585,8,851,162,0,689,162
34585,7,1490,252,0,1238,252
34585,6,1534,228,0,1306,228
34585,5,580,84,0,496,84
34585,4,235,55,0,180,55
34585,3,120,29,0,91,29
34585,2,32,3,0,29,3
34585,1,19,3,0,16,3
191189,10,636,141,11,495,130
191189,9,1275,196,10,1079,186
191189,8,1844,264,13,1580,251
191189,7,740,101,3,639,98
191189,6,365,66,1,299,65
191189,5,99,13,0,86,13
191189,4,48,8,0,40,8
191189,3,27,5,0,22,5
191189,2,13,6,0,7,6
191189,1,12,2,0,10,2
815,10,74,15,0,59,15
815,9,162,40,0,122,40
815,8,653,146,0,507,146
815,7,1252,264,0,988,264
815,6,1631,363,0,1268,363
815,5,614,167,0,447,167
815,4,363,121,0,242,121
815,3,151,69,0,82,69
815,2,102,58,0,44,58
815,1,23,13,0,10,13
242,10,177,49,0,128,49
242,9,387,92,0,295,92
242,8,1075,272,0,803,272
242,7,1328,269,0,1059,269
242,6,1156,249,0,907,249
242,5,414,92,0,322,92
242,4,254,76,0,178,76
242,3,127,37,0,90,37
242,2,72,28,0,44,28
242,1,32,6,0,26,6
200147,10,96,17,0,79,17
200147,9,290,43,0,247,43
200147,8,1632,208,0,1424,208
200147,7,1794,197,0,1597,197
200147,6,922,119,0,803,119
200147,5,198,34,0,164,34
200147,4,61,12,0,49,12
200147,3,18,5,0,13,5
200147,2,9,5,0,4,5
200147,1,6,1,0,5,1
54138,10,446,88,0,358,88
54138,9,929,139,0,790,139
54138,8,1885,263,0,1622,263
54138,7,927,127,0,800,127
54138,6,518,83,0,435,83
54138,5,151,31,0,120,31
54138,4,73,17,0,56,17
54138,3,40,11,0,29,11
54138,2,25,4,0,21,4
54138,1,26,2,0,24,2
179275,10,141,31,0,110,31
179275,9,440,93,5,347,88
179275,8,1692,281,14,1411,267
179275,7,1538,211,13,1327,198
179275,6,853,149,0,704,149
179275,5,213,38,0,175,38
179275,4,80,19,1,61,18
179275,3,43,14,0,29,14
179275,2,18,12,1,6,11
179275,1,10,4,0,6,4
121410,10,58,11,0,47,11
121410,9,226,41,0,185,41
121410,8,1427,213,0,1214,213
121410,7,1656,222,0,1434,222
121410,6,1152,155,0,997,155
121410,5,305,58,0,247,58
121410,4,121,32,0,89,32
121410,3,47,12,0,35,12
121410,2,13,2,0,11,2
121410,1,11,2,0,9,2
220877,10,223,30,0,193,30
220877,9,677,96,0,581,96
220877,8,2399,246,0,2153,246
220877,7,1118,118,0,1000,118
220877,6,441,90,0,351,90
220877,5,99,24,0,75,24
220877,4,43,12,0,31,12
220877,3,19,7,0,12,7
56692,10,72,19,0,53,19
56692,9,248,68,0,180,68
56692,8,1333,273,0,1060,273
56692,7,1755,315,0,1440,315
56692,6,1153,217,0,936,217
56692,5,288,53,0,235,53
56692,4,92,29,0,63,29
56692,3,41,10,0,31,10
56692,2,13,3,0,10,3
56692,1,8,1,0,7,1
65532,10,279,77,1,202,76
65532,9,578,141,1,437,140
65532,8,1602,343,0,1259,343
65532,7,1303,275,1,1028,274
65532,6,818,191,0,627,191
65532,5,240,67,0,173,67
65532,4,111,31,0,80,31
65532,3,40,13,0,27,13
65532,2,12,3,0,9,3
65532,1,9,2,0,7,2
71836,10,98,26,0,72,26
71836,9,220,58,0,162,58
71836,8,1049,262,0,787,262
71836,7,1480,276,0,1204,276
71836,6,1445,285,0,1160,285
71836,5,431,94,0,337,94
71836,4,150,44,0,106,44
71836,3,73,25,0,48,25
71836,2,35,16,0,19,16
71836,1,13,5,0,8,5
2407,10,43,12,0,31,12
2407,9,38,10,0,28,10
2407,8,133,42,0,91,42
2407,7,327,82,0,245,82
2407,6,802,192,0,610,192
2407,5,1113,244,0,869,244
2407,4,1183,270,0,913,270
2407,3,680,195,0,485,195
2407,2,451,111,0,340,111
2407,1,216,51,0,165,51
17223,10,200,36,0,164,36
17223,9,321,69,0,252,69
17223,8,1072,221,0,851,221
17223,7,1249,257,0,992,257
17223,6,1155,239,0,916,239
17223,5,451,95,0,356,95
17223,4,272,77,0,195,77
17223,3,142,45,0,97,45
17223,2,87,30,0,57,30
17223,1,37,9,0,28,9
188920,10,672,115,5,557,110
188920,9,1114,159,12,955,147
188920,8,1755,217,13,1538,204
188920,7,736,82,3,654,79
188920,6,396,61,4,335,57
188920,5,137,24,1,113,23
188920,4,69,15,1,54,14
188920,3,57,20,2,37,18
188920,2,28,7,0,21,7
188920,1,26,11,1,15,10
712,10,531,137,0,394,137
712,9,748,154,0,594,154
712,8,1481,272,0,1209,272
712,7,1149,199,1,950,198
712,6,648,101,0,547,101
712,5,188,36,0,152,36
712,4,107,31,0,76,31
712,3,42,12,0,30,12
712,2,24,6,0,18,6
712,1,36,6,0,30,6
233371,10,356,52,0,304,52
233371,9,985,110,0,875,110
233371,8,2218,245,0,1973,245
233371,7,921,126,0,795,126
233371,6,340,51,0,289,51
233371,5,75,16,0,59,16
233371,4,37,15,0,22,15
233371,3,20,2,0,18,2
233371,2,5,1,0,4,1
233371,1,8,1,0,7,1
91872,10,245,46,0,199,46
91872,9,455,69,0,386,69
91872,8,1634,280,0,1354,280
91872,7,1395,179,0,1216,179
91872,6,821,120,0,701,120
91872,5,234,39,0,195,39
91872,4,92,25,0,67,25
91872,3,32,11,0,21,11
91872,2,14,3,0,11,3
554,10,94,30,0,64,30
554,9,343,124,0,219,124
554,8,1517,396,0,1121,396
554,7,1527,361,0,1166,361
554,6,956,260,0,696,260
554,5,280,76,0,204,76
554,4,117,43,0,74,43
554,3,41,19,0,22,19
554,2,19,8,0,11,8
103886,10,338,76,0,262,76
103886,9,539,91,0,448,91
103886,8,1460,237,0,1223,237
103886,7,1213,153,0,1060,153
103886,6,825,114,0,711,114
103886,5,292,47,0,245,47
103886,4,128,29,0,99,29
103886,3,56,11,0,45,11
103886,2,22,2,0,20,2
103886,1,26,2,0,24,2
21050,10,810,341,0,469,341
21050,9,1054,284,0,770,284
21050,8,1551,388,0,1163,388
21050,7,710,177,0,533,177
21050,6,388,134,0,254,134
21050,5,119,41,0,78,41
21050,4,102,47,0,55,47
21050,3,56,26,0,30,26
21050,2,38,16,0,22,16
21050,1,46,8,0,38,8
10640,10,171,45,0,126,45
10640,9,323,95,0,228,95
10640,8,1240,366,0,874,366
10640,7,1340,364,0,976,364
10640,6,1139,301,0,838,301
10640,5,342,95,0,247,95
10640,4,174,65,0,109,65
10640,3,74,21,0,53,21
10640,2,53,21,0,32,21
10640,1,14,5,0,9,5
137408,10,178,33,1,145,32
137408,9,559,98,7,461,91
137408,8,2036,339,3,1697,336
137408,7,1248,182,4,1066,178
137408,6,566,134,1,432,133
137408,5,167,46,0,121,46
137408,4,69,29,0,40,29
137408,3,24,12,0,12,12
137408,2,10,2,0,8,2
137408,1,10,2,0,8,2
127024,10,92,17,0,75,17
127024,9,188,17,0,171,17
127024,8,1121,121,0,1000,121
127024,7,1607,172,0,1435,172
127024,6,1283,138,0,1145,138
127024,5,327,37,0,290,37
127024,4,150,27,0,123,27
127024,3,59,8,0,51,8
127024,2,23,2,0,21,2
127024,1,11,1,0,10,1
124172,10,79,9,0,70,9
124172,9,193,25,0,168,25
124172,8,944,131,0,813,131
124172,7,1411,189,0,1222,189
124172,6,1384,211,0,1173,211
124172,5,455,76,0,379,76
124172,4,214,59,0,155,59
124172,3,93,43,0,50,43
124172,2,51,19,0,32,19
124172,1,17,7,0,10,7
1269,10,62,8,0,54,8
1269,9,66,15,0,51,15
1269,8,271,38,0,233,38
1269,7,661,92,0,569,92
1269,6,1377,208,0,1169,208
1269,5,1109,183,0,926,183
1269,4,723,168,0,555,168
1269,3,338,92,0,246,92
1269,2,171,50,0,121,50
1269,1,58,16,0,42,16
155624,10,116,21,0,95,21
155624,9,479,55,0,424,55
155624,8,1802,240,0,1562,240
155624,7,1342,172,0,1170,172
155624,6,757,111,0,646,111
155624,5,181,27,0,154,27
155624,4,94,20,0,74,20
155624,3,33,9,0,24,9
155624,2,16,6,0,10,6
155624,1,11,2,0,9,2
146439,10,436,102,0,334,102
146439,9,854,143,0,711,143
146439,8,1938,305,0,1633,305
146439,7,991,128,0,863,128
146439,6,388,61,0,327,61
146439,5,129,21,0,108,21
146439,4,43,8,0,35,8
146439,3,19,3,0,16,3
146439,2,11,4,0,7,4
146439,1,18,1,0,17,1
66056,10,154,28,0,126,28
66056,9,348,61,0,287,61
66056,8,1312,194,0,1118,194
66056,7,1423,195,0,1228,195
66056,6,1087,176,0,911,176
66056,5,305,47,0,258,47
66056,4,112,26,0,86,26
66056,3,55,12,0,43,12
66056,2,16,3,0,13,3
66056,1,12,1,0,11,1
58421,10,167,28,0,139,28
58421,9,494,87,0,407,87
58421,8,1954,316,0,1638,316
58421,7,1357,245,0,1112,245
58421,6,592,102,0,490,102
58421,5,134,43,0,91,43
58421,4,64,23,0,41,23
58421,3,19,5,0,14,5
58421,2,6,1,0,5,1
192457,10,204,43,0,161,43
192457,9,561,83,0,478,83
192457,8,1719,199,0,1520,199
192457,7,1188,170,0,1018,170
192457,6,711,112,0,599,112
192457,5,223,38,0,185,38
192457,4,107,26,0,81,26
192457,3,45,12,0,33,12
192457,2,17,9,0,8,9
192457,1,20,5,0,15,5
12962,10,126,55,0,71,55
12962,9,456,180,0,276,180
12962,8,1643,539,0,1104,539
12962,7,1218,324,1,894,323
12962,6,855,251,0,604,251
12962,5,254,81,0,173,81
12962,4,138,60,0,78,60
12962,3,69,22,0,47,22
12962,2,23,10,0,13,10
12962,1,12,1,0,11,1
681,10,159,23,0,136,23
681,9,282,62,0,220,62
681,8,1001,185,0,816,185
681,7,1509,260,0,1249,260
681,6,1216,234,0,982,234
681,5,416,102,0,314,102
681,4,148,42,0,106,42
681,3,41,7,0,34,7
681,2,14,1,0,13,1
681,1,4,1,0,3,1
714,10,266,92,0,174,92
714,9,309,96,0,213,96
714,8,729,192,0,537,192
714,7,945,237,0,708,237
714,6,1212,299,0,913,299
714,5,580,173,0,407,173
714,4,361,130,0,231,130
714,3,187,71,0,116,71
714,2,144,70,0,74,70
714,1,47,20,0,27,20
8989,10,34,12,0,22,12
8989,9,165,49,0,116,49
8989,8,1331,455,0,876,455
8989,7,1687,423,0,1264,423
8989,6,1110,335,0,775,335
8989,5,295,99,0,196,99
8989,4,97,38,0,59,38
8989,3,40,15,0,25,15
8989,2,10,5,0,5,5
8989,1,9,1,0,8,1
1,10,493,180,0,313,180
1,9,838,255,0,583,255
1,8,1603,449,0,1154,449
1,7,905,212,0,693,212
1,6,551,168,0,383,168
1,5,182,53,0,129,53
1,4,89,40,0,49,40
1,3,48,14,0,34,14
1,2,35,11,0,24,11
1,1,31,7,0,24,7
195421,10,429,59,5,370,54
195421,9,1051,130,10,921,120
195421,8,1939,238,23,1701,215
195421,7,825,105,8,720,97
195421,6,366,57,2,309,55
195421,5,102,16,3,86,13
195421,4,38,10,1,28,9
195421,3,21,4,0,17,4
195421,2,8,1,0,7,1
195421,1,6,2,0,4,2
232043,10,129,20,0,109,20
232043,9,381,52,0,329,52
232043,8,1860,208,0,1652,208
232043,7,1524,165,0,1359,165
232043,6,623,84,0,539,84
232043,5,169,31,0,138,31
232043,4,54,15,0,39,15
232043,3,21,9,0,12,9
232043,2,7,3,0,4,3
904,10,84,39,0,45,39
904,9,280,137,0,143,137
904,8,1503,539,0,964,539
904,7,1535,407,0,1128,407
904,6,1003,285,0,718,285
904,5,205,55,0,150,55
904,4,91,37,0,54,37
904,3,28,8,0,20,8
904,2,19,6,0,13,6
904,1,13,3,0,10,3
1897,10,116,35,0,81,35
1897,9,302,84,0,218,84
1897,8,1161,305,0,856,305
1897,7,1373,323,0,1050,323
1897,6,1076,244,0,832,244
1897,5,374,97,0,277,97
1897,4,178,62,0,116,62
1897,3,91,31,0,60,31
1897,2,38,14,0,24,14
1897,1,13,3,0,10,3
1897,0,1,1,0,0,1
163,10,106,32,0,74,32
163,9,199,49,0,150,49
163,8,789,201,0,588,201
163,7,1111,264,0,847,264
163,6,1467,352,0,1115,352
163,5,592,146,0,446,146
163,4,302,73,0,229,73
163,3,103,28,0,75,28
163,2,39,14,0,25,14
163,1,14,9,0,5,9
162007,10,149,32,6,117,26
162007,9,450,87,14,363,73
162007,8,1703,257,22,1446,235
162007,7,1257,172,13,1085,159
162007,6,827,121,7,706,114
162007,5,171,23,0,148,23
162007,4,108,17,0,91,17
162007,3,38,13,0,25,13
162007,2,12,4,0,8,4
163068,10,513,93,9,420,84
163068,9,904,139,16,765,123
163068,8,1814,280,38,1534,242
163068,7,749,101,10,648,91
163068,6,477,74,5,403,69
163068,5,132,29,3,103,26
163068,4,57,11,1,46,10
163068,3,42,9,0,33,9
163068,2,15,7,0,8,7
163068,1,9,3,0,6,3
9440,10,106,42,0,64,42
9440,9,379,132,0,247,132
9440,8,1560,430,0,1130,430
9440,7,1438,315,0,1123,315
9440,6,835,219,0,616,219
9440,5,209,61,0,148,61
9440,4,104,41,0,63,41
9440,3,44,21,0,23,21
9440,2,22,8,0,14,8
40765,10,403,119,0,284,119
40765,9,749,160,0,589,160
40765,8,1764,332,0,1432,332
40765,7,954,160,0,794,160
40765,6,527,111,0,416,111
40765,5,160,32,0,128,32
40765,4,82,24,0,58,24
40765,3,34,10,0,24,10
40765,2,18,8,0,10,8
40765,1,15,1,0,14,1
112686,10,137,17,0,120,17
112686,9,238,28,0,210,28
112686,8,888,135,0,753,135
112686,7,1247,149,0,1098,149
112686,6,1336,194,0,1142,194
112686,5,394,81,0,313,81
112686,4,226,53,0,173,53
112686,3,114,33,0,81,33
112686,2,80,28,0,52,28
112686,1,29,14,0,15,14
120,10,53,23,0,30,23
120,9,164,48,0,116,48
120,8,806,253,0,553,253
120,7,1414,366,0,1048,366
120,6,1482,417,0,1065,417
120,5,450,149,0,301,149
120,4,194,76,0,118,76
120,3,77,35,0,42,35
120,2,31,15,0,16,15
120,1,14,6,0,8,6
180593,10,83,16,0,67,16
180593,9,253,52,0,201,52
180593,8,1384,231,0,1153,231
180593,7,1518,198,0,1320,198
180593,6,982,143,0,839,143
180593,5,251,46,0,205,46
180593,4,135,23,0,112,23
180593,3,51,9,0,42,9
180593,2,14,5,0,9,5
180593,1,7,2,0,5,2
27364,10,55,13,0,42,13
27364,9,223,59,0,164,59
27364,8,1354,357,0,997,357
27364,7,1534,361,0,1173,361
27364,6,1021,283,0,738,283
27364,5,283,75,0,208,75
27364,4,111,39,0,72,39
27364,3,39,14,0,25,14
27364,2,16,4,0,12,4
27364,1,13,4,0,9,4
4636,10,37,18,0,19,18
4636,9,133,54,0,79,54
4636,8,808,297,0,511,297
4636,7,1527,432,0,1095,432
4636,6,1425,368,0,1057,368
4636,5,445,134,0,311,134
4636,4,183,61,0,122,61
4636,3,69,32,0,37,32
4636,2,15,8,0,7,8
4636,1,7,1,0,6,1
225694,10,328,48,0,280,48
225694,9,824,109,0,715,109
225694,8,2041,235,0,1806,235
225694,7,913,106,0,807,106
225694,6,391,53,0,338,53
225694,5,98,14,0,84,14
225694,4,41,10,0,31,10
225694,3,18,6,0,12,6
225694,2,8,3,0,5,3
1382,10,83,31,0,52,31
1382,9,225,88,0,137,88
1382,8,1283,428,0,855,428
1382,7,1620,459,0,1161,459
1382,6,973,290,0,683,290
1382,5,282,97,0,185,97
1382,4,99,39,0,60,39
1382,3,31,16,0,15,16
1382,2,8,3,0,5,3
1382,1,11,1,0,10,1
221,10,162,53,0,109,53
221,9,343,101,0,242,101
221,8,1165,354,0,811,354
221,7,1460,365,0,1095,365
221,6,999,271,0,728,271
221,5,302,86,0,216,86
221,4,108,31,0,77,31
221,3,49,18,0,31,18
221,2,16,3,0,13,3
221,1,9,3,0,6,3
200680,10,801,118,0,683,118
200680,9,1119,153,0,966,153
200680,8,1564,160,1,1404,159
200680,7,647,59,0,588,59
200680,6,283,29,0,254,29
200680,5,82,11,0,71,11
200680,4,49,3,0,46,3
200680,3,30,3,0,27,3
200680,2,25,1,0,24,1
200680,1,24,4,0,20,4
8125,10,89,42,0,47,42
8125,9,297,132,0,165,132
8125,8,1558,495,0,1063,495
8125,7,1457,346,0,1111,346
8125,6,851,204,0,647,204
8125,5,218,50,0,168,50
8125,4,87,28,0,59,28
8125,3,29,10,0,19,10
8125,2,13,2,0,11,2
8125,1,11,1,0,10,1
28,10,136,38,0,98,38
28,9,248,54,0,194,54
28,8,816,174,0,642,174
28,7,1189,227,0,962,227
28,6,1245,240,0,1005,240
28,5,514,113,0,401,113
28,4,268,90,0,178,90
28,3,111,34,0,77,34
28,2,62,25,0,37,25
28,1,17,8,0,9,8
33154,10,43,10,0,33,10
33154,9,105,31,0,74,31
33154,8,876,200,0,676,200
33154,7,1380,345,0,1035,345
33154,6,1485,353,0,1132,353
33154,5,423,125,0,298,125
33154,4,172,67,0,105,67
33154,3,76,31,0,45,31
33154,2,23,8,0,15,8
33154,1,12,1,0,11,1
2593,10,68,18,0,50,18
2593,9,66,18,0,48,18
2593,8,254,66,0,188,66
2593,7,551,127,0,424,127
2593,6,1299,315,0,984,315
2593,5,1054,265,0,789,265
2593,4,700,214,0,486,214
2593,3,328,107,0,221,107
2593,2,194,65,0,129,65
2593,1,82,32,0,50,32
191977,10,77,12,0,65,12
191977,9,272,38,0,234,38
191977,8,1585,258,0,1327,258
191977,7,1453,228,0,1225,228
191977,6,830,126,0,704,126
191977,5,220,40,0,180,40
191977,4,97,26,0,71,26
191977,3,39,16,0,23,16
191977,2,13,4,0,9,4
16395,10,62,15,0,47,15
16395,9,199,58,0,141,58
16395,8,1061,326,0,735,326
16395,7,1617,396,0,1221,396
16395,6,1204,289,0,915,289
16395,5,293,63,0,230,63
16395,4,97,29,0,68,29
16395,3,25,8,0,17,8
16395,2,13,5,0,8,5
16395,1,13,1,0,12,1
234,10,553,228,0,325,228
234,9,881,286,0,595,286
234,8,1620,414,1,1206,413
234,7,840,199,0,641,199
234,6,380,104,0,276,104
234,5,143,43,0,100,43
234,4,72,22,0,50,22
234,3,36,19,0,17,19
234,2,18,3,0,15,3
234,1,31,2,0,29,2
25071,10,135,11,0,124,11
25071,9,192,23,0,169,23
25071,8,625,47,0,578,47
25071,7,1028,108,0,920,108
25071,6,1359,193,0,1166,193
25071,5,574,68,0,506,68
25071,4,322,58,0,264,58
25071,3,167,37,0,130,37
25071,2,93,21,0,72,21
25071,1,43,8,0,35,8
28259,10,72,14,0,58,14
28259,9,199,42,0,157,42
28259,8,994,228,0,766,228
28259,7,1222,253,0,969,253
28259,6,1209,274,0,935,274
28259,5,420,113,0,307,113
28259,4,234,73,0,161,73
28259,3,116,38,0,78,38
28259,2,54,18,0,36,18
28259,1,16,4,0,12,4
174660,10,69,20,0,49,20
174660,9,162,39,0,123,39
174660,8,1212,176,0,1036,176
174660,7,1554,197,0,1357,197
174660,6,1080,162,0,918,162
174660,5,304,47,0,257,47
174660,4,113,23,0,90,23
174660,3,28,4,0,24,4
174660,2,12,4,0,8,4
174660,1,4,2,0,2,2
1353,10,369,95,0,274,95
1353,9,555,136,0,419,136
1353,8,1391,266,0,1125,266
1353,7,1018,181,0,837,181
1353,6,708,99,0,609,99
1353,5,235,54,0,181,54
1353,4,112,29,0,83,29
1353,3,64,18,0,46,18
1353,2,42,9,0,33,9
1353,1,27,7,0,20,7
9203,10,106,30,0,76,30
9203,9,269,84,0,185,84
9203,8,1083,339,0,744,339
9203,7,1417,368,0,1049,368
9203,6,1102,305,0,797,305
9203,5,320,82,0,238,82
9203,4,128,41,0,87,41
9203,3,60,23,0,37,23
9203,2,12,2,0,10,2
9203,1,17,6,0,11,6
113997,10,207,42,0,165,42
113997,9,496,85,0,411,85
113997,8,1490,225,0,1265,225
113997,7,1135,136,0,999,136
113997,6,757,88,0,669,88
113997,5,209,34,0,175,34
113997,4,115,22,0,93,22
113997,3,60,11,0,49,11
113997,2,16,4,0,12,4
113997,1,10,1,0,9,1
126792,10,159,29,0,130,29
126792,9,395,67,0,328,67
126792,8,1678,221,0,1457,221
126792,7,1251,173,0,1078,173
126792,6,678,127,0,551,127
126792,5,192,37,0,155,37
126792,4,80,14,0,66,14
126792,3,38,8,0,30,8
126792,2,7,3,0,4,3
126792,1,11,2,0,9,2
32125,10,29,7,0,22,7
32125,9,89,23,0,66,23
32125,8,840,194,0,646,194
32125,7,1529,331,0,1198,331
32125,6,1383,287,0,1096,287
32125,5,395,88,0,307,88
32125,4,140,41,0,99,41
32125,3,49,19,0,30,19
32125,2,18,5,0,13,5
32125,1,14,4,0,10,4
157526,10,49,10,0,39,10
157526,9,201,37,5,164,32
157526,8,1284,175,25,1109,150
157526,7,1477,211,27,1266,184
157526,6,1007,164,15,843,149
157526,5,273,54,4,219,50
157526,4,119,32,3,87,29
157526,3,55,17,3,38,14
157526,2,17,5,0,12,5
157526,1,6,3,0,3,3
19600,10,116,41,0,75,41
19600,9,347,107,0,240,107
19600,8,1431,404,0,1027,404
19600,7,1325,332,0,993,332
19600,6,790,242,0,548,242
19600,5,243,90,0,153,90
19600,4,133,58,0,75,58
19600,3,46,21,0,25,21
19600,2,17,8,0,9,8
19600,1,10,2,0,8,2
66505,10,72,14,0,58,14
66505,9,245,64,0,181,64
66505,8,1436,313,0,1123,313
66505,7,1449,262,0,1187,262
66505,6,890,178,0,712,178
66505,5,203,56,0,147,56
66505,4,99,38,0,61,38
66505,3,43,16,0,27,16
66505,2,13,6,0,7,6
201921,10,137,24,3,113,21
201921,9,336,47,4,289,43
201921,8,1521,202,21,1319,181
201921,7,1365,184,20,1181,164
201921,6,761,100,5,661,95
201921,5,191,40,4,151,36
201921,4,81,21,0,60,21
201921,3,37,12,1,25,11
201921,2,17,5,1,12,4
201921,1,9,2,1,7,1
171233,10,82,19,0,63,19
171233,9,297,37,0,260,37
171233,8,1391,198,0,1193,198
171233,7,1344,171,0,1173,171
171233,6,910,130,0,780,130
171233,5,228,29,0,199,29
171233,4,112,34,0,78,34
171233,3,55,12,0,43,12
171233,2,23,4,0,19,4
171233,1,9,2,0,7,2
168584,10,191,30,0,161,30
168584,9,408,56,0,352,56
168584,8,1454,229,0,1225,229
168584,7,1366,189,0,1177,189
168584,6,737,93,0,644,93
168584,5,163,25,0,138,25
168584,4,66,16,0,50,16
168584,3,28,4,0,24,4
168584,2,13,4,0,9,4
168584,1,12,1,0,11,1
119,10,49,16,0,33,16
119,9,138,38,0,100,38
119,8,813,232,0,581,232
119,7,1448,355,0,1093,355
119,6,1399,361,0,1038,361
119,5,372,111,0,261,111
119,4,129,43,0,86,43
119,3,52,22,0,30,22
119,2,16,8,0,8,8
43868,10,49,11,0,38,11
43868,9,121,43,0,78,43
43868,8,834,230,0,604,230
43868,7,1381,335,0,1046,335
43868,6,1448,388,0,1060,388
43868,5,338,101,0,237,101
43868,4,158,58,0,100,58
43868,3,51,18,0,33,18
43868,2,24,12,0,12,12
43868,1,12,6,0,6,6
229853,10,400,56,0,344,56
229853,9,1127,120,1,1007,119
229853,8,1846,216,0,1630,216
229853,7,626,84,0,542,84
229853,6,277,51,0,226,51
229853,5,92,24,0,68,24
229853,4,34,6,0,28,6
229853,3,24,7,0,17,7
229853,2,11,5,0,6,5
229853,1,14,2,0,12,2
124,10,76,12,0,64,12
124,9,262,78,0,184,78
124,8,1295,342,0,953,342
124,7,1373,330,0,1043,330
124,6,935,265,0,670,265
124,5,236,69,0,167,69
124,4,136,51,0,85,51
124,3,66,23,0,43,23
124,2,25,15,0,10,15
170416,10,209,45,4,164,41
170416,9,503,75,7,428,68
170416,8,1543,190,9,1353,181
170416,7,1052,146,7,906,139
170416,6,671,114,6,557,108
170416,5,205,41,0,164,41
170416,4,131,38,2,93,36
170416,3,51,20,0,31,20
170416,2,29,15,0,14,15
170416,1,11,4,0,7,4
244521,10,203,17,0,186,17
244521,9,641,72,0,569,72
244521,8,1969,229,0,1740,229
244521,7,957,117,0,840,117
244521,6,423,64,0,359,64
244521,5,139,39,0,100,39
244521,4,56,18,0,38,18
244521,3,25,8,0,17,8
244521,2,7,4,0,3,4
244521,1,6,1,0,5,1
27710,10,19,2,0,17,2
27710,9,53,9,0,44,9
27710,8,276,52,0,224,52
27710,7,685,135,0,550,135
27710,6,1695,340,0,1355,340
27710,5,922,205,0,717,205
27710,4,434,102,0,332,102
27710,3,177,61,0,116,61
27710,2,98,32,0,66,32
27710,1,24,7,0,17,7
128271,10,180,46,0,134,46
128271,9,506,124,0,382,124
128271,8,1710,258,0,1452,258
128271,7,1127,162,0,965,162
128271,6,590,103,0,487,103
128271,5,157,30,0,127,30
128271,4,64,20,0,44,20
128271,3,26,8,0,18,8
128271,2,15,6,0,9,6
128271,1,9,2,0,7,2
116998,10,206,43,0,163,43
116998,9,580,105,0,475,105
116998,8,1598,256,0,1342,256
116998,7,1108,176,0,932,176
116998,6,556,105,0,451,105
116998,5,167,32,0,135,32
116998,4,85,24,0,61,24
116998,3,40,13,0,27,13
116998,2,16,5,0,11,5
116998,1,21,3,0,18,3
102104,10,124,18,0,106,18
102104,9,211,23,0,188,23
102104,8,675,73,0,602,73
102104,7,1091,108,0,983,108
102104,6,1276,162,0,1114,162
102104,5,477,59,0,418,59
102104,4,261,48,0,213,48
102104,3,143,32,0,111,32
102104,2,77,25,0,52,25
102104,1,38,13,0,25,13
36345,10,73,13,0,60,13
36345,9,136,21,0,115,21
36345,8,516,73,0,443,73
36345,7,945,133,0,812,133
36345,6,1443,229,0,1214,229
36345,5,613,111,0,502,111
36345,4,338,86,0,252,86
36345,3,172,42,0,130,42
36345,2,96,38,0,58,38
36345,1,39,7,0,32,7
167400,10,309,60,0,249,60
167400,9,503,72,0,431,72
167400,8,1499,201,0,1298,201
167400,7,1020,139,0,881,139
167400,6,658,99,0,559,99
167400,5,222,30,0,192,30
167400,4,85,22,0,63,22
167400,3,49,18,0,31,18
167400,2,15,3,0,12,3
167400,1,7,3,0,4,3
202408,10,83,16,0,67,16
202408,9,328,51,0,277,51
202408,8,1564,221,0,1343,221
202408,7,1265,168,0,1097,168
202408,6,725,114,0,611,114
202408,5,238,46,0,192,46
202408,4,84,21,0,63,21
202408,3,34,10,0,24,10
202408,2,9,3,0,6,3
202408,1,4,1,0,3,1
2955,10,92,13,0,79,13
2955,9,279,73,0,206,73
2955,8,1529,370,0,1159,370
2955,7,1413,302,0,1111,302
2955,6,756,188,0,568,188
2955,5,166,33,0,133,33
2955,4,56,23,0,33,23
2955,3,25,10,0,15,10
2955,2,10,1,0,9,1
199,10,40,14,0,26,14
199,9,163,48,0,115,48
199,8,881,222,0,659,222
199,7,1519,321,0,1198,321
199,6,1193,261,0,932,261
199,5,351,74,0,277,74
199,4,123,33,0,90,33
199,3,37,14,0,23,14
199,2,15,4,0,11,4
199,1,8,1,0,7,1
136991,10,73,11,0,62,11
136991,9,205,31,0,174,31
136991,8,1178,145,0,1033,145
136991,7,1556,169,0,1387,169
136991,6,1025,127,0,898,127
136991,5,187,18,0,169,18
136991,4,60,8,0,52,8
136991,3,22,4,0,18,4
136991,2,9,2,0,7,2
136991,1,6,2,0,4,2
166669,10,156,28,0,128,28
166669,9,462,80,0,382,80
166669,8,1903,290,0,1613,290
166669,7,1177,142,0,1035,142
166669,6,452,57,0,395,57
166669,5,105,16,0,89,16
166669,4,36,6,0,30,6
166669,3,6,3,0,3,3
104710,10,161,38,0,123,38
104710,9,350,79,0,271,79
104710,8,1295,246,0,1049,246
104710,7,1175,180,0,995,180
104710,6,892,156,0,736,156
104710,5,249,36,0,213,36
104710,4,116,29,0,87,29
104710,3,37,6,0,31,6
104710,2,17,4,0,13,4
104710,1,11,2,0,9,2
42776,10,268,72,0,196,72
42776,9,530,119,1,411,118
42776,8,1613,328,0,1285,328
42776,7,1009,157,0,852,157
42776,6,577,98,0,479,98
42776,5,163,28,0,135,28
42776,4,74,13,0,61,13
42776,3,34,9,0,25,9
42776,2,16,5,0,11,5
239188,10,464,94,2,370,92
239188,9,1089,151,8,938,143
239188,8,1754,178,7,1576,171
239188,7,606,63,2,543,61
239188,6,264,49,0,215,49
239188,5,69,12,0,57,12
239188,4,37,8,0,29,8
239188,3,19,7,0,12,7
239188,2,15,7,0,8,7
239188,1,10,2,0,8,2
181521,10,185,37,0,148,37
181521,9,483,71,0,412,71
181521,8,1657,236,0,1421,236
181521,7,1148,151,1,997,150
181521,6,567,95,0,472,95
181521,5,155,31,0,124,31
181521,4,57,12,0,45,12
181521,3,29,10,0,19,10
181521,2,8,4,0,4,4
181521,1,5,1,0,4,1
1159,10,54,17,0,37,17
1159,9,202,69,0,133,69
1159,8,1067,292,0,775,292
1159,7,1507,346,0,1161,346
1159,6,1026,238,0,788,238
1159,5,260,83,0,177,83
1159,4,116,43,0,73,43
1159,3,34,12,0,22,12
1159,2,14,4,0,10,4
1159,1,7,1,0,6,1
4095,10,81,12,0,69,12
4095,9,169,21,0,148,21
4095,8,576,63,0,513,63
4095,7,912,114,0,798,114
4095,6,1296,166,0,1130,166
4095,5,585,102,0,483,102
4095,4,362,84,0,278,84
4095,3,166,37,0,129,37
4095,2,100,29,0,71,29
4095,1,37,9,0,28,9
152162,10,77,22,0,55,22
152162,9,213,46,0,167,46
152162,8,1220,221,0,999,221
152162,7,1460,243,0,1217,243
152162,6,926,175,0,751,175
152162,5,240,47,0,193,47
152162,4,96,23,0,73,23
152162,3,30,5,0,25,5
152162,2,15,8,0,7,8
16496,10,56,21,0,35,21
16496,9,184,67,0,117,67
16496,8,1039,296,1,743,295
16496,7,1385,336,1,1049,335
16496,6,1066,256,0,810,256
16496,5,330,82,1,248,81
16496,4,132,42,0,90,42
16496,3,52,22,0,30,22
16496,2,21,4,0,17,4
16496,1,7,1,0,6,1
182134,10,319,68,4,251,64
182134,9,668,105,2,563,103
182134,8,1764,236,14,1528,222
182134,7,956,121,11,835,110
182134,6,403,62,4,341,58
182134,5,88,16,1,72,15
182134,4,41,15,0,26,15
182134,3,17,4,0,13,4
182134,2,9,3,0,6,3
157403,10,73,14,0,59,14
157403,9,244,40,0,204,40
157403,8,1292,243,0,1049,243
157403,7,1398,218,0,1180,218
157403,6,864,151,0,713,151
157403,5,245,37,0,208,37
157403,4,72,23,1,49,22
157403,3,31,14,0,17,14
157403,2,14,2,0,12,2
157403,1,5,2,0,3,2
154246,10,42,3,0,39,3
154246,9,157,36,0,121,36
154246,8,1260,208,0,1052,208
154246,7,1398,220,0,1178,220
154246,6,984,168,0,816,168
154246,5,256,45,0,211,45
154246,4,87,24,0,63,24
154246,3,39,17,0,22,17
154246,2,9,5,0,4,5
30957,10,98,17,0,81,17
30957,9,304,79,0,225,79
30957,8,1530,312,0,1218,312
30957,7,1307,228,0,1079,228
30957,6,704,160,0,544,160
30957,5,178,51,0,127,51
30957,4,69,24,0,45,24
30957,3,19,9,0,10,9
30957,2,6,4,0,2,4
30957,1,8,1,0,7,1
156566,10,100,17,0,83,17
156566,9,317,44,0,273,44
156566,8,1463,193,0,1270,193
156566,7,1291,157,0,1134,157
156566,6,707,70,0,637,70
156566,5,192,25,0,167,25
156566,4,82,13,0,69,13
156566,3,41,4,0,37,4
156566,2,14,2,0,12,2
156566,1,10,2,0,8,2
43528,10,132,17,0,115,17
43528,9,357,65,0,292,65
43528,8,1523,221,0,1302,221
43528,7,1289,162,0,1127,162
43528,6,621,99,0,522,99
43528,5,156,30,0,126,30
43528,4,80,28,0,52,28
43528,3,31,4,0,27,4
43528,2,17,4,0,13,4
43528,1,6,1,0,5,1
35815,10,166,43,0,123,43
35815,9,332,83,0,249,83
35815,8,1157,247,0,910,247
35815,7,1120,216,0,904,216
35815,6,854,197,0,657,197
35815,5,314,84,0,230,84
35815,4,137,47,0,90,47
35815,3,64,26,0,38,26
35815,2,37,9,0,28,9
35815,1,14,3,0,11,3
224,10,231,81,0,150,81
224,9,385,127,0,258,127
224,8,1177,352,0,825,352
224,7,1149,292,0,857,292
224,6,774,222,0,552,222
224,5,252,85,0,167,85
224,4,129,50,0,79,50
224,3,54,25,0,29,25
224,2,31,20,0,11,20
224,1,13,5,0,8,5
234487,10,165,22,0,143,22
234487,9,608,59,0,549,59
234487,8,1823,216,0,1607,216
234487,7,898,125,0,773,125
234487,6,472,76,0,396,76
234487,5,114,31,0,83,31
234487,4,49,12,0,37,12
234487,3,39,20,0,19,20
234487,2,13,5,0,8,5
234487,1,8,1,0,7,1
553,10,55,10,0,45,10
553,9,85,21,0,64,21
553,8,353,64,0,289,64
553,7,727,132,0,595,132
553,6,1359,281,0,1078,281
553,5,753,163,0,590,163
553,4,441,112,0,329,112
553,3,256,81,0,175,81
553,2,118,50,0,68,50
553,1,36,16,0,20,16
182631,10,379,54,0,325,54
182631,9,736,86,0,650,86
182631,8,1808,182,1,1626,181
182631,7,855,98,0,757,98
182631,6,313,40,0,273,40
182631,5,55,9,0,46,9
182631,4,19,4,0,15,4
182631,2,5,2,0,3,2
221965,10,113,27,0,86,27
221965,9,401,84,0,317,84
221965,8,1644,238,0,1406,238
221965,7,1237,182,0,1055,182
221965,6,580,92,0,488,92
221965,5,129,24,0,105,24
221965,4,48,13,0,35,13
221965,3,19,3,0,16,3
221965,2,10,2,0,8,2
221965,1,4,1,0,3,1
18100,10,56,20,0,36,20
18100,9,221,106,0,115,106
18100,8,1206,406,0,800,406
18100,7,1471,431,0,1040,431
18100,6,879,233,0,646,233
18100,5,214,67,0,147,67
18100,4,81,36,0,45,36
18100,3,26,10,0,16,10
18100,2,11,3,0,8,3
18100,1,7,1,0,6,1
161614,10,186,36,1,150,35
161614,9,480,100,3,380,97
161614,8,1802,262,6,1540,256
161614,7,1031,159,4,872,155
161614,6,466,73,1,393,72
161614,5,107,23,0,84,23
161614,4,56,12,0,44,12
161614,3,19,5,0,14,5
161614,1,6,1,0,5,1
494,10,62,27,0,35,27
494,9,197,73,0,124,73
494,8,808,255,0,553,255
494,7,1256,351,0,905,351
494,6,1173,324,0,849,324
494,5,361,110,0,251,110
494,4,179,64,0,115,64
494,3,73,32,0,41,32
494,2,24,10,0,14,10
494,1,16,8,0,8,8
109276,10,420,83,0,337,83
109276,9,862,137,0,725,137
109276,8,1596,231,0,1365,231
109276,7,628,77,0,551,77
109276,6,383,78,0,305,78
109276,5,124,25,0,99,25
109276,4,69,25,0,44,25
109276,3,39,13,0,26,13
109276,2,23,4,0,19,4
109276,1,9,1,0,8,1
42052,10,279,54,0,225,54
42052,9,611,125,1,486,124
42052,8,1551,248,2,1303,246
42052,7,804,117,0,687,117
42052,6,506,93,0,413,93
42052,5,185,42,0,143,42
42052,4,82,23,0,59,23
42052,3,50,20,0,30,20
42052,2,23,5,0,18,5
42052,1,17,1,0,16,1
925,10,253,109,1,144,108
925,9,316,116,1,200,115
925,8,808,286,0,522,286
925,7,934,263,0,671,263
925,6,886,272,1,614,271
925,5,317,91,0,226,91
925,4,245,82,0,163,82
925,3,134,41,0,93,41
925,2,120,48,0,72,48
925,1,89,30,0,59,30
5737,10,65,26,0,39,26
5737,9,244,74,0,170,74
5737,8,1195,338,0,857,338
5737,7,1368,292,1,1076,291
5737,6,854,228,0,626,228
5737,5,207,48,0,159,48
5737,4,102,35,0,67,35
5737,3,42,17,0,25,17
5737,2,7,4,0,3,4
5737,1,11,1,0,10,1
145659,10,82,16,1,66,15
145659,9,272,37,3,235,34
145659,8,1499,205,11,1294,194
145659,7,1243,180,11,1063,169
145659,6,686,119,1,567,118
145659,5,192,56,2,136,54
145659,4,62,15,0,47,15
145659,3,34,12,1,22,11
145659,2,16,5,0,11,5
145659,1,4,1,0,3,1
132,10,21,6,0,15,6
132,9,68,26,0,42,26
132,8,571,161,0,410,161
132,7,1312,311,0,1001,311
132,6,1404,297,0,1107,297
132,5,462,135,0,327,135
132,4,167,55,0,112,55
132,3,54,25,0,29,25
132,2,12,7,0,5,7
94,10,138,66,0,72,66
94,9,377,130,0,247,130
94,8,1324,312,0,1012,312
94,7,1264,283,0,981,283
94,6,638,156,0,482,156
94,5,203,61,0,142,61
94,4,79,36,0,43,36
94,3,28,7,0,21,7
94,2,14,5,0,9,5
94,1,12,1,0,11,1
2338,10,59,14,0,45,14
2338,9,232,68,0,164,68
2338,8,996,278,0,718,278
2338,7,1348,308,0,1040,308
2338,6,934,201,0,733,201
2338,5,306,91,0,215,91
2338,4,111,37,0,74,37
2338,3,57,24,0,33,24
2338,2,20,5,0,15,5
41002,10,118,19,0,99,19
41002,9,359,58,0,301,58
41002,8,1550,263,0,1287,263
41002,7,1157,181,0,976,181
41002,6,568,127,0,441,127
41002,5,152,39,0,113,39
41002,4,86,27,0,59,27
41002,3,42,18,0,24,18
41002,2,19,9,0,10,9
41002,1,11,2,0,9,2
121297,10,63,25,1,38,24
121297,9,213,64,3,149,61
121297,8,1230,290,17,940,273
121297,7,1264,255,8,1009,247
121297,6,857,187,10,670,177
121297,5,245,62,2,183,60
121297,4,119,41,2,78,39
121297,3,42,14,0,28,14
121297,2,11,4,1,7,3
121297,1,10,2,0,8,2
2346,10,228,79,0,149,79
2346,9,484,159,0,325,159
2346,8,1427,386,0,1041,386
2346,7,1124,274,0,850,274
2346,6,513,124,0,389,124
2346,5,153,52,0,101,52
2346,4,63,24,0,39,24
2346,3,22,6,0,16,6
2346,2,17,3,0,14,3
91,10,714,250,0,464,250
91,9,952,268,0,684,268
91,8,1299,318,0,981,318
91,7,532,134,0,398,134
91,6,282,87,0,195,87
91,5,106,25,0,81,25
91,4,48,20,0,28,20
91,3,39,11,0,28,11
91,2,24,8,0,16,8
91,1,50,3,0,47,3
1041,10,94,34,0,60,34
1041,9,319,111,0,208,111
1041,8,1370,422,0,948,422
1041,7,1244,312,0,932,312
1041,6,710,180,0,530,180
1041,5,166,40,0,126,40
1041,4,96,36,0,60,36
1041,3,30,8,0,22,8
1041,2,8,2,0,6,2
1041,1,7,1,0,6,1
245638,10,198,32,0,166,32
245638,9,695,87,0,608,87
245638,8,1922,195,0,1727,195
245638,7,751,100,0,651,100
245638,6,341,64,0,277,64
245638,5,94,23,0,71,23
245638,4,32,14,0,18,14
245638,3,19,6,0,13,6
245638,2,6,5,0,1,5
245638,1,5,1,0,4,1
26990,10,194,69,0,125,69
26990,9,457,154,0,303,154
26990,8,1232,335,1,897,334
26990,7,990,226,0,764,226
26990,6,646,176,0,470,176
26990,5,251,74,0,177,74
26990,4,140,48,0,92,48
26990,3,82,40,0,42,40
26990,2,34,13,0,21,13
26990,1,16,5,0,11,5
161533,10,705,131,8,574,123
161533,9,1086,157,12,929,145
161533,8,1334,173,13,1161,160
161533,7,472,75,0,397,75
161533,6,281,46,4,235,42
161533,5,74,7,0,67,7
161533,4,46,18,0,28,18
161533,3,18,4,0,14,4
161533,2,11,4,0,7,4
161533,1,11,2,0,9,2
157809,10,52,8,0,44,8
157809,9,209,37,0,172,37
157809,8,1221,196,0,1025,196
157809,7,1309,202,0,1107,202
157809,6,836,153,0,683,153
157809,5,238,39,0,199,39
157809,4,103,29,0,74,29
157809,3,42,19,0,23,19
157809,2,10,5,0,5,5
157809,1,8,1,0,7,1
12902,10,107,31,0,76,31
12902,9,320,103,0,217,103
12902,8,1379,381,0,998,381
12902,7,1241,266,0,975,266
12902,6,657,150,0,507,150
12902,5,199,46,0,153,46
12902,4,72,18,0,54,18
12902,3,27,8,0,19,8
12902,2,5,3,0,2,3
184921,10,135,32,0,103,32
184921,9,408,66,0,342,66
184921,8,1586,205,0,1381,205
184921,7,1103,118,0,985,118
184921,6,540,101,0,439,101
184921,5,133,18,0,115,18
184921,4,59,18,0,41,18
184921,3,23,5,0,18,5
184921,2,11,2,0,9,2
184921,1,8,3,0,5,3
213893,10,110,20,0,90,20
213893,9,362,56,0,306,56
213893,8,1496,167,0,1329,167
213893,7,1094,137,0,957,137
213893,6,614,94,0,520,94
213893,5,177,35,0,142,35
213893,4,73,24,0,49,24
213893,3,35,7,0,28,7
213893,2,14,3,0,11,3
213893,1,8,3,0,5,3
361,10,58,17,0,41,17
361,9,149,47,0,102,47
361,8,720,185,0,535,185
361,7,1270,289,0,981,289
361,6,1237,273,0,964,273
361,5,345,90,0,255,90
361,4,115,38,0,77,38
361,3,51,26,0,25,26
361,2,22,7,0,15,7
361,1,8,3,0,5,3
94362,10,99,26,0,73,26
94362,9,212,48,0,164,48
94362,8,954,165,0,789,165
94362,7,1170,170,0,1000,170
94362,6,984,163,0,821,163
94362,5,348,64,0,284,64
94362,4,135,36,0,99,36
94362,3,43,11,0,32,11
94362,2,14,3,0,11,3
4324,10,38,7,0,31,7
4324,9,71,18,0,53,18
4324,8,317,73,0,244,73
4324,7,767,144,0,623,144
4324,6,1477,275,0,1202,275
4324,5,729,139,0,590,139
4324,4,334,85,0,249,85
4324,3,147,43,0,104,43
4324,2,65,21,0,44,21
4324,1,18,9,0,9,9
155969,10,31,6,0,25,6
155969,9,108,28,3,80,25
155969,8,814,170,14,644,156
155969,7,1222,177,10,1045,167
155969,6,1153,188,9,965,179
155969,5,356,82,5,274,77
155969,4,158,46,3,112,43
155969,3,79,28,1,51,27
155969,2,30,14,1,16,13
155969,1,6,4,1,2,3
421,10,622,215,0,407,215
421,9,756,189,0,567,189
421,8,1290,312,0,978,312
421,7,635,138,0,497,138
421,6,379,115,0,264,115
421,5,111,36,0,75,36
421,4,69,24,0,45,24
421,3,46,19,0,27,19
421,2,25,9,0,16,9
421,1,25,1,0,24,1
18258,10,47,12,0,35,12
18258,9,185,46,0,139,46
18258,8,1158,306,0,852,306
18258,7,1323,314,0,1009,314
18258,6,833,228,0,605,228
18258,5,234,74,0,160,74
18258,4,108,34,0,74,34
18258,3,40,19,0,21,19
18258,2,12,5,0,7,5
18258,1,10,2,0,8,2
140603,10,156,32,1,124,31
140603,9,436,75,3,361,72
140603,8,1622,252,5,1370,247
140603,7,982,159,1,823,158
140603,6,521,103,0,418,103
140603,5,144,41,0,103,41
140603,4,37,11,0,26,11
140603,3,27,9,0,18,9
140603,2,8,5,0,3,5
140603,1,6,1,0,5,1
25643,10,36,16,0,20,16
25643,9,153,55,0,98,55
25643,8,1159,341,0,818,341
25643,7,1333,357,0,976,357
25643,6,873,253,0,620,253
25643,5,242,64,0,178,64
25643,4,99,23,0,76,23
25643,3,21,9,0,12,9
25643,2,7,2,0,5,2
25643,1,8,1,0,7,1
163166,10,315,27,2,288,25
163166,9,526,67,2,459,65
163166,8,1262,138,8,1124,130
163166,7,1002,109,4,893,105
163166,6,494,63,1,431,62
163166,5,166,33,2,133,31
163166,4,85,16,0,69,16
163166,3,38,4,0,34,4
163166,2,22,5,0,17,5
163166,1,22,3,0,19,3
194880,10,78,13,0,65,13
194880,9,178,27,0,151,27
194880,8,1013,153,0,860,153
194880,7,1412,190,0,1222,190
194880,6,940,103,0,837,103
194880,5,212,40,0,172,40
194880,4,64,14,0,50,14
194880,3,24,4,0,20,4
194880,2,5,1,0,4,1
41916,10,83,14,0,69,14
41916,9,183,33,0,150,33
41916,8,843,170,0,673,170
41916,7,1349,230,1,1119,229
41916,6,1102,184,0,918,184
41916,5,238,41,0,197,41
41916,4,87,16,0,71,16
41916,3,28,4,0,24,4
41916,2,5,1,0,4,1
144592,10,216,45,0,171,45
144592,9,583,104,0,479,104
144592,8,1687,258,0,1429,258
144592,7,865,114,1,751,113
144592,6,372,71,0,301,71
144592,5,117,25,0,92,25
144592,4,45,17,0,28,17
144592,3,23,8,0,15,8
144592,1,8,2,0,6,2
217449,10,58,11,0,47,11
217449,9,242,32,0,210,32
217449,8,1065,178,0,887,178
217449,7,1307,161,0,1146,161
217449,6,914,112,0,802,112
217449,5,208,39,0,169,39
217449,4,80,18,0,62,18
217449,3,33,6,0,27,6
217449,2,10,5,0,5,5
217449,1,6,1,0,5,1
70512,10,143,36,0,107,36
70512,9,418,99,0,319,99
70512,8,1500,270,0,1230,270
70512,7,1021,154,0,867,154
70512,6,538,107,0,431,107
70512,5,164,36,0,128,36
70512,4,74,20,0,54,20
70512,3,31,11,0,20,11
70512,2,16,6,0,10,6
70512,1,11,2,0,9,2
19100,10,67,24,0,43,24
19100,9,175,76,0,99,76
19100,8,1125,312,0,813,312
19100,7,1300,279,0,1021,279
19100,6,844,199,0,645,199
19100,5,259,69,0,190,69
19100,4,87,28,0,59,28
19100,3,33,13,0,20,13
19100,2,7,2,0,5,2
203427,10,77,13,0,64,13
203427,9,261,38,0,223,38
203427,8,1265,185,0,1080,185
203427,7,1227,169,0,1058,169
203427,6,770,118,0,652,118
203427,5,188,38,0,150,38
203427,4,73,14,0,59,14
203427,3,25,2,0,23,2
203427,2,8,2,0,6,2
203427,1,5,1,0,4,1
195539,10,220,36,0,184,36
195539,9,602,103,0,499,103
195539,8,1615,186,0,1429,186
195539,7,852,85,0,767,85
195539,6,362,45,0,317,45
195539,5,117,17,0,100,17
195539,4,62,13,0,49,13
195539,3,31,9,0,22,9
195539,2,8,1,0,7,1
195539,1,8,2,0,6,2
203417,10,109,8,0,101,8
203417,9,378,43,0,335,43
203417,8,1388,145,0,1243,145
203417,7,1120,102,0,1018,102
203417,6,571,86,0,485,86
203417,5,161,29,0,132,29
203417,4,65,14,0,51,14
203417,3,34,10,0,24,10
203417,2,31,4,0,27,4
203417,1,17,4,0,13,4
142326,10,48,9,0,39,9
142326,9,190,35,1,155,34
142326,8,1146,214,6,932,208
142326,7,1353,212,2,1141,210
142326,6,828,134,3,694,131
142326,5,197,41,0,156,41
142326,4,80,10,0,70,10
142326,3,20,5,0,15,5
142326,1,5,2,0,3,2
34887,10,51,14,0,37,14
34887,9,187,35,0,152,35
34887,8,974,215,0,759,215
34887,7,1177,214,0,963,214
34887,6,904,179,0,725,179
34887,5,287,76,0,211,76
34887,4,167,43,0,124,43
34887,3,69,27,0,42,27
34887,2,35,15,0,20,15
34887,1,15,5,0,10,5
121288,10,226,24,0,202,24
121288,9,419,60,0,359,60
121288,8,1349,181,0,1168,181
121288,7,1095,130,0,965,130
121288,6,562,83,0,479,83
121288,5,114,15,0,99,15
121288,4,51,7,0,44,7
121288,3,18,4,0,14,4
121288,2,8,1,0,7,1
240,10,209,70,0,139,70
240,9,412,136,0,276,136
240,8,1140,314,0,826,314
240,7,1062,279,0,783,279
240,6,634,168,0,466,168
240,5,203,56,0,147,56
240,4,106,38,0,68,38
240,3,49,20,0,29,20
240,2,24,15,0,9,15
240,1,16,7,0,9,7
104363,10,149,35,0,114,35
104363,9,413,82,0,331,82
104363,8,1154,175,0,979,175
104363,7,1025,134,0,891,134
104363,6,678,117,0,561,117
104363,5,198,35,0,163,35
104363,4,112,31,0,81,31
104363,3,59,22,0,37,22
104363,2,32,7,0,25,7
104363,1,19,2,0,17,2
25568,10,61,21,0,40,21
25568,9,206,63,0,143,63
25568,8,1155,340,0,815,340
25568,7,1274,272,0,1002,272
25568,6,835,164,0,671,164
25568,5,202,48,0,154,48
25568,4,66,20,0,46,20
25568,3,22,10,0,12,10
25568,2,12,3,0,9,3
25568,1,6,1,0,5,1
60,10,102,35,0,67,35
60,9,299,88,0,211,88
60,8,1221,368,0,853,368
60,7,1164,291,0,873,291
60,6,656,200,0,456,200
60,5,238,82,0,156,82
60,4,92,38,0,54,38
60,3,36,13,0,23,13
60,2,18,7,0,11,7
60,1,8,1,0,7,1
72321,10,63,15,0,48,15
72321,9,289,40,5,249,35
72321,8,1491,259,18,1232,241
72321,7,1140,144,4,996,140
72321,6,663,120,3,543,117
72321,5,117,18,0,99,18
72321,4,48,18,0,30,18
72321,3,14,4,0,10,4
72321,2,8,2,0,6,2
72321,1,3,2,0,1,2
163745,10,500,82,0,418,82
163745,9,832,118,0,714,118
163745,8,1270,171,0,1099,171
163745,7,666,70,0,596,70
163745,6,365,45,0,320,45
163745,5,98,22,0,76,22
163745,4,52,10,0,42,10
163745,3,19,6,0,13,6
163745,2,15,4,0,11,4
163745,1,17,1,0,16,1
119432,10,150,56,0,94,56
119432,9,462,113,3,349,110
119432,8,1497,299,6,1198,293
119432,7,980,180,1,800,179
119432,6,482,95,1,387,94
119432,5,143,38,0,105,38
119432,4,63,20,0,43,20
119432,3,31,14,0,17,14
119432,2,8,2,0,6,2
119432,1,9,1,0,8,1
106217,10,92,21,0,71,21
106217,9,305,56,0,249,56
106217,8,1373,228,0,1145,228
106217,7,1101,161,0,940,161
106217,6,621,117,0,504,117
106217,5,192,43,0,149,43
106217,4,74,27,0,47,27
106217,3,38,15,0,23,15
106217,2,17,9,0,8,9
143515,10,82,12,0,70,12
143515,9,265,52,0,213,52
143515,8,1492,254,0,1238,254
143515,7,1195,173,1,1022,172
143515,6,582,98,0,484,98
143515,5,134,36,0,98,36
143515,4,34,8,0,26,8
143515,3,15,7,0,8,7
104347,10,53,5,0,48,5
104347,9,143,17,0,126,17
104347,8,1023,168,0,855,168
104347,7,1376,183,0,1193,183
104347,6,901,117,0,784,117
104347,5,200,35,0,165,35
104347,4,72,21,0,51,21
104347,3,22,5,0,17,5
104347,2,9,4,0,5,4
104347,1,8,1,0,7,1
2596,10,35,8,0,27,8
2596,9,122,38,0,84,38
2596,8,559,167,0,392,167
2596,7,1162,262,0,900,262
2596,6,1279,308,0,971,308
2596,5,398,89,0,309,89
2596,4,143,38,0,105,38
2596,3,63,19,0,44,19
2596,2,18,6,0,12,6
2596,1,16,7,0,9,7
207830,10,167,47,4,120,43
207830,9,360,68,8,292,60
207830,8,1185,204,15,981,189
207830,7,1106,164,11,942,153
207830,6,664,94,5,570,89
207830,5,176,31,0,145,31
207830,4,74,15,0,59,15
207830,3,30,10,1,20,9
207830,2,14,4,1,10,3
207830,1,7,2,0,5,2
62227,10,276,68,0,208,68
62227,9,638,142,0,496,142
62227,8,1414,269,0,1145,269
62227,7,765,156,0,609,156
62227,6,397,97,0,300,97
62227,5,131,33,0,98,33
62227,4,74,22,0,52,22
62227,3,35,15,0,20,15
62227,2,16,6,0,10,6
62227,1,31,8,0,23,8
179572,10,45,6,0,39,6
179572,9,123,20,0,103,20
179572,8,996,164,0,832,164
179572,7,1239,183,0,1056,183
179572,6,966,145,0,821,145
179572,5,249,47,1,202,46
179572,4,106,23,0,83,23
179572,3,37,8,0,29,8
179572,2,11,6,0,5,6
15,10,192,93,0,99,93
15,9,199,68,0,131,68
15,8,496,184,0,312,184
15,7,577,169,0,408,169
15,6,523,190,0,333,190
15,5,196,62,0,134,62
15,4,121,51,0,70,51
15,3,52,27,0,25,27
15,2,25,17,0,8,17
15,1,10,4,0,6,4
103,10,309,153,0,156,153
103,9,359,115,0,244,115
103,8,829,256,0,573,256
103,7,885,227,0,658,227
103,6,733,172,0,561,172
103,5,294,79,0,215,79
103,4,178,56,0,122,56
103,3,105,40,0,65,40
103,2,46,31,0,15,31
103,1,18,7,0,11,7
21441,10,28,9,0,19,9
21441,9,119,47,0,72,47
21441,8,1046,325,0,721,325
21441,7,1331,321,0,1010,321
21441,6,852,233,0,619,233
21441,5,239,68,0,171,68
21441,4,93,32,0,61,32
21441,3,29,13,0,16,13
21441,2,9,5,0,4,5
21441,1,8,2,0,6,2
181810,10,61,8,1,53,7
181810,9,158,21,1,137,20
181810,8,834,148,15,686,133
181810,7,1293,176,9,1117,167
181810,6,998,156,4,842,152
181810,5,269,55,0,214,55
181810,4,93,23,1,70,22
181810,3,26,7,0,19,7
181810,2,14,5,0,9,5
181810,1,4,2,0,2,2
878,10,53,25,0,28,25
878,9,181,73,0,108,73
878,8,899,294,1,605,293
878,7,1320,384,0,936,384
878,6,878,228,0,650,228
878,5,253,70,0,183,70
878,4,90,33,0,57,33
878,3,44,13,0,31,13
878,2,12,6,0,6,6
878,1,8,2,0,6,2
170,10,61,21,0,40,21
170,9,97,35,0,62,35
170,8,409,99,0,310,99
170,7,836,190,0,646,190
170,6,1323,331,0,992,331
170,5,506,141,0,365,141
170,4,274,96,0,178,96
170,3,129,44,0,85,44
170,2,79,28,0,51,28
170,1,24,9,0,15,9
171669,10,58,11,0,47,11
171669,9,202,37,0,165,37
171669,8,1326,174,1,1152,173
171669,7,1216,160,0,1056,160
171669,6,698,121,0,577,121
171669,5,151,31,0,120,31
171669,4,54,18,0,36,18
171669,3,25,7,0,18,7
171669,2,10,1,0,9,1
34127,10,30,3,0,27,3
34127,9,69,10,0,59,10
34127,8,486,123,0,363,123
34127,7,972,196,0,776,196
34127,6,1206,263,0,943,263
34127,5,522,129,0,393,129
34127,4,248,66,0,182,66
34127,3,110,33,0,77,33
34127,2,66,33,0,33,33
34127,1,14,4,0,10,4
24742,10,52,23,0,29,23
24742,9,138,41,0,97,41
24742,8,798,211,0,587,211
24742,7,1123,267,0,856,267
24742,6,1071,262,0,809,262
24742,5,297,73,0,224,73
24742,4,149,53,0,96,53
24742,3,63,20,0,43,20
24742,2,20,9,0,11,9
24742,1,12,2,0,10,2
31563,10,209,56,0,153,56
31563,9,454,105,0,349,105
31563,8,1290,273,0,1017,273
31563,7,933,184,0,749,184
31563,6,515,120,0,395,120
31563,5,178,51,0,127,51
31563,4,81,27,0,54,27
31563,3,40,15,0,25,15
31563,2,13,8,0,5,8
31563,1,11,4,0,7,4
119788,10,139,25,0,114,25
119788,9,382,64,0,318,64
119788,8,1351,176,0,1175,176
119788,7,911,138,0,773,138
119788,6,599,90,0,509,90
119788,5,180,36,0,144,36
119788,4,100,35,0,65,35
119788,3,40,14,0,26,14
119788,2,12,2,0,10,2
119788,1,9,3,0,6,3
158900,10,53,9,0,44,9
158900,9,145,25,0,120,25
158900,8,889,151,0,738,151
158900,7,1170,168,0,1002,168
158900,6,949,130,0,819,130
158900,5,298,47,0,251,47
158900,4,137,26,0,111,26
158900,3,51,11,0,40,11
158900,2,17,5,0,12,5
158900,1,13,3,0,10,3
21632,10,21,10,0,11,10
21632,9,93,26,0,67,26
21632,8,617,186,0,431,186
21632,7,1188,321,0,867,321
21632,6,1179,348,0,831,348
21632,5,332,112,0,220,112
21632,4,168,69,0,99,69
21632,3,86,49,0,37,49
21632,2,24,12,0,12,12
21632,1,9,3,0,6,3
215311,10,128,29,0,99,29
215311,9,349,54,0,295,54
215311,8,1554,207,0,1347,207
215311,7,1009,132,0,877,132
215311,6,491,76,0,415,76
215311,5,114,23,0,91,23
215311,4,43,10,0,33,10
215311,3,22,7,0,15,7
215311,2,8,2,0,6,2
215311,1,4,1,0,3,1
98351,10,129,39,0,90,39
98351,9,296,71,0,225,71
98351,8,1323,295,2,1028,293
98351,7,995,204,1,791,203
98351,6,634,165,0,469,165
98351,5,196,54,0,142,54
98351,4,79,26,0,53,26
98351,3,31,7,0,24,7
98351,2,16,7,0,9,7
98351,1,8,1,0,7,1
2136,10,39,7,0,32,7
2136,9,39,13,0,26,13
2136,8,101,25,0,76,25
2136,7,253,70,0,183,70
2136,6,608,148,0,460,148
2136,5,795,178,0,617,178
2136,4,807,201,0,606,201
2136,3,484,119,0,365,119
2136,2,391,132,0,259,132
2136,1,189,58,0,131,58
227789,10,141,16,0,125,16
227789,9,494,58,0,436,58
227789,8,1689,188,0,1501,188
227789,7,862,105,0,757,105
227789,6,366,61,0,305,61
227789,5,99,25,0,74,25
227789,4,37,11,0,26,11
227789,3,12,4,0,8,4
227789,2,8,1,0,7,1
227789,1,4,1,0,3,1
1513,10,503,154,0,349,154
1513,9,599,127,0,472,127
1513,8,1047,225,0,822,225
1513,7,680,152,0,528,152
1513,6,455,103,0,352,103
1513,5,182,41,0,141,41
1513,4,110,41,0,69,41
1513,3,60,23,0,37,23
1513,2,34,13,0,21,13
1513,1,28,7,0,21,7
203416,10,148,18,0,130,18
203416,9,475,59,0,416,59
203416,8,1363,147,0,1216,147
203416,7,925,104,0,821,104
203416,6,459,56,0,403,56
203416,5,135,23,0,112,23
203416,4,62,9,0,53,9
203416,3,68,24,0,44,24
203416,2,36,7,0,29,7
203416,1,25,8,0,17,8
4143,10,24,3,0,21,3
4143,9,30,13,0,17,13
4143,8,86,32,0,54,32
4143,7,254,60,0,194,60
4143,6,753,186,0,567,186
4143,5,946,187,0,759,187
4143,4,923,211,0,712,211
4143,3,418,111,0,307,111
4143,2,212,52,0,160,52
4143,1,46,10,0,36,10
206941,10,96,14,0,82,14
206941,9,421,62,0,359,62
206941,8,1687,207,0,1480,207
206941,7,918,117,0,801,117
206941,6,431,81,0,350,81
206941,5,89,15,0,74,15
206941,4,35,5,0,30,5
206941,3,12,5,0,7,5
200077,10,92,26,1,66,25
200077,9,223,43,4,180,39
200077,8,1144,202,26,942,176
200077,7,1308,208,19,1100,189
200077,6,695,112,11,583,101
200077,5,157,23,1,134,22
200077,4,47,11,0,36,11
200077,3,19,8,0,11,8
200077,2,6,1,0,5,1
88408,10,91,18,0,73,18
88408,9,202,52,0,150,52
88408,8,755,143,0,612,143
88408,7,907,165,0,742,165
88408,6,900,175,0,725,175
88408,5,418,93,0,325,93
88408,4,243,74,0,169,74
88408,3,106,28,0,78,28
88408,2,47,13,0,34,13
88408,1,16,7,0,9,7
137988,10,264,33,3,231,30
137988,9,485,37,1,448,36
137988,8,1213,116,6,1097,110
137988,7,941,79,8,862,71
137988,6,493,53,3,440,50
137988,5,148,19,1,129,18
137988,4,64,13,1,51,12
137988,3,28,4,0,24,4
137988,2,19,5,1,14,4
137988,1,28,1,0,27,1
22038,10,111,26,0,85,26
22038,9,249,67,0,182,67
22038,8,952,225,0,727,225
22038,7,1022,188,0,834,188
22038,6,804,171,0,633,171
22038,5,285,69,0,216,69
22038,4,156,44,0,112,44
22038,3,51,20,0,31,20
22038,2,29,10,0,19,10
22038,1,12,1,0,11,1
6411,10,40,17,0,23,17
6411,9,161,42,0,119,42
6411,8,844,253,0,591,253
6411,7,1236,339,0,897,339
6411,6,998,270,0,728,270
6411,5,252,75,0,177,75
6411,4,97,25,0,72,25
6411,3,21,3,0,18,3
6411,2,13,3,0,10,3
6411,1,8,1,0,7,1
199792,10,424,76,5,348,71
199792,9,816,129,14,687,115
199792,8,1438,200,19,1238,181
199792,7,582,74,3,508,71
199792,6,259,53,2,206,51
199792,5,78,20,1,58,19
199792,4,35,13,0,22,13
199792,3,27,12,1,15,11
199792,1,15,2,0,13,2
37628,10,82,30,0,52,30
37628,9,236,66,0,170,66
37628,8,1060,278,1,782,277
37628,7,1122,243,5,879,238
37628,6,766,188,1,578,187
37628,5,239,56,0,183,56
37628,4,92,22,0,70,22
37628,3,41,13,0,28,13
37628,2,12,4,0,8,4
37628,1,9,3,0,6,3
35570,10,76,18,0,58,18
35570,9,269,65,0,204,65
35570,8,1467,347,0,1120,347
35570,7,1090,217,0,873,217
35570,6,539,109,0,430,109
35570,5,129,29,0,100,29
35570,4,48,20,0,28,20
35570,3,18,8,0,10,8
35570,2,11,3,0,8,3
1231,10,92,24,0,68,24
1231,9,230,75,0,155,75
1231,8,885,246,0,639,246
1231,7,1052,282,0,770,282
1231,6,905,259,0,646,259
1231,5,288,78,0,210,78
1231,4,128,31,0,97,31
1231,3,40,14,0,26,14
1231,2,21,6,0,15,6
1231,1,6,1,0,5,1
205398,10,97,18,0,79,18
205398,9,243,32,0,211,32
205398,8,919,96,0,823,96
205398,7,734,82,0,652,82
205398,6,294,31,0,263,31
205398,5,70,11,0,59,11
205398,4,26,4,0,22,4
205398,3,12,1,0,11,1
228341,10,180,21,0,159,21
228341,9,656,69,0,587,69
228341,8,1678,177,0,1501,177
228341,7,686,84,0,602,84
228341,6,310,52,0,258,52
228341,5,84,15,0,69,15
228341,4,32,13,0,19,13
228341,3,15,4,0,11,4
228341,2,4,3,0,1,3
175621,10,161,34,2,127,32
175621,9,208,57,6,151,51
175621,8,673,131,10,542,121
175621,7,828,142,10,686,132
175621,6,976,154,11,822,143
175621,5,387,68,5,319,63
175621,4,222,46,4,176,42
175621,3,112,28,1,84,27
175621,2,48,15,0,33,15
175621,1,24,12,1,12,11
528,10,171,58,0,113,58
528,9,387,126,0,261,126
528,8,1149,304,0,845,304
528,7,1066,271,0,795,271
528,6,594,172,0,422,172
528,5,150,46,0,104,46
528,4,76,38,0,38,38
528,3,28,6,0,22,6
528,2,11,2,0,9,2
205359,10,447,77,0,370,77
205359,9,637,73,0,564,73
205359,8,1173,132,0,1041,132
205359,7,707,87,0,620,87
205359,6,400,59,0,341,59
205359,5,134,15,0,119,15
205359,4,69,13,0,56,13
205359,3,24,7,0,17,7
205359,2,20,10,0,10,10
205359,1,26,5,0,21,5
113401,10,45,7,0,38,7
113401,9,124,11,0,113,11
113401,8,747,92,0,655,92
113401,7,1294,131,0,1163,131
113401,6,1083,121,0,962,121
113401,5,239,38,0,201,38
113401,4,60,8,0,52,8
113401,3,24,6,0,18,6
113401,2,6,1,0,5,1
113401,1,13,3,0,10,3
132372,10,51,16,0,35,16
132372,9,195,30,0,165,30
132372,8,1096,211,0,885,211
132372,7,1163,188,0,975,188
132372,6,768,132,0,636,132
132372,5,225,51,0,174,51
132372,4,73,16,0,57,16
132372,3,35,10,0,25,10
132372,2,17,10,0,7,10
52461,10,81,15,0,66,15
52461,9,253,52,0,201,52
52461,8,1362,236,0,1126,236
52461,7,1086,161,0,925,161
52461,6,576,103,0,473,103
52461,5,157,34,0,123,34
52461,4,67,16,0,51,16
52461,3,27,11,0,16,11
52461,2,11,4,0,7,4
52461,1,9,2,0,7,2
176734,10,216,41,1,175,40
176734,9,659,100,4,559,96
176734,8,1632,206,5,1426,201
176734,7,708,105,0,603,105
176734,6,295,63,0,232,63
176734,5,66,12,0,54,12
176734,4,25,12,0,13,12
176734,3,12,1,0,11,1
176734,1,9,1,0,8,1
22825,10,199,48,0,151,48
22825,9,397,95,0,302,95
22825,8,1134,242,0,892,242
22825,7,900,194,0,706,194
22825,6,599,143,0,456,143
22825,5,219,69,0,150,69
22825,4,94,49,0,45,49
22825,3,48,15,0,33,15
22825,2,17,4,0,13,4
22825,1,16,6,0,10,6
35497,10,76,11,0,65,11
35497,9,221,41,0,180,41
35497,8,1033,182,0,851,182
35497,7,1258,194,0,1064,194
35497,6,746,116,0,630,116
35497,5,175,27,0,148,27
35497,4,68,12,0,56,12
35497,3,26,3,0,23,3
35497,2,12,1,0,11,1
35497,1,7,1,0,6,1
2386,10,23,6,0,17,6
2386,9,28,8,0,20,8
2386,8,135,31,0,104,31
2386,7,365,75,0,290,75
2386,6,934,212,0,722,212
2386,5,929,199,0,730,199
2386,4,726,179,0,547,179
2386,3,304,71,0,233,71
2386,2,139,41,0,98,41
2386,1,41,13,0,28,13
3685,10,207,92,0,115,92
3685,9,529,201,0,328,201
3685,8,1438,489,0,949,489
3685,7,827,242,1,585,241
3685,6,378,125,0,253,125
3685,5,129,41,0,88,41
3685,4,56,26,0,30,26
3685,3,22,7,0,15,7
3685,2,15,3,0,12,3
3685,1,20,4,1,16,3
17025,10,28,10,0,18,10
17025,9,82,28,0,54,28
17025,8,487,147,0,340,147
17025,7,1141,313,0,828,313
17025,6,1280,345,0,935,345
17025,5,379,112,0,267,112
17025,4,141,41,0,100,41
17025,3,48,16,0,32,16
17025,2,16,8,0,8,8
17025,1,6,1,0,5,1
256,10,23,12,0,11,12
256,9,71,25,0,46,25
256,8,505,177,0,328,177
256,7,1110,299,0,811,299
256,6,1158,276,0,882,276
256,5,450,93,0,357,93
256,4,184,42,0,142,42
256,3,53,18,0,35,18
256,2,38,13,0,25,13
256,1,7,1,0,6,1
9625,10,219,94,0,125,94
9625,9,535,189,0,346,189
9625,8,1364,383,0,981,383
9625,7,758,215,0,543,215
9625,6,435,126,0,309,126
9625,5,133,53,0,80,53
9625,4,79,24,0,55,24
9625,3,38,18,0,20,18
9625,2,21,11,0,10,11
9625,1,16,2,0,14,2
65515,10,35,13,0,22,13
65515,9,133,29,0,104,29
65515,8,742,179,0,563,179
65515,7,1007,171,0,836,171
65515,6,1007,200,0,807,200
65515,5,346,80,0,266,80
65515,4,184,47,0,137,47
65515,3,86,27,0,59,27
65515,2,27,11,0,16,11
65515,1,13,1,0,12,1
192458,10,241,50,0,191,50
192458,9,529,83,0,446,83
192458,8,1544,212,1,1332,211
192458,7,783,87,0,696,87
192458,6,322,46,0,276,46
192458,5,88,15,0,73,15
192458,4,39,8,0,31,8
192458,3,21,5,0,16,5
192458,1,13,2,0,11,2
181530,10,256,41,0,215,41
181530,9,531,82,0,449,82
181530,8,1361,173,0,1188,173
181530,7,794,82,0,712,82
181530,6,410,62,0,348,62
181530,5,117,25,0,92,25
181530,4,50,7,0,43,7
181530,3,30,3,0,27,3
181530,2,12,5,0,7,5
181530,1,14,2,0,12,2
149155,10,66,13,0,53,13
149155,9,175,30,2,145,28
149155,8,843,160,8,683,152
149155,7,1161,175,13,986,162
149155,6,947,149,6,798,143
149155,5,245,48,0,197,48
149155,4,89,19,0,70,19
149155,3,28,8,0,20,8
149155,2,14,3,1,11,2
150999,10,49,14,0,35,14
150999,9,216,49,0,167,49
150999,8,1131,222,0,909,222
150999,7,1238,191,0,1047,191
150999,6,671,122,0,549,122
150999,5,152,26,0,126,26
150999,4,70,14,0,56,14
150999,3,27,7,0,20,7
39339,10,162,62,0,100,62
39339,9,280,78,0,202,78
39339,8,847,234,0,613,234
39339,7,843,207,0,636,207
39339,6,732,191,0,541,191
39339,5,272,77,0,195,77
39339,4,213,68,0,145,68
39339,3,127,54,0,73,54
39339,2,56,23,0,33,23
39339,1,26,7,0,19,7
986,10,47,14,0,33,14
986,9,134,43,0,91,43
986,8,753,192,0,561,192
986,7,1126,265,0,861,265
986,6,1005,232,0,773,232
986,5,305,85,0,220,85
986,4,126,46,0,80,46
986,3,42,14,0,28,14
986,2,14,3,0,11,3
18866,10,26,9,0,17,9
18866,9,64,19,0,45,19
18866,8,549,161,0,388,161
18866,7,1042,267,0,775,267
18866,6,1193,272,0,921,272
18866,5,387,135,0,252,135
18866,4,201,66,0,135,66
18866,3,63,20,0,43,20
18866,2,24,9,0,15,9
18866,1,5,1,0,4,1
1403,10,44,8,0,36,8
1403,9,137,33,0,104,33
1403,8,792,198,0,594,198
1403,7,1238,276,0,962,276
1403,6,936,198,0,738,198
1403,5,229,40,0,189,40
1403,4,99,22,0,77,22
1403,3,31,11,0,20,11
1403,2,12,3,0,9,3
1403,1,4,1,0,3,1
19777,10,427,136,0,291,136
19777,9,784,207,0,577,207
19777,8,1180,266,0,914,266
19777,7,581,136,0,445,136
19777,6,321,81,0,240,81
19777,5,95,30,0,65,30
19777,4,69,25,0,44,25
19777,3,34,15,0,19,15
19777,2,20,6,0,14,6
19777,1,14,3,0,11,3
129948,10,70,16,0,54,16
129948,9,258,64,0,194,64
129948,8,1255,220,0,1035,220
129948,7,1084,179,0,905,179
129948,6,613,109,0,504,109
129948,5,153,26,0,127,26
129948,4,45,11,0,34,11
129948,3,21,10,0,11,10
129948,2,7,3,0,4,3
129948,1,4,1,0,3,1
232832,10,226,48,0,178,48
232832,9,533,86,0,447,86
232832,8,1574,243,0,1331,243
232832,7,784,115,0,669,115
232832,6,268,32,0,236,32
232832,5,75,20,0,55,20
232832,4,30,9,0,21,9
232832,3,14,7,0,7,7
232832,2,6,1,0,5,1
232832,1,6,2,0,4,2
4396,10,36,13,0,23,13
4396,9,113,42,2,71,40
4396,8,747,311,0,436,311
4396,7,1091,325,1,766,324
4396,6,1026,293,1,733,292
4396,5,309,103,0,206,103
4396,4,119,40,0,79,40
4396,3,29,14,0,15,14
4396,2,15,6,0,9,6
34084,10,51,13,0,38,13
34084,9,210,58,0,152,58
34084,8,1066,243,0,823,243
34084,7,1151,220,0,931,220
34084,6,703,139,0,564,139
34084,5,196,50,0,146,50
34084,4,75,16,0,59,16
34084,3,26,10,0,16,10
34084,2,11,7,0,4,7
34084,1,5,1,0,4,1
230080,10,52,4,0,48,4
230080,9,161,24,0,137,24
230080,8,1124,138,0,986,138
230080,7,1187,131,0,1056,131
230080,6,708,100,0,608,100
230080,5,173,32,0,141,32
230080,4,62,14,0,48,14
230080,3,18,4,0,14,4
230080,2,6,1,0,5,1
230080,1,3,1,0,2,1
148319,10,201,42,0,159,42
148319,9,408,72,0,336,72
148319,8,1134,192,0,942,192
148319,7,819,119,0,700,119
148319,6,593,80,0,513,80
148319,5,166,40,0,126,40
148319,4,88,22,0,66,22
148319,3,47,11,0,36,11
148319,2,22,5,0,17,5
148319,1,11,2,0,9,2
37196,10,21,5,0,16,5
37196,9,80,27,0,53,27
37196,8,524,182,0,342,182
37196,7,1019,343,0,676,343
37196,6,1215,368,0,847,368
37196,5,389,108,0,281,108
37196,4,160,60,0,100,60
37196,3,42,7,0,35,7
37196,2,26,6,0,20,6
71671,10,103,24,0,79,24
71671,9,267,50,0,217,50
71671,8,1058,193,0,865,193
71671,7,1008,169,0,839,169
71671,6,688,132,0,556,132
71671,5,200,45,0,155,45
71671,4,93,31,0,62,31
71671,3,35,11,0,24,11
71671,2,19,5,0,14,5
71671,1,8,2,0,6,2
158275,10,164,17,0,147,17
158275,9,369,41,0,328,41
158275,8,1131,135,0,996,135
158275,7,938,94,0,844,94
158275,6,586,88,0,498,88
158275,5,175,26,0,149,26
158275,4,72,10,0,62,10
158275,3,21,5,0,16,5
158275,2,7,2,0,5,2
158275,1,13,4,0,9,4
193042,10,147,27,0,120,27
193042,9,400,52,0,348,52
193042,8,1441,205,0,1236,205
193042,7,868,108,0,760,108
193042,6,459,60,0,399,60
193042,5,84,18,0,66,18
193042,4,50,10,0,40,10
193042,3,10,1,0,9,1
193042,2,8,2,0,6,2
134352,10,198,44,0,154,44
134352,9,351,82,8,269,74
134352,8,950,153,7,797,146
134352,7,819,132,6,687,126
134352,6,664,90,0,574,90
134352,5,232,39,0,193,39
134352,4,138,36,1,102,35
134352,3,70,16,0,54,16
134352,2,33,17,2,16,15
134352,1,19,8,0,11,8
139976,10,678,147,6,531,141
139976,9,657,136,13,521,123
139976,8,1032,147,8,885,139
139976,7,547,71,3,476,68
139976,6,335,56,2,279,54
139976,5,108,27,0,81,27
139976,4,44,5,0,39,5
139976,3,34,6,0,28,6
139976,2,19,2,0,17,2
139976,1,23,6,1,17,5
2163,10,330,105,0,225,105
2163,9,453,129,0,324,129
2163,8,1068,257,0,811,257
2163,7,852,165,0,687,165
2163,6,474,92,0,382,92
2163,5,150,26,0,124,26
2163,4,57,12,0,45,12
2163,3,27,9,0,18,9
2163,2,14,2,0,12,2
2163,1,44,12,0,32,12
16747,10,154,42,0,112,42
16747,9,277,80,0,197,80
16747,8,1083,280,3,803,277
16747,7,982,229,3,753,226
16747,6,646,134,0,512,134
16747,5,186,46,1,140,45
16747,4,71,19,0,52,19
16747,3,36,8,0,28,8
16747,2,11,3,0,8,3
119591,10,28,4,0,24,4
119591,9,129,20,0,109,20
119591,8,1049,193,0,856,193
119591,7,1162,183,0,979,183
119591,6,768,137,0,631,137
119591,5,201,38,0,163,38
119591,4,61,14,0,47,14
119591,3,36,13,0,23,13
119591,2,8,1,0,7,1
119591,1,7,1,0,6,1
169255,10,420,64,0,356,64
169255,9,557,80,0,477,80
169255,8,1109,137,0,972,137
169255,7,693,66,0,627,66
169255,6,403,47,0,356,47
169255,5,147,29,0,118,29
169255,4,64,9,0,55,9
169255,3,29,7,0,22,7
169255,2,14,4,0,10,4
169255,1,10,1,0,9,1
153065,10,61,12,0,49,12
153065,9,203,48,0,155,48
153065,8,957,183,0,774,183
153065,7,1207,173,0,1034,173
153065,6,739,103,0,636,103
153065,5,182,37,0,145,37
153065,4,55,12,0,43,12
153065,3,19,8,0,11,8
153065,2,10,2,0,8,2
38159,10,249,53,0,196,53
38159,9,332,63,0,269,63
38159,8,914,149,1,765,148
38159,7,810,115,0,695,115
38159,6,660,101,0,559,101
38159,5,198,31,0,167,31
38159,4,125,20,0,105,20
38159,3,63,13,0,50,13
38159,2,46,14,0,32,14
38159,1,37,10,0,27,10
72225,10,119,34,0,85,34
72225,9,338,66,1,272,65
72225,8,1243,217,1,1026,216
72225,7,859,155,0,704,155
72225,6,534,103,0,431,103
72225,5,154,33,0,121,33
72225,4,81,27,0,54,27
72225,3,36,7,0,29,7
72225,2,29,7,0,22,7
72225,1,19,3,0,16,3
55600,10,110,23,0,87,23
55600,9,395,80,0,315,80
55600,8,1346,250,0,1096,250
55600,7,817,173,0,644,173
55600,6,488,107,0,381,107
55600,5,140,37,0,103,37
55600,4,66,23,0,43,23
55600,3,30,7,0,23,7
55600,2,12,4,0,8,4
118063,10,26,4,0,22,4
118063,9,92,21,0,71,21
118063,8,721,140,0,581,140
118063,7,1053,192,0,861,192
118063,6,962,172,0,790,172
118063,5,304,63,0,241,63
118063,4,145,33,0,112,33
118063,3,66,15,0,51,15
118063,2,24,5,0,19,5
118063,1,7,1,0,6,1
3307,10,185,73,0,112,73
3307,9,537,197,0,340,197
3307,8,1264,407,0,857,407
3307,7,762,211,0,551,211
3307,6,371,103,0,268,103
3307,5,153,49,0,104,49
3307,4,58,20,0,38,20
3307,3,28,12,0,16,12
3307,2,18,11,0,7,11
3307,1,23,4,0,19,4
5048,10,27,9,0,18,9
5048,9,15,8,0,7,8
5048,8,33,12,0,21,12
5048,7,72,38,0,34,38
5048,6,122,57,0,65,57
5048,5,354,115,0,239,115
5048,4,679,231,0,448,231
5048,3,774,246,0,528,246
5048,2,742,240,0,502,240
5048,1,576,167,0,409,167
29678,10,59,6,0,53,6
29678,9,119,11,0,108,11
29678,8,422,52,0,370,52
29678,7,683,93,0,590,93
29678,6,941,127,0,814,127
29678,5,485,64,0,421,64
29678,4,301,51,0,250,51
29678,3,199,43,0,156,43
29678,2,119,35,0,84,35
29678,1,58,16,0,42,16
207336,10,44,6,0,38,6
207336,9,143,19,0,124,19
207336,8,1037,135,0,902,135
207336,7,1217,153,0,1064,153
207336,6,720,107,0,613,107
207336,5,148,26,0,122,26
207336,4,56,13,0,43,13
207336,3,14,4,0,10,4
207336,2,3,1,0,2,1
207336,1,3,1,0,2,1
144553,10,29,3,0,26,3
144553,9,62,8,0,54,8
144553,8,550,79,0,471,79
144553,7,1093,135,0,958,135
144553,6,1157,180,0,977,180
144553,5,310,52,0,258,52
144553,4,130,30,0,100,30
144553,3,38,6,0,32,6
144553,2,12,3,0,9,3
144553,1,4,2,0,2,2
154809,10,182,21,0,161,21
154809,9,529,80,0,449,80
154809,8,1552,175,0,1377,175
154809,7,679,88,1,591,87
154809,6,291,44,0,247,44
154809,5,79,13,0,66,13
154809,4,27,8,0,19,8
154809,3,15,5,0,10,5
154809,2,5,2,0,3,2
36235,10,183,45,2,138,43
36235,9,374,70,2,304,68
36235,8,1226,231,4,995,227
36235,7,901,133,4,768,129
36235,6,483,77,0,406,77
36235,5,133,23,0,110,23
36235,4,42,17,0,25,17
36235,3,18,5,0,13,5
36235,1,3,1,0,2,1
151004,10,156,12,0,144,12
151004,9,332,21,0,311,21
151004,8,1107,70,0,1037,70
151004,7,1064,61,0,1003,61
151004,6,490,38,0,452,38
151004,5,123,11,0,112,11
151004,4,47,2,0,45,2
151004,3,17,2,0,15,2
151004,2,9,1,0,8,1
151004,1,10,3,0,7,3
4491,10,26,8,0,18,8
4491,9,69,23,0,46,23
4491,8,508,176,0,332,176
4491,7,964,259,0,705,259
4491,6,1185,314,0,871,314
4491,5,373,102,0,271,102
4491,4,142,46,0,96,46
4491,3,55,20,0,35,20
4491,2,18,6,0,12,6
4491,1,6,3,0,3,3
25021,10,332,108,0,224,108
25021,9,805,191,0,614,191
25021,8,1406,285,0,1121,285
25021,7,479,107,0,372,107
25021,6,209,54,0,155,54
25021,5,54,10,0,44,10
25021,4,25,4,0,21,4
25021,3,10,3,0,7,3
25021,2,4,1,0,3,1
25021,1,13,1,0,12,1
551,10,139,54,0,85,54
551,9,285,102,0,183,102
551,8,965,367,0,598,367
551,7,997,337,0,660,337
551,6,643,215,0,428,215
551,5,188,64,0,124,64
551,4,77,36,0,41,36
551,3,17,7,0,10,7
551,2,10,6,0,4,6
551,1,11,2,0,9,2
6887,10,100,30,0,70,30
6887,9,142,33,0,109,33
6887,8,482,138,0,344,138
6887,7,877,191,0,686,191
6887,6,971,195,0,776,195
6887,5,447,93,0,354,93
6887,4,201,41,0,160,41
6887,3,76,17,0,59,17
6887,2,28,9,0,19,9
24417,10,90,42,0,48,42
24417,9,237,83,0,154,83
24417,8,852,250,0,602,250
24417,7,957,250,0,707,250
24417,6,705,163,0,542,163
24417,5,218,65,0,153,65
24417,4,136,50,0,86,50
24417,3,73,32,0,41,32
24417,2,44,18,0,26,18
24417,1,17,7,0,10,7
42487,10,49,10,0,39,10
42487,9,130,29,0,101,29
42487,8,813,162,0,651,162
42487,7,1150,198,0,952,198
42487,6,770,172,0,598,172
42487,5,239,51,0,188,51
42487,4,103,29,0,74,29
42487,3,43,15,0,28,15
42487,2,17,3,0,14,3
42487,1,10,1,0,9,1
21920,10,41,11,0,30,11
21920,9,130,37,0,93,37
21920,8,840,235,0,605,235
21920,7,1067,286,0,781,286
21920,6,792,223,0,569,223
21920,5,260,101,0,159,101
21920,4,106,49,0,57,49
21920,3,52,20,0,32,20
21920,2,18,5,0,13,5
21920,1,6,1,0,5,1
131646,10,138,32,0,106,32
131646,9,328,71,0,257,71
131646,8,1085,187,0,898,187
131646,7,887,148,0,739,148
131646,6,549,114,0,435,114
131646,5,151,44,0,107,44
131646,4,95,32,0,63,32
131646,3,40,12,0,28,12
131646,2,26,12,0,14,12
131646,1,8,2,0,6,2
232918,10,170,27,0,143,27
232918,9,348,52,0,296,52
232918,8,963,138,0,825,138
232918,7,806,110,0,696,110
232918,6,559,95,0,464,95
232918,5,193,33,0,160,33
232918,4,143,41,0,102,41
232918,3,78,30,0,48,30
232918,2,36,11,0,25,11
232918,1,20,4,0,16,4
115,10,109,42,0,67,42
115,9,242,86,0,156,86
115,8,807,237,0,570,237
115,7,892,250,0,642,250
115,6,740,182,0,558,182
115,5,267,71,0,196,71
115,4,120,46,0,74,46
115,3,63,19,0,44,19
115,2,44,20,0,24,20
115,1,25,6,0,19,6
244228,10,91,16,0,75,16
244228,9,226,30,0,196,30
244228,8,1234,159,0,1075,159
244228,7,1023,115,0,908,115
244228,6,537,82,0,455,82
244228,5,146,32,0,114,32
244228,4,46,11,0,35,11
244228,3,11,3,0,8,3
244228,2,2,1,0,1,1
18803,10,54,5,0,49,5
18803,9,109,18,0,91,18
18803,8,383,70,0,313,70
18803,7,679,77,0,602,77
18803,6,1123,124,0,999,124
18803,5,512,53,0,459,53
18803,4,240,38,0,202,38
18803,3,125,21,0,104,21
18803,2,48,11,0,37,11
18803,1,29,9,0,20,9
193558,10,101,17,0,84,17
193558,9,312,47,0,265,47
193558,8,1284,153,0,1131,153
193558,7,896,105,0,791,105
193558,6,490,81,0,409,81
193558,5,132,25,0,107,25
193558,4,50,13,0,37,13
193558,3,21,8,0,13,8
193558,2,8,3,0,5,3
17392,10,582,186,0,396,186
17392,9,750,190,0,560,190
17392,8,977,225,0,752,225
17392,7,450,119,0,331,119
17392,6,277,86,0,191,86
17392,5,91,34,0,57,34
17392,4,65,29,0,36,29
17392,3,39,21,0,18,21
17392,2,31,8,0,23,8
17392,1,30,1,0,29,1
1339,10,53,23,0,30,23
1339,9,84,29,0,55,29
1339,8,301,85,0,216,85
1339,7,599,159,0,440,159
1339,6,1137,308,0,829,308
1339,5,633,153,0,480,153
1339,4,297,85,0,212,85
1339,3,117,33,0,84,33
1339,2,51,20,0,31,20
1339,1,9,3,0,6,3
119506,10,160,51,4,109,47
119506,9,444,99,0,345,99
119506,8,1371,252,8,1119,244
119506,7,791,158,2,633,156
119506,6,357,71,1,286,70
119506,5,95,22,0,73,22
119506,4,31,14,0,17,14
119506,3,10,2,0,8,2
119506,2,8,3,0,5,3
119506,1,8,2,0,6,2
229220,10,140,17,0,123,17
229220,9,447,56,0,391,56
229220,8,1427,167,0,1260,167
229220,7,803,95,0,708,95
229220,6,335,57,0,278,57
229220,5,76,10,0,66,10
229220,4,29,8,0,21,8
229220,3,11,2,0,9,2
229220,1,8,1,0,7,1
249,10,45,12,0,33,12
249,9,120,43,0,77,43
249,8,712,187,0,525,187
249,7,963,246,0,717,246
249,6,883,231,0,652,231
249,5,267,84,0,183,84
249,4,148,54,0,94,54
249,3,71,26,0,45,26
249,2,39,18,0,21,18
249,1,14,1,0,13,1
15985,10,561,135,0,426,135
15985,9,639,120,0,519,120
15985,8,955,125,0,830,125
15985,7,590,69,0,521,69
15985,6,292,50,0,242,50
15985,5,82,14,0,68,14
15985,4,41,7,0,34,7
15985,3,28,4,0,24,4
15985,2,23,5,0,18,5
15985,1,50,9,0,41,9
189932,10,245,35,0,210,35
189932,9,660,100,0,560,100
189932,8,1389,196,0,1193,196
189932,7,633,86,0,547,86
189932,6,218,31,0,187,31
189932,5,64,7,0,57,7
189932,4,31,7,0,24,7
189932,3,11,2,0,9,2
189932,1,8,2,0,6,2
131325,10,49,8,0,41,8
131325,9,127,12,0,115,12
131325,8,626,73,0,553,73
131325,7,1203,138,0,1065,138
131325,6,965,110,0,855,110
131325,5,210,25,0,185,25
131325,4,52,11,0,41,11
131325,3,10,1,0,9,1
131325,1,8,2,0,6,2
95527,10,284,67,0,217,67
95527,9,532,82,0,450,82
95527,8,1217,193,0,1024,193
95527,7,635,111,0,524,111
95527,6,339,59,0,280,59
95527,5,119,26,0,93,26
95527,4,65,25,0,40,25
95527,3,36,9,0,27,9
95527,2,22,7,0,15,7
95527,1,6,2,0,4,2
481,10,51,19,0,32,19
481,9,164,72,0,92,72
481,8,831,233,0,598,233
481,7,1043,255,0,788,255
481,6,743,169,0,574,169
481,5,248,76,0,172,76
481,4,105,33,0,72,33
481,3,33,11,0,22,11
481,2,23,6,0,17,6
481,1,9,3,0,6,3
106662,10,37,4,0,33,4
106662,9,112,17,0,95,17
106662,8,933,180,0,753,180
106662,7,1026,170,0,856,170
106662,6,764,139,0,625,139
106662,5,218,49,0,169,49
106662,4,103,31,0,72,31
106662,3,34,10,0,24,10
106662,2,12,4,0,8,4
106662,1,9,3,0,6,3
1117,10,56,20,0,36,20
1117,9,108,31,0,77,31
1117,8,646,152,0,494,152
1117,7,983,187,0,796,187
1117,6,932,216,0,716,216
1117,5,305,65,0,240,65
1117,4,134,29,0,105,29
1117,3,56,13,0,43,13
1117,2,21,7,0,14,7
1117,1,4,1,0,3,1
5894,10,35,10,0,25,10
5894,9,32,12,0,20,12
5894,8,94,15,0,79,15
5894,7,199,46,0,153,46
5894,6,609,107,0,502,107
5894,5,631,102,0,529,102
5894,4,744,156,0,588,156
5894,3,487,113,0,374,113
5894,2,283,82,0,201,82
5894,1,132,31,0,101,31
45986,10,116,27,0,89,27
45986,9,331,77,0,254,77
45986,8,1097,218,0,879,218
45986,7,836,145,0,691,145
45986,6,551,128,0,423,128
45986,5,162,30,0,132,30
45986,4,83,15,0,68,15
45986,3,33,11,0,22,11
45986,2,22,4,0,18,4
243,10,968,388,0,580,388
243,9,576,176,0,400,176
243,8,654,189,0,465,189
243,7,408,113,0,295,113
243,6,255,63,0,192,63
243,5,147,49,0,98,49
243,4,77,29,0,48,29
243,3,55,24,0,31,24
243,2,41,16,0,25,16
243,1,43,16,0,27,16
101785,10,63,20,3,43,17
101785,9,175,48,8,127,40
101785,8,823,182,19,641,163
101785,7,1002,207,15,795,192
101785,6,782,169,13,613,156
101785,5,227,49,3,178,46
101785,4,100,35,2,65,33
101785,3,37,15,1,22,14
101785,2,18,7,1,11,6
101785,1,10,1,0,9,1
26566,10,80,34,0,46,34
26566,9,239,72,0,167,72
26566,8,1271,298,0,973,298
26566,7,941,201,0,740,201
26566,6,473,130,0,343,130
26566,5,131,39,0,92,39
26566,4,51,25,0,26,25
26566,3,22,6,0,16,6
26566,1,13,2,0,11,2
491,10,122,52,0,70,52
491,9,375,125,0,250,125
491,8,1035,315,0,720,315
491,7,961,228,0,733,228
491,6,484,121,0,363,121
491,5,130,36,0,94,36
491,4,72,30,0,42,30
491,3,18,8,0,10,8
491,2,12,6,0,6,6
491,1,8,3,0,5,3
160010,10,402,88,9,314,79
160010,9,644,113,18,531,95
160010,8,1096,172,20,924,152
160010,7,541,70,9,471,61
160010,6,319,37,0,282,37
160010,5,100,26,1,74,25
160010,4,54,12,0,42,12
160010,3,29,8,1,21,7
160010,2,9,5,1,4,4
160010,1,16,2,0,14,2
340,10,46,13,0,33,13
340,9,147,35,0,112,35
340,8,563,158,0,405,158
340,7,990,236,0,754,236
340,6,951,257,0,694,257
340,5,305,85,0,220,85
340,4,127,38,0,89,38
340,3,39,8,0,31,8
340,2,21,8,0,13,8
340,1,10,1,0,9,1
180511,10,118,19,0,99,19
180511,9,336,59,0,277,59
180511,8,1329,202,0,1127,202
180511,7,842,111,0,731,111
180511,6,409,61,0,348,61
180511,5,100,17,0,83,17
180511,4,36,6,0,30,6
180511,3,17,3,0,14,3
180511,2,5,2,0,3,2
855,10,78,28,0,50,28
855,9,220,84,0,136,84
855,8,918,256,0,662,256
855,7,1014,233,0,781,233
855,6,622,161,0,461,161
855,5,201,69,0,132,69
855,4,83,36,0,47,36
855,3,30,11,0,19,11
855,2,12,6,0,6,6
855,1,9,3,0,6,3
128996,10,184,59,0,125,59
128996,9,458,118,5,340,113
128996,8,1484,318,6,1166,312
128996,7,666,132,1,534,131
128996,6,273,69,1,204,68
128996,5,62,20,0,42,20
128996,4,32,12,1,20,11
128996,3,8,2,0,6,2
128996,2,3,2,0,1,2
128996,1,12,3,0,9,3
19999,10,40,15,0,25,15
19999,9,142,57,0,85,57
19999,8,850,291,0,559,291
19999,7,1057,275,1,782,274
19999,6,761,219,1,542,218
19999,5,200,44,0,156,44
19999,4,74,31,0,43,31
19999,3,35,12,0,23,12
19999,2,14,8,0,6,8
19999,1,6,1,0,5,1
233398,10,310,139,15,171,124
233398,9,868,347,37,521,310
233398,8,1420,436,42,984,394
233398,7,405,85,4,320,81
233398,6,126,30,4,96,26
233398,5,36,14,0,22,14
233398,4,12,3,0,9,3
233398,3,5,2,0,3,2
233398,2,4,1,0,3,1
233398,1,3,1,0,2,1
39206,10,45,12,1,33,11
39206,9,87,21,0,66,21
39206,8,517,113,1,404,112
39206,7,865,174,6,691,168
39206,6,1079,249,7,830,242
39206,5,361,87,1,274,86
39206,4,150,34,0,116,34
39206,3,51,13,1,38,12
39206,2,16,2,0,14,2
39206,1,11,5,1,6,4
220520,10,57,5,0,52,5
220520,9,252,28,0,224,28
220520,8,1220,142,0,1078,142
220520,7,1029,122,0,907,122
220520,6,465,64,0,401,64
220520,5,107,25,0,82,25
220520,4,30,6,0,24,6
220520,3,14,7,0,7,7
638,10,42,14,0,28,14
638,9,129,54,0,75,54
638,8,549,201,0,348,201
638,7,899,249,0,650,249
638,6,962,276,0,686,276
638,5,355,121,0,234,121
638,4,143,51,0,92,51
638,3,63,28,0,35,28
638,2,24,10,0,14,10
638,1,5,4,0,1,4
131287,10,99,21,0,78,21
131287,9,335,64,0,271,64
131287,8,1286,185,0,1101,185
131287,7,764,123,0,641,123
131287,6,460,100,0,360,100
131287,5,115,26,0,89,26
131287,4,71,27,0,44,27
131287,3,28,5,0,23,5
131287,2,7,2,0,5,2
131287,1,6,1,0,5,1
95103,10,172,41,0,131,41
95103,9,326,62,0,264,62
95103,8,961,174,0,787,174
95103,7,750,135,0,615,135
95103,6,538,126,0,412,126
95103,5,182,33,0,149,33
95103,4,113,32,0,81,32
95103,3,59,19,0,40,19
95103,2,40,15,0,25,15
95103,1,21,10,0,11,10
108784,10,157,23,0,134,23
108784,9,305,34,0,271,34
108784,8,1058,164,0,894,164
108784,7,938,131,0,807,131
108784,6,489,75,0,414,75
108784,5,124,22,0,102,22
108784,4,56,10,0,46,10
108784,3,20,4,0,16,4
108784,2,9,1,0,8,1
108784,1,10,1,0,9,1
13122,10,407,118,0,289,118
13122,9,720,159,0,561,159
13122,8,1095,287,0,808,287
13122,7,467,124,0,343,124
13122,6,263,81,0,182,81
13122,5,101,31,0,70,31
13122,4,37,12,0,25,12
13122,3,23,8,0,15,8
13122,2,20,6,0,14,6
13122,1,20,4,0,16,4
106,10,84,33,0,51,33
106,9,183,53,0,130,53
106,8,836,288,0,548,288
106,7,984,258,1,726,257
106,6,730,200,0,530,200
106,5,208,64,0,144,64
106,4,78,28,0,50,28
106,3,22,8,0,14,8
106,2,11,4,0,7,4
106,1,8,2,0,6,2
112138,10,129,23,0,106,23
112138,9,218,37,4,181,33
112138,8,728,104,3,624,101
112138,7,876,119,4,757,115
112138,6,729,79,2,650,77
112138,5,248,32,1,216,31
112138,4,126,22,0,104,22
112138,3,56,10,0,46,10
112138,2,22,3,0,19,3
112138,1,10,1,0,9,1
902,10,48,21,0,27,21
902,9,165,49,0,116,49
902,8,825,219,0,606,219
902,7,1060,226,0,834,226
902,6,722,149,0,573,149
902,5,190,38,0,152,38
902,4,79,18,0,61,18
902,3,29,8,0,21,8
902,2,15,2,0,13,2
1540,10,214,72,0,142,72
1540,9,289,68,0,221,68
1540,8,695,181,0,514,181
1540,7,798,192,0,606,192
1540,6,705,155,0,550,155
1540,5,225,54,0,171,54
1540,4,130,41,0,89,41
1540,3,50,20,0,30,20
1540,2,16,9,0,7,9
1540,1,9,4,0,5,4
5432,10,8,4,0,4,4
5432,9,8,4,0,4,4
5432,8,24,11,0,13,11
5432,7,38,15,0,23,15
5432,6,103,26,0,77,26
5432,5,256,68,0,188,68
5432,4,515,136,0,379,136
5432,3,622,157,0,465,157
5432,2,802,245,0,557,245
5432,1,735,238,0,497,238
191231,10,41,13,0,28,13
191231,9,187,37,0,150,37
191231,8,1042,162,0,880,162
191231,7,1015,121,0,894,121
191231,6,619,95,0,524,95
191231,5,135,26,0,109,26
191231,4,43,4,0,39,4
191231,3,19,5,0,14,5
191231,2,5,1,0,4,1
19526,10,22,7,0,15,7
19526,9,101,39,0,62,39
19526,8,715,225,0,490,225
19526,7,977,212,0,765,212
19526,6,804,215,0,589,215
19526,5,297,74,0,223,74
19526,4,128,36,0,92,36
19526,3,41,11,0,30,11
19526,2,10,5,0,5,5
19526,1,5,1,0,4,1
117915,10,176,64,0,112,64
117915,9,404,82,0,322,82
117915,8,1170,190,0,980,190
117915,7,690,131,0,559,131
117915,6,367,95,0,272,95
117915,5,141,42,0,99,42
117915,4,74,30,0,44,30
117915,3,42,18,0,24,18
117915,2,19,9,0,10,9
117915,1,10,4,0,6,4
201825,10,97,18,0,79,18
201825,9,275,38,0,237,38
201825,8,1141,136,0,1005,136
201825,7,870,90,0,780,90
201825,6,498,78,0,420,78
201825,5,122,33,0,89,33
201825,4,53,20,0,33,20
201825,3,22,9,0,13,9
201825,2,5,2,0,3,2
201825,1,8,3,0,5,3
151347,10,416,96,3,320,93
151347,9,562,88,3,474,85
151347,8,1071,169,7,902,162
151347,7,514,80,4,434,76
151347,6,303,41,1,262,40
151347,5,87,20,0,67,20
151347,4,62,16,1,46,15
151347,3,40,10,0,30,10
151347,2,19,9,0,10,9
151347,1,8,1,0,7,1
232219,10,92,17,0,75,17
232219,9,257,33,0,224,33
232219,8,1162,125,0,1037,125
232219,7,924,86,0,838,86
232219,6,486,63,0,423,63
232219,5,102,15,0,87,15
232219,4,35,9,0,26,9
232219,3,13,5,0,8,5
232219,1,3,1,0,2,1
168679,10,25,6,0,19,6
168679,9,71,10,0,61,10
168679,8,476,87,0,389,87
168679,7,880,116,0,764,116
168679,6,1030,189,0,841,189
168679,5,349,63,0,286,63
168679,4,145,46,0,99,46
168679,3,71,22,0,49,22
168679,2,26,8,0,18,8
168679,1,5,2,0,3,2
6707,10,45,15,0,30,15
6707,9,107,36,0,71,36
6707,8,410,130,0,280,130
6707,7,723,222,0,501,222
6707,6,929,299,0,630,299
6707,5,397,137,0,260,137
6707,4,267,111,0,156,111
6707,3,114,48,0,66,48
6707,2,62,31,0,31,31
6707,1,17,10,0,7,10
73171,10,431,129,0,302,129
73171,9,552,123,0,429,123
73171,8,960,196,0,764,196
73171,7,520,114,0,406,114
73171,6,347,78,0,269,78
73171,5,126,26,0,100,26
73171,4,55,12,0,43,12
73171,3,38,9,0,29,9
73171,2,19,6,0,13,6
73171,1,21,3,0,18,3
130176,10,66,17,0,49,17
130176,9,183,32,0,151,32
130176,8,928,156,0,772,156
130176,7,1056,155,0,901,155
130176,6,647,93,0,554,93
130176,5,122,21,0,101,21
130176,4,42,12,0,30,12
130176,2,7,3,0,4,3
12477,10,50,14,0,36,14
12477,9,144,47,0,97,47
12477,8,688,196,0,492,196
12477,7,926,253,2,673,251
12477,6,773,231,0,542,231
12477,5,269,98,0,171,98
12477,4,129,43,0,86,43
12477,3,50,24,0,26,24
12477,2,21,8,0,13,8
12477,1,13,6,0,7,6
31497,10,33,9,0,24,9
31497,9,101,25,0,76,25
31497,8,724,197,0,527,197
31497,7,1056,257,0,799,257
31497,6,788,191,0,597,191
31497,5,229,65,0,164,65
31497,4,79,32,0,47,32
31497,3,40,19,0,21,19
31497,2,8,4,0,4,4
31497,1,3,1,0,2,1
145639,10,103,29,0,74,29
145639,9,207,42,0,165,42
145639,8,848,173,1,675,172
145639,7,920,178,3,742,175
145639,6,717,126,0,591,126
145639,5,179,40,0,139,40
145639,4,53,8,0,45,8
145639,3,22,7,0,15,7
145639,2,7,2,0,5,2
16267,10,25,6,0,19,6
16267,9,82,22,0,60,22
16267,8,581,135,0,446,135
16267,7,1061,209,0,852,209
16267,6,927,223,0,704,223
16267,5,244,70,0,174,70
16267,4,83,27,0,56,27
16267,3,35,17,0,18,17
16267,2,12,4,0,8,4
16267,1,9,4,0,5,4
155873,10,338,57,0,281,57
155873,9,689,89,0,600,89
155873,8,1271,153,0,1118,153
155873,7,491,61,0,430,61
155873,6,169,22,0,147,22
155873,5,51,6,0,45,6
155873,4,16,5,0,11,5
155873,3,9,2,0,7,2
155873,2,5,1,0,4,1
155873,1,13,2,0,11,2
183880,10,70,19,0,51,19
183880,9,159,42,0,117,42
183880,8,987,220,0,767,220
183880,7,1037,183,0,854,183
183880,6,592,103,0,489,103
183880,5,123,18,0,105,18
183880,4,45,11,0,34,11
183880,3,16,5,0,11,5
183880,1,8,5,0,3,5
8107,10,89,28,0,61,28
8107,9,121,29,0,92,29
8107,8,542,146,0,396,146
8107,7,741,157,0,584,157
8107,6,919,226,0,693,226
8107,5,358,86,0,272,86
8107,4,154,40,0,114,40
8107,3,75,21,0,54,21
8107,2,31,16,0,15,16
8107,1,9,1,0,8,1
123096,10,63,13,0,50,13
123096,9,169,27,0,142,27
123096,8,684,108,0,576,108
123096,7,799,121,0,678,121
123096,6,783,135,0,648,135
123096,5,243,67,0,176,67
123096,4,150,34,0,116,34
123096,3,81,25,0,56,25
123096,2,46,17,0,29,17
123096,1,12,2,0,10,2
242574,10,101,14,0,87,14
242574,9,246,34,0,212,34
242574,8,1203,155,0,1048,155
242574,7,952,113,0,839,113
242574,6,418,52,0,366,52
242574,5,73,19,0,54,19
242574,4,23,8,0,15,8
242574,3,9,4,0,5,4
242574,2,8,3,0,5,3
3931,10,82,31,0,51,31
3931,9,189,59,0,130,59
3931,8,715,194,0,521,194
3931,7,845,224,1,621,223
3931,6,673,175,0,498,175
3931,5,289,100,0,189,100
3931,4,130,55,0,75,55
3931,3,70,29,0,41,29
3931,2,20,10,0,10,10
3931,1,10,6,0,4,6
180852,10,49,6,0,43,6
180852,9,127,22,3,105,19
180852,8,745,115,9,630,106
180852,7,929,129,22,800,107
180852,6,718,110,14,608,96
180852,5,246,50,4,196,46
180852,4,133,33,2,100,31
180852,3,39,9,0,30,9
180852,2,28,10,2,18,8
180852,1,10,6,3,4,3
256226,10,170,28,0,142,28
256226,9,380,52,0,328,52
256226,8,1312,151,0,1161,151
256226,7,728,95,0,633,95
256226,6,327,49,0,278,49
256226,5,85,19,0,66,19
256226,4,23,7,0,16,7
256226,3,13,7,0,6,7
256226,2,4,1,0,3,1
256226,1,10,3,0,7,3
193621,10,101,17,1,84,16
193621,9,183,31,0,152,31
193621,8,516,79,7,437,72
193621,7,692,100,5,592,95
193621,6,864,109,7,755,102
193621,5,337,62,0,275,62
193621,4,175,30,3,145,27
193621,3,86,15,0,71,15
193621,2,42,17,0,25,17
193621,1,21,9,0,12,9
382,10,29,9,0,20,9
382,9,100,24,0,76,24
382,8,440,106,0,334,106
382,7,868,179,0,689,179
382,6,1049,257,0,792,257
382,5,326,82,0,244,82
382,4,122,33,0,89,33
382,3,59,18,0,41,18
382,2,18,8,0,10,8
382,1,4,1,0,3,1
135382,10,195,50,0,145,50
135382,9,381,81,0,300,81
135382,8,899,153,0,746,153
135382,7,683,112,0,571,112
135382,6,482,96,0,386,96
135382,5,157,34,0,123,34
135382,4,104,29,0,75,29
135382,3,61,14,0,47,14
135382,2,29,11,0,18,11
135382,1,20,10,0,10,10
3737,9,11,5,0,6,5
3737,8,29,9,0,20,9
3737,7,93,18,0,75,18
3737,6,343,80,0,263,80
3737,5,616,125,0,491,125
3737,4,895,212,0,683,212
3737,3,553,121,0,432,121
3737,2,336,95,0,241,95
3737,1,120,28,0,92,28
7,10,60,23,0,37,23
7,9,117,35,0,82,35
7,8,467,141,0,326,141
7,7,796,225,0,571,225
7,6,1011,281,0,730,281
7,5,365,118,0,247,118
7,4,130,50,0,80,50
7,3,45,15,0,30,15
7,2,8,2,0,6,2
7,1,3,2,0,1,2
99975,10,39,4,0,35,4
99975,9,103,12,0,91,12
99975,8,574,63,0,511,63
99975,7,1086,114,0,972,114
99975,6,915,109,0,806,109
99975,5,195,32,0,163,32
99975,4,52,11,0,41,11
99975,3,17,2,0,15,2
99975,2,11,3,0,8,3
99975,1,9,2,0,7,2
71061,10,90,28,0,62,28
71061,9,173,41,0,132,41
71061,8,680,155,0,525,155
71061,7,811,165,0,646,165
71061,6,706,148,0,558,148
71061,5,233,55,0,178,55
71061,4,113,28,0,85,28
71061,3,92,25,0,67,25
71061,2,67,28,0,39,28
71061,1,31,13,0,18,13
154386,10,36,10,0,26,10
154386,9,148,30,0,118,30
154386,8,898,139,0,759,139
154386,7,992,120,0,872,120
154386,6,669,103,0,566,103
154386,5,159,23,0,136,23
154386,4,57,12,0,45,12
154386,3,27,3,0,24,3
154386,2,3,1,0,2,1
154386,1,6,1,0,5,1
492,10,46,14,0,32,14
492,9,166,65,0,101,65
492,8,789,255,0,534,255
492,7,1019,281,0,738,281
492,6,664,206,0,458,206
492,5,167,51,0,116,51
492,4,88,34,0,54,34
492,3,34,20,0,14,20
492,2,14,6,0,8,6
79127,10,246,62,0,184,62
79127,9,470,101,0,369,101
79127,8,1032,222,0,810,222
79127,7,632,127,0,505,127
79127,6,383,86,0,297,86
79127,5,106,35,0,71,35
79127,4,63,19,0,44,19
79127,3,29,13,0,16,13
79127,2,19,6,0,13,6
79127,1,12,2,0,10,2
143185,10,93,10,0,83,10
143185,9,203,15,0,188,15
143185,8,654,51,0,603,51
143185,7,875,53,0,822,53
143185,6,737,73,0,664,73
143185,5,224,40,0,184,40
143185,4,117,16,0,101,16
143185,3,50,11,0,39,11
143185,2,26,5,0,21,5
143185,1,9,3,0,6,3
30645,10,103,24,0,79,24
30645,9,301,83,3,218,80
30645,8,1099,256,10,843,246
30645,7,755,150,9,605,141
30645,6,479,93,2,386,91
30645,5,119,32,0,87,32
30645,4,67,20,1,47,19
30645,3,42,15,0,27,15
30645,2,14,7,1,7,6
30645,1,8,2,0,6,2
134453,10,46,6,0,40,6
134453,9,138,26,0,112,26
134453,8,780,135,0,645,135
134453,7,1031,126,0,905,126
134453,6,722,98,0,624,98
134453,5,166,23,0,143,23
134453,4,61,9,0,52,9
134453,3,24,7,0,17,7
134453,2,13,4,0,9,4
197070,10,223,40,6,183,34
197070,9,412,60,6,352,54
197070,8,1006,151,17,855,134
197070,7,653,95,8,558,87
197070,6,389,56,2,333,54
197070,5,134,35,3,99,32
197070,4,83,24,2,59,22
197070,3,46,17,1,29,16
197070,2,18,9,0,9,9
197070,1,19,9,1,10,8
30381,10,30,7,0,23,7
30381,9,158,45,0,113,45
30381,8,1034,258,0,776,258
30381,7,957,204,0,753,204
30381,6,552,153,0,399,153
30381,5,155,50,0,105,50
30381,4,46,10,0,36,10
30381,3,29,10,0,19,10
30381,2,11,4,0,7,4
95064,10,124,12,0,112,12
95064,9,284,36,0,248,36
95064,8,1003,156,0,847,156
95064,7,884,137,0,747,137
95064,6,500,79,0,421,79
95064,5,105,15,0,90,15
95064,4,46,10,0,36,10
95064,3,14,2,0,12,2
95064,2,9,1,0,8,1
129051,10,42,9,0,33,9
129051,9,105,14,0,91,14
129051,8,885,155,0,730,155
129051,7,974,129,0,845,129
129051,6,672,114,0,558,114
129051,5,173,26,0,147,26
129051,4,74,17,0,57,17
129051,3,25,8,0,17,8
129051,2,12,3,0,9,3
129051,1,6,1,0,5,1
31105,10,35,13,0,22,13
31105,9,111,36,0,75,36
31105,8,577,188,0,389,188
31105,7,959,273,0,686,273
31105,6,923,255,0,668,255
31105,5,221,81,0,140,81
31105,4,93,33,0,60,33
31105,3,28,6,0,22,6
31105,2,11,5,0,6,5
31105,1,6,1,0,5,1
175199,10,111,33,1,78,32
175199,9,266,61,2,205,59
175199,8,885,171,6,714,165
175199,7,768,121,2,647,119
175199,6,564,131,5,433,126
175199,5,177,42,0,135,42
175199,4,110,35,1,75,34
175199,3,42,13,0,29,13
175199,2,20,7,0,13,7
175199,1,13,6,0,7,6
25261,10,81,23,0,58,23
25261,9,158,41,0,117,41
25261,8,573,132,0,441,132
25261,7,718,148,0,570,148
25261,6,756,165,0,591,165
25261,5,300,68,0,232,68
25261,4,196,46,0,150,46
25261,3,99,35,0,64,35
25261,2,44,20,0,24,20
25261,1,22,9,0,13,9
634,10,32,11,0,21,11
634,9,63,14,0,49,14
634,8,522,116,0,406,116
634,7,837,190,0,647,190
634,6,1002,187,0,815,187
634,5,281,58,0,223,58
634,4,133,41,0,92,41
634,3,48,21,0,27,21
634,2,24,10,0,14,10
634,1,6,1,0,5,1
246192,10,95,13,0,82,13
246192,9,298,41,0,257,41
246192,8,1321,128,0,1193,128
246192,7,805,102,0,703,102
246192,6,337,48,0,289,48
246192,5,72,22,0,50,22
246192,4,29,5,0,24,5
246192,3,10,3,0,7,3
194626,10,121,26,0,95,26
194626,9,207,43,0,164,43
194626,8,693,126,0,567,126
194626,7,803,115,0,688,115
194626,6,736,121,0,615,121
194626,5,199,29,0,170,29
194626,4,95,16,0,79,16
194626,3,45,10,0,35,10
194626,2,23,5,0,18,5
194626,1,15,1,0,14,1
250458,10,140,22,2,118,20
250458,9,457,61,3,396,58
250458,8,1306,156,11,1150,145
250458,7,598,78,4,520,74
250458,6,299,49,1,250,48
250458,5,88,18,0,70,18
250458,4,32,14,0,18,14
250458,3,12,5,0,7,5
250458,2,8,4,0,4,4
250458,1,5,2,1,3,1
1035,10,291,120,0,171,120
1035,9,414,126,0,288,126
1035,8,884,251,0,633,251
1035,7,702,197,0,505,197
1035,6,382,102,0,280,102
1035,5,135,38,0,97,38
1035,4,54,14,0,40,14
1035,3,37,11,0,26,11
1035,2,14,6,0,8,6
1035,1,17,1,0,16,1
134253,10,80,22,0,58,22
134253,9,184,43,3,141,40
134253,8,821,151,14,670,137
134253,7,954,144,12,810,132
134253,6,630,123,5,507,118
134253,5,150,37,1,113,36
134253,4,51,20,1,31,19
134253,3,29,10,0,19,10
134253,2,17,9,0,8,9
134253,1,6,1,0,5,1
165722,10,238,53,0,185,53
165722,9,372,48,0,324,48
165722,8,1085,136,0,949,136
165722,7,726,107,0,619,107
165722,6,351,42,0,309,42
165722,5,80,10,0,70,10
165722,4,42,8,0,34,8
165722,3,14,5,0,9,5
165722,2,7,2,0,5,2
3284,10,154,57,0,97,57
3284,9,233,71,0,162,71
3284,8,665,202,0,463,202
3284,7,829,259,0,570,259
3284,6,643,201,0,442,201
3284,5,230,85,0,145,85
3284,4,100,36,0,64,36
3284,3,39,13,0,26,13
3284,2,13,5,0,8,5
3284,1,9,1,0,8,1
151022,10,203,63,2,140,61
151022,9,420,96,1,324,95
151022,8,1102,225,3,877,222
151022,7,652,105,2,547,103
151022,6,354,70,0,284,70
151022,5,103,19,0,84,19
151022,4,45,13,0,32,13
151022,3,22,4,0,18,4
151022,2,8,2,0,6,2
24800,10,223,78,0,145,78
24800,9,451,115,0,336,115
24800,8,1029,234,0,795,234
24800,7,651,190,0,461,190
24800,6,329,100,0,229,100
24800,5,111,31,0,80,31
24800,4,54,20,0,34,20
24800,3,21,12,0,9,12
24800,2,15,4,0,11,4
24800,1,23,2,0,21,2
146791,10,535,104,11,431,93
146791,9,687,110,6,577,104
146791,8,827,109,14,718,95
146791,7,405,52,2,353,50
146791,6,256,57,1,199,56
146791,5,89,18,1,71,17
146791,4,54,9,1,45,8
146791,3,24,7,1,17,6
146791,2,11,5,0,6,5
146791,1,20,3,2,17,1
66171,10,31,7,0,24,7
66171,9,89,16,0,73,16
66171,8,513,130,0,383,130
66171,7,892,165,0,727,165
66171,6,953,158,0,795,158
66171,5,263,57,0,206,57
66171,4,106,28,0,78,28
66171,3,35,12,0,23,12
66171,2,16,4,0,12,4
66171,1,6,3,0,3,3
4099,10,32,16,0,16,16
4099,9,166,60,0,106,60
4099,8,961,300,0,661,300
4099,7,975,244,0,731,244
4099,6,541,161,0,380,161
4099,5,137,52,0,85,52
4099,4,49,21,0,28,21
4099,3,23,10,0,13,10
4099,2,9,3,0,6,3
4099,1,9,3,0,6,3
24827,10,35,13,0,22,13
24827,9,113,35,0,78,35
24827,8,786,236,0,550,236
24827,7,957,212,0,745,212
24827,6,723,169,0,554,169
24827,5,171,46,0,125,46
24827,4,72,29,0,43,29
24827,3,31,7,0,24,7
24827,2,12,6,0,6,6
141517,10,188,61,1,127,60
141517,9,374,93,6,281,87
141517,8,854,149,4,705,145
141517,7,629,120,5,509,115
141517,6,504,87,1,417,86
141517,5,156,25,1,131,24
141517,4,113,25,2,88,23
141517,3,52,18,0,34,18
141517,2,26,4,0,22,4
82168,10,67,15,0,52,15
82168,9,183,29,0,154,29
82168,8,794,147,0,647,147
82168,7,863,128,0,735,128
82168,6,669,107,0,562,107
82168,5,168,46,0,122,46
82168,4,88,21,0,67,21
82168,3,34,8,0,26,8
82168,2,19,9,0,10,9
82168,1,7,2,0,5,2
216459,10,67,15,0,52,15
216459,9,185,38,0,147,38
216459,8,938,156,0,782,156
216459,7,986,138,0,848,138
216459,6,534,101,0,433,101
216459,5,122,19,0,103,19
216459,4,43,11,0,32,11
216459,3,14,6,0,8,6
619,10,48,18,0,30,18
619,9,139,48,0,91,48
619,8,675,241,0,434,241
619,7,908,277,0,631,277
619,6,720,195,0,525,195
619,5,216,55,0,161,55
619,4,112,40,0,72,40
619,3,38,19,0,19,19
619,2,18,9,0,9,9
619,1,9,2,0,7,2
12005,10,23,13,0,10,13
12005,9,77,34,0,43,34
12005,8,540,194,0,346,194
12005,7,910,245,0,665,245
12005,6,917,251,0,666,251
12005,5,248,70,0,178,70
12005,4,98,36,0,62,36
12005,3,49,23,0,26,23
12005,2,15,7,0,8,7
12005,1,4,1,0,3,1
142992,10,52,14,0,38,14
142992,9,155,26,0,129,26
142992,8,803,143,0,660,143
142992,7,928,145,0,783,145
142992,6,650,123,0,527,123
142992,5,169,41,0,128,41
142992,4,82,28,0,54,28
142992,3,24,8,0,16,8
142992,2,15,6,0,9,6
12495,10,59,24,0,35,24
12495,9,181,62,0,119,62
12495,8,910,279,0,631,279
12495,7,887,227,0,660,227
12495,6,525,157,0,368,157
12495,5,178,52,0,126,52
12495,4,86,28,0,58,28
12495,3,30,15,0,15,15
12495,2,14,5,0,9,5
12495,1,9,1,0,8,1
54137,10,46,12,0,34,12
54137,9,98,18,0,80,18
54137,8,594,112,0,482,112
54137,7,898,150,0,748,150
54137,6,868,141,0,727,141
54137,5,245,39,0,206,39
54137,4,76,10,0,66,10
54137,3,33,4,0,29,4
54137,2,8,1,0,7,1
54137,1,2,1,0,1,1
176558,10,42,6,0,36,6
176558,9,108,13,0,95,13
176558,8,605,75,0,530,75
176558,7,839,98,0,741,98
176558,6,837,129,0,708,129
176558,5,255,41,0,214,41
176558,4,114,21,0,93,21
176558,3,44,5,0,39,5
176558,2,17,6,0,11,6
176558,1,11,2,0,9,2
40393,10,20,5,0,15,5
40393,9,72,21,0,51,21
40393,8,556,166,0,390,166
40393,7,945,251,0,694,251
40393,6,886,215,0,671,215
40393,5,232,61,0,171,61
40393,4,96,31,0,65,31
40393,3,41,15,0,26,15
40393,2,9,7,0,2,7
40393,1,11,5,0,6,5
1042,10,16,7,0,9,7
1042,9,61,21,0,40,21
1042,8,485,161,0,324,161
1042,7,853,196,0,657,196
1042,6,967,234,0,733,234
1042,5,285,83,0,202,83
1042,4,131,37,0,94,37
1042,3,45,16,0,29,16
1042,2,14,6,0,8,6
1042,1,9,5,0,4,5
217,10,23,5,0,18,5
217,9,75,20,0,55,20
217,8,444,126,0,318,126
217,7,854,202,0,652,202
217,6,1006,239,0,767,239
217,5,289,73,0,216,73
217,4,109,34,0,75,34
217,3,48,13,0,35,13
217,2,14,6,0,8,6
17710,10,84,34,0,50,34
17710,9,147,54,0,93,54
17710,8,662,197,0,465,197
17710,7,834,214,0,620,214
17710,6,681,158,0,523,158
17710,5,231,60,0,171,60
17710,4,126,32,0,94,32
17710,3,51,16,0,35,16
17710,2,27,10,0,17,10
17710,1,11,6,0,5,6
222509,10,443,97,10,346,87
222509,9,702,95,9,607,86
222509,8,970,135,10,835,125
222509,7,371,37,3,334,34
222509,6,211,24,2,187,22
222509,5,77,16,1,61,15
222509,4,36,10,1,26,9
222509,3,14,5,1,9,4
222509,2,9,3,0,6,3
222509,1,22,9,3,13,6
943,10,61,14,0,47,14
943,9,112,26,0,86,26
943,8,370,74,0,296,74
943,7,624,120,0,504,120
943,6,940,151,0,789,151
943,5,368,72,0,296,72
943,4,204,56,0,148,56
943,3,85,22,0,63,22
943,2,55,24,0,31,24
943,1,25,7,0,18,7
154458,10,76,22,0,54,22
154458,9,205,48,0,157,48
154458,8,1125,218,0,907,218
154458,7,834,159,0,675,159
154458,6,441,101,0,340,101
154458,5,105,27,0,78,27
154458,4,38,14,0,24,14
154458,3,15,4,0,11,4
154458,2,4,4,0,0,4
154458,1,2,1,0,1,1
15511,10,44,16,0,28,16
15511,9,108,38,0,70,38
15511,8,609,228,0,381,228
15511,7,910,299,0,611,299
15511,6,809,230,0,579,230
15511,5,214,69,0,145,69
15511,4,87,30,0,57,30
15511,3,40,12,0,28,12
15511,2,10,7,0,3,7
38386,9,78,21,0,57,21
38386,8,689,157,0,532,157
38386,7,943,209,0,734,209
38386,6,760,153,0,607,153
38386,5,208,66,0,142,66
38386,4,72,30,0,42,30
38386,3,34,17,0,17,17
38386,2,13,7,0,6,7
170561,10,139,34,3,105,31
170561,9,315,63,3,252,60
170561,8,1087,171,8,916,163
170561,7,749,106,7,643,99
170561,6,373,54,0,319,54
170561,5,94,20,1,74,19
170561,4,41,9,0,32,9
170561,3,16,3,0,13,3
170561,2,7,3,0,4,3
170561,1,5,2,0,3,2
16772,10,63,16,0,47,16
16772,9,150,55,0,95,55
16772,8,607,176,0,431,176
16772,7,791,195,0,596,195
16772,6,717,189,0,528,189
16772,5,243,62,0,181,62
16772,4,147,45,0,102,45
16772,3,58,17,0,41,17
16772,2,32,9,0,23,9
16772,1,10,1,0,9,1
177590,10,77,19,0,58,19
177590,9,312,72,1,240,71
177590,8,1151,227,5,924,222
177590,7,767,158,2,609,156
177590,6,374,63,0,311,63
177590,5,97,22,1,75,21
177590,4,24,7,0,17,7
177590,3,12,1,0,11,1
177590,2,6,1,0,5,1
117985,10,85,15,0,70,15
117985,9,184,30,0,154,30
117985,8,784,131,0,653,131
117985,7,904,139,0,765,139
117985,6,593,92,0,501,92
117985,5,161,28,0,133,28
117985,4,59,13,0,46,13
117985,3,18,6,0,12,6
117985,2,18,4,0,14,4
117985,1,12,2,0,10,2
174785,10,188,41,2,147,39
174785,9,452,89,13,363,76
174785,8,1106,166,18,940,148
174785,7,578,71,3,507,68
174785,6,343,53,3,290,50
174785,5,70,15,2,55,13
174785,4,52,20,1,32,19
174785,3,14,5,0,9,5
174785,2,9,3,0,6,3
174785,1,6,2,0,4,2
40270,10,120,31,0,89,31
40270,9,240,60,0,180,60
40270,8,680,129,0,551,129
40270,7,783,133,0,650,133
40270,6,581,105,0,476,105
40270,5,229,41,0,188,41
40270,4,115,27,0,88,27
40270,3,44,13,0,31,13
40270,2,14,4,0,10,4
40270,1,10,1,0,9,1
69552,10,47,11,0,36,11
69552,9,111,29,0,82,29
69552,8,455,93,0,362,93
69552,7,552,91,0,461,91
69552,6,766,144,0,622,144
69552,5,337,77,0,260,77
69552,4,264,87,0,177,87
69552,3,144,59,0,85,59
69552,2,95,44,0,51,44
69552,1,45,24,0,21,24
13780,10,45,23,0,22,23
13780,9,169,67,0,102,67
13780,8,797,281,0,516,281
13780,7,832,241,0,591,241
13780,6,639,213,0,426,213
13780,5,208,75,0,133,75
13780,4,79,28,0,51,28
13780,3,26,13,0,13,13
13780,2,9,5,0,4,5
57390,10,70,21,0,49,21
57390,9,240,71,0,169,71
57390,8,912,238,3,674,235
57390,7,802,191,2,611,189
57390,6,529,138,4,391,134
57390,5,129,33,0,96,33
57390,4,73,27,0,46,27
57390,3,25,8,0,17,8
57390,2,17,6,0,11,6
57390,1,9,2,0,7,2
128667,10,55,6,0,49,6
128667,9,112,21,0,91,21
128667,8,598,80,0,518,80
128667,7,873,125,0,748,125
128667,6,762,115,0,647,115
128667,5,231,34,0,197,34
128667,4,109,24,0,85,24
128667,3,35,3,0,32,3
128667,2,19,6,0,13,6
128667,1,7,2,0,5,2
201,10,44,7,0,37,7
201,9,123,30,0,93,30
201,8,637,156,0,481,156
201,7,946,183,0,763,183
201,6,732,149,0,583,149
201,5,203,37,0,166,37
201,4,69,24,0,45,24
201,3,28,10,0,18,10
201,2,14,4,0,10,4
201,1,5,2,0,3,2
232405,10,281,68,10,213,58
232405,9,504,82,10,422,72
232405,8,1093,148,16,945,132
232405,7,488,69,7,419,62
232405,6,272,66,2,206,64
232405,5,77,18,2,59,16
232405,4,35,7,2,28,5
232405,3,24,11,2,13,9
232405,2,11,4,0,7,4
232405,1,13,3,0,10,3
29934,10,53,13,0,40,13
29934,9,143,40,0,103,40
29934,8,821,196,0,625,196
29934,7,885,230,0,655,230
29934,6,614,165,0,449,165
29934,5,170,53,0,117,53
29934,4,58,25,0,33,25
29934,3,20,8,0,12,8
29934,2,13,6,0,7,6
29934,1,9,1,0,8,1
57925,10,30,7,0,23,7
57925,9,114,23,0,91,23
57925,8,718,121,0,597,121
57925,7,969,143,0,826,143
57925,6,688,114,0,574,114
57925,5,168,38,0,130,38
57925,4,56,14,0,42,14
57925,3,29,8,0,21,8
57925,2,9,4,0,5,4
57925,1,4,1,0,3,1
81453,10,22,4,0,18,4
81453,9,62,13,0,49,13
81453,8,502,114,0,388,114
81453,7,852,158,0,694,158
81453,6,889,166,0,723,166
81453,5,266,58,0,208,58
81453,4,109,18,0,91,18
81453,3,47,13,0,34,13
81453,2,21,9,0,12,9
81453,1,12,4,0,8,4
2165,10,78,17,0,61,17
2165,9,99,23,0,76,23
2165,8,355,91,0,264,91
2165,7,578,137,0,441,137
2165,6,857,182,0,675,182
2165,5,428,89,0,339,89
2165,4,233,65,0,168,65
2165,3,85,21,0,64,21
2165,2,45,13,0,32,13
2165,1,19,5,0,14,5
159109,10,60,12,2,48,10
159109,9,198,30,4,168,26
159109,8,895,162,21,733,141
159109,7,790,123,9,667,114
159109,6,523,97,6,426,91
159109,5,180,44,5,136,39
159109,4,71,13,0,58,13
159109,3,35,7,0,28,7
159109,2,18,5,0,13,5
159109,1,9,1,0,8,1
111124,10,64,20,0,44,20
111124,9,214,52,0,162,52
111124,8,894,159,0,735,159
111124,7,778,122,0,656,122
111124,6,531,102,0,429,102
111124,5,170,52,0,118,52
111124,4,67,15,0,52,15
111124,3,31,9,0,22,9
111124,2,12,3,0,9,3
111124,1,10,4,0,6,4
11901,10,73,35,1,38,34
11901,9,8,2,0,6,2
11901,8,15,5,0,10,5
11901,7,26,5,0,21,5
11901,6,62,18,0,44,18
11901,5,140,33,0,107,33
11901,4,312,77,0,235,77
11901,3,500,138,0,362,138
11901,2,679,203,0,476,203
11901,1,953,298,0,655,298
65901,10,95,28,0,67,28
65901,9,346,97,0,249,97
65901,8,1065,252,0,813,252
65901,7,696,156,0,540,156
65901,6,376,98,0,278,98
65901,5,102,31,0,71,31
65901,4,42,19,0,23,19
65901,3,26,10,0,16,10
65901,2,10,2,0,8,2
875,10,338,102,0,236,102
875,9,544,131,0,413,131
875,8,884,217,0,667,217
875,7,499,136,0,363,136
875,6,278,89,0,189,89
875,5,85,25,0,60,25
875,4,63,30,0,33,30
875,3,24,7,0,17,7
875,2,25,14,0,11,14
875,1,22,8,0,14,8
43022,10,173,64,0,109,64
43022,9,297,86,0,211,86
43022,8,708,145,0,563,145
43022,7,629,128,0,501,128
43022,6,553,131,0,422,131
43022,5,207,42,0,165,42
43022,4,95,27,0,68,27
43022,3,48,17,0,31,17
43022,2,29,12,0,17,12
43022,1,23,9,0,14,9
31999,10,212,65,0,147,65
31999,9,383,106,0,277,106
31999,8,1114,257,0,857,257
31999,7,669,137,0,532,137
31999,6,273,54,0,219,54
31999,5,62,14,0,48,14
31999,4,21,5,0,16,5
31999,3,8,2,0,6,2
31999,2,9,1,0,8,1
142079,10,64,13,0,51,13
142079,9,193,41,0,152,41
142079,8,749,143,0,606,143
142079,7,749,138,0,611,138
142079,6,608,133,0,475,133
142079,5,190,29,0,161,29
142079,4,115,33,0,82,33
142079,3,54,13,0,41,13
142079,2,31,12,0,19,12
142079,1,7,3,0,4,3
1261,10,52,14,0,38,14
1261,9,184,51,0,133,51
1261,8,839,208,0,631,208
1261,7,928,200,0,728,200
1261,6,519,111,0,408,111
1261,5,138,39,0,99,39
1261,4,61,20,0,41,20
1261,3,21,3,0,18,3
1261,2,8,4,0,4,4
1261,1,10,4,0,6,4
168917,10,144,15,0,129,15
168917,9,278,20,0,258,20
168917,8,846,52,0,794,52
168917,7,867,63,0,804,63
168917,6,457,35,0,422,35
168917,5,93,14,0,79,14
168917,4,39,5,0,34,5
168917,3,15,3,0,12,3
168917,2,4,1,0,3,1
168917,1,7,2,0,5,2
339,10,37,10,0,27,10
339,9,80,14,0,66,14
339,8,280,73,0,207,73
339,7,600,134,0,466,134
339,6,899,204,0,695,204
339,5,463,113,0,350,113
339,4,238,90,0,148,90
339,3,101,37,0,64,37
339,2,40,19,0,21,19
339,1,10,6,0,4,6
38343,10,34,6,0,28,6
38343,9,143,24,0,119,24
38343,8,745,187,0,558,187
38343,7,864,185,0,679,185
38343,6,636,153,0,483,153
38343,5,205,55,0,150,55
38343,4,85,29,0,56,29
38343,3,22,9,0,13,9
38343,2,5,2,0,3,2
38343,1,7,1,0,6,1
162286,10,74,19,0,55,19
162286,9,263,48,1,215,47
162286,8,1188,161,1,1027,160
162286,7,736,87,0,649,87
162286,6,377,57,0,320,57
162286,5,72,15,0,57,15
162286,4,24,3,0,21,3
162286,3,8,1,0,7,1
162286,2,3,2,0,1,2
162286,1,2,1,0,1,1
108906,10,123,31,0,92,31
108906,9,335,76,1,259,75
108906,8,1051,210,1,841,209
108906,7,602,90,0,512,90
108906,6,378,70,0,308,70
108906,5,123,31,0,92,31
108906,4,69,24,0,45,24
108906,3,47,16,0,31,16
108906,2,7,2,0,5,2
108906,1,10,4,0,6,4
99875,10,15,3,0,12,3
99875,9,78,19,0,59,19
99875,8,344,90,0,254,90
99875,7,705,153,0,552,153
99875,6,1068,235,0,833,235
99875,5,323,68,0,255,68
99875,4,132,37,0,95,37
99875,3,56,19,0,37,19
99875,2,12,2,0,10,2
99875,1,5,1,0,4,1
2181,10,578,161,0,417,161
2181,9,333,79,0,254,79
2181,8,546,123,0,423,123
2181,7,460,89,0,371,89
2181,6,399,80,0,319,80
2181,5,187,42,0,145,42
2181,4,124,43,0,81,43
2181,3,47,13,0,34,13
2181,2,33,14,0,19,14
2181,1,28,5,0,23,5
86955,10,71,2,0,69,2
86955,9,116,12,0,104,12
86955,8,371,34,0,337,34
86955,7,630,62,0,568,62
86955,6,826,77,0,749,77
86955,5,359,39,0,320,39
86955,4,203,43,0,160,43
86955,3,86,17,0,69,17
86955,2,52,15,0,37,15
86955,1,17,1,0,16,1
466,10,35,6,0,29,6
466,9,111,35,0,76,35
466,8,498,81,0,417,81
466,7,817,141,0,676,141
466,6,845,136,0,709,136
466,5,237,41,0,196,41
466,4,109,28,0,81,28
466,3,50,16,0,34,16
466,2,19,8,0,11,8
466,1,7,2,0,5,2
19841,10,37,3,0,34,3
19841,9,88,16,0,72,16
19841,8,360,70,0,290,70
19841,7,718,138,0,580,138
19841,6,987,171,0,816,171
19841,5,353,72,0,281,72
19841,4,133,41,0,92,41
19841,3,31,8,0,23,8
19841,2,12,2,0,10,2
987,10,95,37,0,58,37
987,9,148,45,0,103,45
987,8,446,120,0,326,120
987,7,670,177,0,493,177
987,6,766,204,0,562,204
987,5,321,111,0,210,111
987,4,153,55,0,98,55
987,3,78,40,0,38,40
987,2,30,14,0,16,14
987,1,13,8,0,5,8
37120,10,16,3,0,13,3
37120,9,56,9,0,47,9
37120,8,453,97,0,356,97
37120,7,749,151,0,598,151
37120,6,987,164,0,823,164
37120,5,275,55,0,220,55
37120,4,109,27,0,82,27
37120,3,47,12,0,35,12
37120,2,20,8,0,12,8
37120,1,5,1,0,4,1
73369,10,74,19,0,55,19
73369,9,171,43,0,128,43
73369,8,740,158,0,582,158
73369,7,754,152,0,602,152
73369,6,605,141,0,464,141
73369,5,195,53,0,142,53
73369,4,107,29,0,78,29
73369,3,38,14,0,24,14
73369,2,16,6,0,10,6
73369,1,16,4,0,12,4
12194,10,61,7,0,54,7
12194,9,95,12,0,83,12
12194,8,319,28,0,291,28
12194,7,532,65,0,467,65
12194,6,828,104,0,724,104
12194,5,422,60,0,362,60
12194,4,247,58,0,189,58
12194,3,133,42,0,91,42
12194,2,47,13,0,34,13
12194,1,28,7,0,21,7
1544,10,105,39,0,66,39
1544,9,181,65,0,116,65
1544,8,570,158,0,412,158
1544,7,704,189,0,515,189
1544,6,758,198,0,560,198
1544,5,230,57,0,173,57
1544,4,107,32,0,75,32
1544,3,35,12,0,23,12
1544,2,12,2,0,10,2
1410,10,12,6,0,6,6
1410,9,16,7,0,9,7
1410,8,29,7,0,22,7
1410,7,81,20,0,61,20
1410,6,244,59,0,185,59
1410,5,410,84,0,326,84
1410,4,704,170,0,534,170
1410,3,549,152,0,397,152
1410,2,447,133,0,314,133
1410,1,211,60,0,151,60
713,10,73,23,0,50,23
713,9,117,39,0,78,39
713,8,339,100,1,239,99
713,7,634,174,2,460,172
713,6,804,240,2,564,238
713,5,360,105,0,255,105
713,4,182,64,0,118,64
713,3,115,51,0,64,51
713,2,59,32,0,27,32
713,1,18,8,0,10,8
168,10,107,31,0,76,31
168,9,211,56,0,155,56
168,8,643,177,0,466,177
168,7,762,186,0,576,186
168,6,620,178,0,442,178
168,5,206,78,0,128,78
168,4,92,45,0,47,45
168,3,30,12,0,18,12
168,2,20,10,0,10,10
168,1,8,4,0,4,4
179172,10,206,66,5,140,61
179172,9,376,84,10,292,74
179172,8,873,126,16,747,110
179172,7,593,91,4,502,87
179172,6,386,64,4,322,60
179172,5,128,29,3,99,26
179172,4,73,21,0,52,21
179172,3,38,11,0,27,11
179172,2,17,6,0,11,6
179172,1,12,3,0,9,3
21550,10,52,12,0,40,12
21550,9,132,39,0,93,39
21550,8,703,182,0,521,182
21550,7,893,209,0,684,209
21550,6,656,159,0,497,159
21550,5,183,48,0,135,48
21550,4,48,17,0,31,17
21550,3,15,6,0,9,6
21550,1,9,1,0,8,1
157789,10,32,5,0,27,5
157789,9,70,5,0,65,5
157789,8,446,38,0,408,38
157789,7,780,86,0,694,86
157789,6,876,115,0,761,115
157789,5,295,49,0,246,49
157789,4,119,29,0,90,29
157789,3,44,7,0,37,7
157789,2,15,7,0,8,7
157789,1,11,4,0,7,4
6351,10,47,22,0,25,22
6351,9,153,82,0,71,82
6351,8,580,287,0,293,287
6351,7,898,359,0,539,359
6351,6,734,261,0,473,261
6351,5,172,61,0,111,61
6351,4,62,22,0,40,22
6351,3,22,5,0,17,5
6351,2,11,5,0,6,5
6351,1,6,1,0,5,1
398,10,23,13,0,10,13
398,9,83,34,0,49,34
398,8,483,225,0,258,225
398,7,877,321,0,556,321
398,6,862,302,0,560,302
398,5,242,82,0,160,82
398,4,71,35,0,36,35
398,3,34,14,0,20,14
398,2,4,1,0,3,1
398,1,6,2,0,4,2
527,10,90,24,0,66,24
527,9,225,68,0,157,68
527,8,762,204,0,558,204
527,7,835,164,0,671,164
527,6,517,123,0,394,123
527,5,166,55,0,111,55
527,4,50,18,0,32,18
527,3,22,3,0,19,3
527,2,10,3,0,7,3
55427,10,111,20,0,91,20
55427,9,240,47,0,193,47
55427,8,891,150,0,741,150
55427,7,798,117,0,681,117
55427,6,475,66,0,409,66
55427,5,97,19,0,78,19
55427,4,43,12,0,31,12
55427,3,13,2,0,11,2
55427,2,6,1,0,5,1
55427,1,9,2,0,7,2
36553,10,304,66,0,238,66
36553,9,470,107,0,363,107
36553,8,946,161,0,785,161
36553,7,548,97,0,451,97
36553,6,246,44,0,202,44
36553,5,74,14,0,60,14
36553,4,30,5,0,25,5
36553,3,21,3,0,18,3
36553,2,22,7,0,15,7
36553,1,15,1,0,14,1
172047,10,198,34,3,164,31
172047,9,404,77,5,327,72
172047,8,895,124,14,771,110
172047,7,594,63,5,531,58
172047,6,349,46,2,303,44
172047,5,117,22,2,95,20
172047,4,63,16,0,47,16
172047,3,21,8,0,13,8
172047,2,15,5,0,10,5
172047,1,19,4,2,15,2
196326,10,205,19,0,186,19
196326,9,361,44,0,317,44
196326,8,936,113,0,823,113
196326,7,674,84,0,590,84
196326,6,329,51,0,278,51
196326,5,102,16,0,86,16
196326,4,42,9,0,33,9
196326,3,14,5,0,9,5
196326,2,5,3,0,2,3
196326,1,6,1,0,5,1
20545,10,77,16,0,61,16
20545,9,102,18,0,84,18
20545,8,379,63,0,316,63
20545,7,606,107,0,499,107
20545,6,896,140,0,756,140
20545,5,377,59,0,318,59
20545,4,123,22,0,101,22
20545,3,56,13,0,43,13
20545,2,26,8,0,18,8
20545,1,26,6,0,20,6
10653,10,54,16,0,38,16
10653,9,91,30,0,61,30
10653,8,280,91,0,189,91
10653,7,548,148,0,400,148
10653,6,860,264,0,596,264
10653,5,418,154,0,264,154
10653,4,238,115,0,123,115
10653,3,105,56,0,49,56
10653,2,56,39,0,17,39
10653,1,15,10,0,5,10
41933,10,43,10,0,33,10
41933,9,142,20,0,122,20
41933,8,750,142,0,608,142
41933,7,794,150,0,644,150
41933,6,592,140,0,452,140
41933,5,212,54,0,158,54
41933,4,74,22,0,52,22
41933,3,40,11,0,29,11
41933,2,12,6,0,6,6
41933,1,5,1,0,4,1
105037,10,40,5,0,35,5
105037,9,155,27,0,128,27
105037,8,839,145,0,694,145
105037,7,843,142,0,701,142
105037,6,530,105,0,425,105
105037,5,162,31,0,131,31
105037,4,59,13,0,46,13
105037,3,27,3,0,24,3
105037,2,6,4,0,2,4
181687,10,77,14,1,63,13
181687,9,209,36,2,173,34
181687,8,972,158,12,814,146
181687,7,817,100,8,717,92
181687,6,411,74,3,337,71
181687,5,108,31,1,77,30
181687,4,35,11,1,24,10
181687,3,23,7,0,16,7
181687,2,7,3,0,4,3
31016,10,60,16,0,44,16
31016,9,82,17,0,65,17
31016,8,233,50,0,183,50
31016,7,397,95,0,302,95
31016,6,753,122,0,631,122
31016,5,458,85,0,373,85
31016,4,313,69,0,244,69
31016,3,127,34,0,93,34
31016,2,139,39,0,100,39
31016,1,101,39,0,62,39
242302,10,105,24,0,81,24
242302,9,307,46,0,261,46
242302,8,1071,163,0,908,163
242302,7,704,85,0,619,85
242302,6,326,66,0,260,66
242302,5,85,24,0,61,24
242302,4,44,12,0,32,12
242302,3,14,7,0,7,7
242302,2,12,4,0,8,4
41010,10,48,8,0,40,8
41010,9,114,33,0,81,33
41010,8,517,144,0,373,144
41010,7,895,206,0,689,206
41010,6,718,137,0,581,137
41010,5,234,43,0,191,43
41010,4,87,21,0,66,21
41010,3,31,8,0,23,8
41010,2,9,1,0,8,1
120217,10,43,6,0,37,6
120217,9,156,23,0,133,23
120217,8,641,103,0,538,103
120217,7,756,133,0,623,133
120217,6,653,105,0,548,105
120217,5,204,43,0,161,43
120217,4,117,34,0,83,34
120217,3,42,11,0,31,11
120217,2,32,9,0,23,9
120217,1,9,3,0,6,3
123123,10,547,158,8,389,150
123123,9,497,104,3,393,101
123123,8,809,142,5,667,137
123123,7,389,65,1,324,64
123123,6,249,37,0,212,37
123123,5,80,18,1,62,17
123123,4,35,5,0,30,5
123123,3,18,5,0,13,5
123123,2,16,1,0,15,1
123123,1,15,2,0,13,2
256382,10,105,27,0,78,27
256382,9,211,31,0,180,31
256382,8,876,107,0,769,107
256382,7,723,70,0,653,70
256382,6,467,76,0,391,76
256382,5,132,32,0,100,32
256382,4,79,21,0,58,21
256382,3,52,24,0,28,24
256382,2,16,8,0,8,8
256382,1,5,1,0,4,1
175324,10,149,30,2,119,28
175324,9,334,53,0,281,53
175324,8,911,126,12,785,114
175324,7,591,80,2,511,78
175324,6,408,76,2,332,74
175324,5,116,25,1,91,24
175324,4,68,20,0,48,20
175324,3,53,17,0,36,17
175324,2,20,7,0,13,7
175324,1,15,8,1,7,7
128442,10,88,16,0,72,16
128442,9,161,27,0,134,27
128442,8,714,120,0,594,120
128442,7,720,101,0,619,101
128442,6,592,75,0,517,75
128442,5,174,26,0,148,26
128442,4,99,23,0,76,23
128442,3,41,12,0,29,12
128442,2,39,14,0,25,14
128442,1,18,4,0,14,4
153064,10,32,4,0,28,4
153064,9,131,24,0,107,24
153064,8,606,100,3,506,97
153064,7,758,102,0,656,102
153064,6,706,109,1,597,108
153064,5,249,36,0,213,36
153064,4,94,16,0,78,16
153064,3,44,12,0,32,12
153064,2,15,4,0,11,4
153064,1,10,2,0,8,2
196,10,98,31,0,67,31
196,9,229,62,1,167,61
196,8,726,191,5,535,186
196,7,742,156,3,586,153
196,6,494,127,2,367,125
196,5,166,44,0,122,44
196,4,94,29,0,65,29
196,3,52,21,0,31,21
196,2,28,15,0,13,15
196,1,13,2,0,11,2
29223,10,34,5,0,29,5
29223,9,84,21,0,63,21
29223,8,507,94,0,413,94
29223,7,899,147,0,752,147
29223,6,825,159,0,666,159
29223,5,182,41,0,141,41
29223,4,82,22,0,60,22
29223,3,25,4,0,21,4
29223,2,5,2,0,3,2
13551,10,17,4,0,13,4
13551,9,74,24,0,50,24
13551,8,562,170,0,392,170
13551,7,906,235,1,671,234
13551,6,726,205,0,521,205
13551,5,219,68,0,151,68
13551,4,86,34,0,52,34
13551,3,36,15,0,21,15
13551,2,6,2,0,4,2
145189,10,39,2,0,37,2
145189,9,110,10,0,100,10
145189,8,496,56,0,440,56
145189,7,910,89,0,821,89
145189,6,831,83,0,748,83
145189,5,163,19,0,144,19
145189,4,52,16,0,36,16
145189,3,20,3,0,17,3
145189,2,8,1,0,7,1
145189,1,5,2,0,3,2
23107,10,34,10,0,24,10
23107,9,79,20,0,59,20
23107,8,442,139,0,303,139
23107,7,812,204,0,608,204
23107,6,782,189,0,593,189
23107,5,288,68,0,220,68
23107,4,105,33,0,72,33
23107,3,52,21,0,31,21
23107,2,17,5,0,12,5
23107,1,9,2,0,7,2
67492,10,138,32,0,106,32
67492,9,295,63,0,232,63
67492,8,905,165,0,740,165
67492,7,661,122,0,539,122
67492,6,374,72,0,302,72
67492,5,129,29,0,100,29
67492,4,66,18,0,48,18
67492,3,29,10,0,19,10
67492,2,11,3,0,8,3
98229,10,96,16,0,80,16
98229,9,257,39,0,218,39
98229,8,962,136,0,826,136
98229,7,714,105,0,609,105
98229,6,411,42,0,369,42
98229,5,95,14,0,81,14
98229,4,54,6,0,48,6
98229,3,15,2,0,13,2
98229,2,11,1,0,10,1
715,10,68,15,0,53,15
715,9,138,34,0,104,34
715,8,516,132,0,384,132
715,7,721,138,0,583,138
715,6,747,159,0,588,159
715,5,249,56,0,193,56
715,4,102,29,0,73,29
715,3,48,13,0,35,13
715,2,21,8,0,13,8
715,1,7,1,0,6,1
175640,10,376,64,6,312,58
175640,9,726,97,9,629,88
175640,8,1027,135,11,892,124
175640,7,292,31,2,261,29
175640,6,118,18,0,100,18
175640,5,37,6,0,31,6
175640,4,18,3,0,15,3
175640,3,13,2,0,11,2
175640,2,4,1,0,3,1
175640,1,6,1,0,5,1
147303,10,58,8,0,50,8
147303,9,160,29,0,131,29
147303,8,810,157,0,653,157
147303,7,903,134,0,769,134
147303,6,504,89,0,415,89
147303,5,124,25,0,99,25
147303,4,33,6,0,27,6
147303,3,12,2,0,10,2
147303,1,4,1,0,3,1
17240,10,25,5,0,20,5
17240,9,64,16,0,48,16
17240,8,400,116,0,284,116
17240,7,869,210,0,659,210
17240,6,841,199,0,642,199
17240,5,248,60,0,188,60
17240,4,117,42,0,75,42
17240,3,36,15,0,21,15
17240,2,7,4,0,3,4
17240,1,4,1,0,3,1
85325,10,63,12,0,51,12
85325,9,138,20,0,118,20
85325,8,538,92,0,446,92
85325,7,825,92,0,733,92
85325,6,680,82,0,598,82
85325,5,204,29,0,175,29
85325,4,96,14,0,82,14
85325,3,40,12,0,28,12
85325,2,17,5,0,12,5
85325,1,5,2,0,3,2
1502,10,35,5,0,30,5
1502,9,45,9,0,36,9
1502,8,161,39,0,122,39
1502,7,318,51,0,267,51
1502,6,820,150,0,670,150
1502,5,547,77,0,470,77
1502,4,398,91,0,307,91
1502,3,164,43,0,121,43
1502,2,93,25,0,68,25
1502,1,20,10,0,10,10
37198,10,39,7,0,32,7
37198,9,62,9,0,53,9
37198,8,272,52,0,220,52
37198,7,542,76,0,466,76
37198,6,888,117,0,771,117
37198,5,426,53,0,373,53
37198,4,206,38,0,168,38
37198,3,104,17,0,87,17
37198,2,50,10,0,40,10
37198,1,16,3,0,13,3
135779,10,65,14,0,51,14
135779,9,193,43,0,150,43
135779,8,838,144,0,694,144
135779,7,781,117,0,664,117
135779,6,528,82,0,446,82
135779,5,111,20,0,91,20
135779,4,65,16,0,49,16
135779,3,13,3,0,10,3
135779,2,3,1,0,2,1
135779,1,7,1,0,6,1
90305,10,19,4,0,15,4
90305,9,57,6,0,51,6
90305,8,482,94,0,388,94
90305,7,771,137,0,634,137
90305,6,810,157,0,653,157
90305,5,269,66,0,203,66
90305,4,123,30,0,93,30
90305,3,43,10,0,33,10
90305,2,16,3,0,13,3
90305,1,6,2,0,4,2
40760,10,13,1,0,12,1
40760,9,47,11,0,36,11
40760,8,512,161,0,351,161
40760,7,910,216,0,694,216
40760,6,812,199,0,613,199
40760,5,186,62,0,124,62
40760,4,75,29,0,46,29
40760,3,28,8,0,20,8
40760,2,4,3,0,1,3
40760,1,6,1,0,5,1
178336,10,50,9,1,41,8
178336,9,190,39,3,151,36
178336,8,955,161,6,794,155
178336,7,805,121,3,684,118
178336,6,443,76,1,367,75
178336,5,92,15,0,77,15
178336,4,36,10,0,26,10
178336,3,12,8,0,4,8
178336,2,5,1,0,4,1
125548,10,91,16,0,75,16
125548,9,190,34,0,156,34
125548,8,698,107,0,591,107
125548,7,789,107,2,682,105
125548,6,535,80,0,455,80
125548,5,143,23,0,120,23
125548,4,86,19,2,67,17
125548,3,39,7,0,32,7
125548,2,8,2,0,6,2
125548,1,9,3,0,6,3
111341,10,301,85,0,216,85
111341,9,503,103,1,400,102
111341,8,894,158,0,736,158
111341,7,443,90,0,353,90
111341,6,260,58,0,202,58
111341,5,80,29,0,51,29
111341,4,57,23,0,34,23
111341,3,18,4,0,14,4
111341,2,10,3,0,7,3
111341,1,10,2,0,8,2
125,10,18,6,0,12,6
125,9,52,16,0,36,16
125,8,438,149,0,289,149
125,7,835,199,0,636,199
125,6,850,232,0,618,232
125,5,232,70,0,162,70
125,4,105,28,0,77,28
125,3,34,12,0,22,12
125,2,7,3,0,4,3
42910,10,49,15,0,34,15
42910,9,169,58,0,111,58
42910,8,907,228,0,679,228
42910,7,786,160,0,626,160
42910,6,437,117,0,320,117
42910,5,134,39,0,95,39
42910,4,44,16,0,28,16
42910,3,23,7,0,16,7
42910,2,6,2,0,4,2
42910,1,8,1,0,7,1
193214,10,88,21,0,67,21
193214,9,199,26,0,173,26
193214,8,905,109,0,796,109
193214,7,732,75,0,657,75
193214,6,451,54,0,397,54
193214,5,85,12,0,73,12
193214,4,67,17,0,50,17
193214,3,27,10,0,17,10
193214,2,9,1,0,8,1
193214,1,7,2,0,5,2
160018,10,127,10,0,117,10
160018,9,249,19,0,230,19
160018,8,828,59,0,769,59
160018,7,847,64,0,783,64
160018,6,358,23,0,335,23
160018,5,90,8,0,82,8
160018,4,36,6,0,30,6
160018,3,12,2,0,10,2
160018,2,5,1,0,4,1
160018,1,7,2,0,5,2
354,10,65,26,0,39,26
354,9,195,67,0,128,67
354,8,688,223,0,465,223
354,7,838,216,0,622,216
354,6,514,119,0,395,119
354,5,157,45,0,112,45
354,4,58,16,0,42,16
354,3,20,7,0,13,7
354,2,9,3,0,6,3
354,1,11,2,0,9,2
168609,10,21,6,0,15,6
168609,9,86,22,1,64,21
168609,8,672,119,3,553,116
168609,7,896,141,2,755,139
168609,6,650,125,2,525,123
168609,5,149,45,2,104,43
168609,4,52,12,0,40,12
168609,3,18,6,0,12,6
168609,2,10,6,0,4,6
230,10,146,63,0,83,63
230,9,254,69,0,185,69
230,8,717,218,0,499,218
230,7,711,166,0,545,166
230,6,425,103,0,322,103
230,5,155,50,0,105,50
230,4,86,29,0,57,29
230,3,37,17,0,20,17
230,2,12,4,0,8,4
230,1,8,2,0,6,2
32116,10,6,2,0,4,2
32116,9,39,10,0,29,10
32116,8,392,130,0,262,130
32116,7,766,206,0,560,206
32116,6,893,276,0,617,276
32116,5,282,94,0,188,94
32116,4,113,55,0,58,55
32116,3,33,17,0,16,17
32116,2,21,9,0,12,9
192836,10,209,31,0,178,31
192836,9,516,59,0,457,59
192836,8,971,159,0,812,159
192836,7,450,73,0,377,73
192836,6,245,62,0,183,62
192836,5,80,20,0,60,20
192836,4,38,12,0,26,12
192836,3,28,13,0,15,13
192836,2,5,1,0,4,1
192836,1,8,1,0,7,1
1515,10,19,8,0,11,8
1515,9,44,17,0,27,17
1515,8,166,49,0,117,49
1515,7,422,127,0,295,127
1515,6,898,217,0,681,217
1515,5,535,111,0,424,111
1515,4,282,77,0,205,77
1515,3,125,46,0,79,46
1515,2,47,11,0,36,11
1515,1,12,3,0,9,3
160495,10,141,25,0,116,25
160495,9,337,59,0,278,59
160495,8,1120,173,1,947,172
160495,7,576,87,1,489,86
160495,6,242,50,0,192,50
160495,5,77,23,0,54,23
160495,4,25,10,0,15,10
160495,3,19,5,0,14,5
160495,2,10,3,0,7,3
85897,10,130,21,0,109,21
85897,9,333,33,0,300,33
85897,8,911,136,0,775,136
85897,7,601,80,0,521,80
85897,6,354,56,0,298,56
85897,5,116,25,0,91,25
85897,4,42,5,0,37,5
85897,3,29,5,0,24,5
85897,2,16,3,0,13,3
85897,1,15,1,0,14,1
84419,10,233,71,0,162,71
84419,9,430,112,0,318,112
84419,8,914,200,0,714,200
84419,7,487,96,0,391,96
84419,6,289,68,0,221,68
84419,5,102,30,0,72,30
84419,4,49,16,0,33,16
84419,3,24,10,0,14,10
84419,2,12,4,0,8,4
84419,1,8,1,0,7,1
1295,10,94,31,0,63,31
1295,9,139,49,0,90,49
1295,8,437,134,0,303,134
1295,7,638,149,0,489,149
1295,6,774,171,0,603,171
1295,5,303,68,0,235,68
1295,4,101,32,0,69,32
1295,3,38,10,0,28,10
1295,2,13,6,0,7,6
1295,1,7,2,0,5,2
10997,10,15,5,0,10,5
10997,9,66,19,0,47,19
10997,8,444,181,0,263,181
10997,7,816,255,0,561,255
10997,6,828,220,0,608,220
10997,5,223,55,0,168,55
10997,4,105,46,0,59,46
10997,3,30,17,0,13,17
10997,2,11,6,0,5,6
10997,1,5,3,0,2,3
156858,10,121,38,1,83,37
156858,9,358,74,2,284,72
156858,8,1055,173,8,882,165
156858,7,593,88,3,505,85
156858,6,264,58,0,206,58
156858,5,76,24,0,52,24
156858,4,33,10,0,23,10
156858,3,26,11,0,15,11
156858,2,12,6,0,6,6
156858,1,9,3,0,6,3
3633,10,42,9,0,33,9
3633,9,72,19,0,53,19
3633,8,237,64,0,173,64
3633,7,433,98,0,335,98
3633,6,674,169,0,505,169
3633,5,410,114,0,296,114
3633,4,307,87,0,220,87
3633,3,197,69,0,128,69
3633,2,110,46,0,64,46
3633,1,57,27,0,30,27
204305,10,278,34,0,244,34
204305,9,534,66,0,468,66
204305,8,993,105,0,888,105
204305,7,445,43,0,402,43
204305,6,192,28,0,164,28
204305,5,40,7,0,33,7
204305,4,28,5,0,23,5
204305,3,15,3,0,12,3
204305,2,8,1,0,7,1
204305,1,11,3,0,8,3
65611,10,31,6,0,25,6
65611,9,32,9,0,23,9
65611,8,161,30,0,131,30
65611,7,286,43,0,243,43
65611,6,687,133,0,554,133
65611,5,575,105,0,470,105
65611,4,344,88,0,256,88
65611,3,214,64,0,150,64
65611,2,128,63,0,65,63
65611,1,33,13,0,20,13
165950,10,41,8,0,33,8
165950,9,103,11,0,92,11
165950,8,583,91,0,492,91
165950,7,858,122,0,736,122
165950,6,710,119,0,591,119
165950,5,170,30,0,140,30
165950,4,49,6,0,43,6
165950,3,18,5,0,13,5
165950,2,5,2,0,3,2
165950,1,2,1,0,1,1
197443,10,61,15,0,46,15
197443,9,194,35,2,159,33
197443,8,960,144,14,816,130
197443,7,816,123,12,693,111
197443,6,404,69,3,335,66
197443,5,72,17,1,55,16
197443,4,19,8,1,11,7
197443,3,9,4,0,5,4
197443,1,5,2,0,3,2
195544,10,34,4,0,30,4
195544,9,113,12,0,101,12
195544,8,640,91,0,549,91
195544,7,926,113,0,813,113
195544,6,603,89,0,514,89
195544,5,142,29,0,113,29
195544,4,53,12,0,41,12
195544,3,16,6,0,10,6
195544,2,7,1,0,6,1
195544,1,3,1,0,2,1
23094,10,103,23,0,80,23
23094,9,246,49,0,197,49
23094,8,817,174,0,643,174
23094,7,685,115,0,570,115
23094,6,429,87,0,342,87
23094,5,136,22,0,114,22
23094,4,65,11,0,54,11
23094,3,30,10,0,20,10
23094,2,13,3,0,10,3
594,10,81,31,0,50,31
594,9,190,59,0,131,59
594,8,621,182,1,439,181
594,7,735,193,0,542,193
594,6,575,143,0,432,143
594,5,164,55,0,109,55
594,4,87,27,0,60,27
594,3,37,14,0,23,14
594,2,21,12,0,9,12
594,1,9,3,0,6,3
33451,10,119,14,1,105,13
33451,9,163,23,0,140,23
33451,8,583,74,0,509,74
33451,7,737,82,0,655,82
33451,6,601,89,0,512,89
33451,5,176,29,0,147,29
33451,4,68,12,0,56,12
33451,3,32,7,0,25,7
33451,2,24,4,0,20,4
33451,1,12,1,0,11,1
156776,10,217,42,0,175,42
156776,9,292,54,0,238,54
156776,8,756,116,0,640,116
156776,7,646,90,0,556,90
156776,6,403,45,0,358,45
156776,5,93,14,0,79,14
156776,4,60,8,0,52,8
156776,3,22,7,0,15,7
156776,2,12,1,0,11,1
156776,1,12,1,0,11,1
3570,10,48,12,0,36,12
3570,9,92,32,0,60,32
3570,8,421,143,0,278,143
3570,7,777,224,0,553,224
3570,6,810,242,0,568,242
3570,5,215,50,0,165,50
3570,4,91,23,0,68,23
3570,3,41,14,0,27,14
3570,2,10,1,0,9,1
3570,1,6,1,0,5,1
122159,10,40,7,0,33,7
122159,9,78,4,0,74,4
122159,8,346,42,0,304,42
122159,7,587,60,0,527,60
122159,6,769,98,0,671,98
122159,5,312,35,0,277,35
122159,4,194,29,0,165,29
122159,3,103,28,0,75,28
122159,2,61,14,0,47,14
122159,1,23,4,0,19,4
5206,10,133,51,2,82,49
5206,9,206,68,4,138,64
5206,8,538,180,9,358,171
5206,7,709,198,11,511,187
5206,6,571,166,2,405,164
5206,5,223,65,2,158,63
5206,4,37,12,0,25,12
859,10,47,8,0,39,8
859,9,100,23,0,77,23
859,8,354,72,0,282,72
859,7,610,130,0,480,130
859,6,685,131,0,554,131
859,5,317,69,0,248,69
859,4,222,68,0,154,68
859,3,106,35,0,71,35
859,2,48,14,0,34,14
859,1,17,8,0,9,8
16991,10,42,11,0,31,11
16991,9,93,28,0,65,28
16991,8,419,132,0,287,132
16991,7,754,210,0,544,210
16991,6,751,197,0,554,197
16991,5,264,68,0,196,68
16991,4,117,33,0,84,33
16991,3,45,18,0,27,18
16991,2,12,5,0,7,5
16991,1,4,1,0,3,1
472,10,87,32,0,55,32
472,9,177,60,0,117,60
472,8,461,153,0,308,153
472,7,669,186,0,483,186
472,6,695,191,0,504,191
472,5,223,60,0,163,60
472,4,103,38,0,65,38
472,3,49,11,0,38,11
472,2,23,13,0,10,13
472,1,14,6,0,8,6
233247,10,96,13,0,83,13
233247,9,291,44,0,247,44
233247,8,951,131,0,820,131
233247,7,652,79,0,573,79
233247,6,356,65,0,291,65
233247,5,101,23,0,78,23
233247,4,39,8,0,31,8
233247,3,15,6,0,9,6
233247,2,5,2,0,3,2
4192,10,125,36,0,89,36
4192,9,179,37,0,142,37
4192,8,528,120,0,408,120
4192,7,584,129,0,455,129
4192,6,586,128,0,458,128
4192,5,222,72,0,150,72
4192,4,117,36,0,81,36
4192,3,76,27,0,49,27
4192,2,45,22,0,23,22
4192,1,33,10,0,23,10
4192,0,1,1,0,0,1
223321,10,521,74,0,447,74
223321,9,706,98,0,608,98
223321,8,717,74,0,643,74
223321,7,265,30,0,235,30
223321,6,158,23,0,135,23
223321,5,57,11,0,46,11
223321,4,31,12,0,19,12
223321,3,26,6,0,20,6
223321,2,12,3,0,9,3
223321,1,18,9,0,9,9
50768,10,68,21,0,47,21
50768,9,191,52,0,139,52
50768,8,923,194,0,729,194
50768,7,716,119,0,597,119
50768,6,420,98,0,322,98
50768,5,97,17,0,80,17
50768,4,57,16,0,41,16
50768,3,12,4,0,8,4
50768,2,4,1,0,3,1
191051,10,140,19,3,121,16
191051,9,304,45,6,259,39
191051,8,983,105,13,878,92
191051,7,607,53,6,554,47
191051,6,302,41,4,261,37
191051,5,98,14,0,84,14
191051,4,36,10,1,26,9
191051,3,15,2,0,13,2
191051,1,5,1,0,4,1
228,10,38,12,0,26,12
228,9,68,15,0,53,15
228,8,233,55,0,178,55
228,7,393,97,0,296,97
228,6,741,189,0,552,189
228,5,427,121,0,306,121
228,4,287,96,0,191,96
228,3,136,57,0,79,57
228,2,111,49,0,62,49
228,1,55,29,0,26,29
148261,10,134,23,0,111,23
148261,9,223,50,0,173,50
148261,8,561,98,0,463,98
148261,7,457,79,0,378,79
148261,6,457,83,0,374,83
148261,5,213,50,0,163,50
148261,4,139,39,0,100,39
148261,3,145,46,0,99,46
148261,2,106,54,0,52,54
148261,1,50,19,0,31,19
17161,10,17,7,0,10,7
17161,9,86,32,0,54,32
17161,8,473,150,0,323,150
17161,7,762,213,0,549,213
17161,6,678,232,0,446,232
17161,5,244,91,0,153,91
17161,4,134,55,0,79,55
17161,3,60,28,0,32,28
17161,2,23,9,0,14,9
17161,1,5,4,0,1,4
46255,10,26,3,0,23,3
46255,9,64,15,0,49,15
46255,8,599,151,0,448,151
46255,7,803,189,0,614,189
46255,6,615,162,0,453,162
46255,5,215,72,0,143,72
46255,4,100,40,0,60,40
46255,3,35,12,0,23,12
46255,2,18,7,0,11,7
46255,1,5,3,0,2,3
2507,10,75,34,0,41,34
2507,9,222,69,0,153,69
2507,8,813,240,0,573,240
2507,7,693,196,0,497,196
2507,6,450,132,0,318,132
2507,5,110,38,0,72,38
2507,4,80,33,0,47,33
2507,3,25,15,0,10,15
2507,2,4,2,0,2,2
2507,1,8,1,0,7,1
128780,10,258,81,1,177,80
128780,9,490,147,1,343,146
128780,8,843,183,0,660,183
128780,7,394,93,0,301,93
128780,6,271,66,0,205,66
128780,5,96,26,0,70,26
128780,4,58,13,0,45,13
128780,3,29,10,0,19,10
128780,2,16,6,0,10,6
128780,1,15,1,0,14,1
4174,10,43,11,0,32,11
4174,9,79,18,0,61,18
4174,8,393,97,0,296,97
4174,7,629,117,0,512,117
4174,6,782,151,1,631,150
4174,5,289,47,0,242,47
4174,4,146,23,0,123,23
4174,3,55,13,0,42,13
4174,2,38,15,0,23,15
4174,1,10,2,0,8,2
176165,10,85,16,0,69,16
176165,9,197,32,0,165,32
176165,8,769,130,8,639,122
176165,7,781,97,5,684,92
176165,6,466,54,1,412,53
176165,5,116,21,0,95,21
176165,4,36,12,0,24,12
176165,3,14,3,0,11,3
176165,2,4,3,0,1,3
908,10,16,5,0,11,5
908,9,52,13,0,39,13
908,8,258,79,0,179,79
908,7,599,139,0,460,139
908,6,904,227,0,677,227
908,5,359,93,0,266,93
908,4,167,57,0,110,57
908,3,76,35,0,41,35
908,2,22,11,0,11,11
908,1,7,2,0,5,2
128,10,36,9,0,27,9
128,9,95,24,0,71,24
128,8,437,112,0,325,112
128,7,782,181,0,601,181
128,6,751,156,0,595,156
128,5,209,61,0,148,61
128,4,104,31,0,73,31
128,3,30,11,0,19,11
128,2,6,3,0,3,3
128,1,6,1,0,5,1
192135,10,770,164,7,606,157
192135,9,698,108,6,590,102
192135,8,544,93,5,451,88
192135,7,200,33,0,167,33
192135,6,129,28,1,101,27
192135,5,55,10,0,45,10
192135,4,26,12,0,14,12
192135,3,17,6,0,11,6
192135,2,8,3,0,5,3
192135,1,8,5,2,3,3
197831,10,151,29,2,122,27
197831,9,232,40,2,192,38
197831,8,558,93,3,465,90
197831,7,507,75,4,432,71
197831,6,459,76,8,383,68
197831,5,190,43,2,147,41
197831,4,165,34,0,131,34
197831,3,84,26,1,58,25
197831,2,50,20,3,30,17
197831,1,60,29,4,31,25
116954,10,28,8,0,20,8
116954,9,98,24,0,74,24
116954,8,598,131,0,467,131
116954,7,865,169,0,696,169
116954,6,634,105,0,529,105
116954,5,150,38,0,112,38
116954,4,56,17,0,39,17
116954,3,15,5,0,10,5
212402,10,125,40,2,85,38
212402,9,235,41,5,194,36
212402,8,830,110,14,720,96
212402,7,655,87,6,568,81
212402,6,399,61,2,338,59
212402,5,120,29,2,91,27
212402,4,52,15,1,37,14
212402,3,17,5,0,12,5
212402,2,11,3,0,8,3
212402,1,5,1,0,4,1
198454,10,61,8,0,53,8
198454,9,194,24,0,170,24
198454,8,835,101,0,734,101
198454,7,728,81,0,647,81
198454,6,441,43,0,398,43
198454,5,136,23,0,113,23
198454,4,37,4,0,33,4
198454,3,17,6,0,11,6
198454,2,5,2,0,3,2
198454,1,3,1,0,2,1
16933,10,50,6,0,44,6
16933,9,69,5,0,64,5
16933,8,268,36,0,232,36
16933,7,463,49,0,414,49
16933,6,713,78,0,635,78
16933,5,416,59,0,357,59
16933,4,243,50,0,193,50
16933,3,126,32,0,94,32
16933,2,72,22,1,50,21
16933,1,25,3,0,22,3
12761,10,32,13,0,19,13
12761,9,116,39,0,77,39
12761,8,725,210,0,515,210
12761,7,770,175,0,595,175
12761,6,527,147,0,380,147
12761,5,154,43,0,111,43
12761,4,74,27,0,47,27
12761,3,24,13,0,11,13
12761,2,7,1,0,6,1
12761,1,11,3,0,8,3
167698,10,61,16,0,45,16
167698,9,91,22,0,69,22
167698,8,417,72,0,345,72
167698,7,630,97,0,533,97
167698,6,668,90,0,578,90
167698,5,276,46,0,230,46
167698,4,159,28,0,131,28
167698,3,94,21,0,73,21
167698,2,31,7,0,24,7
167698,1,15,6,0,9,6
162,10,53,25,0,28,25
162,9,94,40,0,54,40
162,8,385,144,0,241,144
162,7,673,234,0,439,234
162,6,776,241,0,535,241
162,5,269,81,0,188,81
162,4,123,50,0,73,50
162,3,39,14,0,25,14
162,2,21,9,0,12,9
13884,10,99,28,0,71,28
13884,9,216,57,0,159,57
13884,8,720,194,0,526,194
13884,7,607,162,0,445,162
13884,6,451,146,0,305,146
13884,5,158,61,0,97,61
13884,4,109,48,0,61,48
13884,3,48,26,0,22,26
13884,2,20,5,0,15,5
13884,1,7,1,0,6,1
7479,10,30,4,0,26,4
7479,9,62,15,0,47,15
7479,8,276,62,0,214,62
7479,7,584,118,0,466,118
7479,6,833,154,0,679,154
7479,5,329,80,0,249,80
7479,4,179,55,0,124,55
7479,3,90,24,0,66,24
7479,2,34,10,0,24,10
7479,1,12,2,0,10,2
3243,10,9,2,0,7,2
3243,9,27,5,0,22,5
3243,8,233,54,0,179,54
3243,7,566,114,0,452,114
3243,6,1005,173,0,832,173
3243,5,368,84,0,284,84
3243,4,146,44,0,102,44
3243,3,54,24,0,30,24
3243,2,18,8,0,10,8
3243,1,3,2,0,1,2
185589,10,53,8,0,45,8
185589,9,202,31,1,171,30
185589,8,915,137,3,778,134
185589,7,729,93,2,636,91
185589,6,364,74,1,290,73
185589,5,94,15,0,79,15
185589,4,37,11,0,26,11
185589,3,18,6,0,12,6
185589,2,11,4,0,7,4
72991,10,28,8,0,20,8
72991,9,114,22,0,92,22
72991,8,738,175,0,563,175
72991,7,833,152,0,681,152
72991,6,534,122,0,412,122
72991,5,127,34,0,93,34
72991,4,32,8,0,24,8
72991,3,13,2,0,11,2
65907,10,32,6,0,26,6
65907,9,97,15,0,82,15
65907,8,525,111,0,414,111
65907,7,668,117,0,551,117
65907,6,680,125,0,555,125
65907,5,207,61,0,146,61
65907,4,125,36,0,89,36
65907,3,54,19,0,35,19
65907,2,22,10,0,12,10
65907,1,14,3,0,11,3
1568,10,123,32,0,91,32
1568,9,158,36,0,122,36
1568,8,562,118,0,444,118
1568,7,699,105,0,594,105
1568,6,587,125,0,462,125
1568,5,182,43,0,139,43
1568,4,73,21,0,52,21
1568,3,21,8,0,13,8
1568,2,11,2,0,9,2
1568,1,3,1,0,2,1
82421,10,216,16,0,200,16
82421,9,346,44,0,302,44
82421,8,848,93,0,755,93
82421,7,542,54,0,488,54
82421,6,290,32,0,258,32
82421,5,91,15,0,76,15
82421,4,52,6,0,46,6
82421,3,14,2,0,12,2
82421,2,6,1,0,5,1
82421,1,15,1,0,14,1
92190,10,99,17,1,82,16
92190,9,172,30,1,142,29
92190,8,624,110,0,514,110
92190,7,619,110,2,509,108
92190,6,521,92,0,429,92
92190,5,199,38,0,161,38
92190,4,94,27,1,67,26
92190,3,50,16,0,34,16
92190,2,21,9,0,12,9
92190,1,15,5,0,10,5
66587,10,46,6,0,40,6
66587,9,103,31,0,72,31
66587,8,509,95,0,414,95
66587,7,640,122,0,518,122
66587,6,671,143,0,528,143
66587,5,241,60,0,181,60
66587,4,111,24,0,87,24
66587,3,62,16,0,46,16
66587,2,26,8,0,18,8
66587,1,4,1,0,3,1
5576,10,22,9,0,13,9
5576,9,61,30,0,31,30
5576,8,254,76,0,178,76
5576,7,594,130,0,464,130
5576,6,829,183,0,646,183
5576,5,349,84,0,265,84
5576,4,192,65,0,127,65
5576,3,77,26,0,51,26
5576,2,23,7,0,16,7
5576,1,10,2,0,8,2
18723,10,32,10,0,22,10
18723,9,97,21,0,76,21
18723,8,236,58,0,178,58
18723,7,450,80,0,370,80
18723,6,815,143,0,672,143
18723,5,353,61,0,292,61
18723,4,220,44,0,176,44
18723,3,110,20,0,90,20
18723,2,66,15,0,51,15
18723,1,33,8,0,25,8
179303,10,42,4,0,38,4
179303,9,137,26,0,111,26
179303,8,558,84,1,474,83
179303,7,773,109,0,664,109
179303,6,565,93,0,472,93
179303,5,198,34,0,164,34
179303,4,83,25,0,58,25
179303,3,33,5,0,28,5
179303,2,11,3,0,8,3
179303,1,9,2,0,7,2
3837,10,30,14,0,16,14
3837,9,57,16,0,41,16
3837,8,272,77,0,195,77
3837,7,562,146,0,416,146
3837,6,898,218,0,680,218
3837,5,354,75,0,279,75
3837,4,163,46,0,117,46
3837,3,34,14,0,20,14
3837,2,25,11,0,14,11
3837,1,11,2,0,9,2
2569,10,18,8,0,10,8
2569,9,52,26,0,26,26
2569,8,368,132,0,236,132
2569,7,837,263,0,574,263
2569,6,812,222,0,590,222
2569,5,206,56,0,150,56
2569,4,77,28,0,49,28
2569,3,20,7,0,13,7
2569,2,8,1,0,7,1
92319,10,43,9,0,34,9
92319,9,130,23,0,107,23
92319,8,680,119,0,561,119
92319,7,787,142,0,645,142
92319,6,508,112,0,396,112
92319,5,162,42,0,120,42
92319,4,49,14,0,35,14
92319,3,28,7,0,21,7
176083,10,48,12,0,36,12
176083,9,105,20,0,85,20
176083,8,592,103,0,489,103
176083,7,760,110,0,650,110
176083,6,597,90,0,507,90
176083,5,158,21,0,137,21
176083,4,78,19,0,59,19
176083,3,39,11,0,28,11
176083,2,11,3,0,8,3
176083,1,5,2,0,3,2
158339,10,23,5,0,18,5
158339,9,81,12,0,69,12
158339,8,490,93,0,397,93
158339,7,755,121,0,634,121
158339,6,714,100,0,614,100
158339,5,193,32,0,161,32
158339,4,81,26,0,55,26
158339,3,26,5,0,21,5
158339,2,11,3,0,8,3
158339,1,7,2,0,5,2
265,10,39,13,0,26,13
265,9,110,50,0,60,50
265,8,433,154,0,279,154
265,7,580,179,0,401,179
265,6,673,190,0,483,190
265,5,249,65,0,184,65
265,4,152,53,0,99,53
265,3,69,26,0,43,26
265,2,52,20,0,32,20
265,1,21,4,0,17,4
39684,10,37,7,0,30,7
39684,9,150,36,0,114,36
39684,8,788,174,0,614,174
39684,7,719,144,0,575,144
39684,6,444,102,0,342,102
39684,5,143,38,0,105,38
39684,4,62,26,0,36,26
39684,3,20,7,0,13,7
39684,2,12,5,0,7,5
39684,1,4,1,0,3,1
12891,10,208,88,0,120,88
12891,9,346,145,0,201,145
12891,8,889,283,0,606,283
12891,7,480,134,0,346,134
12891,6,254,84,0,170,84
12891,5,91,27,0,64,27
12891,4,45,17,0,28,17
12891,3,33,10,0,23,10
12891,2,19,11,0,8,11
12891,1,9,2,0,7,2
40354,10,300,105,0,195,105
40354,9,514,139,0,375,139
40354,8,899,200,0,699,200
40354,7,355,66,0,289,66
40354,6,196,42,0,154,42
40354,5,55,13,0,42,13
40354,4,24,8,0,16,8
40354,2,8,2,0,6,2
40354,1,16,2,0,14,2
183562,10,327,32,0,295,32
183562,9,496,39,0,457,39
183562,8,844,73,0,771,73
183562,7,439,44,0,395,44
183562,6,167,17,0,150,17
183562,5,46,3,0,43,3
183562,3,9,1,0,8,1
183562,1,22,2,0,20,2
104020,10,70,22,0,48,22
104020,9,244,40,0,204,40
104020,8,893,153,0,740,153
104020,7,584,89,0,495,89
104020,6,355,77,0,278,77
104020,5,113,25,0,88,25
104020,4,49,16,0,33,16
104020,3,26,9,0,17,9
104020,2,17,6,0,11,6
104020,1,20,7,0,13,7
34194,10,40,4,0,36,4
34194,9,107,27,0,80,27
34194,8,669,184,0,485,184
34194,7,865,191,0,674,191
34194,6,514,131,0,383,131
34194,5,109,26,0,83,26
34194,4,49,16,0,33,16
34194,3,7,2,0,5,2
34194,2,2,1,0,1,1
181345,10,22,2,0,20,2
181345,9,80,15,0,65,15
181345,8,474,86,0,388,86
181345,7,754,106,0,648,106
181345,6,788,129,0,659,129
181345,5,159,24,0,135,24
181345,4,63,11,0,52,11
181345,3,19,4,0,15,4
181345,2,7,1,0,6,1
246784,10,122,22,0,100,22
246784,9,322,54,0,268,54
246784,8,1020,121,0,899,121
246784,7,523,83,0,440,83
246784,6,269,39,0,230,39
246784,5,84,28,0,56,28
246784,4,25,5,0,20,5
246784,3,12,3,0,9,3
246784,2,8,6,0,2,6
139898,10,116,29,1,87,28
139898,9,315,65,3,250,62
139898,8,965,153,4,812,149
139898,7,538,100,6,438,94
139898,6,294,61,1,233,60
139898,5,96,24,0,72,24
139898,4,25,7,0,18,7
139898,3,11,8,0,3,8
139898,2,2,1,0,1,1
139898,1,5,2,0,3,2
27848,10,58,12,0,46,12
27848,9,123,35,0,88,35
27848,8,573,143,0,430,143
27848,7,643,133,1,510,132
27848,6,554,122,2,432,120
27848,5,206,48,0,158,48
27848,4,107,39,0,68,39
27848,3,67,30,0,37,30
27848,2,22,8,0,14,8
27848,1,13,3,0,10,3
520,10,48,7,0,41,7
520,9,96,20,0,76,20
520,8,431,87,0,344,87
520,7,646,129,0,517,129
520,6,704,172,0,532,172
520,5,227,69,0,158,69
520,4,126,40,0,86,40
520,3,51,26,0,25,26
520,2,22,7,0,15,7
520,1,12,4,0,8,4
204,10,42,23,0,19,23
204,9,141,61,0,80,61
204,8,648,208,2,440,206
204,7,714,185,1,529,184
204,6,518,141,0,377,141
204,5,172,53,1,119,52
204,4,74,26,1,48,25
204,3,30,9,0,21,9
204,2,10,6,0,4,6
204,1,10,2,0,8,2
23686,10,33,7,0,26,7
23686,9,92,22,0,70,22
23686,8,410,98,0,312,98
23686,7,612,120,0,492,120
23686,6,724,179,0,545,179
23686,5,242,55,0,187,55
23686,4,155,46,0,109,46
23686,3,51,13,0,38,13
23686,2,23,8,0,15,8
200954,10,42,6,1,36,5
200954,9,170,35,5,135,30
200954,8,866,137,17,729,120
200954,7,747,105,9,642,96
200954,6,378,74,3,304,71
200954,5,90,11,1,79,10
200954,4,32,10,1,22,9
200954,3,22,8,1,14,7
200954,2,3,2,0,1,2
200954,1,3,1,0,2,1
337,10,19,8,0,11,8
337,9,78,31,0,47,31
337,8,401,156,2,245,154
337,7,789,242,2,547,240
337,6,767,204,1,563,203
337,5,197,61,0,136,61
337,4,76,25,0,51,25
337,3,23,9,0,14,9
337,2,5,2,0,3,2
27356,10,9,4,0,5,4
27356,9,26,9,0,17,9
27356,8,346,107,0,239,107
27356,7,734,170,0,564,170
27356,6,840,188,0,652,188
27356,5,241,58,0,183,58
27356,4,108,34,0,74,34
27356,3,33,6,0,27,6
205610,10,34,3,0,31,3
205610,9,80,16,0,64,16
205610,8,502,86,0,416,86
205610,7,820,95,0,725,95
205610,6,655,85,0,570,85
205610,5,167,30,0,137,30
205610,4,66,12,0,54,12
205610,3,21,4,0,17,4
205610,2,6,3,0,3,3
205610,1,5,1,0,4,1
156943,10,117,24,0,93,24
156943,9,282,36,0,246,36
156943,8,962,117,1,845,116
156943,7,595,64,2,531,62
156943,6,276,40,0,236,40
156943,5,61,10,0,51,10
156943,4,16,8,0,8,8
156943,3,17,2,0,15,2
156943,2,9,3,0,6,3
156943,1,7,2,0,5,2
91873,10,33,8,0,25,8
91873,9,147,20,0,127,20
91873,8,861,141,0,720,141
91873,7,736,121,0,615,121
91873,6,405,83,0,322,83
91873,5,103,16,0,87,16
91873,4,29,8,0,21,8
91873,3,17,2,0,15,2
91873,2,2,1,0,1,1
91873,1,7,1,0,6,1
156546,10,244,45,1,199,44
156546,9,409,62,0,347,62
156546,8,834,111,3,723,108
156546,7,475,67,0,408,67
156546,6,264,42,1,222,41
156546,5,62,11,0,51,11
156546,4,25,6,0,19,6
156546,3,9,1,0,8,1
156546,2,14,5,0,9,5
156546,1,5,2,0,3,2
14808,10,46,19,0,27,19
14808,9,101,32,0,69,32
14808,8,426,143,0,283,143
14808,7,597,153,0,444,153
14808,6,622,158,0,464,158
14808,5,270,86,0,184,86
14808,4,145,58,0,87,58
14808,3,78,31,0,47,31
14808,2,36,17,0,19,17
14808,1,16,3,0,13,3
21791,10,16,5,0,11,5
21791,9,45,22,0,23,22
21791,8,415,136,0,279,136
21791,7,774,197,0,577,197
21791,6,728,218,0,510,218
21791,5,221,81,0,140,81
21791,4,90,39,0,51,39
21791,3,32,19,0,13,19
21791,2,10,6,0,4,6
21791,1,6,3,0,3,3
144797,10,228,78,3,150,75
144797,9,437,95,1,342,94
144797,8,848,150,6,698,144
144797,7,411,70,4,341,66
144797,6,255,56,0,199,56
144797,5,72,22,0,50,22
144797,4,45,19,1,26,18
144797,3,27,10,0,17,10
144797,2,12,4,0,8,4
144797,1,4,2,0,2,2
35503,10,33,14,0,19,14
35503,9,111,46,0,65,46
35503,8,593,177,0,416,177
35503,7,719,144,0,575,144
35503,6,544,119,0,425,119
35503,5,180,48,0,132,48
35503,4,84,32,0,52,32
35503,3,48,25,0,23,25
35503,2,13,7,0,6,7
35503,1,7,3,0,4,3
15318,10,10,1,0,9,1
15318,9,46,19,0,27,19
15318,8,394,134,0,260,134
15318,7,813,217,0,596,217
15318,6,728,219,0,509,219
15318,5,229,80,0,149,80
15318,4,71,25,0,46,25
15318,3,23,13,0,10,13
15318,2,12,4,0,8,4
15318,1,4,2,0,2,2
17053,10,62,19,0,43,19
17053,9,81,31,0,50,31
17053,8,316,106,0,210,106
17053,7,586,137,0,449,137
17053,6,829,195,0,634,195
17053,5,281,78,0,203,78
17053,4,121,25,0,96,25
17053,3,38,6,0,32,6
17053,2,17,4,0,13,4
2679,10,18,7,0,11,7
2679,9,12,1,0,11,1
2679,8,37,14,0,23,14
2679,7,80,16,0,64,16
2679,6,302,97,0,205,97
2679,5,425,114,0,311,114
2679,4,603,155,0,448,155
2679,3,421,140,0,281,140
2679,2,308,104,0,204,104
2679,1,118,40,0,78,40
217085,10,59,13,0,46,13
217085,9,127,25,0,102,25
217085,8,662,93,0,569,93
217085,7,719,86,0,633,86
217085,6,503,82,0,421,82
217085,5,147,24,0,123,24
217085,4,62,19,0,43,19
217085,3,22,11,0,11,11
217085,2,13,6,0,7,6
217085,1,8,4,0,4,4
66,10,57,16,0,41,16
66,9,190,57,0,133,57
66,8,669,185,0,484,185
66,7,729,164,0,565,164
66,6,424,102,0,322,102
66,5,133,35,0,98,35
66,4,74,27,0,47,27
66,3,22,7,0,15,7
66,2,5,2,0,3,2
66,1,10,1,0,9,1
6830,10,174,71,0,103,71
6830,9,276,86,0,190,86
6830,8,691,225,0,466,225
6830,7,545,138,0,407,138
6830,6,373,103,0,270,103
6830,5,129,35,0,94,35
6830,4,47,14,0,33,14
6830,3,37,19,0,18,19
6830,2,20,7,0,13,7
6830,1,18,5,0,13,5
16366,10,40,9,0,31,9
16366,9,72,23,0,49,23
16366,8,436,121,0,315,121
16366,7,656,176,0,480,176
16366,6,669,208,0,461,208
16366,5,222,82,0,140,82
16366,4,119,47,0,72,47
16366,3,53,24,0,29,24
16366,2,28,15,0,13,15
16366,1,6,4,0,2,4
38862,10,33,11,0,22,11
38862,9,136,33,0,103,33
38862,8,687,149,0,538,149
38862,7,714,139,0,575,139
38862,6,516,104,0,412,104
38862,5,134,35,0,99,35
38862,4,51,18,0,33,18
38862,3,15,1,0,14,1
38862,2,7,2,0,5,2
10383,10,44,9,0,35,9
10383,9,71,23,0,48,23
10383,8,368,78,0,290,78
10383,7,508,104,0,404,104
10383,6,722,152,0,570,152
10383,5,310,73,0,237,73
10383,4,155,48,0,107,48
10383,3,75,27,0,48,27
10383,2,34,9,0,25,9
10383,1,7,3,0,4,3
91523,10,20,4,0,16,4
91523,9,94,12,0,82,12
91523,8,420,74,0,346,74
91523,7,645,110,0,535,110
91523,6,746,119,0,627,119
91523,5,220,33,0,187,33
91523,4,90,18,0,72,18
91523,3,36,5,0,31,5
91523,2,15,3,0,12,3
91523,1,8,1,0,7,1
156689,10,210,17,0,193,17
156689,9,353,45,0,308,45
156689,8,804,83,0,721,83
156689,7,521,64,0,457,64
156689,6,267,29,0,238,29
156689,5,75,2,0,73,2
156689,4,30,5,0,25,5
156689,3,17,4,0,13,4
156689,2,7,1,0,6,1
156689,1,7,1,0,6,1
205597,10,61,13,0,48,13
205597,9,170,46,0,124,46
205597,8,704,146,0,558,146
205597,7,654,114,0,540,114
205597,6,461,93,0,368,93
205597,5,134,30,0,104,30
205597,4,71,25,0,46,25
205597,3,23,8,0,15,8
205597,2,11,4,0,7,4
192860,10,33,3,0,30,3
192860,9,110,23,0,87,23
192860,8,605,77,1,528,76
192860,7,807,86,0,721,86
192860,6,525,67,0,458,67
192860,5,149,32,0,117,32
192860,4,36,7,0,29,7
192860,3,18,7,0,11,7
192860,2,4,2,0,2,2
113289,10,64,22,0,42,22
113289,9,123,24,0,99,24
113289,8,533,99,0,434,99
113289,7,620,111,0,509,111
113289,6,589,119,0,470,119
113289,5,195,25,0,170,25
113289,4,91,23,0,68,23
113289,3,43,7,0,36,7
113289,2,19,4,0,15,4
113289,1,5,3,0,2,3
141736,10,12,5,0,7,5
141736,9,61,18,0,43,18
141736,8,593,114,0,479,114
141736,7,773,138,0,635,138
141736,6,584,96,0,488,96
141736,5,158,42,0,116,42
141736,4,58,12,0,46,12
141736,3,26,8,0,18,8
141736,2,13,2,0,11,2
141736,1,5,1,0,4,1
68182,10,39,16,0,23,16
68182,9,88,18,0,70,18
68182,8,534,111,0,423,111
68182,7,704,122,0,582,122
68182,6,619,113,0,506,113
68182,5,160,40,0,120,40
68182,4,81,28,0,53,28
68182,3,37,10,0,27,10
68182,2,14,7,0,7,7
99,10,80,30,0,50,30
99,9,128,51,0,77,51
99,8,481,148,0,333,148
99,7,613,169,0,444,169
99,6,593,145,0,448,145
99,5,213,54,0,159,54
99,4,95,33,0,62,33
99,3,44,15,0,29,15
99,2,24,7,0,17,7
99,1,8,1,0,7,1
118174,10,43,7,1,36,6
118174,9,117,19,3,98,16
118174,8,553,94,6,459,88
118174,7,675,118,13,557,105
118174,6,594,96,2,498,94
118174,5,172,38,0,134,38
118174,4,76,18,2,58,16
118174,3,25,5,0,20,5
118174,2,18,7,1,11,6
24773,10,32,17,0,15,17
24773,9,101,35,0,66,35
24773,8,648,222,0,426,222
24773,7,744,217,0,527,217
24773,6,486,150,0,336,150
24773,5,163,63,0,100,63
24773,4,68,30,0,38,30
24773,3,21,9,0,12,9
24773,1,5,1,0,4,1
70,10,32,13,0,19,13
70,9,107,42,0,65,42
70,8,570,209,1,361,208
70,7,802,212,2,590,210
70,6,537,173,0,364,173
70,5,144,36,0,108,36
70,4,53,22,0,31,22
70,3,14,2,0,12,2
70,2,8,4,0,4,4
214,10,19,4,0,15,4
214,9,57,14,0,43,14
214,8,255,56,0,199,56
214,7,644,122,0,522,122
214,6,807,167,0,640,167
214,5,287,57,0,230,57
214,4,123,35,0,88,35
214,3,48,13,0,35,13
214,2,19,12,0,7,12
214,1,7,3,0,4,3
1260,10,69,24,0,45,24
1260,9,97,22,0,75,22
1260,8,324,89,0,235,89
1260,7,528,135,0,393,135
1260,6,693,160,0,533,160
1260,5,340,77,0,263,77
1260,4,133,33,0,100,33
1260,3,55,22,0,33,22
1260,2,14,7,0,7,7
1260,1,9,2,0,7,2
19370,10,28,8,0,20,8
19370,9,56,14,0,42,14
19370,8,202,45,0,157,45
19370,7,311,60,0,251,60
19370,6,611,109,0,502,109
19370,5,352,67,0,285,67
19370,4,284,67,0,217,67
19370,3,163,43,0,120,43
19370,2,132,41,0,91,41
19370,1,123,43,0,80,43
3439,10,111,26,0,85,26
3439,9,126,31,0,95,31
3439,8,367,96,0,271,96
3439,7,493,108,0,385,108
3439,6,628,185,0,443,185
3439,5,286,99,0,187,99
3439,4,150,54,0,96,54
3439,3,68,26,0,42,26
3439,2,23,9,0,14,9
3439,1,9,6,0,3,6
917,10,10,1,0,9,1
917,9,47,14,0,33,14
917,8,135,24,0,111,24
917,7,355,71,0,284,71
917,6,783,168,0,615,168
917,5,527,141,0,386,141
917,4,236,70,0,166,70
917,3,104,37,0,67,37
917,2,33,11,0,22,11
917,1,12,4,0,8,4
9028,10,23,6,0,17,6
9028,9,45,13,0,32,13
9028,8,311,106,0,205,106
9028,7,537,173,0,364,173
9028,6,808,241,0,567,241
9028,5,274,106,0,168,106
9028,4,141,63,0,78,63
9028,3,62,32,1,30,31
9028,2,29,12,0,17,12
9028,1,6,3,0,3,3
1275,10,35,15,0,20,15
1275,9,56,12,0,44,12
1275,8,207,66,0,141,66
1275,7,407,101,0,306,101
1275,6,824,215,0,609,215
1275,5,402,121,0,281,121
1275,4,180,61,0,119,61
1275,3,76,27,0,49,27
1275,2,44,16,0,28,16
216734,10,305,118,9,187,109
216734,9,411,88,5,323,83
216734,8,811,119,10,692,109
216734,7,358,45,2,313,43
216734,6,202,34,1,168,33
216734,5,89,22,1,67,21
216734,4,26,7,0,19,7
216734,3,28,7,0,21,7
216734,2,7,5,0,2,5
216734,1,4,3,0,1,3
3228,10,28,7,0,21,7
3228,9,117,42,0,75,42
3228,8,588,172,0,416,172
3228,7,733,195,0,538,195
3228,6,548,132,0,416,132
3228,5,140,54,0,86,54
3228,4,51,14,0,37,14
3228,3,18,8,0,10,8
3228,2,6,5,0,1,5
60435,10,99,37,0,62,37
60435,9,195,50,0,145,50
60435,8,760,165,1,595,164
60435,7,627,131,0,496,131
60435,6,348,58,0,290,58
60435,5,113,27,0,86,27
60435,4,47,13,0,34,13
60435,3,29,8,0,21,8
60435,2,6,1,0,5,1
170771,10,378,86,3,292,83
170771,9,588,86,10,502,76
170771,8,696,103,8,593,95
170771,7,313,46,1,267,45
170771,6,153,28,0,125,28
170771,5,60,19,2,41,17
170771,4,21,9,1,12,8
170771,3,10,4,0,6,4
170771,2,5,1,0,4,1
170771,1,9,3,0,6,3
182189,10,30,6,0,24,6
182189,9,82,16,0,66,16
182189,8,546,98,2,448,96
182189,7,703,99,3,604,96
182189,6,609,92,4,517,88
182189,5,166,35,0,131,35
182189,4,63,15,0,48,15
182189,3,21,6,1,15,5
182189,2,9,3,0,6,3
182189,1,3,2,0,1,2
1301,10,223,83,0,140,83
1301,9,323,113,0,210,113
1301,8,642,178,0,464,178
1301,7,497,131,0,366,131
1301,6,318,64,0,254,64
1301,5,120,23,0,97,23
1301,4,58,13,0,45,13
1301,3,25,8,0,17,8
1301,2,12,1,0,11,1
1301,1,9,4,0,5,4
187377,10,113,22,2,91,20
187377,9,234,36,9,198,27
187377,8,779,108,7,671,101
187377,7,614,58,6,556,52
187377,6,328,38,3,290,35
187377,5,90,12,1,78,11
187377,4,44,5,0,39,5
187377,3,17,3,0,14,3
187377,1,5,1,0,4,1
6068,10,9,5,0,4,5
6068,9,47,20,0,27,20
6068,8,368,128,0,240,128
6068,7,683,185,0,498,185
6068,6,721,197,0,524,197
6068,5,236,75,0,161,75
6068,4,112,36,0,76,36
6068,3,38,15,0,23,15
6068,2,10,6,0,4,6
17835,10,12,4,0,8,4
17835,9,29,10,0,19,10
17835,8,189,67,0,122,67
17835,7,513,174,0,339,174
17835,6,835,290,0,545,290
17835,5,347,125,0,222,125
17835,4,177,68,0,109,68
17835,3,72,27,0,45,27
17835,2,44,29,0,15,29
17835,1,6,2,0,4,2
17396,10,88,28,0,60,28
17396,9,247,90,0,157,90
17396,8,790,232,0,558,232
17396,7,584,167,0,417,167
17396,6,319,92,0,227,92
17396,5,107,31,0,76,31
17396,4,55,24,0,31,24
17396,3,18,10,0,8,10
17396,2,6,3,0,3,3
17396,1,10,2,0,8,2
15510,10,13,6,0,7,6
15510,9,63,29,0,34,29
15510,8,462,203,0,259,203
15510,7,728,213,0,515,213
15510,6,651,200,0,451,200
15510,5,184,58,0,126,58
15510,4,78,32,0,46,32
15510,3,27,11,0,16,11
15510,2,10,3,0,7,3
195043,10,29,2,0,27,2
195043,9,66,8,0,58,8
195043,8,562,71,0,491,71
195043,7,824,107,0,717,107
195043,6,536,65,0,471,65
195043,5,130,24,0,106,24
195043,4,46,10,0,36,10
195043,3,25,4,0,21,4
195043,2,4,1,0,3,1
141423,10,69,14,1,55,13
141423,9,178,34,2,144,32
141423,8,712,140,7,572,133
141423,7,677,93,1,584,92
141423,6,418,68,1,350,67
141423,5,96,18,0,78,18
141423,4,42,13,0,29,13
141423,3,16,3,0,13,3
141423,2,11,4,0,7,4
73538,10,47,7,0,40,7
73538,9,84,11,0,73,11
73538,8,298,36,0,262,36
73538,7,485,65,0,420,65
73538,6,720,105,0,615,105
73538,5,301,44,0,257,44
73538,4,150,24,0,126,24
73538,3,77,20,0,57,20
73538,2,35,6,0,29,6
73538,1,23,6,0,17,6
171011,10,33,8,0,25,8
171011,9,105,18,0,87,18
171011,8,560,93,0,467,93
171011,7,703,112,1,591,111
171011,6,564,109,0,455,109
171011,5,162,32,0,130,32
171011,4,58,22,0,36,22
171011,3,20,8,0,12,8
171011,2,8,4,0,4,4
171011,1,5,1,0,4,1
62222,10,296,76,0,220,76
62222,9,448,104,0,344,104
62222,8,875,199,0,676,199
62222,7,346,72,0,274,72
62222,6,147,34,0,113,34
62222,5,49,17,0,32,17
62222,4,26,7,0,19,7
62222,3,12,4,0,8,4
62222,2,7,5,0,2,5
62222,1,17,1,0,16,1
1634,10,261,70,1,191,69
1634,9,290,77,0,213,77
1634,8,590,131,0,459,131
1634,7,493,89,0,404,89
1634,6,355,78,0,277,78
1634,5,123,30,0,93,30
1634,4,49,11,0,38,11
1634,3,23,5,0,18,5
1634,2,16,6,0,10,6
1634,1,16,4,0,12,4
437,10,16,5,0,11,5
437,9,43,15,0,28,15
437,8,248,64,0,184,64
437,7,595,130,0,465,130
437,6,858,170,0,688,170
437,5,305,68,0,237,68
437,4,101,26,0,75,26
437,3,37,9,0,28,9
437,2,7,5,0,2,5
2162,10,99,20,0,79,20
2162,9,145,27,0,118,27
2162,8,391,84,0,307,84
2162,7,513,119,0,394,119
2162,6,540,139,0,401,139
2162,5,228,70,0,158,70
2162,4,127,45,0,82,45
2162,3,77,33,0,44,33
2162,2,44,25,0,19,25
2162,1,40,13,0,27,13
180680,10,59,15,0,44,15
180680,9,194,43,0,151,43
180680,8,925,184,0,741,184
180680,7,630,98,0,532,98
180680,6,287,57,0,230,57
180680,5,74,26,0,48,26
180680,4,25,3,0,22,3
180680,3,10,5,0,5,5
180680,2,2,1,0,1,1
82420,10,192,18,0,174,18
82420,9,331,36,0,295,36
82420,8,792,85,0,707,85
82420,7,479,50,0,429,50
82420,6,276,33,0,243,33
82420,5,73,9,0,64,9
82420,4,33,1,0,32,1
82420,2,6,1,0,5,1
82420,1,15,1,0,14,1
4394,10,17,3,0,14,3
4394,9,74,26,0,48,26
4394,8,465,140,0,325,140
4394,7,694,169,0,525,169
4394,6,600,170,0,430,170
4394,5,180,50,0,130,50
4394,4,95,35,0,60,35
4394,3,49,14,0,35,14
4394,2,19,9,0,10,9
949,10,82,23,0,59,23
949,9,115,41,0,74,41
949,8,370,122,0,248,122
949,7,565,134,0,431,134
949,6,640,167,0,473,167
949,5,267,65,0,202,65
949,4,104,31,0,73,31
949,3,31,9,0,22,9
949,2,18,6,0,12,6
949,1,6,3,0,3,3
208895,10,30,5,0,25,5
208895,9,83,17,0,66,17
208895,8,515,103,0,412,103
208895,7,780,105,0,675,105
208895,6,557,76,0,481,76
208895,5,151,23,0,128,23
208895,4,46,6,0,40,6
208895,3,23,4,0,19,4
208895,2,6,2,0,4,2
208895,1,4,2,0,2,2
8190,10,22,9,0,13,9
8190,9,96,42,0,54,42
8190,8,511,145,0,366,145
8190,7,716,200,0,516,200
8190,6,574,179,0,395,179
8190,5,176,57,0,119,57
8190,4,69,31,0,38,31
8190,3,19,4,0,15,4
8190,2,8,6,0,2,6
155708,10,24,3,0,21,3
155708,9,48,6,3,42,3
155708,8,350,69,8,281,61
155708,7,612,81,4,531,77
155708,6,709,104,17,605,87
155708,5,233,40,3,193,37
155708,4,124,41,4,83,37
155708,3,51,13,1,38,12
155708,2,27,8,0,19,8
155708,1,13,3,1,10,2
35052,10,270,50,0,220,50
35052,9,304,81,0,223,81
35052,8,616,121,0,495,121
35052,7,444,57,0,387,57
35052,6,295,43,0,252,43
35052,5,115,16,0,99,16
35052,4,73,18,0,55,18
35052,3,36,10,0,26,10
35052,2,23,1,0,22,1
35052,1,15,3,0,12,3
34297,10,28,7,0,21,7
34297,9,109,33,0,76,33
34297,8,606,145,0,461,145
34297,7,702,147,0,555,147
34297,6,520,134,0,386,134
34297,5,150,37,0,113,37
34297,4,41,16,0,25,16
34297,3,25,11,0,14,11
34297,2,6,2,0,4,2
34297,1,3,1,0,2,1
38996,10,152,68,0,84,68
38996,9,347,95,0,252,95
38996,8,882,226,0,656,226
38996,7,458,112,0,346,112
38996,6,221,69,0,152,69
38996,5,67,28,0,39,28
38996,4,28,12,0,16,12
38996,3,14,5,0,9,5
38996,2,5,5,0,0,5
38996,1,12,2,0,10,2
204836,10,75,8,0,67,8
204836,9,172,20,0,152,20
204836,8,789,101,0,688,101
204836,7,610,83,0,527,83
204836,6,356,47,0,309,47
204836,5,92,17,0,75,17
204836,4,51,5,0,46,5
204836,3,14,2,0,12,2
204836,2,16,4,0,12,4
204836,1,10,5,0,5,5
32341,10,19,3,0,16,3
32341,9,36,5,0,31,5
32341,8,269,42,0,227,42
32341,7,509,63,0,446,63
32341,6,821,117,0,704,117
32341,5,293,44,0,249,44
32341,4,136,24,0,112,24
32341,3,60,15,0,45,15
32341,2,34,9,0,25,9
232,10,57,13,0,44,13
232,9,145,40,0,105,40
232,8,500,124,0,376,124
232,7,702,171,0,531,171
232,6,485,119,0,366,119
232,5,172,61,0,111,61
232,4,74,32,0,42,32
232,3,21,9,0,12,9
232,2,12,8,0,4,8
232,1,6,2,0,4,2
17449,10,24,15,0,9,15
17449,9,64,35,0,29,35
17449,8,398,189,0,209,189
17449,7,569,211,0,358,211
17449,6,634,210,0,424,210
17449,5,252,94,0,158,94
17449,4,135,53,0,82,53
17449,3,66,25,0,41,25
17449,2,20,6,0,14,6
17449,1,11,2,0,9,2
9823,10,277,90,0,187,90
9823,9,465,132,0,333,132
9823,8,702,208,0,494,208
9823,7,386,119,0,267,119
9823,6,187,62,0,125,62
9823,5,61,14,0,47,14
9823,4,30,18,0,12,18
9823,3,19,5,0,14,5
9823,2,14,2,0,12,2
9823,1,31,3,0,28,3
90040,10,13,3,0,10,3
90040,9,65,16,0,49,16
90040,8,636,127,0,509,127
90040,7,753,146,0,607,146
90040,6,528,95,0,433,95
90040,5,119,29,0,90,29
90040,4,38,13,0,25,13
90040,3,12,6,0,6,6
90040,2,2,1,0,1,1
2582,10,60,21,0,39,21
2582,9,86,30,0,56,30
2582,8,334,105,0,229,105
2582,7,487,146,0,341,146
2582,6,659,176,0,483,176
2582,5,306,82,0,224,82
2582,4,149,35,0,114,35
2582,3,54,18,0,36,18
2582,2,25,14,0,11,14
2582,1,9,3,0,6,3
6607,10,36,5,0,31,5
6607,9,65,8,0,57,8
6607,8,228,33,0,195,33
6607,7,399,59,0,340,59
6607,6,669,87,0,582,87
6607,5,365,53,0,312,53
6607,4,215,47,0,168,47
6607,3,111,26,0,85,26
6607,2,54,19,0,35,19
6607,1,21,2,0,19,2
156091,10,86,22,0,64,22
156091,9,218,52,0,166,52
156091,8,821,144,0,677,144
156091,7,581,82,0,499,82
156091,6,324,56,0,268,56
156091,5,81,15,0,66,15
156091,4,29,6,0,23,6
75449,10,48,12,0,36,12
75449,9,172,34,0,138,34
75449,8,830,163,2,667,161
75449,7,646,98,1,548,97
75449,6,344,64,0,280,64
75449,5,74,19,2,55,17
75449,4,29,10,0,19,10
75449,3,9,7,0,2,7
75449,2,6,3,0,3,3
1797,10,21,3,0,18,3
1797,9,22,6,0,16,6
1797,8,58,16,0,42,16
1797,7,148,25,0,123,25
1797,6,437,110,0,327,110
1797,5,553,104,0,449,104
1797,4,475,107,0,368,107
1797,3,263,79,0,184,79
1797,2,136,45,0,91,45
1797,1,46,14,0,32,14
632,10,11,5,0,6,5
632,9,49,10,0,39,10
632,8,365,118,0,247,118
632,7,609,213,0,396,213
632,6,768,245,0,523,245
632,5,227,73,0,154,73
632,4,80,32,0,48,32
632,3,33,10,0,23,10
632,2,11,7,0,4,7
234277,10,80,10,0,70,10
234277,9,273,49,0,224,49
234277,8,936,132,0,804,132
234277,7,533,75,0,458,75
234277,6,229,37,0,192,37
234277,5,69,12,0,57,12
234277,4,23,5,0,18,5
234277,2,4,2,0,2,2
129090,10,20,5,1,15,4
129090,9,26,6,0,20,6
129090,8,250,52,1,198,51
129090,7,508,89,1,419,88
129090,6,791,130,0,661,130
129090,5,304,52,0,252,52
129090,4,156,29,0,127,29
129090,3,59,18,0,41,18
129090,2,28,9,0,19,9
129090,1,10,3,0,7,3
27976,10,214,45,0,169,45
27976,9,295,61,0,234,61
27976,8,700,144,0,556,144
27976,7,556,107,0,449,107
27976,6,272,48,0,224,48
27976,5,64,10,0,54,10
27976,4,23,4,0,19,4
27976,3,12,3,0,9,3
1270,10,175,48,0,127,48
1270,9,180,57,0,123,57
1270,8,354,98,0,256,98
1270,7,422,111,0,311,111
1270,6,490,114,0,376,114
1270,5,256,63,0,193,63
1270,4,140,34,0,106,34
1270,3,72,16,0,56,16
1270,2,37,16,0,21,16
1270,1,20,7,0,13,7
55697,10,36,6,0,30,6
55697,9,138,36,0,102,36
55697,8,696,141,0,555,141
55697,7,633,111,0,522,111
55697,6,416,97,0,319,97
55697,5,122,29,0,93,29
55697,4,68,20,0,48,20
55697,3,21,6,0,15,6
55697,2,8,1,0,7,1
55697,1,8,1,0,7,1
32441,10,26,7,0,19,7
32441,9,89,15,0,74,15
32441,8,371,61,0,310,61
32441,7,548,83,0,465,83
32441,6,613,110,0,503,110
32441,5,280,55,0,225,55
32441,4,143,33,0,110,33
32441,3,52,12,0,40,12
32441,2,19,8,0,11,8
32441,1,5,2,0,3,2
195314,10,50,19,1,31,18
195314,9,131,34,0,97,34
195314,8,682,137,8,545,129
195314,7,713,135,6,578,129
195314,6,457,89,7,368,82
195314,5,73,14,0,59,14
195314,4,31,13,0,18,13
195314,3,6,1,0,5,1
195314,1,4,1,0,3,1
67877,10,41,12,0,29,12
67877,9,92,20,0,72,20
67877,8,432,69,0,363,69
67877,7,607,106,0,501,106
67877,6,631,100,0,531,100
67877,5,180,35,0,145,35
67877,4,95,25,0,70,25
67877,3,42,13,0,29,13
67877,2,21,5,0,16,5
167355,10,562,132,11,430,121
167355,9,698,138,11,560,127
167355,8,509,82,5,427,77
167355,7,192,32,1,160,31
167355,6,92,19,2,73,17
167355,5,36,11,1,25,10
167355,4,22,9,0,13,9
167355,3,10,4,0,6,4
167355,2,7,2,0,5,2
167355,1,19,7,0,12,7
2122,10,252,81,0,171,81
2122,9,234,71,0,163,71
2122,8,454,123,0,331,123
2122,7,447,105,0,342,105
2122,6,399,89,0,310,89
2122,5,166,44,0,122,44
2122,4,97,21,0,76,21
2122,3,51,22,0,29,22
2122,2,18,5,0,13,5
2122,1,13,4,0,9,4
108044,10,23,5,0,18,5
108044,9,81,14,0,67,14
108044,8,374,81,0,293,81
108044,7,541,90,0,451,90
108044,6,616,110,0,506,110
108044,5,263,59,0,204,59
108044,4,138,37,0,101,37
108044,3,54,17,0,37,17
108044,2,29,9,0,20,9
108044,1,6,1,0,5,1
236191,10,73,12,0,61,12
236191,9,297,56,0,241,56
236191,8,1010,128,0,882,128
236191,7,492,55,0,437,55
236191,6,191,37,0,154,37
236191,5,38,7,0,31,7
236191,4,13,3,0,10,3
236191,3,4,1,0,3,1
236191,2,3,1,0,2,1
236191,1,4,1,0,3,1
180040,10,35,8,1,27,7
180040,9,117,24,3,93,21
180040,8,672,118,14,554,104
180040,7,716,118,17,598,101
180040,6,439,74,6,365,68
180040,5,103,15,0,88,15
180040,4,31,9,1,22,8
180040,2,2,1,0,1,1
111417,10,27,6,0,21,6
111417,9,88,18,2,70,16
111417,8,581,128,12,453,116
111417,7,742,145,6,597,139
111417,6,487,100,1,387,99
111417,5,131,32,3,99,29
111417,4,47,15,1,32,14
111417,3,11,2,0,9,2
111417,2,4,2,0,2,2
111417,1,1,1,0,0,1
28089,10,31,6,0,25,6
28089,9,73,26,0,47,26
28089,8,468,131,0,337,131
28089,7,774,198,0,576,198
28089,6,581,146,0,435,146
28089,5,136,39,0,97,39
28089,4,32,9,0,23,9
28089,3,13,4,0,9,4
28089,2,3,1,0,2,1
9027,10,23,10,0,13,10
9027,9,57,22,0,35,22
9027,8,450,152,0,298,152
9027,7,739,222,0,517,222
9027,6,601,180,0,421,180
9027,5,147,53,0,94,53
9027,4,61,22,0,39,22
9027,3,23,11,0,12,11
9027,2,7,4,0,3,4
75358,10,22,7,0,15,7
75358,9,79,35,0,44,35
75358,8,508,142,0,366,142
75358,7,650,162,0,488,162
75358,6,575,143,1,432,142
75358,5,186,49,0,137,49
75358,4,65,16,0,49,16
75358,3,14,5,0,9,5
75358,2,9,3,0,6,3
25951,10,39,6,0,33,6
25951,9,79,21,0,58,21
25951,8,403,107,0,296,107
25951,7,539,90,0,449,90
25951,6,631,131,0,500,131
25951,5,218,58,0,160,58
25951,4,105,28,0,77,28
25951,3,56,23,0,33,23
25951,2,29,12,0,17,12
25951,1,10,3,0,7,3
151007,10,146,21,0,125,21
151007,9,301,37,0,264,37
151007,8,655,83,0,572,83
151007,7,464,53,0,411,53
151007,6,333,43,0,290,43
151007,5,114,20,0,94,20
151007,4,48,9,0,39,9
151007,3,19,6,0,13,6
151007,2,17,5,0,12,5
151007,1,12,2,0,10,2
191876,10,31,7,0,24,7
191876,9,109,16,0,93,16
191876,8,742,99,0,643,99
191876,7,665,81,0,584,81
191876,6,410,84,0,326,84
191876,5,96,29,0,67,29
191876,4,36,9,0,27,9
191876,3,15,4,0,11,4
191876,1,3,2,0,1,2
8129,10,37,12,0,25,12
8129,9,93,34,0,59,34
8129,8,546,202,0,344,202
8129,7,714,168,0,546,168
8129,6,480,122,2,358,120
8129,5,144,42,0,102,42
8129,4,64,19,0,45,19
8129,3,19,7,0,12,7
8129,2,6,2,0,4,2
938,10,19,5,0,14,5
938,9,14,6,0,8,6
938,8,167,60,0,107,60
938,7,352,114,0,238,114
938,6,722,218,0,504,218
938,5,461,129,0,332,129
938,4,232,70,0,162,70
938,3,87,26,0,61,26
938,2,39,13,0,26,13
938,1,6,1,0,5,1
120523,10,107,27,0,80,27
120523,9,206,37,1,169,36
120523,8,676,115,3,561,112
120523,7,490,71,5,419,66
120523,6,378,81,5,297,76
120523,5,102,24,0,78,24
120523,4,68,19,0,49,19
120523,3,35,11,1,24,10
120523,2,23,9,0,14,9
120523,1,14,8,0,6,8
4218,10,13,7,0,6,7
4218,9,57,23,0,34,23
4218,8,366,146,0,220,146
4218,7,746,275,0,471,275
4218,6,636,207,0,429,207
4218,5,189,59,0,130,59
4218,4,52,15,0,37,15
4218,3,18,7,0,11,7
4218,2,9,6,0,3,6
4218,1,4,1,0,3,1
34707,10,28,9,0,19,9
34707,9,65,31,0,34,31
34707,8,515,146,0,369,146
34707,7,698,147,0,551,147
34707,6,541,152,0,389,152
34707,5,155,47,0,108,47
34707,4,60,23,0,37,23
34707,3,13,7,0,6,7
34707,2,10,5,0,5,5
34707,1,3,1,0,2,1
157096,10,38,7,0,31,7
157096,9,126,16,0,110,16
157096,8,624,102,2,522,100
157096,7,626,101,2,525,99
157096,6,421,72,2,349,70
157096,5,151,44,0,107,44
157096,4,57,14,0,43,14
157096,3,21,9,0,12,9
157096,2,11,6,0,5,6
157096,1,1,1,0,0,1
40990,10,34,8,0,26,8
40990,9,50,12,0,38,12
40990,8,398,95,0,303,95
40990,7,623,144,0,479,144
40990,6,692,135,0,557,135
40990,5,174,38,0,136,38
40990,4,61,16,0,45,16
40990,3,25,7,0,18,7
40990,2,9,2,0,7,2
40990,1,6,2,0,4,2
1475,10,17,4,0,13,4
1475,9,49,25,0,24,25
1475,8,172,60,0,112,60
1475,7,358,118,0,240,118
1475,6,695,210,0,485,210
1475,5,413,118,0,295,118
1475,4,242,76,0,166,76
1475,3,73,26,0,47,26
1475,2,40,14,0,26,14
1475,1,10,4,0,6,4
4471,10,13,5,0,8,5
4471,9,46,18,0,28,18
4471,8,280,112,0,168,112
4471,7,512,167,0,345,167
4471,6,682,184,0,498,184
4471,5,279,92,0,187,92
4471,4,153,70,0,83,70
4471,3,70,30,0,40,30
4471,2,23,14,0,9,14
4471,1,9,4,0,5,4
174570,10,103,12,0,91,12
174570,9,281,35,0,246,35
174570,8,822,107,0,715,107
174570,7,504,54,0,450,54
174570,6,239,32,0,207,32
174570,5,67,10,0,57,10
174570,4,28,8,0,20,8
174570,3,16,4,0,12,4
174570,2,3,1,0,2,1
174570,1,4,1,0,3,1
16216,10,24,7,0,17,7
16216,9,75,25,0,50,25
16216,8,345,107,0,238,107
16216,7,621,146,0,475,146
16216,6,638,169,0,469,169
16216,5,197,54,0,143,54
16216,4,108,32,0,76,32
16216,3,32,9,0,23,9
16216,2,15,4,0,11,4
37400,10,15,5,0,10,5
37400,9,26,5,0,21,5
37400,8,305,77,0,228,77
37400,7,632,138,0,494,138
37400,6,792,153,0,639,153
37400,5,190,46,0,144,46
37400,4,71,19,0,52,19
37400,3,22,4,0,18,4
37400,2,10,3,0,7,3
195856,10,55,10,0,45,10
195856,9,138,22,0,116,22
195856,8,565,89,0,476,89
195856,7,643,84,0,559,84
195856,6,429,49,0,380,49
195856,5,140,26,0,114,26
195856,4,64,16,0,48,16
195856,3,20,5,0,15,5
195856,2,8,2,0,6,2
195856,1,6,4,0,2,4
26,10,157,51,0,106,51
26,9,232,76,0,156,76
26,8,549,138,0,411,138
26,7,484,123,0,361,123
26,6,343,100,0,243,100
26,5,135,48,0,87,48
26,4,77,42,0,35,42
26,3,44,24,0,20,24
26,2,32,20,0,12,20
26,1,11,3,0,8,3
3085,10,60,22,0,38,22
3085,9,106,30,0,76,30
3085,8,367,106,0,261,106
3085,7,598,140,0,458,140
3085,6,564,149,0,415,149
3085,5,198,59,0,139,59
3085,4,98,30,0,68,30
3085,3,42,14,0,28,14
3085,2,17,10,0,7,10
3085,1,9,1,0,8,1
164265,10,79,15,0,64,15
164265,9,231,43,0,188,43
164265,8,749,107,0,642,107
164265,7,498,84,0,414,84
164265,6,336,54,0,282,54
164265,5,100,23,0,77,23
164265,4,42,9,0,33,9
164265,3,17,4,0,13,4
148943,10,73,9,0,64,9
148943,9,182,36,2,146,34
148943,8,605,105,5,500,100
148943,7,582,91,2,491,89
148943,6,387,80,3,307,77
148943,5,115,30,1,85,29
148943,4,73,22,0,51,22
148943,3,19,5,0,14,5
148943,2,14,3,0,11,3
148943,1,7,2,0,5,2
192455,10,132,43,0,89,43
192455,9,182,35,0,147,35
192455,8,529,85,0,444,85
192455,7,426,61,0,365,61
192455,6,369,62,0,307,62
192455,5,157,37,0,120,37
192455,4,92,33,0,59,33
192455,3,77,33,0,44,33
192455,2,58,26,0,32,26
192455,1,35,15,0,20,15
37371,10,11,3,0,8,3
37371,9,62,18,0,44,18
37371,8,372,104,0,268,104
37371,7,657,171,0,486,171
37371,6,679,160,0,519,160
37371,5,172,51,0,121,51
37371,4,76,21,0,55,21
37371,3,16,7,0,9,7
37371,2,7,2,0,5,2
143405,10,63,21,0,42,21
143405,9,140,37,0,103,37
143405,8,698,143,0,555,143
143405,7,614,85,0,529,85
143405,6,411,74,0,337,74
143405,5,77,17,0,60,17
143405,4,31,7,0,24,7
143405,3,13,4,0,9,4
29937,10,43,11,0,32,11
29937,9,131,52,0,79,52
29937,8,564,187,0,377,187
29937,7,610,174,0,436,174
29937,6,478,135,0,343,135
29937,5,113,32,0,81,32
29937,4,64,34,0,30,34
29937,3,32,11,0,21,11
29937,2,11,6,0,5,6
29937,1,5,1,0,4,1
34615,10,30,10,0,20,10
34615,9,58,10,0,48,10
34615,8,351,75,0,276,75
34615,7,634,115,0,519,115
34615,6,607,131,0,476,131
34615,5,200,51,0,149,51
34615,4,104,31,0,73,31
34615,3,33,15,0,18,15
34615,2,26,13,0,13,13
34615,1,7,1,0,6,1
91534,10,19,2,0,17,2
91534,9,40,5,0,35,5
91534,8,236,35,0,201,35
91534,7,514,71,0,443,71
91534,6,764,132,0,632,132
91534,5,299,52,0,247,52
91534,4,103,21,0,82,21
91534,3,42,10,0,32,10
91534,2,18,6,0,12,6
91534,1,15,3,0,12,3
2944,10,16,3,0,13,3
2944,9,35,2,0,33,2
2944,8,162,31,0,131,31
2944,7,373,69,0,304,69
2944,6,744,139,0,605,139
2944,5,382,58,0,324,58
2944,4,179,25,0,154,25
2944,3,95,14,0,81,14
2944,2,47,10,0,37,10
2944,1,16,1,0,15,1
177678,10,72,13,0,59,13
177678,9,207,27,0,180,27
177678,8,900,118,0,782,118
177678,7,493,70,0,423,70
177678,6,259,46,0,213,46
177678,5,74,20,0,54,20
177678,4,28,7,0,21,7
177678,3,12,4,0,8,4
177678,2,2,1,0,1,1
177678,1,4,2,0,2,2
198525,10,34,4,0,30,4
198525,9,72,15,0,57,15
198525,8,470,77,0,393,77
198525,7,676,85,0,591,85
198525,6,576,76,0,500,76
198525,5,137,29,0,108,29
198525,4,57,20,0,37,20
198525,3,19,6,0,13,6
198525,2,4,3,0,1,3
8045,10,111,44,0,67,44
8045,9,285,105,0,180,105
8045,8,716,224,0,492,224
8045,7,471,121,2,350,119
8045,6,283,82,0,201,82
8045,5,92,26,0,66,26
8045,4,45,20,0,25,20
8045,3,23,6,0,17,6
8045,2,11,6,0,5,6
8045,1,7,1,0,6,1
176,10,22,6,0,16,6
176,9,37,6,0,31,6
176,8,204,64,1,140,63
176,7,375,94,0,281,94
176,6,681,160,1,521,159
176,5,388,109,0,279,109
176,4,185,75,0,110,75
176,3,89,27,0,62,27
176,2,52,22,0,30,22
176,1,13,9,0,4,9
172381,10,28,2,0,26,2
172381,9,126,10,0,116,10
172381,8,662,75,0,587,75
172381,7,619,67,0,552,67
172381,6,403,61,0,342,61
172381,5,133,19,0,114,19
172381,4,37,11,0,26,11
172381,3,21,2,0,19,2
172381,1,8,2,0,6,2
586,10,380,173,4,207,169
586,9,371,128,1,243,127
586,8,588,179,5,409,174
586,7,339,100,2,239,98
586,6,190,48,1,142,47
586,5,73,22,0,51,22
586,4,43,17,0,26,17
586,3,21,10,1,11,9
586,2,10,4,0,6,4
586,1,25,2,0,23,2
442,10,42,11,0,31,11
442,9,106,27,0,79,27
442,8,483,138,0,345,138
442,7,639,143,0,496,143
442,6,514,102,0,412,102
442,5,160,39,0,121,39
442,4,61,16,0,45,16
442,3,25,4,0,21,4
442,2,6,3,0,3,3
442,1,5,1,0,4,1
67239,10,32,4,0,28,4
67239,9,106,23,0,83,23
67239,8,534,120,0,414,120
67239,7,626,113,0,513,113
67239,6,471,97,0,374,97
67239,5,160,43,0,117,43
67239,4,66,18,0,48,18
67239,3,26,8,0,18,8
67239,2,8,1,0,7,1
67239,1,9,2,0,7,2
7688,10,17,7,0,10,7
7688,9,15,5,0,10,5
7688,8,81,29,0,52,29
7688,7,148,46,0,102,46
7688,6,390,122,0,268,122
7688,5,486,140,0,346,140
7688,4,480,151,0,329,151
7688,3,210,54,0,156,54
7688,2,148,41,0,107,41
7688,1,10,3,0,7,3
150145,10,104,19,0,85,19
150145,9,191,40,0,151,40
150145,8,616,82,0,534,82
150145,7,623,65,0,558,65
150145,6,347,42,0,305,42
150145,5,94,11,0,83,11
150145,4,39,11,0,28,11
150145,3,13,2,0,11,2
150145,2,10,6,0,4,6
233312,10,176,35,0,141,35
233312,9,352,47,0,305,47
233312,8,846,105,0,741,105
233312,7,397,52,0,345,52
233312,6,171,34,0,137,34
233312,5,50,8,0,42,8
233312,4,23,3,0,20,3
233312,3,14,3,0,11,3
233312,2,9,7,0,2,7
233312,1,5,2,0,3,2
103185,10,27,5,0,22,5
103185,9,107,29,0,78,29
103185,8,657,168,0,489,168
103185,7,614,115,0,499,115
103185,6,434,97,0,337,97
103185,5,121,28,0,93,28
103185,4,42,17,0,25,17
103185,3,22,8,0,14,8
103185,2,8,2,0,6,2
94246,10,63,18,0,45,18
94246,9,183,45,0,138,45
94246,8,812,238,2,574,236
94246,7,573,121,2,452,119
94246,6,285,77,1,208,76
94246,5,61,20,0,41,20
94246,4,30,12,0,18,12
94246,3,13,8,0,5,8
94246,1,7,2,0,5,2
221318,10,40,8,0,32,8
221318,9,157,37,0,120,37
221318,8,769,103,0,666,103
221318,7,591,73,0,518,73
221318,6,322,54,0,268,54
221318,5,88,12,0,76,12
221318,4,47,13,0,34,13
221318,3,18,8,0,10,8
221318,2,2,1,0,1,1
221318,1,5,1,0,4,1
161866,10,162,13,1,149,12
161866,9,310,30,4,280,26
161866,8,753,70,7,683,63
161866,7,451,38,6,413,32
161866,6,234,24,6,210,18
161866,5,63,4,0,59,4
161866,4,19,3,1,16,2
161866,3,11,2,0,9,2
161866,2,12,2,0,10,2
161866,1,16,2,0,14,2
3800,10,32,15,0,17,15
3800,9,109,34,0,75,34
3800,8,608,158,0,450,158
3800,7,662,147,0,515,147
3800,6,427,99,0,328,99
3800,5,122,28,0,94,28
3800,4,38,14,0,24,14
3800,3,18,6,0,12,6
3800,2,11,5,0,6,5
8924,10,33,8,0,25,8
8924,9,66,18,0,48,18
8924,8,304,86,0,218,86
8924,7,553,146,0,407,146
8924,6,704,179,0,525,179
8924,5,218,53,0,165,53
8924,4,89,21,0,68,21
8924,3,31,5,0,26,5
8924,2,20,7,0,13,7
8924,1,13,1,0,12,1
205158,10,52,5,0,47,5
205158,9,141,15,0,126,15
205158,8,450,45,0,405,45
205158,7,532,65,0,467,65
205158,6,497,67,0,430,67
205158,5,178,39,0,139,39
205158,4,101,22,0,79,22
205158,3,43,12,0,31,12
205158,2,18,5,0,13,5
205158,1,20,4,0,16,4
2795,10,66,24,0,42,24
2795,9,90,34,0,56,34
2795,8,289,85,1,204,84
2795,7,499,154,1,345,153
2795,6,587,159,0,428,159
2795,5,260,97,0,163,97
2795,4,142,62,0,80,62
2795,3,61,33,0,28,33
2795,2,29,11,0,18,11
2795,1,7,1,0,6,1
122,10,22,12,0,10,12
122,9,62,26,0,36,26
122,8,325,122,0,203,122
122,7,587,163,0,424,163
122,6,648,170,0,478,170
122,5,223,62,0,161,62
122,4,102,35,0,67,35
122,3,37,12,0,25,12
122,2,15,8,0,7,8
122,1,6,1,0,5,1
245654,10,51,10,0,41,10
245654,9,195,23,0,172,23
245654,8,785,73,0,712,73
245654,7,616,68,0,548,68
245654,6,281,33,0,248,33
245654,5,71,18,0,53,18
245654,4,24,2,0,22,2
245654,3,7,1,0,6,1
1608,10,186,86,0,100,86
1608,9,266,94,0,172,94
1608,8,551,164,0,387,164
1608,7,510,139,0,371,139
1608,6,310,89,0,221,89
1608,5,102,36,0,66,36
1608,4,52,18,0,34,18
1608,3,21,10,0,11,10
1608,2,7,6,0,1,6
40237,10,38,13,0,25,13
40237,9,80,25,0,55,25
40237,8,482,154,0,328,154
40237,7,595,138,0,457,138
40237,6,535,137,0,398,137
40237,5,150,45,0,105,45
40237,4,70,28,0,42,28
40237,3,32,14,0,18,14
40237,2,21,7,0,14,7
125921,10,28,8,0,20,8
125921,9,76,13,0,63,13
125921,8,376,107,0,269,107
125921,7,644,136,0,508,136
125921,6,607,129,0,478,129
125921,5,184,26,0,158,26
125921,4,61,14,0,47,14
125921,3,17,5,0,12,5
125921,2,11,4,0,7,4
125921,1,3,1,0,2,1
32412,10,21,2,0,19,2
32412,9,78,10,0,68,10
32412,8,454,85,0,369,85
32412,7,669,112,0,557,112
32412,6,570,112,0,458,112
32412,5,139,35,0,104,35
32412,4,50,9,0,41,9
32412,3,19,5,0,14,5
32412,2,3,2,0,1,2
32412,1,2,1,0,1,1
7806,10,15,3,0,12,3
7806,9,28,11,0,17,11
7806,8,262,73,0,189,73
7806,7,584,147,0,437,147
7806,6,784,203,0,581,203
7806,5,201,46,0,155,46
7806,4,88,28,0,60,28
7806,3,33,12,0,21,12
7806,2,8,6,0,2,6
7806,1,4,1,0,3,1
107255,10,32,6,0,26,6
107255,9,91,21,0,70,21
107255,8,597,82,0,515,82
107255,7,663,77,0,586,77
107255,6,438,62,0,376,62
107255,5,109,24,0,85,24
107255,4,42,10,0,32,10
107255,3,19,4,0,15,4
107255,2,5,2,0,3,2
107255,1,4,2,0,2,2
85005,10,29,5,0,24,5
85005,9,85,10,0,75,10
85005,8,520,116,0,404,116
85005,7,663,99,0,564,99
85005,6,490,78,0,412,78
85005,5,131,24,0,107,24
85005,4,49,11,0,38,11
85005,3,19,4,0,15,4
85005,2,10,1,0,9,1
85005,1,4,1,0,3,1
4529,10,9,3,0,6,3
4529,9,44,18,0,26,18
4529,8,249,101,0,148,101
4529,7,531,177,0,354,177
4529,6,685,219,0,466,219
4529,5,268,85,0,183,85
4529,4,138,60,0,78,60
4529,3,56,30,0,26,30
4529,2,17,11,0,6,11
4529,1,2,1,0,1,1
6795,10,15,7,0,8,7
6795,9,39,16,0,23,16
6795,8,272,125,0,147,125
6795,7,485,219,0,266,219
6795,6,741,305,0,436,305
6795,5,276,87,0,189,87
6795,4,110,45,0,65,45
6795,3,41,12,0,29,12
6795,2,16,5,0,11,5
114031,10,29,5,0,24,5
114031,9,91,18,0,73,18
114031,8,510,93,0,417,93
114031,7,634,113,0,521,113
114031,6,456,89,0,367,89
114031,5,158,41,0,117,41
114031,4,66,21,0,45,21
114031,3,35,6,0,29,6
114031,2,12,4,0,8,4
114031,1,5,2,0,3,2
218333,10,65,13,0,52,13
218333,9,184,26,0,158,26
218333,8,718,89,0,629,89
218333,7,603,78,0,525,78
218333,6,310,40,0,270,40
218333,5,72,15,0,57,15
218333,4,30,7,0,23,7
218333,3,13,2,0,11,2
6901,10,102,27,0,75,27
6901,9,174,54,0,120,54
6901,8,388,94,0,294,94
6901,7,497,137,0,360,137
6901,6,474,121,0,353,121
6901,5,181,61,0,120,61
6901,4,113,47,0,66,47
6901,3,33,13,0,20,13
6901,2,24,13,0,11,13
6901,1,11,4,0,7,4
939,10,151,49,0,102,49
939,9,288,100,0,188,100
939,8,724,242,0,482,242
939,7,460,134,0,326,134
939,6,224,61,0,163,61
939,5,82,20,0,62,20
939,4,32,11,0,21,11
939,3,19,8,0,11,8
939,2,4,2,0,2,2
939,1,9,1,0,8,1
38992,10,18,3,0,15,3
38992,9,67,14,0,53,14
38992,8,569,136,0,433,136
38992,7,687,140,0,547,140
38992,6,476,117,0,359,117
38992,5,112,28,0,84,28
38992,4,40,17,0,23,17
38992,3,15,4,0,11,4
38992,2,6,1,0,5,1
15290,10,12,3,0,9,3
15290,9,49,19,0,30,19
15290,8,385,126,0,259,126
15290,7,681,200,0,481,200
15290,6,596,165,0,431,165
15290,5,171,36,0,135,36
15290,4,65,22,0,43,22
15290,3,15,6,0,9,6
15290,2,9,2,0,7,2
156714,10,207,48,0,159,48
156714,9,227,43,0,184,43
156714,8,518,98,0,420,98
156714,7,408,74,0,334,74
156714,6,327,63,0,264,63
156714,5,167,29,0,138,29
156714,4,64,16,0,48,16
156714,3,30,6,0,24,6
156714,2,25,9,0,16,9
156714,1,10,3,0,7,3
178054,10,41,8,0,33,8
178054,9,150,29,0,121,29
178054,8,609,93,0,516,93
178054,7,546,73,0,473,73
178054,6,398,63,1,335,62
178054,5,121,24,0,97,24
178054,4,65,9,0,56,9
178054,3,30,8,0,22,8
178054,2,15,5,0,10,5
178054,1,5,2,0,3,2
700,10,51,13,0,38,13
700,9,72,16,0,56,16
700,8,227,58,0,169,58
700,7,377,111,0,266,111
700,6,750,198,0,552,198
700,5,304,83,0,221,83
700,4,126,49,0,77,49
700,3,52,18,0,34,18
700,2,16,8,0,8,8
700,1,4,2,0,2,2
8170,10,32,15,0,17,15
8170,9,67,26,0,41,26
8170,8,390,150,0,240,150
8170,7,555,187,1,368,186
8170,6,537,188,0,349,188
8170,5,222,81,0,141,81
8170,4,110,47,0,63,47
8170,3,35,12,0,23,12
8170,2,22,8,0,14,8
8170,1,8,4,0,4,4
159473,10,119,36,0,83,36
159473,9,275,82,1,193,81
159473,8,695,150,0,545,150
159473,7,436,80,0,356,80
159473,6,275,52,0,223,52
159473,5,89,24,0,65,24
159473,4,47,14,0,33,14
159473,3,28,7,0,21,7
159473,2,9,5,0,4,5
159473,1,3,1,0,2,1
158435,10,114,28,3,86,25
158435,9,235,42,3,193,39
158435,8,775,129,1,646,128
158435,7,499,84,3,415,81
158435,6,258,45,1,213,44
158435,5,57,7,0,50,7
158435,4,23,5,0,18,5
158435,3,7,1,0,6,1
158435,2,4,2,0,2,2
9441,10,48,8,0,40,8
9441,9,93,17,0,76,17
9441,8,389,67,0,322,67
9441,7,624,113,0,511,113
9441,6,576,75,0,501,75
9441,5,151,28,0,123,28
9441,4,71,12,0,59,12
9441,3,18,2,0,16,2
9441,1,2,1,0,1,1
144270,10,17,4,0,13,4
144270,9,54,13,0,41,13
144270,8,453,84,0,369,84
144270,7,591,90,0,501,90
144270,6,569,85,0,484,85
144270,5,192,36,1,156,35
144270,4,61,21,0,40,21
144270,3,31,5,0,26,5
41863,10,112,23,0,89,23
41863,9,148,28,0,120,28
41863,8,424,65,0,359,65
41863,7,549,87,0,462,87
41863,6,472,83,0,389,83
41863,5,134,32,0,102,32
41863,4,71,15,0,56,15
41863,3,34,10,0,24,10
41863,2,18,6,0,12,6
41863,1,10,3,0,7,3
233020,10,144,41,5,103,36
233020,9,179,32,4,147,28
233020,8,620,98,14,522,84
233020,7,498,80,10,418,70
233020,6,358,72,5,286,67
233020,5,91,28,0,63,28
233020,4,38,5,1,33,4
233020,3,28,11,0,17,11
233020,2,12,9,0,3,9
233020,1,7,4,2,3,2
132018,10,172,42,0,130,42
132018,9,365,74,0,291,74
132018,8,741,118,0,623,118
132018,7,357,81,0,276,81
132018,6,206,49,0,157,49
132018,5,57,20,0,37,20
132018,4,41,16,0,25,16
132018,3,17,13,0,4,13
132018,2,6,3,0,3,3
132018,1,8,3,0,5,3
191300,10,32,11,0,21,11
191300,9,136,35,0,101,35
191300,8,657,114,0,543,114
191300,7,681,103,0,578,103
191300,6,327,64,0,263,64
191300,5,83,12,0,71,12
191300,4,33,9,0,24,9
191300,3,10,1,0,9,1
191300,2,6,3,0,3,3
191300,1,2,2,0,0,2
5895,10,28,6,0,22,6
5895,9,12,3,0,9,3
5895,8,40,18,0,22,18
5895,7,59,16,0,43,16
5895,6,229,69,0,160,69
5895,5,369,98,0,271,98
5895,4,529,121,0,408,121
5895,3,314,92,0,222,92
5895,2,279,98,0,181,98
5895,1,103,29,0,74,29
111799,10,112,30,0,82,30
111799,9,363,77,0,286,77
111799,8,848,177,0,671,177
111799,7,391,79,0,312,79
111799,6,149,41,0,108,41
111799,5,45,20,0,25,20
111799,4,29,12,0,17,12
111799,3,13,7,0,6,7
111799,2,6,5,0,1,5
135219,10,188,43,0,145,43
135219,9,368,69,0,299,69
135219,8,820,120,0,700,120
135219,7,366,62,0,304,62
135219,6,139,26,0,113,26
135219,5,39,7,0,32,7
135219,4,13,3,0,10,3
135219,3,8,1,0,7,1
135219,2,5,2,0,3,2
211534,10,25,7,0,18,7
211534,9,42,6,1,36,5
211534,8,152,23,3,129,20
211534,7,337,51,2,286,49
211534,6,577,54,5,523,49
211534,5,347,43,0,304,43
211534,4,229,40,1,189,39
211534,3,129,34,2,95,32
211534,2,85,33,2,52,31
211534,1,32,14,1,18,13
253284,10,46,7,0,39,7
253284,9,113,15,0,98,15
253284,8,588,86,0,502,86
253284,7,699,87,0,612,87
253284,6,379,67,0,312,67
253284,5,86,10,0,76,10
253284,4,28,11,0,17,11
253284,3,14,7,0,7,7
253284,2,2,1,0,1,1
30658,10,39,7,0,32,7
30658,9,172,35,0,137,35
30658,8,636,135,0,501,135
30658,7,533,94,0,439,94
30658,6,346,66,0,280,66
30658,5,116,29,0,87,29
30658,4,64,23,0,41,23
30658,3,19,9,0,10,9
30658,2,13,5,0,8,5
35761,10,15,6,0,9,6
35761,9,80,21,0,59,21
35761,8,479,108,0,371,108
35761,7,610,121,0,489,121
35761,6,516,121,0,395,121
35761,5,152,37,0,115,37
35761,4,57,18,0,39,18
35761,3,24,9,0,15,9
35761,2,4,1,0,3,1
150997,10,381,45,6,336,39
150997,9,464,51,4,413,47
150997,8,577,67,6,510,61
150997,7,264,26,2,238,24
150997,6,128,21,1,107,20
150997,5,54,9,0,45,9
150997,4,31,6,1,25,5
150997,3,18,4,1,14,3
150997,2,9,4,0,5,4
150997,1,14,4,2,10,2
147116,10,48,6,0,42,6
147116,9,85,14,0,71,14
147116,8,380,50,0,330,50
147116,7,464,58,0,406,58
147116,6,499,64,0,435,64
147116,5,213,35,0,178,35
147116,4,133,27,0,106,27
147116,3,74,17,0,57,17
147116,2,31,11,0,20,11
147116,1,12,8,0,4,8
205322,10,16,4,0,12,4
205322,9,11,2,0,9,2
205322,8,67,17,0,50,17
205322,7,139,28,0,111,28
205322,6,350,59,0,291,59
205322,5,320,58,0,262,58
205322,4,396,71,0,325,71
205322,3,301,81,0,220,81
205322,2,204,56,0,148,56
205322,1,136,44,0,92,44
224597,10,277,63,0,214,63
224597,9,449,73,0,376,73
224597,8,648,83,0,565,83
224597,7,306,32,0,274,32
224597,6,154,28,0,126,28
224597,5,56,10,0,46,10
224597,4,18,3,0,15,3
224597,3,15,4,0,11,4
224597,2,7,3,0,4,3
37919,10,81,28,0,53,28
37919,9,177,61,0,116,61
37919,8,636,185,0,451,185
37919,7,517,146,0,371,146
37919,6,340,111,0,229,111
37919,5,108,37,0,71,37
37919,4,32,9,0,23,9
37919,3,21,5,0,16,5
37919,2,15,7,0,8,7
37919,1,8,3,0,5,3
4249,10,14,5,0,9,5
4249,9,34,15,0,19,15
4249,8,337,141,0,196,141
4249,7,587,191,0,396,191
4249,6,624,195,0,429,195
4249,5,213,78,0,135,78
4249,4,80,40,0,40,40
4249,3,30,10,0,20,10
4249,2,11,1,0,10,1
4249,1,4,2,0,2,2
14254,10,39,8,0,31,8
14254,9,124,33,0,91,33
14254,8,527,135,0,392,135
14254,7,626,127,0,499,127
14254,6,404,103,0,301,103
14254,5,120,29,0,91,29
14254,4,53,15,0,38,15
14254,3,22,4,0,18,4
14254,2,8,3,0,5,3
14254,1,6,2,0,4,2
165986,10,40,11,0,29,11
165986,9,127,19,0,108,19
165986,8,700,123,0,577,123
165986,7,586,89,0,497,89
165986,6,339,49,0,290,49
165986,5,85,22,0,63,22
165986,4,31,7,0,24,7
165986,3,13,6,0,7,6
165986,2,4,2,0,2,2
165986,1,4,1,0,3,1
181524,10,61,5,0,56,5
181524,9,164,29,2,135,27
181524,8,622,102,20,520,82
181524,7,556,84,11,472,73
181524,6,342,57,5,285,52
181524,5,103,19,2,84,17
181524,4,49,11,2,38,9
181524,3,16,1,0,15,1
181524,2,12,4,0,8,4
205716,10,111,16,0,95,16
205716,9,244,41,0,203,41
205716,8,646,78,0,568,78
205716,7,426,39,0,387,39
205716,6,283,55,0,228,55
205716,5,100,23,0,77,23
205716,4,48,10,0,38,10
205716,3,38,8,0,30,8
205716,2,20,6,0,14,6
205716,1,8,5,0,3,5
178570,10,34,7,0,27,7
178570,9,60,9,0,51,9
178570,8,385,49,0,336,49
178570,7,521,60,0,461,60
178570,6,582,73,0,509,73
178570,5,169,18,0,151,18
178570,4,85,13,0,72,13
178570,3,33,6,0,27,6
178570,2,25,8,0,17,8
178570,1,27,12,0,15,12
191894,10,32,4,0,28,4
191894,9,129,14,0,115,14
191894,8,492,53,0,439,53
191894,7,645,55,0,590,55
191894,6,453,54,0,399,54
191894,5,116,12,0,104,12
191894,4,34,4,0,30,4
191894,3,14,2,0,12,2
56931,10,36,11,0,25,11
56931,9,83,28,0,55,28
56931,8,534,150,2,384,148
56931,7,629,174,0,455,174
56931,6,451,88,0,363,88
56931,5,112,35,0,77,35
56931,4,43,19,0,24,19
56931,3,14,4,0,10,4
56931,2,12,4,0,8,4
56931,1,4,2,0,2,2
230933,10,41,8,1,33,7
230933,9,161,28,2,133,26
230933,8,646,86,8,560,78
230933,7,545,78,2,467,76
230933,6,326,63,1,263,62
230933,5,107,17,0,90,17
230933,4,48,13,0,35,13
230933,3,29,10,0,19,10
230933,2,9,5,0,4,5
230933,1,7,2,0,5,2
105593,10,50,6,0,44,6
105593,9,78,12,0,66,12
105593,8,316,41,0,275,41
105593,7,498,63,0,435,63
105593,6,620,75,0,545,75
105593,5,195,24,0,171,24
105593,4,80,13,0,67,13
105593,3,51,10,0,41,10
105593,2,21,7,0,14,7
105593,1,10,1,0,9,1
216092,10,55,6,0,49,6
216092,9,179,19,0,160,19
216092,8,692,87,0,605,87
216092,7,565,68,0,497,68
216092,6,288,46,0,242,46
216092,5,65,11,0,54,11
216092,4,33,8,0,25,8
216092,3,17,4,0,13,4
216092,2,9,4,0,5,4
216092,1,10,3,0,7,3
102237,10,23,3,0,20,3
102237,9,64,13,0,51,13
102237,8,401,69,0,332,69
102237,7,649,96,0,553,96
102237,6,515,78,0,437,78
102237,5,157,34,0,123,34
102237,4,71,12,0,59,12
102237,3,23,5,0,18,5
102237,2,6,2,0,4,2
102237,1,3,1,0,2,1
91620,10,41,15,0,26,15
91620,9,80,31,0,49,31
91620,8,519,108,0,411,108
91620,7,556,116,1,440,115
91620,6,485,117,0,368,117
91620,5,123,41,0,82,41
91620,4,66,26,0,40,26
91620,3,26,12,0,14,12
91620,2,9,2,0,7,2
91620,1,2,1,0,1,1
4040,10,7,1,0,6,1
4040,9,17,4,0,13,4
4040,8,78,14,0,64,14
4040,7,232,35,0,197,35
4040,6,601,100,0,501,100
4040,5,444,89,0,355,89
4040,4,304,85,0,219,85
4040,3,142,45,0,97,45
4040,2,60,23,0,37,23
4040,1,21,10,0,11,10
167513,10,52,13,0,39,13
167513,9,153,28,0,125,28
167513,8,599,96,0,503,96
167513,7,540,63,0,477,63
167513,6,392,51,0,341,51
167513,5,93,9,0,84,9
167513,4,48,11,0,37,11
167513,3,18,3,0,15,3
167513,2,4,1,0,3,1
22198,10,6,1,0,5,1
22198,9,21,8,0,13,8
22198,8,211,81,0,130,81
22198,7,535,151,0,384,151
22198,6,722,192,1,530,191
22198,5,245,65,0,180,65
22198,4,106,33,0,73,33
22198,3,40,12,0,28,12
22198,2,18,3,0,15,3
193949,10,193,48,0,145,48
193949,9,401,77,0,324,77
193949,8,666,108,0,558,108
193949,7,325,49,0,276,49
193949,6,198,43,0,155,43
193949,5,63,13,0,50,13
193949,4,28,10,0,18,10
193949,3,18,6,0,12,6
193949,2,9,6,0,3,6
903,10,33,12,0,21,12
903,9,97,28,0,69,28
903,8,427,131,0,296,131
903,7,613,183,0,430,183
903,6,512,136,0,376,136
903,5,137,42,0,95,42
903,4,58,13,0,45,13
903,3,14,3,0,11,3
903,2,7,2,0,5,2
903,1,5,2,0,3,2
1107,10,22,6,0,16,6
1107,9,89,17,0,72,17
1107,8,483,69,0,414,69
1107,7,612,100,0,512,100
1107,6,476,81,0,395,81
1107,5,128,20,0,108,20
1107,4,51,15,0,36,15
1107,3,22,8,0,14,8
1107,2,14,4,0,10,4
1107,1,1,1,0,0,1
244536,10,94,14,2,80,12
244536,9,152,20,2,132,18
244536,8,629,71,5,558,66
244536,7,584,78,12,506,66
244536,6,303,48,2,255,46
244536,5,78,17,2,61,15
244536,4,26,11,1,15,10
244536,3,17,3,1,14,2
244536,2,5,2,0,3,2
244536,1,7,5,1,2,4
207691,10,40,6,0,34,6
207691,9,214,27,0,187,27
207691,8,780,93,0,687,93
207691,7,487,63,0,424,63
207691,6,257,57,0,200,57
207691,5,60,14,0,46,14
207691,4,26,10,0,16,10
207691,3,19,8,0,11,8
207691,2,5,2,0,3,2
164338,10,49,7,0,42,7
164338,9,148,31,0,117,31
164338,8,740,149,0,591,149
164338,7,555,105,0,450,105
164338,6,291,55,0,236,55
164338,5,74,14,0,60,14
164338,4,21,10,0,11,10
164338,3,9,3,0,6,3
164338,2,2,2,0,0,2
235488,10,37,8,0,29,8
235488,9,123,24,0,99,24
235488,8,670,83,0,587,83
235488,7,653,75,0,578,75
235488,6,283,49,0,234,49
235488,5,82,18,0,64,18
235488,4,27,5,0,22,5
235488,3,12,3,0,9,3
235488,2,4,2,0,2,2
127997,10,18,6,0,12,6
127997,9,71,16,0,55,16
127997,8,441,100,0,341,100
127997,7,611,101,0,510,101
127997,6,532,96,0,436,96
127997,5,149,34,0,115,34
127997,4,45,13,0,32,13
127997,3,10,4,0,6,4
127997,2,1,1,0,0,1
127997,1,3,1,0,2,1
148203,10,81,20,0,61,20
148203,9,111,20,0,91,20
148203,8,335,58,0,277,58
148203,7,476,81,0,395,81
148203,6,509,94,0,415,94
148203,5,190,32,0,158,32
148203,4,100,27,0,73,27
148203,3,45,8,0,37,8
148203,2,24,6,0,18,6
148203,1,9,4,0,5,4
62220,10,42,16,0,26,16
62220,9,143,41,0,102,41
62220,8,538,126,0,412,126
62220,7,428,115,0,313,115
62220,6,387,107,0,280,107
62220,5,153,48,0,105,48
62220,4,100,49,0,51,49
62220,3,54,17,0,37,17
62220,2,27,14,0,13,14
62220,1,6,3,0,3,3
216091,10,37,3,0,34,3
216091,9,137,7,0,130,7
216091,8,625,60,0,565,60
216091,7,596,63,0,533,63
216091,6,331,54,0,277,54
216091,5,87,11,0,76,11
216091,4,31,7,0,24,7
216091,3,16,6,0,10,6
216091,2,11,4,0,7,4
216091,1,7,1,0,6,1
195162,10,189,86,4,103,82
195162,9,269,74,10,195,64
195162,8,626,101,18,525,83
195162,7,428,54,7,374,47
195162,6,271,38,3,233,35
195162,5,68,13,1,55,12
195162,4,16,5,0,11,5
195162,3,7,2,0,5,2
195162,1,4,1,0,3,1
67928,10,57,16,0,41,16
67928,9,126,30,0,96,30
67928,8,421,91,1,330,90
67928,7,497,104,0,393,104
67928,6,440,103,0,337,103
67928,5,174,46,0,128,46
67928,4,84,22,0,62,22
67928,3,38,10,0,28,10
67928,2,20,6,0,14,6
67928,1,16,7,0,9,7
592,10,74,22,0,52,22
592,9,130,46,0,84,46
592,8,347,75,0,272,75
592,7,539,120,0,419,120
592,6,470,99,0,371,99
592,5,191,58,0,133,58
592,4,74,17,0,57,17
592,3,26,7,0,19,7
592,2,16,4,0,12,4
592,1,7,2,0,5,2
1334,10,12,6,0,6,6
1334,9,49,18,0,31,18
1334,8,334,106,0,228,106
1334,7,618,152,0,466,152
1334,6,561,162,0,399,162
1334,5,182,57,0,125,57
1334,4,70,20,0,50,20
1334,3,32,12,0,20,12
1334,2,12,7,0,5,7
233678,10,36,11,0,25,11
233678,9,80,7,0,73,7
233678,8,521,69,0,452,69
233678,7,589,79,0,510,79
233678,6,441,56,0,385,56
233678,5,124,29,0,95,29
233678,4,53,13,0,40,13
233678,3,19,2,0,17,2
233678,2,4,1,0,3,1
233678,1,7,2,0,5,2
202670,10,125,17,0,108,17
202670,9,228,35,0,193,35
202670,8,631,74,0,557,74
202670,7,472,58,0,414,58
202670,6,260,43,0,217,43
202670,5,85,21,0,64,21
202670,4,32,5,0,27,5
202670,3,24,7,0,17,7
202670,2,11,2,0,9,2
202670,1,4,1,0,3,1
195560,10,112,22,0,90,22
195560,9,271,47,1,224,46
195560,8,765,102,0,663,102
195560,7,390,52,1,338,51
195560,6,205,38,0,167,38
195560,5,75,19,0,56,19
195560,4,31,16,0,15,16
195560,3,14,8,0,6,8
195560,2,5,1,0,4,1
195560,1,5,1,0,4,1
22,10,254,117,0,137,117
22,9,228,105,0,123,105
22,8,388,122,0,266,122
22,7,369,110,0,259,110
22,6,305,96,0,209,96
22,5,134,49,0,85,49
22,4,91,36,0,55,36
22,3,53,25,0,28,25
22,2,33,16,0,17,16
22,1,11,4,0,7,4
34599,10,7,2,0,5,2
34599,9,15,5,0,10,5
34599,8,260,64,0,196,64
34599,7,552,123,0,429,123
34599,6,642,140,0,502,140
34599,5,236,62,0,174,62
34599,4,91,27,0,64,27
34599,3,44,13,0,31,13
34599,2,9,2,0,7,2
1472,10,33,8,0,25,8
1472,9,51,8,0,43,8
1472,8,196,38,0,158,38
1472,7,328,70,0,258,70
1472,6,611,125,0,486,125
1472,5,326,77,0,249,77
1472,4,189,63,0,126,63
1472,3,77,23,0,54,23
1472,2,37,20,0,17,20
1472,1,12,4,0,8,4
6424,10,9,2,0,7,2
6424,9,9,2,0,7,2
6424,8,31,7,0,24,7
6424,7,65,13,0,52,13
6424,6,271,56,0,215,56
6424,5,417,86,0,331,86
6424,4,489,105,0,384,105
6424,3,302,69,0,233,69
6424,2,181,50,0,131,50
6424,1,86,16,0,70,16
151247,10,31,8,0,23,8
151247,9,82,21,0,61,21
151247,8,429,94,4,335,90
151247,7,556,111,8,445,103
151247,6,501,87,1,414,86
151247,5,148,24,0,124,24
151247,4,73,10,0,63,10
151247,3,27,8,0,19,8
151247,2,10,4,0,6,4
151247,1,2,1,0,1,1
23142,10,18,5,0,13,5
23142,9,35,11,0,24,11
23142,8,182,57,0,125,57
23142,7,435,94,0,341,94
23142,6,683,152,0,531,152
23142,5,253,64,0,189,64
23142,4,142,42,0,100,42
23142,3,64,16,0,48,16
23142,2,35,12,0,23,12
23142,1,8,2,0,6,2
18745,10,36,3,0,33,3
18745,9,113,22,0,91,22
18745,8,548,145,0,403,145
18745,7,605,122,0,483,122
18745,6,403,103,0,300,103
18745,5,104,32,0,72,32
18745,4,31,12,0,19,12
18745,3,8,1,0,7,1
18745,2,4,2,0,2,2
22484,10,37,13,0,24,13
22484,9,133,42,0,91,42
22484,8,581,161,0,420,161
22484,7,607,148,0,459,148
22484,6,348,93,0,255,93
22484,5,93,13,0,80,13
22484,4,35,6,0,29,6
22484,2,5,1,0,4,1
1262,10,43,13,0,30,13
1262,9,100,18,0,82,18
1262,8,384,91,0,293,91
1262,7,546,107,0,439,107
1262,6,469,112,0,357,112
1262,5,170,51,0,119,51
1262,4,79,28,0,51,28
1262,3,34,21,0,13,21
1262,2,21,10,0,11,10
1262,1,7,2,0,5,2
7866,10,21,3,0,18,3
7866,9,37,14,0,23,14
7866,8,226,74,0,152,74
7866,7,578,190,0,388,190
7866,6,698,211,0,487,211
7866,5,203,85,0,118,85
7866,4,61,29,0,32,29
7866,3,16,6,0,10,6
7866,2,8,4,0,4,4
7866,1,3,1,0,2,1
26997,10,179,57,0,122,57
26997,9,363,79,0,284,79
26997,8,708,165,0,543,165
26997,7,353,76,0,277,76
26997,6,143,39,0,104,39
26997,5,56,19,0,37,19
26997,4,25,10,0,15,10
26997,3,9,3,0,6,3
26997,2,4,1,0,3,1
67185,10,17,1,0,16,1
67185,9,68,11,0,57,11
67185,8,417,63,0,354,63
67185,7,583,83,0,500,83
67185,6,525,100,0,425,100
67185,5,141,27,0,114,27
67185,4,72,8,0,64,8
67185,3,15,2,0,13,2
36522,10,34,14,0,20,14
36522,9,85,26,0,59,26
36522,8,521,164,0,357,164
36522,7,617,191,0,426,191
36522,6,406,151,0,255,151
36522,5,110,31,0,79,31
36522,4,43,13,0,30,13
36522,3,18,7,0,11,7
36522,2,7,1,0,6,1
7865,10,16,5,0,11,5
7865,9,49,18,0,31,18
7865,8,304,120,0,184,120
7865,7,584,196,0,388,196
7865,6,635,220,0,415,220
7865,5,163,70,0,93,70
7865,4,62,34,0,28,34
7865,3,21,11,0,10,11
7865,2,7,3,0,4,3
7865,1,1,1,0,0,1
635,10,11,2,0,9,2
635,9,41,15,0,26,15
635,8,290,94,0,196,94
635,7,530,147,0,383,147
635,6,625,189,0,436,189
635,5,202,64,0,138,64
635,4,96,40,0,56,40
635,3,30,15,0,15,15
635,2,16,10,0,6,10
69779,10,178,57,0,121,57
69779,9,344,88,0,256,88
69779,8,662,140,0,522,140
69779,7,336,66,0,270,66
69779,6,189,42,0,147,42
69779,5,66,20,0,46,20
69779,4,36,12,0,24,12
69779,3,14,5,0,9,5
69779,2,11,5,0,6,5
69779,1,8,2,0,6,2
28620,10,15,8,0,7,8
28620,9,75,27,0,48,27
28620,8,372,129,0,243,129
28620,7,564,170,0,394,170
28620,6,494,161,0,333,161
28620,5,175,69,0,106,69
28620,4,85,32,0,53,32
28620,3,37,23,0,14,23
28620,2,17,8,0,9,8
28620,1,4,2,0,2,2
2025,10,12,2,0,10,2
2025,9,32,5,0,27,5
2025,8,177,53,0,124,53
2025,7,324,79,0,245,79
2025,6,568,132,0,436,132
2025,5,324,87,0,237,87
2025,4,207,57,0,150,57
2025,3,116,42,0,74,42
2025,2,60,30,0,30,30
2025,1,17,10,0,7,10
103092,10,23,4,0,19,4
103092,9,107,22,0,85,22
103092,8,565,99,1,466,98
103092,7,573,96,0,477,96
103092,6,407,68,0,339,68
103092,5,92,20,0,72,20
103092,4,47,14,0,33,14
103092,3,15,4,0,11,4
10081,10,32,6,0,26,6
10081,9,61,21,0,40,21
10081,8,328,85,0,243,85
10081,7,504,112,0,392,112
10081,6,520,115,0,405,115
10081,5,215,62,0,153,62
10081,4,82,29,0,53,29
10081,3,56,19,0,37,19
10081,2,27,12,0,15,12
10081,1,9,5,0,4,5
237,10,69,23,0,46,23
237,9,127,44,0,83,44
237,8,455,144,0,311,144
237,7,599,140,0,459,140
237,6,397,101,0,296,101
237,5,121,29,0,92,29
237,4,41,15,0,26,15
237,3,14,5,0,9,5
237,2,4,1,0,3,1
237,1,5,1,0,4,1
144041,10,79,12,0,67,12
144041,9,190,42,0,148,42
144041,8,639,98,0,541,98
144041,7,417,64,1,353,63
144041,6,312,66,0,246,66
144041,5,91,19,0,72,19
144041,4,58,14,0,44,14
144041,3,30,6,0,24,6
144041,2,13,4,0,9,4
29073,10,27,9,0,18,9
29073,9,79,29,0,50,29
29073,8,357,100,0,257,100
29073,7,595,137,0,458,137
29073,6,534,121,0,413,121
29073,5,148,41,0,107,41
29073,4,64,17,0,47,17
29073,3,15,3,0,12,3
29073,2,6,4,0,2,4
29073,1,5,2,0,3,2
166226,10,40,5,0,35,5
166226,9,121,20,0,101,20
166226,8,647,101,0,546,101
166226,7,585,82,0,503,82
166226,6,315,52,0,263,52
166226,5,73,23,0,50,23
166226,4,33,8,0,25,8
166226,3,9,4,0,5,4
166226,2,5,2,0,3,2
166226,1,3,2,0,1,2
31624,10,22,4,0,18,4
31624,9,66,18,0,48,18
31624,8,499,105,0,394,105
31624,7,579,121,0,458,121
31624,6,446,105,0,341,105
31624,5,128,32,0,96,32
31624,4,59,21,0,38,21
31624,3,20,11,0,9,11
31624,2,8,4,0,4,4
31920,10,55,5,0,50,5
31920,9,77,8,0,69,8
31920,8,279,20,0,259,20
31920,7,388,32,0,356,32
31920,6,550,75,0,475,75
31920,5,246,34,0,212,34
31920,4,122,22,0,100,22
31920,3,52,19,0,33,19
31920,2,41,7,0,34,7
31920,1,17,1,0,16,1
29294,10,23,1,0,22,1
29294,9,50,10,0,40,10
29294,8,235,44,0,191,44
29294,7,447,71,0,376,71
29294,6,590,128,0,462,128
29294,5,236,66,0,170,66
29294,4,132,39,0,93,39
29294,3,76,19,0,57,19
29294,2,26,11,0,15,11
29294,1,9,3,0,6,3
8095,10,41,12,0,29,12
8095,9,92,27,0,65,27
8095,8,412,143,0,269,143
8095,7,516,164,0,352,164
8095,6,472,153,0,319,153
8095,5,146,51,0,95,51
8095,4,79,25,0,54,25
8095,3,41,19,0,22,19
8095,2,16,6,0,10,6
117960,9,21,3,0,18,3
117960,8,299,48,0,251,48
117960,7,622,108,0,514,108
117960,6,593,106,0,487,106
117960,5,160,37,0,123,37
117960,4,90,21,0,69,21
117960,3,24,7,0,17,7
117960,2,10,3,0,7,3
40769,10,23,1,0,22,1
40769,9,98,13,0,85,13
40769,8,413,78,0,335,78
40769,7,608,108,0,500,108
40769,6,459,94,0,365,94
40769,5,151,35,0,116,35
40769,4,46,18,0,28,18
40769,3,17,8,0,9,8
40769,2,7,3,0,4,3
37387,10,19,2,0,17,2
37387,9,79,24,0,55,24
37387,8,628,164,0,464,164
37387,7,577,141,0,436,141
37387,6,360,99,0,261,99
37387,5,93,35,0,58,35
37387,4,41,16,0,25,16
37387,3,22,9,0,13,9
37387,2,2,1,0,1,1
35435,10,16,4,0,12,4
35435,9,79,20,0,59,20
35435,8,532,124,0,408,124
35435,7,669,144,0,525,144
35435,6,387,83,0,304,83
35435,5,91,21,0,70,21
35435,4,29,10,0,19,10
35435,3,12,3,0,9,3
35435,2,5,3,0,2,3
701,10,72,36,0,36,36
701,9,117,46,0,71,46
701,8,532,210,0,322,210
701,7,562,149,0,413,149
701,6,358,138,0,220,138
701,5,99,34,0,65,34
701,4,48,17,0,31,17
701,3,18,7,0,11,7
701,1,5,3,0,2,3
98315,10,20,7,0,13,7
98315,9,73,12,0,61,12
98315,8,421,115,0,306,115
98315,7,582,149,0,433,149
98315,6,505,114,0,391,114
98315,5,136,36,0,100,36
98315,4,55,14,0,41,14
98315,3,18,7,0,11,7
98315,2,2,1,0,1,1
72,10,18,4,0,14,4
72,9,69,11,0,58,11
72,8,376,108,0,268,108
72,7,637,128,0,509,128
72,6,492,111,0,381,111
72,5,132,30,0,102,30
72,4,54,17,0,37,17
72,3,21,6,0,15,6
72,2,7,2,0,5,2
112373,10,21,2,0,19,2
112373,9,54,11,0,43,11
112373,8,268,82,0,186,82
112373,7,516,118,0,398,118
112373,6,662,145,0,517,145
112373,5,186,43,0,143,43
112373,4,65,18,0,47,18
112373,3,22,6,0,16,6
112373,2,13,3,0,10,3
112373,1,6,2,0,4,2
38194,10,12,3,0,9,3
38194,9,23,8,0,15,8
38194,8,225,41,0,184,41
38194,7,509,103,0,406,103
38194,6,660,120,0,540,120
38194,5,248,47,0,201,47
38194,4,89,23,0,66,23
38194,3,36,11,0,25,11
38194,2,5,3,0,2,3
38194,1,4,3,0,1,3
247763,10,136,27,0,109,27
247763,9,478,76,0,402,76
247763,8,795,91,1,704,90
247763,7,263,37,0,226,37
247763,6,119,24,0,95,24
247763,5,24,6,0,18,6
247763,4,13,5,0,8,5
247763,3,4,4,0,0,4
154086,10,51,11,0,40,11
154086,9,167,28,0,139,28
154086,8,772,138,0,634,138
154086,7,500,78,0,422,78
154086,6,261,48,0,213,48
154086,5,34,5,0,29,5
154086,4,17,4,0,13,4
154086,3,7,1,0,6,1
186751,10,624,156,15,468,141
186751,9,483,67,8,416,59
186751,8,399,70,13,329,57
186751,7,163,26,3,137,23
186751,6,72,13,0,59,13
186751,5,30,4,1,26,3
186751,4,15,4,0,11,4
186751,3,7,2,0,5,2
186751,2,7,5,0,2,5
244711,10,84,13,0,71,13
244711,9,279,30,0,249,30
244711,8,876,92,0,784,92
244711,7,354,40,0,314,40
244711,6,156,31,0,125,31
244711,5,39,8,0,31,8
244711,4,15,5,0,10,5
244711,3,12,7,0,5,7
244711,1,6,2,0,4,2
38545,10,47,10,0,37,10
38545,9,112,37,0,75,37
38545,8,460,90,0,370,90
38545,7,565,108,0,457,108
38545,6,431,77,0,354,77
38545,5,112,34,0,78,34
38545,4,55,11,0,44,11
38545,3,17,5,0,12,5
38545,2,6,2,0,4,2
21954,10,32,11,0,21,11
21954,9,95,34,0,61,34
21954,8,569,179,0,390,179
21954,7,520,151,0,369,151
21954,6,373,123,0,250,123
21954,5,109,36,0,73,36
21954,4,63,26,0,37,26
21954,3,26,13,0,13,13
21954,2,7,3,0,4,3
21954,1,5,3,0,2,3
38531,10,15,10,0,5,10
38531,9,63,23,0,40,23
38531,8,425,145,0,280,145
38531,7,589,163,0,426,163
38531,6,494,123,0,371,123
38531,5,122,44,0,78,44
38531,4,47,14,0,33,14
38531,3,24,6,0,18,6
38531,2,13,7,0,6,7
38531,1,6,1,0,5,1
21654,10,21,6,0,15,6
21654,9,50,17,0,33,17
21654,8,323,102,0,221,102
21654,7,566,139,0,427,139
21654,6,548,151,0,397,151
21654,5,174,55,0,119,55
21654,4,71,22,0,49,22
21654,3,35,11,0,24,11
21654,2,8,4,0,4,4
21654,1,2,2,0,0,2
176544,10,37,9,0,28,9
176544,9,111,24,1,87,23
176544,8,798,120,0,678,120
176544,7,533,88,0,445,88
176544,6,240,30,0,210,30
176544,5,58,13,0,45,13
176544,4,15,4,0,11,4
7316,10,9,3,0,6,3
7316,9,4,1,0,3,1
7316,8,11,2,0,9,2
7316,7,30,12,0,18,12
7316,6,71,9,0,62,9
7316,5,141,36,0,105,36
7316,4,259,60,0,199,60
7316,3,355,101,0,254,101
7316,2,388,118,0,270,118
7316,1,526,190,0,336,190
5406,10,9,4,0,5,4
5406,9,36,10,0,26,10
5406,8,330,118,0,212,118
5406,7,554,162,0,392,162
5406,6,551,165,0,386,165
5406,5,201,65,0,136,65
5406,4,73,26,0,47,26
5406,3,31,15,0,16,15
5406,2,5,1,0,4,1
3181,10,16,4,0,12,4
3181,9,24,3,0,21,3
3181,8,108,29,0,79,29
3181,7,262,71,0,191,71
3181,6,537,129,0,408,129
3181,5,439,117,0,322,117
3181,4,238,66,0,172,66
3181,3,98,29,0,69,29
3181,2,59,27,0,32,27
3181,1,12,4,0,8,4
154509,10,28,2,0,26,2
154509,9,71,9,0,62,9
154509,8,426,67,0,359,67
154509,7,589,84,0,505,84
154509,6,456,66,0,390,66
154509,5,121,19,0,102,19
154509,4,68,17,0,51,17
154509,3,22,10,0,12,10
154509,2,7,1,0,6,1
154509,1,4,1,0,3,1
1032,10,120,48,0,72,48
1032,9,157,64,0,93,64
1032,8,428,165,0,263,165
1032,7,451,120,0,331,120
1032,6,377,141,0,236,141
1032,5,151,61,0,90,61
1032,4,58,32,0,26,32
1032,3,30,20,0,10,20
1032,2,9,8,0,1,8
1032,1,8,4,0,4,4
219215,10,65,17,0,48,17
219215,9,193,28,0,165,28
219215,8,619,108,0,511,108
219215,7,469,60,0,409,60
219215,6,289,42,1,247,41
219215,5,81,19,0,62,19
219215,4,40,13,0,27,13
219215,3,17,6,0,11,6
219215,2,12,2,0,10,2
219215,1,8,4,0,4,4
152237,10,32,14,0,18,14
152237,9,67,21,2,46,19
152237,8,268,65,3,203,62
152237,7,456,106,1,350,105
152237,6,597,123,4,474,119
152237,5,221,41,2,180,39
152237,4,90,16,0,74,16
152237,3,35,12,0,23,12
152237,2,20,4,0,16,4
443,10,36,14,0,22,14
443,9,84,30,0,54,30
443,8,408,115,0,293,115
443,7,534,127,0,407,127
443,6,473,124,0,349,124
443,5,135,37,0,98,37
443,4,68,26,0,42,26
443,3,35,11,0,24,11
443,2,7,2,0,5,2
443,1,6,1,0,5,1
152,10,75,30,0,45,30
152,9,179,76,0,103,76
152,8,504,171,0,333,171
152,7,516,126,0,390,126
152,6,330,97,0,233,97
152,5,106,35,0,71,35
152,4,42,16,0,26,16
152,3,14,4,0,10,4
152,2,7,5,0,2,5
152,1,6,1,0,5,1
19643,10,79,17,0,62,17
19643,9,124,23,0,101,23
19643,8,346,86,0,260,86
19643,7,429,90,0,339,90
19643,6,471,118,0,353,118
19643,5,191,45,0,146,45
19643,4,75,23,0,52,23
19643,3,33,9,0,24,9
19643,2,16,3,0,13,3
19643,1,14,4,0,10,4
180899,10,60,7,0,53,7
180899,9,177,34,0,143,34
180899,8,630,108,0,522,108
180899,7,463,66,0,397,66
180899,6,296,60,0,236,60
180899,5,86,19,0,67,19
180899,4,37,13,0,24,13
180899,3,23,5,0,18,5
180899,2,6,3,0,3,3
245934,10,68,9,0,59,9
245934,9,231,39,0,192,39
245934,8,780,105,0,675,105
245934,7,429,63,0,366,63
245934,6,191,41,0,150,41
245934,5,63,15,0,48,15
245934,4,13,7,0,6,7
245934,3,5,2,0,3,2
245934,2,4,1,0,3,1
245934,1,3,2,0,1,2
232988,10,32,8,0,24,8
232988,9,98,19,0,79,19
232988,8,505,89,0,416,89
232988,7,566,68,0,498,68
232988,6,404,74,0,330,74
232988,5,102,24,0,78,24
232988,4,32,5,0,27,5
232988,3,23,3,0,20,3
232988,2,8,2,0,6,2
232988,1,1,1,0,0,1
45134,10,11,1,0,10,1
45134,9,37,13,0,24,13
45134,8,260,67,0,193,67
45134,7,411,89,0,322,89
45134,6,584,131,0,453,131
45134,5,224,39,0,185,39
45134,4,146,42,0,104,42
45134,3,60,20,0,40,20
45134,2,31,15,0,16,15
45134,1,5,2,0,3,2
6752,10,20,8,0,12,8
6752,9,45,17,0,28,17
6752,8,171,60,0,111,60
6752,7,343,88,0,255,88
6752,6,567,141,0,426,141
6752,5,312,90,0,222,90
6752,4,152,52,0,100,52
6752,3,95,41,0,54,41
6752,2,49,23,0,26,23
6752,1,14,6,0,8,6
24703,10,85,17,0,68,17
24703,9,115,15,0,100,15
24703,8,413,104,0,309,104
24703,7,542,136,0,406,136
24703,6,410,103,0,307,103
24703,5,129,42,0,87,42
24703,4,42,17,0,25,17
24703,3,22,5,0,17,5
24703,2,2,1,0,1,1
172933,10,39,10,0,29,10
172933,9,84,23,0,61,23
172933,8,369,83,0,286,83
172933,7,557,114,0,443,114
172933,6,513,86,0,427,86
172933,5,147,32,0,115,32
172933,4,35,10,0,25,10
172933,3,17,2,0,15,2
111148,10,30,6,0,24,6
111148,9,69,13,0,56,13
111148,8,368,81,0,287,81
111148,7,549,85,0,464,85
111148,6,491,92,0,399,92
111148,5,151,34,0,117,34
111148,4,72,20,0,52,20
111148,3,17,6,0,11,6
111148,2,11,5,0,6,5
144239,10,41,12,0,29,12
144239,9,131,35,0,96,35
144239,8,494,105,1,389,104
144239,7,450,102,0,348,102
144239,6,396,86,0,310,86
144239,5,134,28,0,106,28
144239,4,72,23,1,49,22
144239,3,23,7,0,16,7
144239,2,12,5,0,7,5
144239,1,5,1,0,4,1
203430,10,25,5,0,20,5
203430,9,58,14,0,44,14
203430,8,327,71,0,256,71
203430,7,515,91,0,424,91
203430,6,529,85,0,444,85
203430,5,168,30,0,138,30
203430,4,93,19,0,74,19
203430,3,32,9,0,23,9
203430,2,11,6,0,5,6
203430,1,1,1,0,0,1
38863,10,26,13,0,13,13
38863,9,101,26,0,75,26
38863,8,561,122,0,439,122
38863,7,562,104,0,458,104
38863,6,384,88,0,296,88
38863,5,76,22,0,54,22
38863,4,29,10,0,19,10
38863,3,13,2,0,11,2
159503,10,71,16,3,55,13
159503,9,175,41,3,134,38
159503,8,564,100,5,464,95
159503,7,500,88,0,412,88
159503,6,306,54,2,252,52
159503,5,88,18,0,70,18
159503,4,29,11,0,18,11
159503,3,11,3,0,8,3
159503,2,8,4,0,4,4
159503,1,3,1,0,2,1
115105,10,27,8,0,19,8
115105,9,28,4,0,24,4
115105,8,156,28,0,128,28
115105,7,304,50,2,254,48
115105,6,581,98,1,483,97
115105,5,317,54,0,263,54
115105,4,172,32,0,140,32
115105,3,93,20,0,73,20
115105,2,49,13,0,36,13
115105,1,22,14,1,8,13
171879,10,33,15,0,18,15
171879,9,130,30,0,100,30
171879,8,719,128,0,591,128
171879,7,505,78,0,427,78
171879,6,270,47,0,223,47
171879,5,52,12,0,40,12
171879,4,26,5,0,21,5
171879,3,12,9,0,3,9
136280,10,35,9,0,26,9
136280,9,102,15,0,87,15
136280,8,466,88,0,378,88
136280,7,557,89,0,468,89
136280,6,443,67,0,376,67
136280,5,105,16,0,89,16
136280,4,29,6,0,23,6
136280,3,7,3,0,4,3
9910,10,43,10,0,33,10
9910,9,98,27,0,71,27
9910,8,436,100,0,336,100
9910,7,630,118,0,512,118
9910,6,385,74,0,311,74
9910,5,84,22,0,62,22
9910,4,41,11,0,30,11
9910,3,20,6,0,14,6
9910,2,7,3,0,4,3
9910,1,4,1,0,3,1
883,10,26,10,0,16,10
883,9,59,18,0,41,18
883,8,297,109,0,188,109
883,7,535,138,0,397,138
883,6,517,137,0,380,137
883,5,197,54,0,143,54
883,4,72,25,0,47,25
883,3,26,17,0,9,17
883,2,10,6,0,4,6
137649,10,97,25,0,72,25
137649,9,234,49,0,185,49
137649,8,678,113,1,565,112
137649,7,382,53,0,329,53
137649,6,226,45,0,181,45
137649,5,69,11,0,58,11
137649,4,24,4,0,20,4
137649,3,20,8,0,12,8
137649,2,2,1,0,1,1
137649,1,7,1,0,6,1
76674,10,10,4,0,6,4
76674,9,25,7,0,18,7
76674,8,283,66,0,217,66
76674,7,530,115,0,415,115
76674,6,557,118,0,439,118
76674,5,193,50,0,143,50
76674,4,89,17,0,72,17
76674,3,33,7,0,26,7
76674,2,15,5,0,10,5
12589,10,24,12,0,12,12
12589,9,77,30,0,47,30
12589,8,425,133,1,292,132
12589,7,566,162,0,404,162
12589,6,451,105,0,346,105
12589,5,118,34,0,84,34
12589,4,47,11,0,36,11
12589,3,19,4,0,15,4
12589,2,7,4,0,3,4
139771,10,226,28,0,198,28
139771,9,299,47,0,252,47
139771,8,441,78,0,363,78
139771,7,360,47,0,313,47
139771,6,245,47,0,198,47
139771,5,67,17,0,50,17
139771,4,43,13,0,30,13
139771,3,25,16,0,9,16
139771,2,13,6,0,7,6
139771,1,17,6,0,11,6
187617,10,207,64,8,143,56
187617,9,406,73,5,333,68
187617,8,714,125,9,589,116
187617,7,253,43,2,210,41
187617,6,103,21,1,82,20
187617,5,23,8,0,15,8
187617,4,10,4,0,6,4
187617,3,15,14,0,1,14
187617,2,5,2,0,3,2
96713,10,9,2,0,7,2
96713,9,28,5,0,23,5
96713,8,301,64,0,237,64
96713,7,516,91,0,425,91
96713,6,563,102,0,461,102
96713,5,184,40,0,144,40
96713,4,81,14,0,67,14
96713,3,32,9,0,23,9
96713,2,14,2,0,12,2
96713,1,4,1,0,3,1
144189,10,260,59,0,201,59
144189,9,387,75,0,312,75
144189,8,641,119,0,522,119
144189,7,243,53,0,190,53
144189,6,122,28,0,94,28
144189,5,38,16,0,22,16
144189,4,17,7,0,10,7
144189,3,13,5,0,8,5
144189,2,8,6,0,2,6
25224,10,33,11,0,22,11
25224,9,82,25,0,57,25
25224,8,507,145,0,362,145
25224,7,571,140,0,431,140
25224,6,329,91,0,238,91
25224,5,122,47,0,75,47
25224,4,62,27,0,35,27
25224,3,16,8,0,8,8
25224,2,7,2,0,5,2
206931,10,23,5,0,18,5
206931,9,87,16,0,71,16
206931,8,460,68,0,392,68
206931,7,665,85,0,580,85
206931,6,396,52,0,344,52
206931,5,70,15,0,55,15
206931,4,21,7,0,14,7
206931,3,7,1,0,6,1
206931,1,1,1,0,0,1
333,10,9,2,0,7,2
333,9,12,3,0,9,3
333,8,89,35,0,54,35
333,7,197,56,0,141,56
333,6,642,178,0,464,178
333,5,444,114,0,330,114
333,4,216,63,0,153,63
333,3,80,28,0,52,28
333,2,41,19,0,22,19
333,1,3,2,0,1,2
226320,10,108,27,0,81,27
226320,9,218,45,0,173,45
226320,8,670,91,0,579,91
226320,7,444,57,0,387,57
226320,6,196,34,0,162,34
226320,5,52,10,0,42,10
226320,4,19,6,0,13,6
226320,3,8,3,0,5,3
226320,2,6,1,0,5,1
226320,1,10,2,0,8,2
3072,10,135,35,0,100,35
3072,9,201,54,0,147,54
3072,8,459,86,0,373,86
3072,7,470,77,0,393,77
3072,6,295,57,0,238,57
3072,5,91,24,0,67,24
3072,4,44,12,0,32,12
3072,3,17,6,0,11,6
3072,2,7,3,0,4,3
3072,1,7,1,0,6,1
198740,10,65,7,0,58,7
198740,9,174,32,0,142,32
198740,8,611,81,0,530,81
198740,7,462,52,0,410,52
198740,6,265,38,0,227,38
198740,5,84,16,0,68,16
198740,4,37,7,0,30,7
198740,3,16,8,0,8,8
198740,2,9,5,0,4,5
198740,1,5,3,0,2,3
403,10,14,8,0,6,8
403,9,45,12,0,33,12
403,8,187,68,0,119,68
403,7,413,154,0,259,154
403,6,662,228,0,434,228
403,5,223,69,0,154,69
403,4,114,38,0,76,38
403,3,40,13,0,27,13
403,2,18,8,0,10,8
403,1,6,4,0,2,4
63759,10,12,5,0,7,5
63759,9,64,21,0,43,21
63759,8,515,136,0,379,136
63759,7,577,104,0,473,104
63759,6,391,98,0,293,98
63759,5,109,30,0,79,30
63759,4,41,12,0,29,12
63759,3,11,1,0,10,1
8124,10,9,5,0,4,5
8124,9,43,17,0,26,17
8124,8,304,103,0,201,103
8124,7,531,155,0,376,155
8124,6,534,167,0,367,167
8124,5,169,50,0,119,50
8124,4,82,31,0,51,31
8124,3,31,7,0,24,7
8124,2,14,5,0,9,5
8124,1,2,2,0,0,2
75165,10,61,20,0,41,20
75165,9,168,33,0,135,33
75165,8,629,120,0,509,120
75165,7,425,81,0,344,81
75165,6,284,57,0,227,57
75165,5,79,14,0,65,14
75165,4,46,20,0,26,20
75165,3,13,4,0,9,4
75165,2,8,1,0,7,1
12004,10,17,6,0,11,6
12004,9,40,11,0,29,11
12004,8,224,67,0,157,67
12004,7,422,100,0,322,100
12004,6,574,146,0,428,146
12004,5,233,73,0,160,73
12004,4,128,40,0,88,40
12004,3,52,26,0,26,26
12004,2,18,11,0,7,11
12004,1,9,3,0,6,3
144826,10,37,11,0,26,11
144826,9,96,11,0,85,11
144826,8,486,72,2,414,70
144826,7,507,89,2,418,87
144826,6,417,61,2,356,59
144826,5,91,15,0,76,15
144826,4,46,12,0,34,12
144826,3,16,3,0,13,3
144826,2,12,1,0,11,1
1563,10,121,54,0,67,54
1563,9,130,41,0,89,41
1563,8,329,111,0,218,111
1563,7,426,105,0,321,105
1563,6,406,118,0,288,118
1563,5,174,55,0,119,55
1563,4,76,31,0,45,31
1563,3,33,16,0,17,16
1563,2,15,10,0,5,10
1563,1,8,2,0,6,2
194690,10,36,5,0,31,5
194690,9,101,19,0,82,19
194690,8,617,70,0,547,70
194690,7,531,61,0,470,61
194690,6,279,38,0,241,38
194690,5,107,16,0,91,16
194690,4,29,5,0,24,5
194690,3,12,3,0,9,3
194690,2,4,2,0,2,2
194690,1,4,1,0,3,1
147253,10,23,9,1,14,8
147253,9,102,27,3,75,24
147253,8,597,106,6,491,100
147253,7,544,84,0,460,84
147253,6,327,65,5,262,60
147253,5,84,16,0,68,16
147253,4,27,8,0,19,8
147253,2,4,1,0,3,1
147253,1,6,2,0,4,2
228660,10,82,15,0,67,15
228660,9,166,32,0,134,32
228660,8,527,66,0,461,66
228660,7,491,55,0,436,55
228660,6,293,38,0,255,38
228660,5,84,19,0,65,19
228660,4,42,14,0,28,14
228660,3,19,5,0,14,5
228660,2,10,3,0,7,3
228660,1,4,4,0,0,4
60131,10,13,3,0,10,3
60131,9,47,17,0,30,17
60131,8,237,53,0,184,53
60131,7,428,97,0,331,97
60131,6,636,117,0,519,117
60131,5,199,43,0,156,43
60131,4,99,24,0,75,24
60131,3,28,7,0,21,7
60131,2,19,9,0,10,9
60131,1,9,1,0,8,1
1915,10,216,75,0,141,75
1915,9,203,65,0,138,65
1915,8,403,113,0,290,113
1915,7,349,82,0,267,82
1915,6,296,65,0,231,65
1915,5,119,37,0,82,37
1915,4,76,23,0,53,23
1915,3,32,8,0,24,8
1915,2,13,3,0,10,3
1915,1,9,4,0,5,4
55253,10,15,5,0,10,5
55253,9,31,6,0,25,6
55253,8,287,62,0,225,62
55253,7,555,112,0,443,112
55253,6,568,112,0,456,112
55253,5,154,40,0,114,40
55253,4,62,14,0,48,14
55253,3,29,6,0,23,6
55253,2,11,4,0,7,4
55253,1,2,1,0,1,1
5867,10,25,9,0,16,9
5867,9,42,14,0,28,14
5867,8,280,104,0,176,104
5867,7,593,155,0,438,155
5867,6,544,154,0,390,154
5867,5,146,56,0,90,56
5867,4,55,26,0,29,26
5867,3,19,8,0,11,8
5867,2,6,3,0,3,3
5867,1,3,2,0,1,2
10934,10,34,10,0,24,10
10934,9,48,16,0,32,16
10934,8,231,61,0,170,61
10934,7,342,61,0,281,61
10934,6,576,96,0,480,96
10934,5,248,47,0,201,47
10934,4,124,22,0,102,22
10934,3,58,21,0,37,21
10934,2,28,5,0,23,5
10934,1,25,10,0,15,10
140863,9,38,9,1,29,8
140863,8,237,45,4,192,41
140863,7,480,86,5,394,81
140863,6,614,120,7,494,113
140863,5,209,54,2,155,52
140863,4,86,14,0,72,14
140863,3,26,8,0,18,8
140863,2,6,1,0,5,1
9341,10,13,9,0,4,9
9341,9,82,41,0,41,41
9341,8,407,157,1,250,156
9341,7,543,156,2,387,154
9341,6,445,134,1,311,133
9341,5,144,31,0,113,31
9341,4,50,17,0,33,17
9341,3,24,10,0,14,10
2570,10,21,11,0,10,11
2570,9,71,28,0,43,28
2570,8,445,155,0,290,155
2570,7,592,181,0,411,181
2570,6,414,113,0,301,113
2570,5,112,40,0,72,40
2570,4,32,12,0,20,12
2570,3,18,4,0,14,4
2570,2,5,3,0,2,3
2570,1,3,1,0,2,1
46807,10,24,8,0,16,8
46807,9,26,2,0,24,2
46807,8,255,67,0,188,67
46807,7,427,101,0,326,101
46807,6,562,143,0,419,143
46807,5,204,59,0,145,59
46807,4,123,44,0,79,44
46807,3,59,25,0,34,25
46807,2,25,12,0,13,12
46807,1,7,3,0,4,3
38506,10,30,10,0,20,10
38506,9,70,13,0,57,13
38506,8,372,86,0,286,86
38506,7,520,105,0,415,105
38506,6,444,101,0,343,101
38506,5,147,39,0,108,39
38506,4,78,24,0,54,24
38506,3,34,11,0,23,11
38506,2,12,5,0,7,5
38506,1,5,3,0,2,3
29972,10,18,4,0,14,4
29972,9,59,11,0,48,11
29972,8,446,104,0,342,104
29972,7,595,142,0,453,142
29972,6,382,93,0,289,93
29972,5,121,38,0,83,38
29972,4,58,22,0,36,22
29972,3,20,10,0,10,10
29972,2,6,3,0,3,3
29972,1,6,3,0,3,3
152470,10,177,27,2,150,25
152470,9,241,34,6,207,28
152470,8,569,109,11,460,98
152470,7,328,48,3,280,45
152470,6,218,29,1,189,28
152470,5,81,18,0,63,18
152470,4,38,14,0,24,14
152470,3,33,16,0,17,16
152470,2,11,5,1,6,4
152470,1,14,6,0,8,6
192074,10,28,5,0,23,5
192074,9,119,29,0,90,29
192074,8,484,70,1,414,69
192074,7,610,86,0,524,86
192074,6,365,61,0,304,61
192074,5,73,16,1,57,15
192074,4,19,6,0,13,6
192074,3,6,1,0,5,1
192074,2,3,3,0,0,3
37358,10,46,19,0,27,19
37358,9,102,38,0,64,38
37358,8,560,139,0,421,139
37358,7,463,103,0,360,103
37358,6,332,91,0,241,91
37358,5,115,34,0,81,34
37358,4,51,21,0,30,21
37358,3,24,8,0,16,8
37358,2,8,5,0,3,5
37358,1,4,1,0,3,1
24509,10,15,2,0,13,2
24509,9,41,8,0,33,8
24509,8,272,48,0,224,48
24509,7,516,99,0,417,99
24509,6,585,125,0,460,125
24509,5,146,39,0,107,39
24509,4,76,24,0,52,24
24509,3,39,14,0,25,14
24509,2,11,4,0,7,4
24509,1,3,1,0,2,1
1197,10,17,6,0,11,6
1197,9,34,11,0,23,11
1197,8,183,60,0,123,60
1197,7,275,80,0,195,80
1197,6,641,202,0,439,202
1197,5,311,102,0,209,102
1197,4,163,53,0,110,53
1197,3,50,23,0,27,23
1197,2,24,4,0,20,4
1197,1,5,1,0,4,1
1038,10,19,6,0,13,6
1038,9,58,13,0,45,13
1038,8,235,50,0,185,50
1038,7,432,92,0,340,92
1038,6,585,98,0,487,98
1038,5,225,52,0,173,52
1038,4,98,36,0,62,36
1038,3,32,11,0,21,11
1038,2,12,5,0,7,5
1038,1,5,2,0,3,2
175,10,19,9,0,10,9
175,9,50,18,0,32,18
175,8,271,94,0,177,94
175,7,483,138,0,345,138
175,6,544,148,0,396,148
175,5,234,66,0,168,66
175,4,64,29,0,35,29
175,3,28,12,0,16,12
175,1,3,2,0,1,2
32666,10,53,12,0,41,12
32666,9,127,29,0,98,29
32666,8,488,136,0,352,136
32666,7,445,111,0,334,111
32666,6,348,87,0,261,87
32666,5,118,42,0,76,42
32666,4,54,22,0,32,22
32666,3,40,17,0,23,17
32666,2,13,6,0,7,6
32666,1,7,4,0,3,4
146130,10,17,3,0,14,3
146130,9,32,10,4,22,6
146130,8,168,43,1,125,42
146130,7,391,101,9,290,92
146130,6,632,157,20,475,137
146130,5,275,57,6,218,51
146130,4,116,31,0,85,31
146130,3,42,11,1,31,10
146130,2,14,2,1,12,1
146130,1,6,2,0,4,2
65282,10,76,16,0,60,16
65282,9,123,37,1,86,36
65282,8,408,66,1,342,65
65282,7,485,100,1,385,99
65282,6,370,62,0,308,62
65282,5,100,29,0,71,29
65282,4,58,13,0,45,13
65282,3,40,9,0,31,9
65282,2,18,3,0,15,3
65282,1,12,4,0,8,4
182694,10,97,13,0,84,13
182694,9,208,25,0,183,25
182694,8,595,65,0,530,65
182694,7,424,45,0,379,45
182694,6,243,27,0,216,27
182694,5,72,15,0,57,15
182694,4,34,7,0,27,7
182694,3,12,4,0,8,4
182694,2,5,1,0,4,1
182694,1,3,2,0,1,2
25674,10,17,3,0,14,3
25674,9,55,16,0,39,16
25674,8,308,87,0,221,87
25674,7,440,108,0,332,108
25674,6,514,126,0,388,126
25674,5,178,63,0,115,63
25674,4,95,31,0,64,31
25674,3,55,20,0,35,20
25674,2,19,10,0,9,10
25674,1,8,3,0,5,3
53093,10,140,32,2,108,30
53093,9,258,47,3,211,44
53093,8,558,83,5,475,78
53093,7,388,49,1,339,48
53093,6,226,32,1,194,31
53093,5,58,14,0,44,14
53093,4,33,9,0,24,9
53093,3,10,3,0,7,3
53093,2,10,7,0,3,7
53093,1,7,2,0,5,2
32484,10,21,7,1,14,6
32484,9,72,32,0,40,32
32484,8,351,161,1,190,160
32484,7,514,194,0,320,194
32484,6,477,158,1,319,157
32484,5,145,41,0,104,41
32484,4,71,29,0,42,29
32484,3,24,13,0,11,13
32484,2,6,5,0,1,5
32484,1,6,1,0,5,1
691,10,16,4,0,12,4
691,9,58,17,0,41,17
691,8,371,124,0,247,124
691,7,549,106,0,443,106
691,6,462,121,0,341,121
691,5,141,40,0,101,40
691,4,52,22,0,30,22
691,3,24,12,0,12,12
691,2,8,4,0,4,4
146418,10,104,26,0,78,26
146418,9,171,40,0,131,40
146418,8,474,80,0,394,80
146418,7,441,52,0,389,52
146418,6,330,39,0,291,39
146418,5,95,17,0,78,17
146418,4,39,7,0,32,7
146418,3,26,5,0,21,5
146418,2,5,1,0,4,1
214032,10,47,12,0,35,12
214032,9,164,19,2,145,17
214032,8,505,70,6,435,64
214032,7,395,59,3,336,56
214032,6,295,60,7,235,53
214032,5,115,27,2,88,25
214032,4,78,23,1,55,22
214032,3,55,28,1,27,27
214032,2,21,11,0,10,11
214032,1,12,7,0,5,7
19948,10,11,2,0,9,2
19948,9,36,16,0,20,16
19948,8,293,95,0,198,95
19948,7,496,143,0,353,143
19948,6,528,151,0,377,151
19948,5,188,59,0,129,59
19948,4,78,30,0,48,30
19948,3,34,15,0,19,15
19948,2,14,9,0,5,9
19948,1,4,2,0,2,2
23730,10,10,5,0,5,5
23730,9,43,15,0,28,15
23730,8,315,123,0,192,123
23730,7,524,140,0,384,140
23730,6,501,159,0,342,159
23730,5,180,68,0,112,68
23730,4,74,37,0,37,37
23730,3,26,15,0,11,15
23730,2,5,2,0,3,2
23730,1,2,2,0,0,2
153016,10,190,31,0,159,31
153016,9,252,32,0,220,32
153016,8,607,92,0,515,92
153016,7,398,57,0,341,57
153016,6,167,29,0,138,29
153016,5,33,5,0,28,5
153016,4,24,4,0,20,4
22348,10,52,11,0,41,11
22348,9,109,13,0,96,13
22348,8,423,72,0,351,72
22348,7,526,85,0,441,85
22348,6,418,65,0,353,65
22348,5,82,12,0,70,12
22348,4,44,12,0,32,12
22348,3,14,4,0,10,4
22348,2,6,1,0,5,1
22348,1,4,1,0,3,1
181293,10,33,5,0,28,5
181293,9,96,13,1,83,12
181293,8,474,73,0,401,73
181293,7,473,58,0,415,58
181293,6,368,83,0,285,83
181293,5,112,20,0,92,20
181293,4,67,20,0,47,20
181293,3,41,8,0,33,8
181293,2,11,2,0,9,2
163413,10,37,5,0,32,5
163413,9,110,21,0,89,21
163413,8,608,98,0,510,98
163413,7,560,94,0,466,94
163413,6,267,44,0,223,44
163413,5,64,19,0,45,19
163413,4,20,6,0,14,6
163413,3,6,4,0,2,4
163413,2,4,2,0,2,2
206051,10,46,5,0,41,5
206051,9,107,18,0,89,18
206051,8,549,70,0,479,70
206051,7,487,66,0,421,66
206051,6,322,47,0,275,47
206051,5,91,14,0,77,14
206051,4,46,11,0,35,11
206051,3,21,4,0,17,4
206051,2,8,3,0,5,3
206051,1,1,1,0,0,1
123239,10,35,4,0,31,4
123239,9,93,15,0,78,15
123239,8,405,58,1,347,57
123239,7,535,68,0,467,68
123239,6,455,67,0,388,67
123239,5,105,14,0,91,14
123239,4,33,8,0,25,8
123239,3,9,1,0,8,1
380,10,25,12,0,13,12
380,9,56,20,0,36,20
380,8,289,117,0,172,117
380,7,445,161,0,284,161
380,6,494,179,0,315,179
380,5,204,72,0,132,72
380,4,85,33,0,52,33
380,3,47,18,0,29,18
380,2,22,10,0,12,10
380,1,7,2,0,5,2
103649,10,18,4,0,14,4
103649,9,67,21,0,46,21
103649,8,281,68,1,213,67
103649,7,510,87,0,423,87
103649,6,525,106,1,419,105
103649,5,157,28,0,129,28
103649,4,76,18,0,58,18
103649,3,25,3,0,22,3
103649,2,13,7,0,6,7
257499,10,220,26,0,194,26
257499,9,454,64,0,390,64
257499,8,576,85,0,491,85
257499,7,207,33,0,174,33
257499,6,101,13,0,88,13
257499,5,56,15,0,41,15
257499,4,25,10,0,15,10
257499,3,16,3,0,13,3
257499,2,10,8,0,2,8
257499,1,16,9,0,7,9
157,10,80,27,0,53,27
157,9,127,35,0,92,35
157,8,478,119,0,359,119
157,7,472,124,0,348,124
157,6,325,98,0,227,98
157,5,104,28,0,76,28
157,4,46,17,0,29,17
157,3,24,12,0,12,12
157,2,11,9,0,2,9
157,1,3,2,0,1,2
137330,10,39,16,0,23,16
137330,9,87,24,0,63,24
137330,8,385,108,0,277,108
137330,7,536,111,0,425,111
137330,6,426,81,0,345,81
137330,5,120,23,0,97,23
137330,4,53,8,0,45,8
137330,3,20,5,0,15,5
137330,2,3,1,0,2,1
2393,10,132,27,0,105,27
2393,9,166,44,0,122,44
2393,8,377,79,0,298,79
2393,7,443,102,0,341,102
2393,6,353,88,0,265,88
2393,5,122,35,0,87,35
2393,4,52,16,0,36,16
2393,3,16,2,0,14,2
2393,2,3,1,0,2,1
6050,10,98,57,0,41,57
6050,9,120,52,0,68,52
6050,8,326,131,0,195,131
6050,7,359,106,0,253,106
6050,6,357,129,0,228,129
6050,5,165,64,0,101,64
6050,4,122,76,0,46,76
6050,3,68,30,0,38,30
6050,2,41,15,0,26,15
6050,1,11,6,0,5,6
60579,10,19,2,0,17,2
60579,9,23,3,0,20,3
60579,8,148,32,0,116,32
60579,7,256,51,0,205,51
60579,6,544,127,0,417,127
60579,5,319,68,0,251,68
60579,4,200,46,0,154,46
60579,3,82,19,0,63,19
60579,2,56,15,0,41,15
60579,1,18,7,0,11,7
218530,10,67,15,0,52,15
218530,9,127,23,1,104,22
218530,8,439,56,10,383,46
218530,7,511,77,6,434,71
218530,6,342,43,3,299,40
218530,5,97,15,0,82,15
218530,4,45,12,0,33,12
218530,3,27,9,2,18,7
218530,2,9,2,0,7,2
173101,10,44,5,0,39,5
173101,9,101,12,0,89,12
173101,8,589,72,0,517,72
173101,7,505,73,0,432,73
173101,6,303,40,0,263,40
173101,5,82,18,0,64,18
173101,4,27,8,0,19,8
173101,3,6,2,0,4,2
173101,2,4,2,0,2,2
173101,1,3,1,0,2,1
146312,10,50,16,0,34,16
146312,9,106,23,0,83,23
146312,8,504,121,0,383,121
146312,7,538,111,0,427,111
146312,6,363,68,0,295,68
146312,5,59,6,0,53,6
146312,4,31,8,0,23,8
146312,3,7,1,0,6,1
146312,2,5,4,0,1,4
37907,10,14,4,0,10,4
37907,9,74,16,0,58,16
37907,8,546,137,0,409,137
37907,7,590,134,0,456,134
37907,6,320,71,0,249,71
37907,5,73,22,0,51,22
37907,4,29,6,0,23,6
37907,3,6,3,0,3,3
37907,2,2,1,0,1,1
123219,10,23,5,0,18,5
123219,9,51,10,0,41,10
123219,8,405,77,0,328,77
123219,7,575,85,0,490,85
123219,6,443,73,0,370,73
123219,5,113,19,0,94,19
123219,4,41,4,0,37,4
123219,3,6,1,0,5,1
86246,10,30,6,1,24,5
86246,9,101,27,2,74,25
86246,8,484,93,4,391,89
86246,7,493,82,3,411,79
86246,6,372,81,2,291,79
86246,5,90,21,1,69,20
86246,4,50,16,0,34,16
86246,3,22,6,0,16,6
86246,2,10,3,0,7,3
86246,1,4,1,0,3,1
183006,10,27,4,0,23,4
183006,9,86,22,0,64,22
183006,8,483,79,0,404,79
183006,7,611,97,0,514,97
183006,6,370,72,0,298,72
183006,5,60,5,0,55,5
183006,4,14,3,0,11,3
183006,3,3,1,0,2,1
79073,10,57,12,0,45,12
79073,9,92,17,0,75,17
79073,8,312,58,0,254,58
79073,7,424,76,0,348,76
79073,6,422,97,0,325,97
79073,5,178,29,0,149,29
79073,4,82,24,0,58,24
79073,3,45,18,0,27,18
79073,2,31,9,0,22,9
79073,1,9,2,0,7,2
1298,10,19,5,0,14,5
1298,9,22,4,0,18,4
1298,8,80,15,0,65,15
1298,7,128,22,0,106,22
1298,6,353,81,0,272,81
1298,5,441,81,0,360,81
1298,4,301,88,0,213,88
1298,3,165,58,0,107,58
1298,2,105,31,0,74,31
1298,1,35,11,0,24,11
215842,10,46,6,0,40,6
215842,9,149,23,0,126,23
215842,8,562,50,0,512,50
215842,7,466,37,0,429,37
215842,6,256,42,0,214,42
215842,5,84,13,0,71,13
215842,4,41,7,0,34,7
215842,3,24,7,0,17,7
215842,2,14,3,0,11,3
215842,1,10,3,0,7,3
134157,10,30,7,0,23,7
134157,9,105,28,0,77,28
134157,8,512,87,0,425,87
134157,7,480,82,0,398,82
134157,6,344,65,0,279,65
134157,5,101,25,0,76,25
134157,4,44,12,0,32,12
134157,3,24,11,0,13,11
134157,2,6,3,0,3,3
71021,10,27,4,0,23,4
71021,9,65,9,0,56,9
71021,8,241,38,0,203,38
71021,7,396,44,0,352,44
71021,6,548,80,0,468,80
71021,5,185,26,0,159,26
71021,4,105,11,0,94,11
71021,3,44,10,0,34,10
71021,2,20,3,0,17,3
71021,1,11,2,0,9,2
140717,10,24,3,0,21,3
140717,9,59,7,0,52,7
140717,8,371,64,6,307,58
140717,7,474,92,14,382,78
140717,6,428,88,7,340,81
140717,5,146,46,4,100,42
140717,4,81,35,2,46,33
140717,3,38,11,2,27,9
140717,2,15,7,0,8,7
140717,1,6,3,0,3,3
117942,10,8,3,0,5,3
117942,9,29,4,0,25,4
117942,8,266,55,0,211,55
117942,7,467,90,0,377,90
117942,6,594,119,0,475,119
117942,5,178,44,0,134,44
117942,4,67,16,0,51,16
117942,3,17,3,0,14,3
117942,2,13,6,0,7,6
34373,10,15,2,0,13,2
34373,9,36,10,0,26,10
34373,8,239,55,0,184,55
34373,7,504,104,0,400,104
34373,6,580,133,0,447,133
34373,5,152,37,0,115,37
34373,4,71,16,0,55,16
34373,3,30,12,0,18,12
34373,2,10,4,0,6,4
34373,1,4,1,0,3,1
67888,10,18,5,0,13,5
67888,9,69,15,0,54,15
67888,8,416,95,0,321,95
67888,7,512,99,0,413,99
67888,6,420,76,0,344,76
67888,5,125,19,0,106,19
67888,4,60,18,0,42,18
67888,3,12,2,0,10,2
67888,2,8,5,0,3,5
181796,10,43,8,0,35,8
181796,9,155,21,0,134,21
181796,8,660,97,0,563,97
181796,7,464,59,0,405,59
181796,6,212,36,0,176,36
181796,5,59,8,0,51,8
181796,4,28,6,0,22,6
181796,3,12,2,0,10,2
181796,2,4,3,0,1,3
89910,10,39,10,1,29,9
89910,9,108,26,2,82,24
89910,8,469,79,6,390,73
89910,7,495,80,5,415,75
89910,6,355,68,0,287,68
89910,5,102,24,1,78,23
89910,4,36,11,0,25,11
89910,3,13,7,0,6,7
89910,2,14,4,0,10,4
89910,1,7,3,0,4,3
228504,10,39,9,0,30,9
228504,9,114,21,0,93,21
228504,8,505,105,0,400,105
228504,7,559,87,0,472,87
228504,6,323,40,0,283,40
228504,5,70,16,0,54,16
228504,4,18,5,0,13,5
228504,3,8,2,0,6,2
228504,1,1,1,0,0,1
153507,10,28,4,0,24,4
153507,9,57,14,0,43,14
153507,8,403,61,0,342,61
153507,7,535,62,0,473,62
153507,6,436,62,0,374,62
153507,5,117,21,0,96,21
153507,4,39,9,0,30,9
153507,3,12,2,0,10,2
153507,2,5,1,0,4,1
153,10,9,3,0,6,3
153,9,37,2,0,35,2
153,8,215,43,0,172,43
153,7,515,73,0,442,73
153,6,586,94,0,492,94
153,5,179,43,0,136,43
153,4,71,18,0,53,18
153,3,13,5,0,8,5
153,2,6,3,0,3,3
139899,10,20,3,1,17,2
139899,9,61,18,0,43,18
139899,8,383,67,1,316,66
139899,7,519,81,4,438,77
139899,6,433,80,2,353,78
139899,5,120,28,1,92,27
139899,4,69,23,1,46,22
139899,3,15,2,0,13,2
139899,2,6,2,0,4,2
139899,1,4,2,0,2,2
139443,10,35,3,0,32,3
139443,9,55,7,0,48,7
139443,8,204,25,0,179,25
139443,7,301,43,0,258,43
139443,6,514,48,0,466,48
139443,5,270,45,0,225,45
139443,4,123,20,1,103,19
139443,3,56,8,0,48,8
139443,2,53,12,0,41,12
139443,1,20,6,0,14,6
224710,10,232,33,4,199,29
224710,9,328,38,9,290,29
224710,8,609,71,10,538,61
224710,7,288,33,4,255,29
224710,6,110,11,1,99,10
224710,5,26,4,1,22,3
224710,4,20,4,0,16,4
224710,3,9,2,0,7,2
224710,2,2,1,0,1,1
224710,1,9,2,1,7,1
80771,10,36,3,0,33,3
80771,9,35,3,0,32,3
80771,8,315,57,0,258,57
80771,7,522,85,0,437,85
80771,6,541,77,0,464,77
80771,5,122,13,0,109,13
80771,4,42,12,0,30,12
80771,3,9,1,0,8,1
80771,2,5,1,0,4,1
80771,1,3,1,0,2,1
18098,10,346,164,0,182,164
18098,9,342,113,0,229,113
18098,8,452,132,0,320,132
18098,7,232,69,0,163,69
18098,6,134,32,0,102,32
18098,5,45,21,0,24,21
18098,4,31,13,0,18,13
18098,3,16,7,0,9,7
18098,2,9,1,0,8,1
18098,1,20,1,0,19,1
103686,10,14,2,0,12,2
103686,9,53,15,0,38,15
103686,8,358,69,0,289,69
103686,7,537,79,0,458,79
103686,6,474,90,0,384,90
103686,5,119,27,0,92,27
103686,4,44,10,0,34,10
103686,3,18,4,0,14,4
103686,2,6,1,0,5,1
103686,1,4,2,0,2,2
173064,10,176,38,0,138,38
173064,9,361,70,0,291,70
173064,8,578,112,0,466,112
173064,7,268,40,0,228,40
173064,6,135,30,0,105,30
173064,5,49,18,0,31,18
173064,4,26,9,0,17,9
173064,3,20,7,0,13,7
173064,2,7,4,0,3,4
173064,1,8,2,0,6,2
209418,10,238,33,0,205,33
209418,9,359,45,0,314,45
209418,8,619,62,0,557,62
209418,7,267,30,0,237,30
209418,6,96,11,0,85,11
209418,5,25,6,0,19,6
209418,4,14,2,0,12,2
217861,10,25,5,0,20,5
217861,9,124,24,0,100,24
217861,8,540,67,0,473,67
217861,7,465,46,0,419,46
217861,6,313,38,0,275,38
217861,5,106,24,0,82,24
217861,4,30,6,0,24,6
217861,3,16,6,0,10,6
217861,2,2,1,0,1,1
217861,1,3,1,0,2,1
8946,10,8,1,0,7,1
8946,9,39,9,0,30,9
8946,8,154,38,0,116,38
8946,7,387,105,0,282,105
8946,6,622,147,0,475,147
8946,5,228,66,0,162,66
8946,4,108,34,0,74,34
8946,3,49,21,0,28,21
8946,2,20,13,0,7,13
8946,1,3,1,0,2,1
205494,10,28,4,0,24,4
205494,9,89,14,0,75,14
205494,8,368,53,0,315,53
205494,7,497,59,0,438,59
205494,6,405,68,0,337,68
205494,5,125,24,0,101,24
205494,4,60,20,0,40,20
205494,3,29,10,0,19,10
205494,2,14,6,0,8,6
205494,1,5,3,0,2,3
40381,10,10,2,0,8,2
40381,9,55,13,0,42,13
40381,8,312,103,1,209,102
40381,7,502,124,0,378,124
40381,6,510,115,1,395,114
40381,5,147,39,0,108,39
40381,4,53,19,0,34,19
40381,3,19,11,0,8,11
40381,2,6,3,0,3,3
40381,1,3,1,0,2,1
54307,10,26,7,0,19,7
54307,9,74,19,0,55,19
54307,8,398,94,0,304,94
54307,7,513,93,0,420,93
54307,6,422,81,0,341,81
54307,5,112,23,0,89,23
54307,4,44,13,0,31,13
54307,3,16,8,0,8,8
54307,2,7,3,0,4,3
54307,1,3,1,0,2,1
85036,10,16,5,0,11,5
85036,9,64,13,0,51,13
85036,8,451,88,0,363,88
85036,7,557,116,0,441,116
85036,6,361,92,0,269,92
85036,5,102,20,0,82,20
85036,4,45,16,0,29,16
85036,3,12,6,0,6,6
85036,2,4,2,0,2,2
23451,10,13,5,0,8,5
23451,9,63,15,0,48,15
23451,8,337,105,0,232,105
23451,7,456,138,0,318,138
23451,6,456,143,0,313,143
23451,5,164,41,0,123,41
23451,4,78,39,0,39,39
23451,3,34,15,0,19,15
23451,2,11,8,0,3,8
23451,1,3,2,0,1,2
22287,10,5,3,0,2,3
22287,9,21,5,0,16,5
22287,8,186,63,0,123,63
22287,7,442,125,0,317,125
22287,6,649,151,0,498,151
22287,5,208,54,0,154,54
22287,4,78,28,0,50,28
22287,3,16,5,0,11,5
22287,2,7,4,0,3,4
22287,1,2,1,0,1,1
129351,10,22,6,0,16,6
129351,9,55,11,0,44,11
129351,8,326,61,0,265,61
129351,7,470,72,0,398,72
129351,6,465,82,0,383,82
129351,5,152,34,0,118,34
129351,4,73,19,0,54,19
129351,3,29,12,0,17,12
129351,2,17,5,0,12,5
129351,1,3,3,0,0,3
153999,10,11,3,0,8,3
153999,9,30,7,0,23,7
153999,8,210,45,3,165,42
153999,7,413,73,3,340,70
153999,6,546,103,7,443,96
153999,5,224,48,2,176,46
153999,4,98,29,0,69,29
153999,3,41,13,1,28,12
153999,2,29,14,1,15,13
153999,1,11,2,0,9,2
163839,10,239,47,5,192,42
163839,9,326,62,7,264,55
163839,8,504,77,4,427,73
163839,7,202,37,4,165,33
163839,6,169,36,1,133,35
163839,5,68,17,1,51,16
163839,4,37,16,1,21,15
163839,3,39,17,3,22,14
163839,2,22,8,2,14,6
163839,1,11,2,0,9,2
29839,10,13,5,0,8,5
29839,9,65,15,0,50,15
29839,8,431,110,0,321,110
29839,7,503,113,0,390,113
29839,6,413,111,0,302,111
29839,5,108,36,0,72,36
29839,4,48,28,0,20,28
29839,3,18,9,0,9,9
29839,2,7,5,0,2,5
1690,10,17,6,0,11,6
1690,9,43,10,0,33,10
1690,8,180,48,4,132,44
1690,7,366,70,1,296,69
1690,6,552,103,1,449,102
1690,5,229,45,1,184,44
1690,4,134,35,0,99,35
1690,3,50,24,0,26,24
1690,2,29,11,0,18,11
1690,1,8,4,0,4,4
655,9,29,11,0,18,11
655,8,187,59,0,128,59
655,7,379,93,0,286,93
655,6,579,161,0,418,161
655,5,253,82,0,171,82
655,4,105,40,0,65,40
655,3,51,24,0,27,24
655,2,19,8,0,11,8
655,1,2,2,0,0,2
61692,10,207,43,0,164,43
61692,9,252,44,0,208,44
61692,8,423,75,0,348,75
61692,7,354,49,0,305,49
61692,6,233,36,0,197,36
61692,5,63,12,0,51,12
61692,4,36,7,0,29,7
61692,3,17,3,0,14,3
61692,2,9,3,0,6,3
61692,1,13,4,0,9,4
7804,10,10,3,0,7,3
7804,9,34,15,0,19,15
7804,8,195,68,0,127,68
7804,7,412,108,0,304,108
7804,6,577,161,0,416,161
7804,5,226,70,0,156,70
7804,4,95,32,0,63,32
7804,3,32,15,0,17,15
7804,2,20,7,0,13,7
7804,1,5,3,0,2,3
1923,10,3,1,0,2,1
1923,9,20,5,0,15,5
1923,8,60,14,0,46,14
1923,7,129,24,0,105,24
1923,6,328,84,0,244,84
1923,5,392,83,0,309,83
1923,4,324,90,0,234,90
1923,3,189,61,0,128,61
1923,2,105,45,0,60,45
1923,1,56,38,0,18,38
191572,10,7,1,0,6,1
191572,9,32,9,0,23,9
191572,8,302,64,0,238,64
191572,7,573,107,0,466,107
191572,6,526,107,0,419,107
191572,5,125,19,0,106,19
191572,4,35,9,0,26,9
191572,3,7,1,0,6,1
191572,2,3,2,0,1,2
180564,10,43,8,0,35,8
180564,9,79,8,0,71,8
180564,8,353,55,0,298,55
180564,7,527,84,0,443,84
180564,6,386,62,0,324,62
180564,5,114,18,0,96,18
180564,4,55,18,0,37,18
180564,3,28,7,0,21,7
180564,2,6,2,0,4,2
180564,1,9,2,0,7,2
73,10,44,19,0,25,19
73,9,84,32,0,52,32
73,8,478,136,0,342,136
73,7,528,112,0,416,112
73,6,327,88,0,239,88
73,5,76,23,0,53,23
73,4,40,13,0,27,13
73,3,15,3,0,12,3
73,2,6,1,0,5,1
184151,10,231,46,0,185,46
184151,9,290,40,0,250,40
184151,8,458,58,0,400,58
184151,7,297,34,0,263,34
184151,6,192,30,0,162,30
184151,5,65,16,0,49,16
184151,4,30,9,0,21,9
184151,3,19,6,0,13,6
184151,2,7,2,0,5,2
184151,1,9,4,0,5,4
24762,10,15,4,0,11,4
24762,9,49,20,0,29,20
24762,8,301,118,0,183,118
24762,7,493,155,0,338,155
24762,6,454,147,0,307,147
24762,5,164,54,0,110,54
24762,4,68,37,0,31,37
24762,3,40,24,0,16,24
24762,2,7,3,0,4,3
24762,1,4,1,0,3,1
189052,10,21,4,0,17,4
189052,9,70,17,0,53,17
189052,8,369,61,0,308,61
189052,7,506,82,0,424,82
189052,6,450,57,0,393,57
189052,5,114,16,0,98,16
189052,4,47,9,0,38,9
189052,3,9,4,0,5,4
189052,2,4,1,0,3,1
189052,1,4,1,0,3,1
66588,10,26,6,0,20,6
66588,9,70,10,0,60,10
66588,8,407,81,0,326,81
66588,7,571,103,0,468,103
66588,6,378,62,0,316,62
66588,5,96,18,0,78,18
66588,4,26,5,0,21,5
66588,3,10,2,0,8,2
66588,2,3,1,0,2,1
123607,10,143,48,1,95,47
123607,9,178,42,0,136,42
123607,8,477,103,4,374,99
123607,7,341,60,0,281,60
123607,6,285,47,0,238,47
123607,5,77,13,0,64,13
123607,4,43,8,0,35,8
123607,3,20,8,0,12,8
123607,2,13,3,0,10,3
123607,1,14,2,0,12,2
195528,10,16,4,0,12,4
195528,9,48,9,0,39,9
195528,8,475,67,0,408,67
195528,7,559,71,0,488,71
195528,6,348,56,0,292,56
195528,5,99,22,0,77,22
195528,4,33,9,0,24,9
195528,3,9,5,0,4,5
19,10,12,6,0,6,6
19,9,28,4,0,24,4
19,8,198,53,0,145,53
19,7,412,89,0,323,89
19,6,634,154,0,480,154
19,5,203,49,0,154,49
19,4,73,22,0,51,22
19,3,20,7,0,13,7
19,2,7,2,0,5,2
218417,10,311,50,6,261,44
218417,9,515,77,9,438,68
218417,8,552,89,9,463,80
218417,7,129,26,0,103,26
218417,6,50,10,0,40,10
218417,5,16,3,0,13,3
218417,4,8,1,0,7,1
218417,1,4,1,0,3,1
71906,10,53,13,0,40,13
71906,9,134,18,0,116,18
71906,8,450,76,0,374,76
71906,7,446,76,0,370,76
71906,6,339,69,0,270,69
71906,5,87,24,0,63,24
71906,4,40,14,0,26,14
71906,3,25,7,0,18,7
71906,2,12,5,0,7,5
36811,10,26,6,0,20,6
36811,9,85,25,0,60,25
36811,8,503,130,0,373,130
36811,7,495,125,0,370,125
36811,6,323,73,0,250,73
36811,5,83,30,0,53,30
36811,4,46,13,0,33,13
36811,3,14,5,0,9,5
36811,2,9,2,0,7,2
174078,10,32,6,0,26,6
174078,9,62,14,0,48,14
174078,8,425,57,0,368,57
174078,7,522,73,0,449,73
174078,6,406,59,0,347,59
174078,5,86,16,0,70,16
174078,4,31,5,0,26,5
174078,3,17,7,0,10,7
174078,2,4,1,0,3,1
174078,1,3,1,0,2,1
254640,10,52,6,0,46,6
254640,9,199,35,0,164,35
254640,8,678,95,0,583,95
254640,7,451,72,0,379,72
254640,6,162,27,0,135,27
254640,5,36,7,0,29,7
254640,4,15,4,0,11,4
254640,2,4,2,0,2,2
11634,10,22,3,0,19,3
11634,9,26,6,0,20,6
11634,8,138,37,0,101,37
11634,7,248,51,0,197,51
11634,6,491,113,0,378,113
11634,5,301,64,0,237,64
11634,4,203,69,0,134,69
11634,3,76,26,0,50,26
11634,2,52,25,0,27,25
11634,1,31,11,0,20,11
21641,10,3,2,0,1,2
21641,9,23,15,0,8,15
21641,8,239,99,0,140,99
21641,7,493,163,0,330,163
21641,6,570,194,0,376,194
21641,5,162,60,0,102,60
21641,4,59,21,0,38,21
21641,3,26,13,0,13,13
21641,2,7,3,0,4,3
21641,1,3,1,0,2,1
35505,10,24,5,1,19,4
35505,9,50,10,1,40,9
35505,8,304,65,5,239,60
35505,7,453,64,3,389,61
35505,6,544,83,5,461,78
35505,5,128,27,3,101,24
35505,4,53,16,0,37,16
35505,3,19,3,0,16,3
35505,2,7,2,1,5,1
35505,1,3,1,0,2,1
1536,10,17,2,0,15,2
1536,9,29,8,0,21,8
1536,8,157,39,1,118,38
1536,7,309,64,1,245,63
1536,6,587,129,1,458,128
1536,5,260,67,0,193,67
1536,4,134,39,0,95,39
1536,3,57,28,0,29,28
1536,2,25,6,0,19,6
1536,1,9,2,0,7,2
805,10,30,11,0,19,11
805,9,74,28,0,46,28
805,8,292,120,0,172,120
805,7,471,153,0,318,153
805,6,483,182,0,301,182
805,5,137,50,0,87,50
805,4,56,22,0,34,22
805,3,19,8,0,11,8
805,2,13,4,0,9,4
805,1,9,2,0,7,2
166286,10,39,16,0,23,16
166286,9,107,24,0,83,24
166286,8,389,76,4,313,72
166286,7,469,87,5,382,82
166286,6,392,79,7,313,72
166286,5,113,26,1,87,25
166286,4,49,18,1,31,17
166286,3,15,5,1,10,4
166286,2,7,2,0,5,2
166286,1,5,1,0,4,1
287,10,23,7,0,16,7
287,9,50,23,0,27,23
287,8,272,102,0,170,102
287,7,465,131,0,334,131
287,6,493,157,0,336,157
287,5,155,59,0,96,59
287,4,88,44,0,44,44
287,3,16,4,0,12,4
287,2,16,8,0,8,8
287,1,3,3,0,0,3
204516,10,92,26,2,66,24
204516,9,246,54,5,192,49
204516,8,674,118,6,556,112
204516,7,336,51,7,285,44
204516,6,147,26,1,121,25
204516,5,37,10,1,27,9
204516,4,22,7,0,15,7
204516,3,14,6,0,8,6
204516,2,9,2,0,7,2
204516,1,6,3,0,3,3
30367,10,15,8,0,7,8
30367,9,61,30,0,31,30
30367,8,381,119,0,262,119
30367,7,528,140,0,388,140
30367,6,408,108,0,300,108
30367,5,111,36,0,75,36
30367,4,54,18,0,36,18
30367,3,12,8,0,4,8
38765,10,52,11,0,41,11
38765,9,133,36,6,97,30
38765,8,500,116,6,384,110
38765,7,421,101,7,320,94
38765,6,301,78,2,223,76
38765,5,88,19,0,69,19
38765,4,51,21,0,30,21
38765,3,23,12,1,11,11
38765,2,4,2,0,2,2
38765,1,6,2,0,4,2
89409,10,239,70,3,169,67
89409,9,271,56,3,215,53
89409,8,487,91,4,396,87
89409,7,287,42,3,245,39
89409,6,192,39,2,153,37
89409,5,50,11,1,39,10
89409,4,28,6,0,22,6
89409,3,13,4,1,9,3
89409,2,4,1,0,3,1
589,10,97,42,0,55,42
589,9,124,56,0,68,56
589,8,324,122,0,202,122
589,7,401,108,0,293,108
589,6,374,113,0,261,113
589,5,151,42,0,109,42
589,4,69,27,0,42,27
589,3,19,6,0,13,6
589,2,13,4,0,9,4
589,1,5,3,0,2,3
144529,10,67,13,0,54,13
144529,9,150,38,0,112,38
144529,8,480,103,0,377,103
144529,7,409,64,0,345,64
144529,6,298,53,0,245,53
144529,5,94,11,0,83,11
144529,4,47,8,0,39,8
144529,3,16,3,0,13,3
144529,2,9,2,0,7,2
20022,10,12,3,0,9,3
20022,9,30,16,0,14,16
20022,8,260,88,0,172,88
20022,7,434,111,0,323,111
20022,6,555,130,0,425,130
20022,5,180,36,0,144,36
20022,4,67,22,0,45,22
20022,3,26,10,0,16,10
20022,1,5,1,0,4,1
95234,10,22,3,0,19,3
95234,9,47,3,0,44,3
95234,8,255,39,0,216,39
95234,7,424,55,0,369,55
95234,6,526,83,0,443,83
95234,5,170,38,0,132,38
95234,4,88,26,0,62,26
95234,3,29,8,0,21,8
95234,2,9,1,0,8,1
95234,1,5,2,0,3,2
212445,10,282,40,0,242,40
212445,9,383,53,0,330,53
212445,8,504,60,0,444,60
212445,7,236,25,0,211,25
212445,6,103,17,0,86,17
212445,5,31,7,0,24,7
212445,4,15,3,0,12,3
212445,3,8,1,0,7,1
212445,2,3,2,0,1,2
212445,1,10,4,0,6,4
1887,10,139,29,0,110,29
1887,9,171,38,0,133,38
1887,8,367,93,0,274,93
1887,7,364,75,0,289,75
1887,6,318,66,0,252,66
1887,5,116,26,0,90,26
1887,4,60,15,0,45,15
1887,3,18,6,0,12,6
1887,2,9,3,0,6,3
1887,1,8,4,0,4,4
123499,10,47,10,0,37,10
123499,9,140,25,0,115,25
123499,8,568,114,7,454,107
123499,7,437,85,0,352,85
123499,6,268,56,1,212,55
123499,5,62,24,0,38,24
123499,4,23,5,0,18,5
123499,3,16,4,0,12,4
123499,2,7,3,0,4,3
123499,1,3,1,0,2,1
3421,10,29,18,0,11,18
3421,9,64,35,0,29,35
3421,8,302,144,0,158,144
3421,7,444,170,0,274,170
3421,6,443,142,0,301,142
3421,5,154,62,0,92,62
3421,4,80,23,0,57,23
3421,3,34,14,0,20,14
3421,2,13,3,0,10,3
3421,1,4,1,0,3,1
3421,0,1,1,0,0,1
814,10,13,3,0,10,3
814,9,27,5,0,22,5
814,8,165,37,0,128,37
814,7,340,96,0,244,96
814,6,549,124,0,425,124
814,5,276,78,0,198,78
814,4,116,45,0,71,45
814,3,43,21,0,22,21
814,2,33,15,0,18,15
814,1,6,1,0,5,1
58,10,32,11,0,21,11
58,9,70,24,0,46,24
58,8,269,86,0,183,86
58,7,470,106,0,364,106
58,6,433,85,0,348,85
58,5,161,49,0,112,49
58,4,81,20,0,61,20
58,3,23,7,0,16,7
58,2,17,1,0,16,1
58,1,10,3,0,7,3
258036,10,62,8,0,54,8
258036,9,190,18,0,172,18
258036,8,678,90,0,588,90
258036,7,387,42,0,345,42
258036,6,159,30,0,129,30
258036,5,56,15,0,41,15
258036,4,27,10,0,17,10
258036,3,9,2,0,7,2
258036,2,3,1,0,2,1
258036,1,4,3,0,1,3
20134,10,21,11,0,10,11
20134,9,67,37,0,30,37
20134,8,414,165,0,249,165
20134,7,489,163,0,326,163
20134,6,369,124,0,245,124
20134,5,126,37,0,89,37
20134,4,52,17,0,35,17
20134,3,19,5,0,14,5
20134,2,5,1,0,4,1
20134,1,4,1,0,3,1
234190,10,80,21,2,59,19
234190,9,102,20,1,82,19
234190,8,253,37,3,216,34
234190,7,369,56,2,313,54
234190,6,390,52,3,338,49
234190,5,152,19,0,133,19
234190,4,116,23,2,93,21
234190,3,53,17,2,36,15
234190,2,44,12,0,32,12
234190,1,14,3,0,11,3
1899,10,26,8,0,18,8
1899,9,39,10,0,29,10
1899,8,132,27,0,105,27
1899,7,245,47,0,198,47
1899,6,562,137,0,425,137
1899,5,329,81,0,248,81
1899,4,143,40,0,103,40
1899,3,59,19,0,40,19
1899,2,25,7,0,18,7
173442,10,177,39,0,138,39
173442,9,317,65,3,252,62
173442,8,620,85,6,535,79
173442,7,256,29,1,227,28
173442,6,126,20,1,106,19
173442,5,40,6,0,34,6
173442,4,12,2,0,10,2
173442,3,11,4,0,7,4
173442,1,5,1,0,4,1
165401,10,126,31,0,95,31
165401,9,303,67,0,236,67
165401,8,664,127,0,537,127
165401,7,291,46,0,245,46
165401,6,122,27,0,95,27
165401,5,24,3,0,21,3
165401,4,17,3,0,14,3
165401,3,9,4,0,5,4
165401,2,3,1,0,2,1
2238,10,38,11,0,27,11
2238,9,70,31,0,39,31
2238,8,249,83,0,166,83
2238,7,416,116,0,300,116
2238,6,479,136,0,343,136
2238,5,190,62,0,128,62
2238,4,74,33,0,41,33
2238,3,32,12,0,20,12
2238,2,8,6,0,2,6
2238,1,3,1,0,2,1
215841,10,45,6,0,39,6
215841,9,149,19,0,130,19
215841,8,523,49,0,474,49
215841,7,453,36,0,417,36
215841,6,250,30,0,220,30
215841,5,70,13,0,57,13
215841,4,31,12,0,19,12
215841,3,22,4,0,18,4
215841,2,12,3,0,9,3
215841,1,8,2,0,6,2
195137,10,102,22,0,80,22
195137,9,239,34,4,205,30
195137,8,633,100,2,533,98
195137,7,322,42,2,280,40
195137,6,172,27,0,145,27
195137,5,54,8,0,46,8
195137,4,24,5,0,19,5
195137,3,9,2,0,7,2
195137,2,1,1,0,0,1
168681,10,20,5,0,15,5
168681,9,82,13,0,69,13
168681,8,469,98,0,371,98
168681,7,490,91,0,399,91
168681,6,362,59,0,303,59
168681,5,84,21,0,63,21
168681,4,29,6,0,23,6
168681,3,13,2,0,11,2
168681,2,7,4,0,3,4
175293,10,23,4,0,19,4
175293,9,64,11,0,53,11
175293,8,435,76,0,359,76
175293,7,566,82,0,484,82
175293,6,353,59,0,294,59
175293,5,70,15,0,55,15
175293,4,31,8,0,23,8
175293,3,9,2,0,7,2
175293,2,3,3,0,0,3
175293,1,3,1,0,2,1
158243,10,6,3,1,3,2
158243,9,13,3,0,10,3
158243,8,106,30,6,76,24
158243,7,259,50,10,209,40
158243,6,560,125,18,435,107
158243,5,317,65,10,252,55
158243,4,165,38,3,127,35
158243,3,88,33,4,55,29
158243,2,29,10,0,19,10
158243,1,12,7,0,5,7
130882,10,8,1,0,7,1
130882,9,39,8,0,31,8
130882,8,269,43,0,226,43
130882,7,514,65,0,449,65
130882,6,535,79,0,456,79
130882,5,117,19,0,98,19
130882,4,50,9,0,41,9
130882,3,13,1,0,12,1
130882,2,6,1,0,5,1
130882,1,3,1,0,2,1
33468,10,37,15,0,22,15
33468,9,47,16,0,31,16
33468,8,184,56,0,128,56
33468,7,371,127,0,244,127
33468,6,578,191,0,387,191
33468,5,209,69,0,140,69
33468,4,88,30,0,58,30
33468,3,19,7,0,12,7
33468,2,15,6,0,9,6
33468,1,4,2,0,2,2
14,10,17,9,0,8,9
14,9,64,33,0,31,33
14,8,350,141,0,209,141
14,7,503,154,0,349,154
14,6,434,152,0,282,152
14,5,123,48,0,75,48
14,4,41,16,0,25,16
14,3,14,6,0,8,6
14,2,4,2,0,2,2
4862,10,8,1,0,7,1
4862,9,26,8,0,18,8
4862,8,132,34,0,98,34
4862,7,258,57,0,201,57
4862,6,538,112,0,426,112
4862,5,332,61,0,271,61
4862,4,167,48,0,119,48
4862,3,71,27,0,44,27
4862,2,17,6,0,11,6
4862,1,3,2,0,1,2
231581,10,81,25,4,56,21
231581,9,249,53,5,196,48
231581,8,652,104,9,548,95
231581,7,315,61,6,254,55
231581,6,180,29,0,151,29
231581,5,37,8,0,29,8
231581,4,25,7,0,18,7
231581,3,15,3,0,12,3
40214,10,11,3,0,8,3
40214,9,14,6,0,8,6
40214,8,199,63,0,136,63
40214,7,466,127,0,339,127
40214,6,576,129,0,447,129
40214,5,189,58,0,131,58
40214,4,56,24,0,32,24
40214,3,28,12,0,16,12
40214,2,8,4,0,4,4
40214,1,3,2,0,1,2
132028,10,180,37,0,143,37
132028,9,376,72,0,304,72
132028,8,581,89,0,492,89
132028,7,250,42,0,208,42
132028,6,97,19,0,78,19
132028,5,32,11,0,21,11
132028,3,9,4,0,5,4
132028,1,7,1,0,6,1
1822,10,119,48,0,71,48
1822,9,280,109,0,171,109
1822,8,582,170,0,412,170
1822,7,349,116,0,233,116
1822,6,136,44,0,92,44
1822,5,52,14,0,38,14
1822,4,21,8,0,13,8
1822,3,7,3,0,4,3
6366,10,37,12,0,25,12
6366,9,71,22,0,49,22
6366,8,244,60,0,184,60
6366,7,415,79,0,336,79
6366,6,485,111,0,374,111
6366,5,178,42,0,136,42
6366,4,69,15,0,54,15
6366,3,30,5,0,25,5
6366,2,14,1,0,13,1
6366,1,5,1,0,4,1
69120,10,31,6,0,25,6
69120,9,36,8,0,28,8
69120,8,236,46,0,190,46
69120,7,381,64,0,317,64
69120,6,498,94,0,404,94
69120,5,205,36,0,169,36
69120,4,102,30,0,72,30
69120,3,33,4,0,29,4
69120,2,21,5,0,16,5
69120,1,5,2,0,3,2
41833,10,14,4,0,10,4
41833,9,29,4,0,25,4
41833,8,137,36,0,101,36
41833,7,317,55,0,262,55
41833,6,563,109,0,454,109
41833,5,263,41,0,222,41
41833,4,136,26,0,110,26
41833,3,48,14,0,34,14
41833,2,31,11,0,20,11
41833,1,8,1,0,7,1
164812,10,39,9,0,30,9
164812,9,69,14,0,55,14
164812,8,250,36,0,214,36
164812,7,457,65,0,392,65
164812,6,511,77,0,434,77
164812,5,132,23,0,109,23
164812,4,59,16,0,43,16
164812,3,16,4,0,12,4
164812,2,9,4,0,5,4
164812,1,6,2,0,4,2
17027,10,25,2,0,23,2
17027,9,26,7,0,19,7
17027,8,168,35,0,133,35
17027,7,338,68,0,270,68
17027,6,565,115,0,450,115
17027,5,225,38,0,187,38
17027,4,119,36,0,83,36
17027,3,45,14,0,31,14
17027,2,22,11,0,11,11
17027,1,10,3,0,7,3
223953,10,66,10,2,56,8
223953,9,193,21,1,172,20
223953,8,647,102,12,545,90
223953,7,388,34,2,354,32
223953,6,171,20,0,151,20
223953,5,43,10,1,33,9
223953,4,23,2,0,21,2
223953,3,4,1,0,3,1
223953,2,4,3,0,1,3
223953,1,5,2,1,3,1
71074,10,34,11,0,23,11
71074,9,99,27,0,72,27
71074,8,477,94,0,383,94
71074,7,457,83,0,374,83
71074,6,330,75,0,255,75
71074,5,83,17,0,66,17
71074,4,40,7,0,33,7
71074,3,12,1,0,11,1
71074,2,5,1,0,4,1
71074,1,2,1,0,1,1
183231,10,15,4,0,11,4
183231,9,83,17,0,66,17
183231,8,439,83,0,356,83
183231,7,529,93,0,436,93
183231,6,330,66,0,264,66
183231,5,96,22,0,74,22
183231,4,30,6,0,24,6
183231,3,16,2,0,14,2
183231,2,3,2,0,1,2
133632,10,40,10,0,30,10
133632,9,96,22,0,74,22
133632,8,457,93,1,364,92
133632,7,421,76,0,345,76
133632,6,322,58,0,264,58
133632,5,98,23,0,75,23
133632,4,57,22,0,35,22
133632,3,33,12,0,21,12
133632,2,10,7,0,3,7
133632,1,4,2,0,2,2
827,10,6,3,0,3,3
827,9,39,13,0,26,13
827,8,247,89,0,158,89
827,7,515,154,0,361,154
827,6,490,127,0,363,127
827,5,140,40,0,100,40
827,4,68,32,0,36,32
827,3,24,10,0,14,10
827,2,3,2,0,1,2
827,1,4,1,0,3,1
94480,10,22,4,0,18,4
94480,9,63,11,0,52,11
94480,8,386,66,0,320,66
94480,7,507,81,0,426,81
94480,6,357,58,0,299,58
94480,5,110,29,0,81,29
94480,4,51,14,0,37,14
94480,3,22,8,0,14,8
94480,2,10,3,0,7,3
94480,1,6,1,0,5,1
215341,10,224,47,7,177,40
215341,9,379,61,11,318,50
215341,8,575,78,13,497,65
215341,7,201,38,1,163,37
215341,6,99,16,2,83,14
215341,5,35,9,0,26,9
215341,4,9,4,0,5,4
215341,3,6,4,0,2,4
215341,2,3,1,0,2,1
215341,1,9,3,0,6,3
135649,10,20,3,0,17,3
135649,9,34,5,0,29,5
135649,8,222,44,0,178,44
135649,7,441,86,0,355,86
135649,6,599,105,0,494,105
135649,5,149,29,0,120,29
135649,4,38,11,0,27,11
135649,3,20,4,0,16,4
135649,2,8,3,0,5,3
173200,10,63,4,0,59,4
173200,9,116,11,0,105,11
173200,8,313,30,0,283,30
173200,7,408,39,0,369,39
173200,6,403,44,0,359,44
173200,5,119,19,0,100,19
173200,4,51,9,0,42,9
173200,3,31,7,0,24,7
173200,2,18,4,0,14,4
173200,1,10,3,0,7,3
123570,10,52,11,0,41,11
123570,9,106,12,0,94,12
123570,8,334,56,0,278,56
123570,7,419,60,0,359,60
123570,6,369,52,0,317,52
123570,5,131,22,0,109,22
123570,4,61,12,0,49,12
123570,3,36,8,0,28,8
123570,2,14,4,0,10,4
123570,1,9,2,0,7,2
140519,10,137,43,6,94,37
140519,9,196,50,5,146,45
140519,8,349,95,14,254,81
140519,7,239,49,8,190,41
140519,6,226,46,4,180,42
140519,5,115,25,2,90,23
140519,4,87,35,6,52,29
140519,3,63,29,4,34,25
140519,2,53,23,2,30,21
140519,1,65,33,3,32,30
63543,10,67,21,0,46,21
63543,9,118,31,0,87,31
63543,8,462,92,0,370,92
63543,7,403,61,0,342,61
63543,6,302,61,0,241,61
63543,5,85,19,0,66,19
63543,4,47,15,0,32,15
63543,3,28,7,0,21,7
63543,2,11,2,0,9,2
83629,10,13,4,0,9,4
83629,9,24,4,0,20,4
83629,8,139,32,0,107,32
83629,7,350,65,0,285,65
83629,6,567,93,0,474,93
83629,5,230,42,0,188,42
83629,4,116,21,0,95,21
83629,3,57,10,0,47,10
83629,2,22,10,0,12,10
83629,1,8,1,0,7,1
137095,10,20,3,0,17,3
137095,9,31,3,0,28,3
137095,8,196,32,0,164,32
137095,7,362,61,0,301,61
137095,6,529,79,0,450,79
137095,5,198,31,0,167,31
137095,4,101,26,0,75,26
137095,3,65,20,0,45,20
137095,2,21,6,0,15,6
172385,10,23,2,0,21,2
172385,9,121,20,0,101,20
172385,8,572,81,0,491,81
172385,7,473,81,0,392,81
172385,6,236,42,0,194,42
172385,5,63,12,0,51,12
172385,4,28,8,0,20,8
172385,3,8,1,0,7,1
172385,2,1,1,0,0,1
3565,10,105,27,0,78,27
3565,9,184,34,0,150,34
3565,8,425,82,0,343,82
3565,7,404,71,0,333,71
3565,6,245,43,0,202,43
3565,5,95,24,0,71,24
3565,4,39,9,0,30,9
3565,3,13,5,0,8,5
3565,2,8,2,0,6,2
3565,1,8,1,0,7,1
568,10,20,8,0,12,8
568,9,52,19,0,33,19
568,8,182,49,0,133,49
568,7,349,83,0,266,83
568,6,521,119,0,402,119
568,5,208,63,0,145,63
568,4,131,44,0,87,44
568,3,45,16,0,29,16
568,2,14,7,0,7,7
568,1,3,1,0,2,1
154182,10,17,1,0,16,1
154182,9,48,11,0,37,11
154182,8,399,61,0,338,61
154182,7,503,71,0,432,71
154182,6,385,80,0,305,80
154182,5,115,25,0,90,25
154182,4,41,13,0,28,13
154182,3,14,3,0,11,3
154182,2,1,1,0,0,1
85250,10,19,3,0,16,3
85250,9,52,6,0,46,6
85250,8,315,63,0,252,63
85250,7,423,65,0,358,65
85250,6,445,79,0,366,79
85250,5,154,29,0,125,29
85250,4,71,15,0,56,15
85250,3,26,9,0,17,9
85250,2,12,6,0,6,6
85250,1,4,1,0,3,1
71882,10,30,9,0,21,9
71882,9,93,25,0,68,25
71882,8,421,110,0,311,110
71882,7,457,100,0,357,100
71882,6,354,82,0,272,82
71882,5,93,19,0,74,19
71882,4,33,12,0,21,12
71882,3,26,9,0,17,9
71882,2,11,5,0,6,5
3522,10,15,6,0,9,6
3522,9,8,3,0,5,3
3522,8,24,6,0,18,6
3522,7,56,10,0,46,10
3522,6,126,26,0,100,26
3522,5,197,40,0,157,40
3522,4,249,62,0,187,62
3522,3,184,54,0,130,54
3522,2,207,77,0,130,77
3522,1,456,222,0,234,222
5336,10,55,14,0,41,14
5336,9,76,21,0,55,21
5336,8,249,62,0,187,62
5336,7,333,82,0,251,82
5336,6,414,97,0,317,97
5336,5,175,53,0,122,53
5336,4,98,40,0,58,40
5336,3,58,13,0,45,13
5336,2,45,17,0,28,17
5336,1,16,9,0,7,9
183571,10,59,19,0,40,19
183571,9,154,38,4,116,34
183571,8,571,135,23,436,112
183571,7,428,76,10,352,66
183571,6,236,57,7,179,50
183571,5,45,14,0,31,14
183571,4,17,4,1,13,3
183571,3,9,4,0,5,4
183571,2,2,2,0,0,2
183571,1,6,3,0,3,3
98085,10,29,4,0,25,4
98085,9,35,5,0,30,5
98085,8,188,36,0,152,36
98085,7,365,59,0,306,59
98085,6,546,79,0,467,79
98085,5,214,39,0,175,39
98085,4,96,19,0,77,19
98085,3,32,8,0,24,8
98085,2,12,5,0,7,5
98085,1,3,1,0,2,1
19301,10,11,5,0,6,5
19301,9,29,7,0,22,7
19301,8,259,73,0,186,73
19301,7,517,138,0,379,138
19301,6,464,138,0,326,138
19301,5,161,55,0,106,55
19301,4,52,18,0,34,18
19301,3,21,11,0,10,11
19301,2,5,4,0,1,4
223040,10,61,13,0,48,13
223040,9,166,27,0,139,27
223040,8,567,78,0,489,78
223040,7,381,51,0,330,51
223040,6,255,44,0,211,44
223040,5,66,13,0,53,13
223040,4,21,6,0,15,6
223040,3,8,2,0,6,2
223040,1,2,1,0,1,1
66214,10,18,8,0,10,8
66214,9,58,14,0,44,14
66214,8,398,113,0,285,113
66214,7,532,119,0,413,119
66214,6,386,106,0,280,106
66214,5,78,17,0,61,17
66214,4,35,20,0,15,20
66214,3,7,3,0,4,3
66214,2,3,1,0,2,1
66214,1,3,1,0,2,1
3141,10,10,4,0,6,4
3141,9,30,11,0,19,11
3141,8,172,65,0,107,65
3141,7,450,142,0,308,142
3141,6,550,174,0,376,174
3141,5,200,56,0,144,56
3141,4,76,29,0,47,29
3141,3,18,11,0,7,11
3141,2,4,2,0,2,2
3141,1,5,1,0,4,1
4488,10,6,1,0,5,1
4488,9,19,11,0,8,11
4488,8,155,69,0,86,69
4488,7,372,111,0,261,111
4488,6,550,167,0,383,167
4488,5,223,65,0,158,65
4488,4,110,33,0,77,33
4488,3,53,22,0,31,22
4488,2,15,8,0,7,8
4488,1,11,7,0,4,7
157001,10,48,12,0,36,12
157001,9,198,42,0,156,42
157001,8,641,103,0,538,103
157001,7,382,67,0,315,67
157001,6,175,32,0,143,32
157001,5,39,7,0,32,7
157001,4,21,8,0,13,8
157001,3,4,1,0,3,1
157001,1,5,2,0,3,2
80006,10,15,2,0,13,2
80006,9,41,11,0,30,11
80006,8,271,66,0,205,66
80006,7,453,101,0,352,101
80006,6,518,101,0,417,101
80006,5,145,28,0,117,28
80006,4,48,12,0,36,12
80006,3,15,5,0,10,5
80006,1,3,1,0,2,1
44,10,4,2,0,2,2
44,9,22,5,0,17,5
44,8,255,91,0,164,91
44,7,471,133,0,338,133
44,6,503,168,0,335,168
44,5,150,51,0,99,51
44,4,79,42,0,37,42
44,3,20,9,0,11,9
44,2,5,1,0,4,1
44,1,2,1,0,1,1
20080,10,6,1,0,5,1
20080,9,20,6,0,14,6
20080,8,195,70,0,125,70
20080,7,473,111,0,362,111
20080,6,535,118,0,417,118
20080,5,169,43,0,126,43
20080,4,81,24,0,57,24
20080,3,23,8,0,15,8
20080,2,9,3,0,6,3
19764,10,42,13,0,29,13
19764,9,94,27,0,67,27
19764,8,350,106,0,244,106
19764,7,445,129,0,316,129
19764,6,382,115,0,267,115
19764,5,108,40,0,68,40
19764,4,60,21,0,39,21
19764,3,13,6,0,7,6
19764,2,12,3,0,9,3
19764,1,5,1,0,4,1
38548,9,38,8,0,30,8
38548,8,243,87,0,156,87
38548,7,488,124,0,364,124
38548,6,523,132,0,391,132
38548,5,130,39,0,91,39
38548,4,61,21,0,40,21
38548,3,19,3,0,16,3
38548,2,5,1,0,4,1
202426,10,222,55,0,167,55
202426,9,303,60,0,243,60
202426,8,487,89,0,398,89
202426,7,235,43,0,192,43
202426,6,156,27,0,129,27
202426,5,46,15,0,31,15
202426,4,24,9,0,15,9
202426,3,21,7,0,14,7
202426,2,7,4,0,3,4
202426,1,10,6,0,4,6
142325,10,5,2,0,3,2
142325,9,36,8,0,28,8
142325,8,231,41,0,190,41
142325,7,443,91,0,352,91
142325,6,483,81,0,402,81
142325,5,181,31,0,150,31
142325,4,71,14,0,57,14
142325,3,39,12,0,27,12
142325,2,15,2,0,13,2
142325,1,4,1,0,3,1
154825,10,160,30,0,130,30
154825,9,362,70,0,292,70
154825,8,546,83,0,463,83
154825,7,228,61,0,167,61
154825,6,118,31,0,87,31
154825,5,42,15,0,27,15
154825,4,23,9,0,14,9
154825,3,17,7,0,10,7
154825,2,6,3,0,3,3
17405,10,157,40,0,117,40
17405,9,397,77,0,320,77
17405,8,605,146,0,459,146
17405,7,204,48,0,156,48
17405,6,85,27,0,58,27
17405,5,27,11,0,16,11
17405,4,19,9,0,10,9
17405,3,7,2,0,5,2
17405,2,4,1,0,3,1
17405,1,4,1,0,3,1
244,10,37,15,0,22,15
244,9,87,27,0,60,27
244,8,311,112,0,199,112
244,7,432,116,0,316,116
244,6,396,121,0,275,121
244,5,142,42,0,100,42
244,4,56,24,0,32,24
244,3,26,8,0,18,8
244,2,8,3,0,5,3
244,1,5,1,0,4,1
2266,10,30,10,0,20,10
2266,9,52,15,0,37,15
2266,8,250,60,0,190,60
2266,7,432,108,0,324,108
2266,6,501,125,0,376,125
2266,5,161,54,0,107,54
2266,4,54,19,0,35,19
2266,3,13,2,0,11,2
2266,1,3,3,0,0,3
130,10,70,23,0,47,23
130,9,117,24,0,93,24
130,8,387,94,0,293,94
130,7,439,111,0,328,111
130,6,289,84,0,205,84
130,5,104,39,0,65,39
130,4,51,22,0,29,22
130,3,19,10,0,9,10
130,2,16,10,0,6,10
130,1,6,2,0,4,2
111105,10,41,12,1,29,11
111105,9,113,34,6,79,28
111105,8,465,114,9,351,105
111105,7,409,89,6,320,83
111105,6,305,89,3,216,86
111105,5,92,25,0,67,25
111105,4,35,12,0,23,12
111105,3,17,7,1,10,6
111105,2,13,8,0,5,8
111105,1,7,3,1,4,2
118695,10,43,8,0,35,8
118695,9,89,17,0,72,17
118695,8,424,107,0,317,107
118695,7,438,67,0,371,67
118695,6,336,56,0,280,56
118695,5,100,18,0,82,18
118695,4,45,8,0,37,8
118695,3,11,4,0,7,4
118695,2,8,2,0,6,2
11229,10,102,36,0,66,36
11229,9,103,27,0,76,27
11229,8,298,73,0,225,73
11229,7,392,87,0,305,87
11229,6,372,104,0,268,104
11229,5,136,37,0,99,37
11229,4,49,16,0,33,16
11229,3,22,11,0,11,11
11229,2,12,2,0,10,2
11229,1,10,4,0,6,4
531,10,16,4,0,12,4
531,9,49,11,0,38,11
531,8,324,98,0,226,98
531,7,509,129,0,380,129
531,6,411,142,0,269,142
531,5,119,44,0,75,44
531,4,42,19,0,23,19
531,3,19,11,0,8,11
531,2,3,2,0,1,2
531,1,3,2,0,1,2
118536,10,40,10,1,30,9
118536,9,102,25,0,77,25
118536,8,444,95,7,349,88
118536,7,426,85,3,341,82
118536,6,303,69,2,234,67
118536,5,91,23,1,68,22
118536,4,49,14,0,35,14
118536,3,22,7,1,15,6
118536,2,15,7,2,8,5
118536,1,2,1,0,1,1
30618,10,180,55,0,125,55
30618,9,208,67,0,141,67
30618,8,449,122,0,327,122
30618,7,316,89,0,227,89
30618,6,204,61,0,143,61
30618,5,59,16,0,43,16
30618,4,28,6,0,22,6
30618,3,14,1,0,13,1
30618,2,9,2,0,7,2
30618,1,25,8,0,17,8
163642,10,53,5,0,48,5
163642,9,159,32,0,127,32
163642,8,598,86,8,512,78
163642,7,376,54,5,322,49
163642,6,210,23,0,187,23
163642,5,57,9,0,48,9
163642,4,25,7,0,18,7
163642,3,10,1,0,9,1
163642,1,4,1,0,3,1
169,10,25,11,0,14,11
169,9,53,27,0,26,27
169,8,247,81,0,166,81
169,7,409,127,0,282,127
169,6,476,105,0,371,105
169,5,168,52,0,116,52
169,4,73,29,0,44,29
169,3,21,6,0,15,6
169,2,16,2,0,14,2
9829,10,24,16,0,8,16
9829,9,53,18,0,35,18
9829,8,215,90,0,125,90
9829,7,364,135,0,229,135
9829,6,441,160,0,281,160
9829,5,161,64,0,97,64
9829,4,128,70,0,58,70
9829,3,67,34,0,33,34
9829,2,28,17,0,11,17
9829,1,9,5,0,4,5
226501,10,124,27,0,97,27
226501,9,249,43,0,206,43
226501,8,501,70,0,431,70
226501,7,273,41,0,232,41
226501,6,194,33,0,161,33
226501,5,66,11,0,55,11
226501,4,41,19,0,22,19
226501,3,26,10,0,16,10
226501,2,12,6,0,6,6
420,10,77,32,0,45,32
420,9,81,27,0,54,27
420,8,237,82,0,155,82
420,7,401,108,0,293,108
420,6,380,121,0,259,121
420,5,152,58,0,94,58
420,4,89,38,0,51,38
420,3,40,20,0,20,20
420,2,25,15,0,10,15
420,1,4,2,0,2,2
43152,10,26,6,0,20,6
43152,9,70,16,0,54,16
43152,8,393,109,0,284,109
43152,7,503,100,0,403,100
43152,6,333,70,0,263,70
43152,5,85,21,0,64,21
43152,4,49,15,0,34,15
43152,3,16,7,0,9,7
43152,2,7,2,0,5,2
20806,10,28,8,0,20,8
20806,9,54,13,0,41,13
20806,8,260,51,0,209,51
20806,7,386,74,0,312,74
20806,6,476,97,0,379,97
20806,5,141,38,0,103,38
20806,4,80,31,0,49,31
20806,3,36,16,0,20,16
20806,2,14,5,0,9,5
20806,1,8,2,0,6,2
113636,9,101,22,3,79,19
113636,8,479,95,3,384,92
113636,7,501,86,0,415,86
113636,6,275,56,2,219,54
113636,5,69,13,1,56,12
113636,4,33,9,0,24,9
113636,3,5,2,0,3,2
2639,10,46,18,0,28,18
2639,9,50,13,0,37,13
2639,8,256,76,0,180,76
2639,7,418,102,0,316,102
2639,6,451,121,0,330,121
2639,5,166,41,0,125,41
2639,4,64,22,0,42,22
2639,3,22,7,0,15,7
2639,1,4,1,0,3,1
204574,10,25,8,0,17,8
204574,9,85,17,3,68,14
204574,8,424,60,1,364,59
204574,7,475,64,6,411,58
204574,6,300,49,3,251,46
204574,5,106,26,1,80,25
204574,4,38,11,0,27,11
204574,3,17,7,0,10,7
204574,2,12,2,1,10,1
204574,1,3,1,0,2,1
7480,10,70,27,0,43,27
7480,9,162,61,0,101,61
7480,8,536,151,0,385,151
7480,7,369,91,0,278,91
7480,6,194,60,0,134,60
7480,5,80,27,0,53,27
7480,4,44,19,0,25,19
7480,3,16,8,0,8,8
7480,2,4,2,0,2,2
130960,10,250,82,0,168,82
130960,9,431,101,0,330,101
130960,8,475,86,0,389,86
130960,7,191,39,0,152,39
130960,6,80,22,0,58,22
130960,5,25,8,0,17,8
130960,4,13,4,0,9,4
130960,3,9,5,0,4,5
130960,2,6,2,0,4,2
444,10,33,12,0,21,12
444,9,43,16,0,27,16
444,8,216,85,0,131,85
444,7,399,141,0,258,141
444,6,507,152,0,355,152
444,5,147,57,0,90,57
444,4,94,26,0,68,26
444,3,28,12,0,16,12
444,2,8,4,0,4,4
444,1,2,1,0,1,1
122842,10,77,25,1,52,24
122842,9,143,28,0,115,28
122842,8,526,108,3,418,105
122842,7,321,47,0,274,47
122842,6,243,45,0,198,45
122842,5,81,19,0,62,19
122842,4,51,16,0,35,16
122842,3,22,4,0,18,4
122842,2,9,5,0,4,5
122842,1,3,2,0,1,2
140535,10,22,4,0,18,4
140535,9,59,11,0,48,11
140535,8,317,58,0,259,58
140535,7,464,74,0,390,74
140535,6,427,63,0,364,63
140535,5,116,15,0,101,15
140535,4,43,7,0,36,7
140535,3,15,3,0,12,3
140535,2,9,1,0,8,1
138233,10,53,5,0,48,5
138233,9,159,12,0,147,12
138233,8,456,55,0,401,55
138233,7,417,63,2,354,61
138233,6,269,45,0,224,45
138233,5,66,15,0,51,15
138233,4,33,6,0,27,6
138233,3,11,3,0,8,3
138233,2,7,2,0,5,2
138233,1,4,1,0,3,1
6263,10,4,2,0,2,2
6263,9,10,2,0,8,2
6263,8,112,32,0,80,32
6263,7,417,123,0,294,123
6263,6,626,181,0,445,181
6263,5,198,60,0,138,60
6263,4,81,25,0,56,25
6263,3,18,9,0,9,9
6263,2,5,1,0,4,1
142852,10,92,13,0,79,13
142852,9,161,20,0,141,20
142852,8,470,65,0,405,65
142852,7,411,56,0,355,56
142852,6,239,28,0,211,28
142852,5,52,12,0,40,12
142852,4,21,5,0,16,5
142852,3,9,3,0,6,3
142852,1,6,2,0,4,2
1501,10,23,9,0,14,9
1501,9,29,6,0,23,6
1501,8,105,38,0,67,38
1501,7,224,68,0,156,68
1501,6,449,125,0,324,125
1501,5,317,108,0,209,108
1501,4,192,59,0,133,59
1501,3,79,33,0,46,33
1501,2,37,21,0,16,21
1501,1,14,8,0,6,8
167270,10,45,11,0,34,11
167270,9,105,20,0,85,20
167270,8,550,95,0,455,95
167270,7,463,77,0,386,77
167270,6,215,34,0,181,34
167270,5,52,13,0,39,13
167270,4,24,5,0,19,5
167270,3,9,4,0,5,4
167270,1,4,1,0,3,1
179803,10,255,22,1,233,21
179803,9,335,49,11,286,38
179803,8,533,71,8,462,63
179803,7,216,36,10,180,26
179803,6,68,8,0,60,8
179803,5,29,6,1,23,5
179803,4,12,1,0,11,1
179803,3,12,4,1,8,3
179803,1,5,1,0,4,1
111,10,12,3,0,9,3
111,9,48,18,0,30,18
111,8,258,95,0,163,95
111,7,495,145,0,350,145
111,6,440,117,0,323,117
111,5,141,50,0,91,50
111,4,52,25,0,27,25
111,3,16,6,0,10,6
111,2,6,3,0,3,3
66424,10,21,5,0,16,5
66424,9,43,10,0,33,10
66424,8,259,44,0,215,44
66424,7,340,58,0,282,58
66424,6,438,102,0,336,102
66424,5,185,47,0,138,47
66424,4,97,29,0,68,29
66424,3,50,24,0,26,24
66424,2,25,13,0,12,13
66424,1,9,2,0,7,2
177249,10,9,4,0,5,4
177249,9,45,6,1,39,5
177249,8,258,51,4,207,47
177249,7,453,73,8,380,65
177249,6,465,76,3,389,73
177249,5,137,24,0,113,24
177249,4,64,19,1,45,18
177249,3,26,13,0,13,13
177249,1,3,1,0,2,1
145203,10,11,2,0,9,2
145203,9,35,5,0,30,5
145203,8,343,53,0,290,53
145203,7,509,92,0,417,92
145203,6,419,70,0,349,70
145203,5,88,21,0,67,21
145203,4,40,14,0,26,14
145203,3,15,7,0,8,7
145203,1,3,1,0,2,1
47055,10,180,65,2,115,63
47055,9,215,57,1,158,56
47055,8,422,131,1,291,130
47055,7,283,75,0,208,75
47055,6,189,47,0,142,47
47055,5,60,14,0,46,14
47055,4,50,19,0,31,19
47055,3,28,12,0,16,12
47055,2,18,8,0,10,8
47055,1,17,4,0,13,4
223855,10,36,2,0,34,2
223855,9,131,26,0,105,26
223855,8,574,95,0,479,95
223855,7,412,69,0,343,69
223855,6,212,41,0,171,41
223855,5,53,11,0,42,11
223855,4,37,7,0,30,7
223855,3,10,3,0,7,3
2476,10,17,7,0,10,7
2476,9,66,23,0,43,23
2476,8,328,94,0,234,94
2476,7,461,154,0,307,154
2476,6,395,116,0,279,116
2476,5,111,29,0,82,29
2476,4,55,27,0,28,27
2476,3,18,7,0,11,7
2476,2,6,3,0,3,3
2476,1,5,1,0,4,1
180020,10,60,5,0,55,5
180020,9,95,12,0,83,12
180020,8,277,37,0,240,37
180020,7,394,32,0,362,32
180020,6,422,41,0,381,41
180020,5,111,12,0,99,12
180020,4,50,8,0,42,8
180020,3,27,2,0,25,2
180020,2,16,2,0,14,2
180020,1,11,1,0,10,1
357,10,15,10,0,5,10
357,9,45,14,0,31,14
357,8,226,77,0,149,77
357,7,371,107,0,264,107
357,6,498,144,0,354,144
357,5,156,59,0,97,59
357,4,83,32,0,51,32
357,3,39,14,0,25,14
357,2,23,10,0,13,10
357,1,5,1,0,4,1
129050,10,22,4,0,18,4
129050,9,59,12,0,47,12
129050,8,338,64,0,274,64
129050,7,468,76,0,392,76
129050,6,379,72,0,307,72
129050,5,105,23,0,82,23
129050,4,58,18,0,40,18
129050,3,23,9,0,14,9
129050,2,8,4,0,4,4
131014,10,94,29,0,65,29
131014,9,153,32,0,121,32
131014,8,543,89,0,454,89
131014,7,396,63,0,333,63
131014,6,195,35,0,160,35
131014,5,55,9,0,46,9
131014,4,10,2,0,8,2
131014,2,2,1,0,1,1
131014,1,6,1,0,5,1
6779,10,28,10,0,18,10
6779,9,77,41,0,36,41
6779,8,396,170,0,226,170
6779,7,490,183,0,307,183
6779,6,340,106,0,234,106
6779,5,93,32,0,61,32
6779,4,22,8,0,14,8
6779,3,7,3,0,4,3
6779,2,2,1,0,1,1
29308,10,7,3,0,4,3
29308,9,18,5,0,13,5
29308,8,218,72,0,146,72
29308,7,423,111,0,312,111
29308,6,518,138,0,380,138
29308,5,156,45,0,111,45
29308,4,73,21,0,52,21
29308,3,33,11,0,22,11
29308,2,8,1,0,7,1
29308,1,4,2,0,2,2
110,10,13,3,0,10,3
110,9,34,12,0,22,12
110,8,183,62,0,121,62
110,7,358,76,0,282,76
110,6,530,131,0,399,131
110,5,207,46,0,161,46
110,4,87,17,0,70,17
110,3,34,20,0,14,20
110,2,9,5,0,4,5
110,1,3,2,0,1,2
3720,10,147,42,0,105,42
3720,9,124,39,0,85,39
3720,8,304,84,0,220,84
3720,7,301,66,0,235,66
3720,6,319,50,0,269,50
3720,5,139,34,0,105,34
3720,4,63,20,0,43,20
3720,3,35,11,0,24,11
3720,2,19,2,0,17,2
3720,1,7,1,0,6,1
184522,10,27,6,0,21,6
184522,9,74,12,0,62,12
184522,8,267,39,0,228,39
184522,7,376,58,0,318,58
184522,6,401,52,0,349,52
184522,5,139,22,0,117,22
184522,4,86,17,0,69,17
184522,3,48,12,0,36,12
184522,2,25,7,0,18,7
184522,1,14,6,0,8,6
197405,10,186,57,7,129,50
197405,9,261,61,8,200,53
197405,8,450,64,4,386,60
197405,7,319,60,3,259,57
197405,6,173,25,1,148,24
197405,5,40,6,0,34,6
197405,4,15,4,0,11,4
197405,2,4,2,0,2,2
197405,1,2,1,0,1,1
168788,10,46,9,0,37,9
168788,9,114,17,1,97,16
168788,8,467,68,2,399,66
168788,7,358,48,8,310,40
168788,6,299,51,2,248,49
168788,5,85,15,1,70,14
168788,4,49,8,0,41,8
168788,3,17,5,1,12,4
168788,2,13,2,0,11,2
168788,1,7,2,0,5,2
192934,10,16,1,0,15,1
192934,9,55,8,0,47,8
192934,8,332,63,0,269,63
192934,7,454,72,0,382,72
192934,6,378,62,0,316,62
192934,5,120,30,0,90,30
192934,4,56,22,0,34,22
192934,3,31,12,0,19,12
192934,2,8,2,0,6,2
36648,10,32,8,0,24,8
36648,9,63,15,0,48,15
36648,8,350,97,0,253,97
36648,7,495,110,0,385,110
36648,6,382,85,0,297,85
36648,5,92,20,0,72,20
36648,4,21,4,0,17,4
36648,3,11,2,0,9,2
36648,1,4,1,0,3,1
40425,10,8,3,0,5,3
40425,9,40,14,0,26,14
40425,8,278,77,0,201,77
40425,7,469,94,0,375,94
40425,6,455,98,0,357,98
40425,5,137,32,0,105,32
40425,4,52,17,0,35,17
40425,3,8,5,0,3,5
40425,2,3,2,0,1,2
13301,10,6,4,0,2,4
13301,9,15,4,0,11,4
13301,8,158,53,0,105,53
13301,7,380,109,0,271,109
13301,6,585,164,0,421,164
13301,5,187,65,0,122,65
13301,4,79,30,0,49,30
13301,3,28,13,0,15,13
13301,2,8,6,0,2,6
204472,10,108,21,2,87,19
204472,9,183,33,2,150,31
204472,8,457,76,4,381,72
204472,7,368,60,7,308,53
204472,6,199,37,1,162,36
204472,5,79,16,0,63,16
204472,4,26,9,1,17,8
204472,3,13,9,0,4,9
204472,2,7,2,0,5,2
204472,1,11,4,0,7,4
5781,10,17,9,0,8,9
5781,9,61,22,0,39,22
5781,8,421,138,0,283,138
5781,7,469,123,0,346,123
5781,6,345,95,0,250,95
5781,5,83,13,0,70,13
5781,4,29,10,0,19,10
5781,3,12,3,0,9,3
5781,2,7,1,0,6,1
5781,1,2,1,0,1,1
230085,10,77,19,0,58,19
230085,9,193,29,0,164,29
230085,8,527,70,0,457,70
230085,7,334,52,0,282,52
230085,6,172,37,0,135,37
230085,5,66,12,0,54,12
230085,4,40,7,0,33,7
230085,3,19,5,0,14,5
230085,2,7,3,0,4,3
230085,1,7,1,0,6,1
104955,10,40,12,0,28,12
104955,9,125,26,0,99,26
104955,8,462,89,0,373,89
104955,7,422,90,0,332,90
104955,6,255,72,0,183,72
104955,5,76,21,0,55,21
104955,4,33,13,0,20,13
104955,3,14,7,0,7,7
104955,1,5,1,0,4,1
157413,10,39,15,1,24,14
157413,9,101,28,1,73,27
157413,8,502,104,7,398,97
157413,7,442,70,4,372,66
157413,6,253,59,5,194,54
157413,5,69,13,0,56,13
157413,4,19,8,1,11,7
157413,3,5,2,0,3,2
157413,2,4,2,0,2,2
157413,1,3,2,0,1,2
1155,10,11,8,0,3,8
1155,9,59,26,0,33,26
1155,8,355,131,0,224,131
1155,7,493,135,0,358,135
1155,6,369,116,0,253,116
1155,5,95,39,0,56,39
1155,4,35,12,0,23,12
1155,3,11,4,0,7,4
1155,2,4,2,0,2,2
15045,10,21,2,0,19,2
15045,9,25,10,0,15,10
15045,8,146,46,0,100,46
15045,7,319,66,0,253,66
15045,6,498,102,0,396,102
15045,5,222,48,0,174,48
15045,4,129,34,0,95,34
15045,3,43,12,0,31,12
15045,2,28,7,0,21,7
22278,9,31,7,0,24,7
22278,8,222,71,0,151,71
22278,7,425,86,0,339,86
22278,6,498,105,0,393,105
22278,5,151,41,0,110,41
22278,4,69,29,0,40,29
22278,3,20,7,0,13,7
22278,2,5,1,0,4,1
169611,10,43,11,0,32,11
169611,9,99,11,0,88,11
169611,8,457,82,0,375,82
169611,7,459,69,0,390,69
169611,6,262,34,0,228,34
169611,5,67,12,0,55,12
169611,4,20,5,0,15,5
169611,3,9,5,0,4,5
169611,2,10,4,0,6,4
169611,1,5,1,0,4,1
91080,10,89,29,0,60,29
91080,9,241,65,0,176,65
91080,8,539,118,0,421,118
91080,7,316,75,0,241,75
91080,6,149,46,0,103,46
91080,5,45,19,0,26,19
91080,4,26,12,0,14,12
91080,3,14,7,0,7,7
91080,2,8,4,0,4,4
173341,10,24,7,0,17,7
173341,9,34,10,0,24,10
173341,8,188,31,0,157,31
173341,7,381,82,0,299,82
173341,6,529,94,0,435,94
173341,5,171,32,0,139,32
173341,4,76,13,0,63,13
173341,3,18,6,0,12,6
173341,2,8,4,0,4,4
173341,1,4,1,0,3,1
1597,10,10,6,0,4,6
1597,9,45,15,0,30,15
1597,8,221,64,0,157,64
1597,7,398,97,0,301,97
1597,6,526,142,0,384,142
1597,5,137,39,0,98,39
1597,4,65,25,0,40,25
1597,3,18,9,0,9,9
1597,2,11,6,0,5,6
24037,10,24,6,0,18,6
24037,9,52,8,0,44,8
24037,8,227,83,0,144,83
24037,7,405,100,0,305,100
24037,6,509,129,0,380,129
24037,5,142,32,0,110,32
24037,4,58,17,0,41,17
24037,3,9,2,0,7,2
95105,10,19,4,0,15,4
95105,9,56,13,0,43,13
95105,8,291,81,0,210,81
95105,7,402,88,0,314,88
95105,6,435,111,0,324,111
95105,5,128,41,0,87,41
95105,4,56,15,0,41,15
95105,3,24,8,0,16,8
95105,2,15,6,0,9,6
95105,1,5,1,0,4,1
158340,10,13,1,0,12,1
158340,9,61,8,0,53,8
158340,8,319,54,0,265,54
158340,7,457,68,0,389,68
158340,6,407,62,0,345,62
158340,5,111,17,0,94,17
158340,4,39,8,0,31,8
158340,3,14,5,0,9,5
158340,2,5,3,0,2,3
158340,1,4,1,0,3,1
28025,10,6,2,0,4,2
28025,9,30,10,0,20,10
28025,8,218,55,0,163,55
28025,7,443,92,0,351,92
28025,6,504,126,0,378,126
28025,5,131,21,0,110,21
28025,4,55,22,0,33,22
28025,3,25,9,0,16,9
28025,2,13,3,0,10,3
28025,1,3,2,0,1,2
172552,10,30,12,0,18,12
172552,9,77,17,2,60,15
172552,8,339,62,8,277,54
172552,7,411,66,4,345,62
172552,6,365,63,5,302,58
172552,5,112,17,1,95,16
172552,4,59,11,0,48,11
172552,3,19,4,0,15,4
172552,2,14,2,0,12,2
55829,10,167,26,0,141,26
55829,9,206,33,0,173,33
55829,8,384,60,0,324,60
55829,7,320,42,0,278,42
55829,6,207,37,0,170,37
55829,5,79,12,0,67,12
55829,4,37,10,0,27,10
55829,3,12,3,0,9,3
55829,2,6,2,0,4,2
55829,1,10,4,0,6,4
260428,10,94,13,0,81,13
260428,9,267,39,0,228,39
260428,8,652,93,0,559,93
260428,7,300,36,0,264,36
260428,6,88,14,0,74,14
260428,5,20,2,0,18,2
260428,3,3,2,0,1,2
260428,2,6,1,0,5,1
223750,10,40,16,1,24,15
223750,9,142,20,1,122,19
223750,8,631,101,11,530,90
223750,7,364,55,5,309,50
223750,6,185,31,1,154,30
223750,5,38,9,1,29,8
223750,4,18,7,0,11,7
223750,3,6,3,0,3,3
223750,2,3,2,0,1,2
223750,1,4,1,0,3,1
118418,10,16,4,0,12,4
118418,9,63,21,0,42,21
118418,8,342,72,0,270,72
118418,7,452,81,0,371,81
118418,6,368,77,0,291,77
118418,5,110,12,0,98,12
118418,4,56,11,0,45,11
118418,3,14,4,0,10,4
118418,2,5,3,0,2,3
118418,1,1,1,0,0,1
171890,10,15,4,0,11,4
171890,9,42,6,0,36,6
171890,8,254,62,12,192,50
171890,7,480,99,8,381,91
171890,6,465,94,3,371,91
171890,5,112,24,1,88,23
171890,4,45,17,0,28,17
171890,3,10,3,0,7,3
171890,2,4,1,0,3,1
171890,1,1,1,0,0,1
58110,10,42,7,0,35,7
58110,9,91,20,0,71,20
58110,8,414,83,0,331,83
58110,7,431,58,0,373,58
58110,6,306,54,0,252,54
58110,5,68,11,0,57,11
58110,4,45,15,0,30,15
58110,3,22,3,0,19,3
193308,10,54,5,0,49,5
193308,9,112,13,0,99,13
193308,8,442,46,0,396,46
193308,7,429,38,0,391,38
193308,6,269,31,0,238,31
193308,5,61,12,0,49,12
193308,4,34,8,0,26,8
193308,3,18,4,0,14,4
193308,2,5,1,0,4,1
193308,1,4,1,0,3,1
216201,10,61,7,0,54,7
216201,9,128,23,0,105,23
216201,8,434,53,0,381,53
216201,7,409,45,0,364,45
216201,6,256,27,0,229,27
216201,5,69,8,0,61,8
216201,4,29,2,0,27,2
216201,3,20,2,0,18,2
216201,2,9,5,0,4,5
216201,1,7,2,0,5,2
172220,10,94,13,0,81,13
172220,9,158,18,0,140,18
172220,8,508,80,0,428,80
172220,7,361,42,0,319,42
172220,6,202,35,0,167,35
172220,5,59,13,0,46,13
172220,4,23,8,0,15,8
172220,3,12,4,0,8,4
172220,2,3,1,0,2,1
41066,10,263,52,0,211,52
41066,9,338,60,0,278,60
41066,8,449,82,0,367,82
41066,7,175,35,0,140,35
41066,6,109,32,0,77,32
41066,5,27,7,0,20,7
41066,4,23,6,0,17,6
41066,3,20,8,0,12,8
41066,2,10,4,0,6,4
28723,10,13,6,0,7,6
28723,9,49,20,0,29,20
28723,8,311,96,0,215,96
28723,7,462,111,0,351,111
28723,6,378,98,0,280,98
28723,5,126,49,0,77,49
28723,4,51,21,0,30,21
28723,3,19,6,0,13,6
28723,2,9,4,0,5,4
160964,10,12,1,0,11,1
160964,9,33,9,0,24,9
160964,8,206,38,0,168,38
160964,7,413,56,0,357,56
160964,6,483,76,0,407,76
160964,5,152,22,0,130,22
160964,4,80,15,0,65,15
160964,3,22,5,0,17,5
160964,2,12,3,0,9,3
160964,1,6,1,0,5,1
162823,10,10,2,0,8,2
162823,9,35,10,0,25,10
162823,8,356,61,0,295,61
162823,7,500,85,0,415,85
162823,6,400,68,0,332,68
162823,5,75,13,0,62,13
162823,4,29,12,0,17,12
162823,3,11,6,0,5,6
162823,2,1,1,0,0,1
214293,10,27,2,0,25,2
214293,9,68,9,0,59,9
214293,8,310,36,0,274,36
214293,7,400,36,0,364,36
214293,6,375,44,0,331,44
214293,5,114,17,0,97,17
214293,4,68,13,0,55,13
214293,3,30,6,0,24,6
214293,2,17,6,0,11,6
214293,1,12,3,0,9,3
79131,10,22,6,0,16,6
79131,9,42,16,0,26,16
79131,8,270,64,0,206,64
79131,7,396,77,0,319,77
79131,6,439,110,0,329,110
79131,5,126,32,0,94,32
79131,4,72,16,0,56,16
79131,3,31,12,0,19,12
79131,2,9,1,0,8,1
79131,1,7,2,0,5,2
175223,10,47,9,0,38,9
175223,9,119,23,0,96,23
175223,8,534,86,0,448,86
175223,7,428,56,0,372,56
175223,6,219,40,0,179,40
175223,5,44,10,0,34,10
175223,4,11,2,0,9,2
175223,3,7,3,0,4,3
175223,2,3,1,0,2,1
175223,1,3,1,0,2,1
31483,10,29,2,0,27,2
31483,9,76,21,0,55,21
31483,8,375,83,0,292,83
31483,7,465,87,0,378,87
31483,6,326,70,0,256,70
31483,5,84,21,0,63,21
31483,4,40,17,0,23,17
31483,3,11,6,0,5,6
169794,10,23,2,0,21,2
169794,9,130,22,0,108,22
169794,8,559,80,1,479,79
169794,7,414,60,0,354,60
169794,6,199,44,0,155,44
169794,5,58,19,0,39,19
169794,4,16,4,0,12,4
169794,3,6,2,0,4,2
92044,10,47,17,0,30,17
92044,9,121,29,0,92,29
92044,8,367,90,0,277,90
92044,7,407,71,0,336,71
92044,6,261,61,0,200,61
92044,5,119,40,0,79,40
92044,4,47,11,0,36,11
92044,3,19,5,0,14,5
92044,2,15,6,0,9,6
119391,10,11,2,0,9,2
119391,9,52,11,0,41,11
119391,8,383,71,0,312,71
119391,7,555,89,1,466,88
119391,6,303,57,0,246,57
119391,5,64,13,0,51,13
119391,4,28,10,0,18,10
119391,3,5,2,0,3,2
119391,2,4,1,0,3,1
119391,1,3,1,0,2,1
58936,10,76,26,0,50,26
58936,9,168,43,0,125,43
58936,8,485,98,0,387,98
58936,7,356,94,0,262,94
58936,6,198,67,0,131,67
58936,5,62,13,0,49,13
58936,4,31,13,0,18,13
58936,3,17,3,0,14,3
58936,2,7,3,0,4,3
58936,1,7,3,0,4,3
21754,10,2,1,0,1,1
21754,9,15,5,0,10,5
21754,8,157,45,0,112,45
21754,7,415,94,0,321,94
21754,6,541,131,0,410,131
21754,5,162,47,0,115,47
21754,4,74,23,0,51,23
21754,3,27,14,0,13,14
21754,2,10,2,0,8,2
21754,1,4,1,0,3,1
5072,10,69,18,0,51,18
5072,9,122,21,0,101,21
5072,8,349,60,0,289,60
5072,7,367,80,0,287,80
5072,6,320,79,0,241,79
5072,5,108,27,0,81,27
5072,4,41,12,0,29,12
5072,3,12,1,0,11,1
5072,2,12,5,0,7,5
33107,10,19,8,0,11,8
33107,9,53,11,0,42,11
33107,8,319,79,0,240,79
33107,7,370,83,0,287,83
33107,6,366,64,0,302,64
33107,5,147,34,0,113,34
33107,4,71,22,0,49,22
33107,3,40,13,0,27,13
33107,2,13,3,0,10,3
33107,1,6,2,0,4,2
168274,10,56,13,0,43,13
168274,9,116,23,3,93,20
168274,8,347,65,7,282,58
168274,7,331,57,2,274,55
168274,6,309,59,8,250,51
168274,5,119,25,0,94,25
168274,4,68,19,0,49,19
168274,3,35,11,0,24,11
168274,1,10,4,0,6,4
41569,10,12,3,0,9,3
41569,9,39,15,1,24,14
41569,8,260,61,0,199,61
41569,7,415,80,1,335,79
41569,6,448,91,2,357,89
41569,5,132,35,0,97,35
41569,4,53,20,0,33,20
41569,3,33,10,0,23,10
41569,2,9,2,0,7,2
30241,10,10,5,0,5,5
30241,9,27,7,0,20,7
30241,8,257,73,0,184,73
30241,7,485,105,0,380,105
30241,6,436,106,0,330,106
30241,5,114,39,0,75,39
30241,4,51,20,0,31,20
30241,3,12,5,0,7,5
30241,2,5,2,0,3,2
137909,10,12,5,0,7,5
137909,9,29,6,0,23,6
137909,8,188,48,0,140,48
137909,7,328,68,0,260,68
137909,6,532,111,0,421,111
137909,5,189,50,0,139,50
137909,4,76,13,0,63,13
137909,3,36,5,0,31,5
137909,2,8,4,0,4,4
137909,1,1,1,0,0,1
176361,10,19,6,0,13,6
176361,9,41,6,0,35,6
176361,8,204,35,4,169,31
176361,7,328,48,3,280,45
176361,6,435,55,5,380,50
176361,5,190,41,1,149,40
176361,4,104,19,1,85,18
176361,3,50,15,0,35,15
176361,2,21,9,0,12,9
176361,1,7,2,0,5,2
160610,10,101,22,1,79,21
160610,9,198,49,5,149,44
160610,8,521,106,9,415,97
160610,7,319,53,3,266,50
160610,6,185,40,6,145,34
160610,5,50,10,0,40,10
160610,4,11,3,0,8,3
160610,1,2,1,0,1,1
3972,10,37,10,0,27,10
3972,9,84,24,0,60,24
3972,8,319,80,0,239,80
3972,7,395,81,0,314,81
3972,6,367,91,0,276,91
3972,5,116,24,0,92,24
3972,4,43,19,0,24,19
3972,3,16,6,0,10,6
3972,2,8,2,0,6,2
3972,1,10,2,0,8,2
38823,10,143,44,0,99,44
38823,9,255,52,0,203,52
38823,8,515,118,0,397,118
38823,7,260,60,0,200,60
38823,6,128,28,0,100,28
38823,5,43,12,0,31,12
38823,4,23,8,0,15,8
38823,3,9,2,0,7,2
38823,1,14,1,0,13,1
40832,10,12,3,0,9,3
40832,9,50,14,0,36,14
40832,8,309,89,0,220,89
40832,7,463,92,0,371,92
40832,6,384,70,0,314,70
40832,5,112,18,0,94,18
40832,4,38,6,0,32,6
40832,3,17,3,0,14,3
40832,1,4,1,0,3,1
141932,10,25,5,1,20,4
141932,9,34,8,0,26,8
141932,8,255,71,15,184,56
141932,7,361,77,12,284,65
141932,6,404,87,10,317,77
141932,5,169,43,8,126,35
141932,4,76,23,4,53,19
141932,3,34,9,1,25,8
141932,2,23,7,1,16,6
141932,1,12,3,2,9,1
153097,10,63,11,1,52,10
153097,9,83,23,2,60,21
153097,8,352,62,7,290,55
153097,7,368,49,5,319,44
153097,6,326,65,6,261,59
153097,5,104,25,0,79,25
153097,4,44,10,1,34,9
153097,3,34,6,0,28,6
153097,2,18,10,0,8,10
153097,1,2,1,0,1,1
40770,9,46,1,0,45,1
40770,8,252,59,0,193,59
40770,7,468,102,0,366,102
40770,6,409,86,0,323,86
40770,5,145,31,0,114,31
40770,4,47,13,0,34,13
40770,3,12,5,0,7,5
40770,1,4,1,0,3,1
180956,10,56,8,0,48,8
180956,9,89,12,0,77,12
180956,8,300,24,1,276,23
180956,7,376,45,4,331,41
180956,6,360,61,1,299,60
180956,5,118,20,0,98,20
180956,4,48,11,0,37,11
180956,3,29,8,0,21,8
180956,2,10,4,0,6,4
180956,1,6,2,0,4,2
137031,10,27,6,0,21,6
137031,9,71,14,0,57,14
137031,8,391,74,4,317,70
137031,7,431,72,2,359,70
137031,6,305,55,3,250,52
137031,5,93,20,1,73,19
137031,4,45,18,0,27,18
137031,3,16,6,0,10,6
137031,2,7,2,0,5,2
137031,1,5,3,0,2,3
195571,10,65,9,1,56,8
195571,9,166,32,0,134,32
195571,8,446,73,0,373,73
195571,7,354,52,0,302,52
195571,6,222,39,0,183,39
195571,5,70,10,0,60,10
195571,4,31,10,0,21,10
195571,3,17,4,0,13,4
195571,2,14,5,0,9,5
195571,1,5,2,0,3,2
122294,10,78,11,0,67,11
122294,9,150,20,0,130,20
122294,8,481,65,0,416,65
122294,7,397,60,0,337,60
122294,6,197,25,0,172,25
122294,5,47,10,0,37,10
122294,4,20,5,0,15,5
122294,3,9,1,0,8,1
122294,2,8,1,0,7,1
122294,1,5,1,0,4,1
146221,10,64,12,1,52,11
146221,9,178,40,5,138,35
146221,8,489,81,7,408,74
146221,7,302,54,5,248,49
146221,6,228,52,4,176,48
146221,5,73,19,5,54,14
146221,4,30,10,1,20,9
146221,3,15,5,0,10,5
146221,2,6,1,0,5,1
146221,1,6,2,0,4,2
143404,10,33,4,0,29,4
143404,9,71,13,0,58,13
143404,8,391,69,0,322,69
143404,7,478,90,0,388,90
143404,6,316,61,0,255,61
143404,5,59,15,0,44,15
143404,4,24,7,0,17,7
143404,3,9,2,0,7,2
40508,8,48,10,0,38,10
40508,7,138,23,0,115,23
40508,6,378,66,0,312,66
40508,5,380,73,0,307,73
40508,4,250,61,0,189,61
40508,3,112,30,0,82,30
40508,2,40,13,0,27,13
40508,1,25,11,0,14,11
27048,10,21,9,0,12,9
27048,9,54,22,0,32,22
27048,8,325,117,0,208,117
27048,7,392,114,0,278,114
27048,6,361,112,0,249,112
27048,5,132,44,0,88,44
27048,4,65,30,0,35,30
27048,3,21,9,0,12,9
27048,2,8,1,0,7,1
27048,1,5,2,0,3,2
29109,10,16,6,0,10,6
29109,9,38,12,0,26,12
29109,8,267,67,0,200,67
29109,7,383,93,0,290,93
29109,6,416,105,0,311,105
29109,5,136,28,0,108,28
29109,4,78,21,0,57,21
29109,3,32,6,0,26,6
29109,2,13,5,0,8,5
29109,1,3,2,0,1,2
175307,10,63,8,0,55,8
175307,9,118,19,0,99,19
175307,8,418,63,0,355,63
175307,7,421,67,0,354,67
175307,6,268,51,0,217,51
175307,5,61,8,0,53,8
175307,4,19,3,0,16,3
175307,3,5,2,0,3,2
175307,2,5,1,0,4,1
91984,10,40,9,0,31,9
91984,9,91,17,0,74,17
91984,8,463,72,0,391,72
91984,7,424,76,0,348,76
91984,6,253,57,0,196,57
91984,5,61,18,0,43,18
91984,4,30,12,0,18,12
91984,3,13,3,0,10,3
91984,2,3,1,0,2,1
27463,10,13,5,0,8,5
27463,9,71,22,0,49,22
27463,8,314,106,0,208,106
27463,7,372,114,0,258,114
27463,6,370,116,0,254,116
27463,5,129,54,0,75,54
27463,4,56,22,0,34,22
27463,3,39,20,0,19,20
27463,2,9,8,0,1,8
124380,10,22,6,0,16,6
124380,9,50,11,0,39,11
124380,8,284,41,0,243,41
124380,7,403,46,0,357,46
124380,6,377,63,0,314,63
124380,5,104,15,0,89,15
124380,4,78,20,0,58,20
124380,3,35,9,0,26,9
124380,2,15,6,0,9,6
124380,1,8,1,0,7,1
1419,10,18,3,0,15,3
1419,9,49,14,0,35,14
1419,8,198,36,0,162,36
1419,7,344,62,0,282,62
1419,6,449,97,0,352,97
1419,5,204,51,0,153,51
1419,4,82,28,0,54,28
1419,3,20,2,0,18,2
1419,2,11,3,0,8,3
1768,10,107,37,0,70,37
1768,9,72,20,0,52,20
1768,8,179,59,0,120,59
1768,7,253,68,0,185,68
1768,6,424,117,1,307,116
1768,5,172,49,0,123,49
1768,4,108,43,0,65,43
1768,3,37,13,0,24,13
1768,2,22,8,0,14,8
73316,10,26,4,0,22,4
73316,9,79,14,0,65,14
73316,8,391,75,0,316,75
73316,7,473,87,0,386,87
73316,6,292,56,0,236,56
73316,5,63,11,0,52,11
73316,4,33,9,0,24,9
73316,3,11,3,0,8,3
73316,2,6,1,0,5,1
138431,10,89,25,2,64,23
138431,9,193,42,4,151,38
138431,8,458,105,12,353,93
138431,7,333,60,2,273,58
138431,6,188,41,4,147,37
138431,5,64,16,0,48,16
138431,4,24,8,0,16,8
138431,3,16,5,0,11,5
138431,2,4,1,0,3,1
117,10,43,17,0,26,17
117,9,85,31,0,54,31
117,8,350,119,0,231,119
117,7,412,104,0,308,104
117,6,339,96,0,243,96
117,5,99,32,0,67,32
117,4,37,9,0,28,9
117,3,5,3,0,2,3
117,1,4,1,0,3,1
177802,10,100,8,0,92,8
177802,9,193,17,0,176,17
177802,8,498,26,0,472,26
177802,7,379,30,0,349,30
177802,6,146,19,0,127,19
177802,5,35,3,0,32,3
177802,4,10,1,0,9,1
177802,3,7,2,0,5,2
177802,2,3,1,0,2,1
177802,1,4,1,0,3,1
4209,10,20,7,0,13,7
4209,9,41,14,0,27,14
4209,8,241,72,0,169,72
4209,7,397,91,0,306,91
4209,6,482,118,0,364,118
4209,5,132,29,0,103,29
4209,4,43,13,0,30,13
4209,3,12,3,0,9,3
4209,2,4,1,0,3,1
10167,10,31,3,0,28,3
10167,9,50,9,0,41,9
10167,8,172,38,0,134,38
10167,7,300,45,0,255,45
10167,6,431,69,0,362,69
10167,5,219,39,0,180,39
10167,4,89,23,0,66,23
10167,3,44,5,0,39,5
10167,2,23,4,0,19,4
10167,1,14,4,0,10,4
215840,10,47,7,0,40,7
215840,9,141,19,0,122,19
215840,8,424,40,0,384,40
215840,7,342,35,0,307,35
215840,6,223,30,0,193,30
215840,5,76,11,0,65,11
215840,4,48,7,0,41,7
215840,3,29,7,0,22,7
215840,2,27,8,0,19,8
215840,1,17,9,0,8,9
75476,10,23,7,0,16,7
75476,9,94,16,0,78,16
75476,8,453,120,0,333,120
75476,7,416,93,0,323,93
75476,6,262,65,0,197,65
75476,5,71,15,0,56,15
75476,4,30,7,0,23,7
75476,3,19,6,0,13,6
75476,2,3,2,0,1,2
35488,10,21,6,0,15,6
35488,9,70,9,0,61,9
35488,8,322,59,0,263,59
35488,7,429,65,0,364,65
35488,6,342,59,0,283,59
35488,5,118,26,0,92,26
35488,4,48,15,0,33,15
35488,3,16,2,0,14,2
35488,2,5,2,0,3,2
35488,1,2,1,0,1,1
205046,10,20,3,0,17,3
205046,9,73,20,0,53,20
205046,8,434,93,0,341,93
205046,7,469,69,0,400,69
205046,6,278,45,0,233,45
205046,5,68,16,0,52,16
205046,4,20,5,0,15,5
205046,3,7,3,0,4,3
40444,10,11,5,0,6,5
40444,9,18,6,0,12,6
40444,8,202,48,0,154,48
40444,7,447,98,0,349,98
40444,6,458,97,0,361,97
40444,5,159,39,0,120,39
40444,4,53,20,0,33,20
40444,3,17,9,0,8,9
40444,2,4,1,0,3,1
40444,1,2,2,0,0,2
198953,10,246,72,0,174,72
198953,9,311,61,0,250,61
198953,8,434,92,0,342,92
198953,7,198,26,0,172,26
198953,6,104,20,0,84,20
198953,5,35,14,0,21,14
198953,4,28,9,0,19,9
198953,3,7,1,0,6,1
198953,2,4,3,0,1,3
198953,1,5,2,0,3,2
135116,10,7,1,0,6,1
135116,9,22,3,0,19,3
135116,8,191,38,0,153,38
135116,7,414,63,0,351,63
135116,6,495,67,0,428,67
135116,5,154,28,0,126,28
135116,4,58,8,0,50,8
135116,3,22,2,0,20,2
135116,2,8,2,0,6,2
222,10,14,1,0,13,1
222,9,26,2,0,24,2
222,8,114,33,0,81,33
222,7,331,86,0,245,86
222,6,521,114,0,407,114
222,5,203,61,0,142,61
222,4,104,20,0,84,20
222,3,32,10,0,22,10
222,2,19,6,0,13,6
222,1,4,2,0,2,2
160902,10,73,13,0,60,13
160902,9,154,21,0,133,21
160902,8,465,68,0,397,68
160902,7,359,51,0,308,51
160902,6,207,31,0,176,31
160902,5,60,8,0,52,8
160902,4,27,4,0,23,4
160902,3,9,1,0,8,1
160902,2,5,2,0,3,2
160902,1,7,1,0,6,1
11231,10,25,6,0,19,6
11231,9,35,6,0,29,6
11231,8,139,45,0,94,45
11231,7,280,85,0,195,85
11231,6,514,162,0,352,162
11231,5,197,52,0,145,52
11231,4,112,36,0,76,36
11231,3,42,16,0,26,16
11231,2,15,7,0,8,7
11231,1,7,4,0,3,4
2603,10,99,31,0,68,31
2603,9,128,38,0,90,38
2603,8,276,71,0,205,71
2603,7,321,90,0,231,90
2603,6,288,69,0,219,69
2603,5,138,39,0,99,39
2603,4,64,25,0,39,25
2603,3,27,13,0,14,13
2603,2,17,6,0,11,6
2603,1,7,3,0,4,3
24304,10,13,4,0,9,4
24304,9,29,6,0,23,6
24304,8,177,44,0,133,44
24304,7,350,75,3,275,72
24304,6,469,110,0,359,110
24304,5,197,61,0,136,61
24304,4,78,21,0,57,21
24304,3,35,20,0,15,20
24304,2,12,5,0,7,5
24304,1,3,2,0,1,2
1484,10,35,9,0,26,9
1484,9,55,16,0,39,16
1484,8,281,89,0,192,89
1484,7,423,138,0,285,138
1484,6,395,128,0,267,128
1484,5,99,31,0,68,31
1484,4,44,15,0,29,15
1484,3,17,5,0,12,5
1484,2,11,5,0,6,5
158889,10,276,48,0,228,48
158889,9,301,47,0,254,47
158889,8,469,69,0,400,69
158889,7,186,23,0,163,23
158889,6,84,9,0,75,9
158889,5,18,5,0,13,5
4864,9,16,2,0,14,2
4864,8,100,20,0,80,20
4864,7,218,40,0,178,40
4864,6,410,98,0,312,98
4864,5,298,72,0,226,72
4864,4,171,45,0,126,45
4864,3,77,24,0,53,24
4864,2,45,15,0,30,15
4864,1,18,7,0,11,7
96613,10,23,3,0,20,3
96613,9,36,7,0,29,7
96613,8,247,63,0,184,63
96613,7,317,53,0,264,53
96613,6,453,78,0,375,78
96613,5,152,31,0,121,31
96613,4,68,13,0,55,13
96613,3,43,13,0,30,13
96613,2,14,6,0,8,6
96613,1,6,2,0,4,2
129736,10,34,10,0,24,10
129736,9,88,18,0,70,18
129736,8,360,60,0,300,60
129736,7,426,49,0,377,49
129736,6,296,49,0,247,49
129736,5,95,10,0,85,10
129736,4,39,5,0,34,5
129736,3,15,3,0,12,3
129736,2,8,3,0,5,3
128554,10,24,4,0,20,4
128554,9,50,10,0,40,10
128554,8,288,55,0,233,55
128554,7,418,78,0,340,78
128554,6,383,70,0,313,70
128554,5,110,26,0,84,26
128554,4,64,17,0,47,17
128554,3,10,6,0,4,6
128554,2,6,3,0,3,3
165838,10,210,47,0,163,47
165838,9,257,44,0,213,44
165838,8,494,74,0,420,74
165838,7,237,28,0,209,28
165838,6,108,14,0,94,14
165838,5,25,2,0,23,2
165838,4,11,1,0,10,1
165838,3,7,1,0,6,1
165838,2,1,1,0,0,1
165838,1,7,1,0,6,1
136056,10,20,9,0,11,9
136056,9,75,17,0,58,17
136056,8,343,60,0,283,60
136056,7,462,72,0,390,72
136056,6,313,59,0,254,59
136056,5,94,11,0,83,11
136056,4,27,4,0,23,4
136056,2,6,1,0,5,1
12681,10,17,6,0,11,6
12681,9,50,14,0,36,14
12681,8,299,98,0,201,98
12681,7,369,116,0,253,116
12681,6,342,127,0,215,127
12681,5,128,44,0,84,44
12681,4,77,38,0,39,38
12681,3,43,16,0,27,16
12681,2,19,8,0,11,8
12681,1,3,2,0,1,2
1297,10,19,2,0,17,2
1297,9,26,10,0,16,10
1297,8,82,17,0,65,17
1297,7,193,40,0,153,40
1297,6,408,85,0,323,85
1297,5,324,74,0,250,74
1297,4,167,43,0,124,43
1297,3,76,33,0,43,33
1297,2,36,17,0,19,17
1297,1,14,5,0,9,5
31133,10,9,4,0,5,4
31133,9,23,10,0,13,10
31133,8,193,54,0,139,54
31133,7,421,102,0,319,102
31133,6,484,138,0,346,138
31133,5,131,46,0,85,46
31133,4,57,22,0,35,22
31133,3,20,11,0,9,11
31133,2,5,2,0,3,2
31133,1,2,1,0,1,1
15033,10,11,4,0,7,4
15033,9,21,5,0,16,5
15033,8,269,107,0,162,107
15033,7,395,140,0,255,140
15033,6,425,132,0,293,132
15033,5,129,49,0,80,49
15033,4,60,20,0,40,20
15033,3,23,10,0,13,10
15033,2,9,5,0,4,5
15033,1,3,2,0,1,2
29581,10,13,2,0,11,2
29581,9,41,10,0,31,10
29581,8,252,68,0,184,68
29581,7,349,73,0,276,73
29581,6,387,109,0,278,109
29581,5,133,49,0,84,49
29581,4,81,26,0,55,26
29581,3,59,23,0,36,23
29581,2,21,10,0,11,10
29581,1,6,3,0,3,3
191004,10,29,5,0,24,5
191004,9,44,8,0,36,8
191004,8,275,58,0,217,58
191004,7,446,55,0,391,55
191004,6,370,49,0,321,49
191004,5,108,16,0,92,16
191004,4,44,10,0,34,10
191004,3,19,4,0,15,4
191004,2,3,1,0,2,1
59,10,16,6,0,10,6
59,9,45,18,0,27,18
59,8,291,78,0,213,78
59,7,466,102,0,364,102
59,6,342,81,0,261,81
59,5,126,35,0,91,35
59,4,33,10,0,23,10
59,3,12,4,0,8,4
59,2,6,2,0,4,2
175878,10,51,18,0,33,18
175878,9,55,22,0,33,22
175878,8,228,59,0,169,59
175878,7,319,64,0,255,64
175878,6,354,73,0,281,73
175878,5,167,45,0,122,45
175878,4,95,30,1,65,29
175878,3,49,8,0,41,8
175878,2,11,6,0,5,6
175878,1,12,4,0,8,4
75,10,23,5,0,18,5
75,9,22,5,0,17,5
75,8,108,43,0,65,43
75,7,203,56,0,147,56
75,6,381,97,0,284,97
75,5,251,74,0,177,74
75,4,177,54,0,123,54
75,3,88,32,0,56,32
75,2,66,28,0,38,28
75,1,21,11,0,10,11
12346,10,19,4,0,15,4
12346,9,43,10,0,33,10
12346,8,224,70,0,154,70
12346,7,367,80,0,287,80
12346,6,425,81,0,344,81
12346,5,145,35,0,110,35
12346,4,71,19,0,52,19
12346,3,35,13,0,22,13
12346,2,6,1,0,5,1
12346,1,3,1,0,2,1
193737,10,37,8,0,29,8
193737,9,115,26,0,89,26
193737,8,403,67,0,336,67
193737,7,402,64,0,338,64
193737,6,258,44,0,214,44
193737,5,76,13,0,63,13
193737,4,30,8,0,22,8
193737,3,10,4,0,6,4
193737,2,7,2,0,5,2
200,10,13,5,0,8,5
200,9,38,11,0,27,11
200,8,207,52,0,155,52
200,7,383,82,0,301,82
200,6,467,99,0,368,99
200,5,149,27,0,122,27
200,4,58,16,0,42,16
200,3,21,5,0,16,5
200,2,2,1,0,1,1
3267,10,5,3,0,2,3
3267,9,16,7,0,9,7
3267,8,253,85,1,168,84
3267,7,468,134,0,334,134
3267,6,404,118,0,286,118
3267,5,115,44,0,71,44
3267,4,58,16,0,42,16
3267,3,11,6,0,5,6
3267,2,8,5,0,3,5
9,10,13,6,0,7,6
9,9,53,20,0,33,20
9,8,254,87,0,167,87
9,7,368,93,0,275,93
9,6,381,96,0,285,96
9,5,150,51,0,99,51
9,4,65,27,0,38,27
9,3,38,12,0,26,12
9,2,11,5,0,6,5
21464,10,2,1,0,1,1
21464,9,13,7,0,6,7
21464,8,155,65,0,90,65
21464,7,381,132,0,249,132
21464,6,510,163,0,347,163
21464,5,177,64,0,113,64
21464,4,64,27,0,37,27
21464,3,20,10,0,10,10
21464,2,13,6,0,7,6
8222,10,11,3,0,8,3
8222,9,37,7,0,30,7
8222,8,139,29,0,110,29
8222,7,257,64,0,193,64
8222,6,449,70,0,379,70
8222,5,226,53,0,173,53
8222,4,130,36,0,94,36
8222,3,51,15,0,36,15
8222,2,27,5,0,22,5
8222,1,9,5,0,4,5
182351,10,16,2,0,14,2
182351,9,34,8,1,26,7
182351,8,249,38,5,211,33
182351,7,434,63,8,371,55
182351,6,395,63,8,332,55
182351,5,111,24,1,87,23
182351,4,55,12,0,43,12
182351,3,20,1,0,19,1
182351,2,15,6,1,9,5
182351,1,4,2,1,2,1
550,10,14,4,0,10,4
550,9,40,12,0,28,12
550,8,201,57,0,144,57
550,7,365,98,0,267,98
550,6,452,102,0,350,102
550,5,140,43,0,97,43
550,4,70,23,0,47,23
550,3,32,11,0,21,11
550,2,16,7,0,9,7
550,1,4,2,0,2,2
3236,10,16,7,0,9,7
3236,9,43,17,0,26,17
3236,8,292,104,0,188,104
3236,7,421,116,0,305,116
3236,6,373,125,0,248,125
3236,5,113,43,0,70,43
3236,4,48,18,0,30,18
3236,3,20,11,0,9,11
3236,2,6,4,0,2,4
833,10,136,55,0,81,55
833,9,224,83,0,141,83
833,8,482,122,0,360,122
833,7,275,64,0,211,64
833,6,130,40,0,90,40
833,5,49,18,0,31,18
833,4,14,3,0,11,3
833,3,14,10,0,4,10
833,2,5,3,0,2,3
19947,10,4,2,0,2,2
19947,9,18,6,0,12,6
19947,8,153,56,0,97,56
19947,7,392,107,0,285,107
19947,6,483,144,0,339,144
19947,5,176,66,0,110,66
19947,4,69,35,0,34,35
19947,3,27,11,0,16,11
19947,2,7,5,0,2,5
40831,10,12,5,0,7,5
40831,9,38,10,0,28,10
40831,8,231,49,0,182,49
40831,7,427,81,0,346,81
40831,6,441,85,0,356,85
40831,5,108,23,0,85,23
40831,4,53,12,0,41,12
40831,3,12,5,0,7,5
40831,2,7,5,0,2,5
235,10,26,9,0,17,9
235,9,47,17,0,30,17
235,8,239,89,0,150,89
235,7,314,97,0,217,97
235,6,375,121,0,254,121
235,5,174,53,0,121,53
235,4,94,39,0,55,39
235,3,37,21,0,16,21
235,2,15,6,0,9,6
235,1,9,5,0,4,5
87890,10,46,12,0,34,12
87890,9,121,21,0,100,21
87890,8,469,102,0,367,102
87890,7,369,70,0,299,70
87890,6,201,41,0,160,41
87890,5,64,16,0,48,16
87890,4,37,12,0,25,12
87890,3,8,2,0,6,2
87890,2,6,1,0,5,1
87890,1,6,2,0,4,2
180602,10,14,2,0,12,2
180602,9,19,1,0,18,1
180602,8,174,26,0,148,26
180602,7,382,46,0,336,46
180602,6,497,50,0,447,50
180602,5,157,20,0,137,20
180602,4,58,14,0,44,14
180602,3,17,3,0,14,3
180602,2,10,3,0,7,3
118705,10,27,2,0,25,2
118705,9,55,10,0,45,10
118705,8,293,45,0,248,45
118705,7,416,46,0,370,46
118705,6,380,40,0,340,40
118705,5,102,12,0,90,12
118705,4,32,3,0,29,3
118705,3,11,1,0,10,1
118705,2,5,1,0,4,1
310,10,11,5,0,6,5
310,9,46,15,0,31,15
310,8,135,50,0,85,50
310,7,322,103,0,219,103
310,6,470,124,0,346,124
310,5,203,65,0,138,65
310,4,83,29,0,54,29
310,3,40,17,0,23,17
310,2,9,3,0,6,3
310,1,6,3,0,3,3
28181,10,231,71,0,160,71
28181,9,356,90,0,266,90
28181,8,417,97,0,320,97
28181,7,154,31,0,123,31
28181,6,75,16,0,59,16
28181,5,33,5,0,28,5
28181,4,18,4,0,14,4
28181,3,11,4,0,7,4
28181,2,4,1,0,3,1
28181,1,25,3,0,22,3
200847,10,15,2,0,13,2
200847,9,45,8,0,37,8
200847,8,273,32,0,241,32
200847,7,397,43,0,354,43
200847,6,375,39,0,336,39
200847,5,113,13,0,100,13
200847,4,65,14,0,51,14
200847,3,25,4,0,21,4
200847,2,12,1,0,11,1
200847,1,4,2,0,2,2
2750,10,7,1,0,6,1
2750,9,17,4,0,13,4
2750,8,93,19,0,74,19
2750,7,202,50,0,152,50
2750,6,417,119,0,298,119
2750,5,275,64,0,211,64
2750,4,188,62,0,126,62
2750,3,78,23,0,55,23
2750,2,35,20,0,15,20
2750,1,12,5,0,7,5
163640,10,13,4,0,9,4
163640,9,47,13,0,34,13
163640,8,240,49,2,191,47
163640,7,381,70,5,311,65
163640,6,416,87,5,329,82
163640,5,129,30,2,99,28
163640,4,54,18,0,36,18
163640,3,26,7,0,19,7
163640,2,12,2,0,10,2
163640,1,4,2,0,2,2
2065,10,156,52,0,104,52
2065,9,164,48,0,116,48
2065,8,288,84,0,204,84
2065,7,340,66,0,274,66
2065,6,215,47,0,168,47
2065,5,82,16,0,66,16
2065,4,44,12,0,32,12
2065,3,14,4,0,10,4
2065,2,8,1,0,7,1
2065,1,8,1,0,7,1
146735,10,44,6,0,38,6
146735,9,79,10,0,69,10
146735,8,245,28,0,217,28
146735,7,282,35,0,247,35
146735,6,394,45,0,349,45
146735,5,150,26,0,124,26
146735,4,75,16,0,59,16
146735,3,28,5,0,23,5
146735,2,13,2,0,11,2
146735,1,8,2,0,6,2
66510,10,100,13,1,87,12
66510,9,138,23,0,115,23
66510,8,325,31,0,294,31
66510,7,361,25,0,336,25
66510,6,258,35,0,223,35
66510,5,76,13,0,63,13
66510,4,23,5,0,18,5
66510,2,14,5,0,9,5
66510,1,8,2,0,6,2
203780,10,20,3,0,17,3
203780,9,57,15,0,42,15
203780,8,331,52,0,279,52
203780,7,427,63,0,364,63
203780,6,326,62,0,264,62
203780,5,104,21,0,83,21
203780,4,37,7,0,30,7
203780,3,8,2,0,6,2
203780,2,2,1,0,1,1
73070,10,10,3,0,7,3
73070,9,76,10,0,66,10
73070,8,401,71,0,330,71
73070,7,383,58,0,325,58
73070,6,284,64,0,220,64
73070,5,80,17,0,63,17
73070,4,38,14,0,24,14
73070,3,25,13,0,12,13
73070,2,7,3,0,4,3
73070,1,8,1,0,7,1
3154,10,8,1,0,7,1
3154,9,32,12,0,20,12
3154,8,186,68,0,118,68
3154,7,404,92,0,312,92
3154,6,435,123,0,312,123
3154,5,148,51,0,97,51
3154,4,57,17,0,40,17
3154,3,32,13,0,19,13
3154,2,8,5,0,3,5
3154,1,2,1,0,1,1
125311,10,20,5,0,15,5
125311,9,44,9,0,35,9
125311,8,211,41,0,170,41
125311,7,410,62,0,348,62
125311,6,447,78,0,369,78
125311,5,115,24,0,91,24
125311,4,39,9,0,30,9
125311,3,12,6,0,6,6
125311,1,5,2,0,3,2
76150,10,32,9,0,23,9
76150,9,68,14,0,54,14
76150,8,352,77,0,275,77
76150,7,413,76,0,337,76
76150,6,297,62,0,235,62
76150,5,86,18,0,68,18
76150,4,40,13,0,27,13
76150,3,16,4,0,12,4
76150,2,3,1,0,2,1
193739,10,22,2,0,20,2
193739,9,46,15,0,31,15
193739,8,403,58,0,345,58
193739,7,392,47,0,345,47
193739,6,302,41,0,261,41
193739,5,77,12,0,65,12
193739,4,41,8,0,33,8
193739,3,18,4,0,14,4
193739,2,7,2,0,5,2
9408,10,8,5,0,3,5
9408,9,22,10,0,12,10
9408,8,204,74,0,130,74
9408,7,429,142,0,287,142
9408,6,418,144,0,274,144
9408,5,128,36,0,92,36
9408,4,71,29,0,42,29
9408,3,19,2,0,17,2
9408,2,6,2,0,4,2
234669,10,111,16,0,95,16
234669,9,211,31,0,180,31
234669,8,473,67,0,406,67
234669,7,252,35,0,217,35
234669,6,139,25,0,114,25
234669,5,51,15,0,36,15
234669,4,22,9,0,13,9
234669,3,19,10,0,9,10
234669,2,20,11,0,9,11
234669,1,14,4,0,10,4
143175,10,24,3,0,21,3
143175,9,89,16,0,73,16
143175,8,414,80,1,334,79
143175,7,417,76,0,341,76
143175,6,270,57,0,213,57
143175,5,61,14,0,47,14
143175,4,24,6,0,18,6
143175,3,4,1,0,3,1
143175,2,4,3,0,1,3
108,10,28,13,0,15,13
108,9,58,24,0,34,24
108,8,331,130,0,201,130
108,7,379,115,0,264,115
108,6,324,97,0,227,97
108,5,99,41,0,58,41
108,4,49,19,0,30,19
108,3,26,7,0,19,7
108,2,7,1,0,6,1
108,1,4,1,0,3,1
10816,10,10,3,0,7,3
10816,9,19,3,0,16,3
10816,8,39,13,0,26,13
10816,7,94,20,0,74,20
10816,6,223,53,0,170,53
10816,5,300,67,0,233,67
10816,4,266,65,0,201,65
10816,3,174,48,0,126,48
10816,2,130,46,0,84,46
10816,1,49,15,0,34,15
2290,10,20,11,0,9,11
2290,9,52,19,0,33,19
2290,8,176,40,0,136,40
2290,7,342,80,0,262,80
2290,6,420,92,0,328,92
2290,5,192,52,0,140,52
2290,4,63,18,0,45,18
2290,3,36,13,0,23,13
2290,2,3,1,0,2,1
15953,10,50,14,0,36,14
15953,9,97,24,0,73,24
15953,8,378,90,0,288,90
15953,7,430,92,0,338,92
15953,6,238,45,0,193,45
15953,5,68,16,0,52,16
15953,4,22,4,0,18,4
15953,2,7,1,0,6,1
27385,9,24,5,0,19,5
27385,8,170,47,0,123,47
27385,7,356,86,0,270,86
27385,6,443,112,0,331,112
27385,5,185,56,0,129,56
27385,4,77,28,0,49,28
27385,3,23,7,0,16,7
27385,2,13,3,0,10,3
27385,1,5,1,0,4,1
66849,10,29,6,0,23,6
66849,9,66,13,0,53,13
66849,8,332,67,0,265,67
66849,7,425,83,0,342,83
66849,6,324,59,0,265,59
66849,5,75,20,0,55,20
66849,4,28,8,0,20,8
66849,3,10,4,0,6,4
66849,2,7,3,0,4,3
154634,10,13,2,1,11,1
154634,9,26,5,1,21,4
154634,8,227,43,6,184,37
154634,7,345,47,5,298,42
154634,6,436,66,3,370,63
154634,5,149,29,3,120,26
154634,4,54,20,3,34,17
154634,3,31,5,0,26,5
154634,2,12,4,0,8,4
154634,1,4,1,0,3,1
25234,9,40,6,0,34,6
25234,8,216,72,1,144,71
25234,7,412,76,0,336,76
25234,6,381,89,0,292,89
25234,5,147,38,0,109,38
25234,4,60,22,0,38,22
25234,3,21,5,0,16,5
25234,2,11,3,0,8,3
25234,1,4,1,0,3,1
9675,10,2,2,0,0,2
9675,9,8,3,0,5,3
9675,8,147,60,0,87,60
9675,7,360,110,0,250,110
9675,6,494,181,0,313,181
9675,5,174,64,0,110,64
9675,4,55,25,0,30,25
9675,3,44,21,0,23,21
9675,2,8,5,0,3,5
9675,1,3,1,0,2,1
15600,10,11,3,0,8,3
15600,9,52,29,0,23,29
15600,8,374,133,0,241,133
15600,7,421,118,0,303,118
15600,6,310,106,0,204,106
15600,5,84,30,0,54,30
15600,4,30,12,0,18,12
15600,3,10,7,0,3,7
15600,2,2,1,0,1,1
148290,10,7,1,0,6,1
148290,9,34,10,0,24,10
148290,8,237,39,0,198,39
148290,7,430,67,0,363,67
148290,6,401,67,0,334,67
148290,5,105,19,0,86,19
148290,4,59,15,0,44,15
148290,3,8,1,0,7,1
148290,2,9,3,0,6,3
148290,1,2,1,0,1,1
104581,10,53,14,0,39,14
104581,9,93,24,0,69,24
104581,8,367,80,0,287,80
104581,7,371,66,0,305,66
104581,6,262,49,0,213,49
104581,5,72,18,0,54,18
104581,4,39,6,0,33,6
104581,3,21,5,0,16,5
104581,2,9,5,0,4,5
104581,1,5,2,0,3,2
154301,10,18,5,0,13,5
154301,9,58,10,0,48,10
154301,8,337,66,0,271,66
154301,7,381,78,0,303,78
154301,6,332,56,0,276,56
154301,5,83,21,0,62,21
154301,4,52,15,0,37,15
154301,3,16,6,0,10,6
154301,2,11,4,0,7,4
847,10,22,10,0,12,10
847,9,34,10,0,24,10
847,8,122,36,0,86,36
847,7,249,66,0,183,66
847,6,449,134,0,315,134
847,5,245,77,0,168,77
847,4,114,42,0,72,42
847,3,36,10,0,26,10
847,2,13,5,0,8,5
847,1,6,2,0,4,2
163930,10,12,1,0,11,1
163930,9,40,15,0,25,15
163930,8,249,32,0,217,32
163930,7,401,56,0,345,56
163930,6,391,60,0,331,60
163930,5,127,24,0,103,24
163930,4,38,11,0,27,11
163930,3,18,6,0,12,6
163930,2,10,2,0,8,2
163930,1,5,1,0,4,1
2379,10,14,4,0,10,4
2379,9,38,10,0,28,10
2379,8,133,42,0,91,42
2379,7,230,66,0,164,66
2379,6,443,95,0,348,95
2379,5,231,53,0,178,53
2379,4,131,40,0,91,40
2379,3,40,8,0,32,8
2379,2,21,8,0,13,8
2379,1,8,3,0,5,3
348,10,31,7,0,24,7
348,9,72,27,0,45,27
348,8,299,95,0,204,95
348,7,382,81,0,301,81
348,6,309,66,0,243,66
348,5,110,27,0,83,27
348,4,52,15,0,37,15
348,3,27,13,0,14,13
348,2,3,1,0,2,1
2808,10,75,35,0,40,35
2808,9,155,68,0,87,68
2808,8,362,133,0,229,133
2808,7,348,101,0,247,101
2808,6,227,66,0,161,66
2808,5,80,31,0,49,31
2808,4,24,8,0,16,8
2808,3,11,5,0,6,5
2808,2,3,1,0,2,1
130877,10,30,8,0,22,8
130877,9,65,17,0,48,17
130877,8,276,44,0,232,44
130877,7,355,60,0,295,60
130877,6,342,54,0,288,54
130877,5,121,19,0,102,19
130877,4,55,13,0,42,13
130877,3,28,3,0,25,3
130877,2,12,3,0,9,3
130877,1,5,1,0,4,1
63706,10,14,4,0,10,4
63706,9,13,8,0,5,8
63706,8,161,41,0,120,41
63706,7,335,60,0,275,60
63706,6,513,105,0,408,105
63706,5,149,27,0,122,27
63706,4,65,18,0,47,18
63706,3,28,3,0,25,3
63706,2,5,2,0,3,2
202583,10,57,20,1,37,19
202583,9,148,37,7,111,30
202583,8,478,86,9,392,77
202583,7,358,53,11,305,42
202583,6,178,26,0,152,26
202583,5,42,12,1,30,11
202583,4,18,5,1,13,4
202583,3,9,3,0,6,3
202583,2,4,1,0,3,1
193560,10,25,7,0,18,7
193560,9,55,15,0,40,15
193560,8,283,65,0,218,65
193560,7,380,87,0,293,87
193560,6,317,69,0,248,69
193560,5,128,28,0,100,28
193560,4,50,18,0,32,18
193560,3,32,9,0,23,9
193560,2,14,5,0,9,5
193560,1,4,2,0,2,2
19427,10,23,12,0,11,12
19427,9,70,24,0,46,24
19427,8,294,100,3,194,97
19427,7,423,84,1,339,83
19427,6,327,93,1,234,92
19427,5,105,23,0,82,23
19427,4,26,4,0,22,4
19427,3,13,5,0,8,5
19427,2,4,1,0,3,1
38984,9,20,2,0,18,2
38984,8,147,36,0,111,36
38984,7,334,63,0,271,63
38984,6,502,102,0,400,102
38984,5,139,23,0,116,23
38984,4,86,20,0,66,20
38984,3,32,6,0,26,6
38984,2,12,5,0,7,5
38984,1,6,3,0,3,3
29603,10,210,72,0,138,72
29603,9,396,115,0,281,115
29603,8,411,112,0,299,112
29603,7,155,33,0,122,33
29603,6,59,14,0,45,14
29603,5,20,8,0,12,8
29603,4,19,5,0,14,5
29603,3,5,1,0,4,1
29603,2,1,1,0,0,1
293,10,16,4,0,12,4
293,9,38,10,0,28,10
293,8,198,57,0,141,57
293,7,344,94,0,250,94
293,6,432,123,0,309,123
293,5,154,48,0,106,48
293,4,61,19,0,42,19
293,3,16,6,0,10,6
293,2,14,2,0,12,2
293,1,10,3,0,7,3
165948,10,17,2,0,15,2
165948,9,69,14,0,55,14
165948,8,476,83,0,393,83
165948,7,439,71,0,368,71
165948,6,205,34,0,171,34
165948,5,48,6,0,42,6
165948,4,18,8,0,10,8
165948,3,7,3,0,4,3
165948,2,2,1,0,1,1
176371,10,39,5,0,34,5
176371,9,120,21,1,99,20
176371,8,466,73,4,393,69
176371,7,392,55,5,337,50
176371,6,210,23,0,187,23
176371,5,37,7,0,30,7
176371,4,15,3,0,12,3
176371,2,1,1,0,0,1
37734,10,10,2,0,8,2
37734,9,57,18,0,39,18
37734,8,326,88,0,238,88
37734,7,362,94,0,268,94
37734,6,338,84,0,254,84
37734,5,112,36,0,76,36
37734,4,45,12,0,33,12
37734,3,21,11,0,10,11
37734,2,8,4,0,4,4
193557,10,15,3,0,12,3
193557,9,51,9,0,42,9
193557,8,268,48,0,220,48
193557,7,426,77,0,349,77
193557,6,355,62,0,293,62
193557,5,105,16,0,89,16
193557,4,41,15,0,26,15
193557,3,16,4,0,12,4
193557,2,5,1,0,4,1
193557,1,2,1,0,1,1
68264,10,125,58,0,67,58
68264,9,270,85,0,185,85
68264,8,504,124,0,380,124
68264,7,204,59,0,145,59
68264,6,103,33,0,70,33
68264,5,34,15,0,19,15
68264,4,17,7,0,10,7
68264,3,10,4,0,6,4
68264,1,10,2,0,8,2
121423,9,15,3,0,12,3
121423,8,99,26,1,73,25
121423,7,288,63,4,225,59
121423,6,512,107,4,405,103
121423,5,221,45,2,176,43
121423,4,93,27,1,66,26
121423,3,34,13,0,21,13
121423,2,7,1,0,6,1
121423,1,4,1,0,3,1
32165,9,27,6,0,21,6
32165,8,220,71,0,149,71
32165,7,437,120,0,317,120
32165,6,391,105,0,286,105
32165,5,130,48,0,82,48
32165,4,43,17,0,26,17
32165,3,14,7,0,7,7
32165,2,4,2,0,2,2
2557,10,12,4,0,8,4
2557,9,16,4,0,12,4
2557,8,82,19,0,63,19
2557,7,175,45,0,130,45
2557,6,403,101,0,302,101
2557,5,280,78,0,202,78
2557,4,165,59,0,106,59
2557,3,88,36,0,52,36
2557,2,37,16,0,21,16
2557,1,17,14,0,3,14
27,10,35,9,0,26,9
27,9,40,13,0,27,13
27,8,132,39,0,93,39
27,7,190,49,0,141,49
27,6,331,99,0,232,99
27,5,216,59,1,157,58
27,4,120,49,0,71,49
27,3,111,55,0,56,55
27,2,61,40,0,21,40
27,1,39,28,0,11,28
143157,10,19,7,1,12,6
143157,9,56,20,0,36,20
143157,8,290,71,0,219,71
143157,7,352,64,1,288,63
143157,6,382,73,0,309,73
143157,5,92,29,0,63,29
143157,4,44,15,0,29,15
143157,3,22,4,0,18,4
143157,2,15,8,0,7,8
143157,1,3,2,0,1,2
154003,10,9,2,0,7,2
154003,9,39,8,0,31,8
154003,8,259,45,0,214,45
154003,7,436,77,0,359,77
154003,6,383,66,0,317,66
154003,5,96,11,0,85,11
154003,4,32,9,0,23,9
154003,3,13,3,0,10,3
154003,2,3,1,0,2,1
2961,10,22,6,0,16,6
2961,9,102,25,0,77,25
2961,8,416,102,0,314,102
2961,7,371,101,0,270,101
2961,6,254,73,0,181,73
2961,5,64,17,0,47,17
2961,4,30,12,0,18,12
2961,3,14,5,0,9,5
2961,1,2,1,0,1,1
132544,10,24,1,0,23,1
132544,9,75,16,1,59,15
132544,8,310,63,8,247,55
132544,7,358,56,4,302,52
132544,6,286,45,4,241,41
132544,5,115,14,1,101,13
132544,4,67,19,2,48,17
132544,3,27,8,0,19,8
132544,2,11,4,0,7,4
132544,1,2,2,0,0,2
65673,10,18,3,0,15,3
65673,9,45,9,0,36,9
65673,8,231,48,0,183,48
65673,7,380,41,0,339,41
65673,6,388,47,0,341,47
65673,5,120,29,0,91,29
65673,4,62,16,0,46,16
65673,3,18,4,0,14,4
65673,2,8,3,0,5,3
37696,10,15,5,0,10,5
37696,9,34,7,0,27,7
37696,8,192,39,0,153,39
37696,7,340,58,0,282,58
37696,6,414,82,0,332,82
37696,5,151,39,0,112,39
37696,4,79,13,0,66,13
37696,3,27,11,0,16,11
37696,2,17,5,0,12,5
37696,1,4,3,0,1,3
172931,10,37,14,0,23,14
172931,9,113,40,0,73,40
172931,8,396,115,0,281,115
172931,7,391,72,0,319,72
172931,6,252,50,0,202,50
172931,5,59,13,0,46,13
172931,4,16,5,0,11,5
172931,3,3,1,0,2,1
127127,10,31,5,0,26,5
127127,9,74,15,0,59,15
127127,8,296,53,0,243,53
127127,7,396,68,0,328,68
127127,6,310,57,0,253,57
127127,5,74,11,0,63,11
127127,4,47,9,0,38,9
127127,3,22,8,0,14,8
127127,2,11,5,0,6,5
127127,1,5,3,0,2,3
218311,9,44,6,0,38,6
218311,8,293,24,0,269,24
218311,7,454,60,0,394,60
218311,6,340,43,0,297,43
218311,5,79,18,0,61,18
218311,4,29,4,0,25,4
218311,3,13,2,0,11,2
172996,10,31,8,0,23,8
172996,9,105,30,0,75,30
172996,8,421,84,0,337,84
172996,7,349,54,0,295,54
172996,6,251,45,0,206,45
172996,5,60,14,0,46,14
172996,4,30,7,0,23,7
172996,3,13,4,0,9,4
172996,2,4,1,0,3,1
172996,1,2,1,0,1,1
15954,10,25,11,0,14,11
15954,9,68,25,0,43,25
15954,8,368,125,0,243,125
15954,7,385,131,0,254,131
15954,6,272,99,0,173,99
15954,5,76,31,0,45,31
15954,4,39,16,0,23,16
15954,3,23,10,0,13,10
15954,2,6,1,0,5,1
15954,1,4,1,0,3,1
73863,9,20,2,0,18,2
73863,8,193,43,0,150,43
73863,7,392,86,0,306,86
73863,6,437,88,0,349,88
73863,5,141,25,0,116,25
73863,4,52,11,0,41,11
73863,3,14,4,0,10,4
73863,1,3,1,0,2,1
244654,10,60,16,0,44,16
244654,9,161,28,0,133,28
244654,8,507,77,0,430,77
244654,7,282,36,0,246,36
244654,6,164,29,0,135,29
244654,5,57,14,0,43,14
244654,4,21,3,0,18,3
244654,3,13,3,0,10,3
244654,2,3,2,0,1,2
2288,10,58,12,0,46,12
2288,9,89,16,0,73,16
2288,8,238,61,0,177,61
2288,7,389,65,0,324,65
2288,6,285,67,0,218,67
2288,5,114,31,0,83,31
2288,4,43,15,0,28,15
2288,3,23,3,0,20,3
2288,2,14,4,0,10,4
2288,1,9,3,0,6,3
138649,10,93,11,0,82,11
138649,9,162,19,0,143,19
138649,8,430,53,0,377,53
138649,7,302,37,0,265,37
138649,6,180,28,0,152,28
138649,5,53,8,0,45,8
138649,4,19,3,0,16,3
138649,3,8,2,0,6,2
138649,2,5,2,0,3,2
138649,1,10,1,0,9,1
27940,10,7,3,0,4,3
27940,9,11,2,0,9,2
27940,8,91,31,0,60,31
27940,7,231,81,0,150,81
27940,6,513,146,0,367,146
27940,5,253,73,0,180,73
27940,4,105,37,0,68,37
27940,3,41,16,0,25,16
27940,2,8,2,0,6,2
27940,1,2,1,0,1,1
3452,10,5,2,0,3,2
3452,9,14,6,0,8,6
3452,8,176,66,0,110,66
3452,7,352,132,0,220,132
3452,6,488,138,0,350,138
3452,5,150,36,0,114,36
3452,4,49,17,0,32,17
3452,3,23,8,0,15,8
3452,2,3,1,0,2,1
229,10,4,1,0,3,1
229,9,23,9,0,14,9
229,8,160,52,0,108,52
229,7,364,83,0,281,83
229,6,419,103,0,316,103
229,5,165,58,0,107,58
229,4,72,34,0,38,34
229,3,35,14,0,21,14
229,2,11,7,0,4,7
229,1,7,4,0,3,4
234671,10,79,13,0,66,13
234671,9,200,43,0,157,43
234671,8,577,86,0,491,86
234671,7,261,35,0,226,35
234671,6,93,18,0,75,18
234671,5,28,6,0,22,6
234671,4,12,3,0,9,3
234671,3,2,1,0,1,1
234671,2,3,2,0,1,2
153318,10,20,6,0,14,6
153318,9,58,11,0,47,11
153318,8,326,56,0,270,56
153318,7,385,67,0,318,67
153318,6,345,65,0,280,65
153318,5,79,10,0,69,10
153318,4,34,9,0,25,9
153318,3,7,1,0,6,1
153318,2,4,1,0,3,1
1499,10,216,90,0,126,90
1499,9,202,67,0,135,67
1499,8,287,81,0,206,81
1499,7,229,56,0,173,56
1499,6,164,48,0,116,48
1499,5,70,24,0,46,24
1499,4,41,11,0,30,11
1499,3,20,12,0,8,12
1499,2,13,6,0,7,6
1499,1,14,6,0,8,6
67180,10,12,3,0,9,3
67180,9,65,16,0,49,16
67180,8,348,65,0,283,65
67180,7,387,62,0,325,62
67180,6,310,53,0,257,53
67180,5,83,24,0,59,24
67180,4,28,6,0,22,6
67180,3,9,6,0,3,6
67180,2,5,2,0,3,2
46396,10,46,10,0,36,10
46396,9,104,23,0,81,23
46396,8,394,67,0,327,67
46396,7,369,49,0,320,49
46396,6,233,33,0,200,33
46396,5,55,12,0,43,12
46396,4,26,9,0,17,9
46396,3,19,8,0,11,8
141,10,6,2,0,4,2
141,9,23,12,0,11,12
141,8,174,64,0,110,64
141,7,422,116,0,306,116
141,6,395,116,0,279,116
141,5,139,42,0,97,42
141,4,55,25,0,30,25
141,3,26,13,0,13,13
141,2,9,3,0,6,3
141,1,4,1,0,3,1
156138,10,20,4,0,16,4
156138,9,48,10,0,38,10
156138,8,354,62,0,292,62
156138,7,405,55,0,350,55
156138,6,305,48,0,257,48
156138,5,76,14,0,62,14
156138,4,30,4,0,26,4
156138,3,13,5,0,8,5
172546,10,17,3,0,14,3
172546,9,32,7,0,25,7
172546,8,203,45,2,158,43
172546,7,389,73,1,316,72
172546,6,424,66,1,358,65
172546,5,111,24,0,87,24
172546,4,54,12,0,42,12
172546,3,16,6,0,10,6
172546,2,6,1,0,5,1
172546,1,2,1,0,1,1
187680,10,22,9,1,13,8
187680,9,69,18,5,51,13
187680,8,359,64,9,295,55
187680,7,439,66,10,373,56
187680,6,265,37,3,228,34
187680,5,67,17,1,50,16
187680,4,25,6,0,19,6
187680,3,4,2,0,2,2
39242,10,18,4,0,14,4
39242,9,66,16,0,50,16
39242,8,285,76,0,209,76
39242,7,330,64,0,266,64
39242,6,314,84,0,230,84
39242,5,121,29,0,92,29
39242,4,68,32,0,36,32
39242,3,36,14,0,22,14
39242,2,13,3,0,10,3
4610,9,13,4,0,9,4
4610,8,97,34,0,63,34
4610,7,266,80,0,186,80
4610,6,511,120,0,391,120
4610,5,188,40,0,148,40
4610,4,107,25,0,82,25
4610,3,47,19,0,28,19
4610,2,14,2,0,12,2
96260,10,3,3,0,0,3
96260,9,19,3,0,16,3
96260,8,142,28,0,114,28
96260,7,313,71,0,242,71
96260,6,425,110,0,315,110
96260,5,160,36,0,124,36
96260,4,101,37,0,64,37
96260,3,53,24,0,29,24
96260,2,24,15,0,9,15
96260,1,8,1,0,7,1
6281,9,28,6,0,22,6
6281,8,185,55,0,130,55
6281,7,358,73,0,285,73
6281,6,426,106,0,320,106
6281,5,139,42,0,97,42
6281,4,69,18,0,51,18
6281,3,27,14,0,13,14
6281,2,6,3,0,3,3
6281,1,2,1,0,1,1
3655,10,47,12,0,35,12
3655,9,94,28,0,66,28
3655,8,256,62,0,194,62
3655,7,332,70,0,262,70
3655,6,319,83,0,236,83
3655,5,110,30,0,80,30
3655,4,46,14,0,32,14
3655,3,25,6,0,19,6
3655,2,9,4,0,5,4
3655,1,8,2,0,6,2
300,10,4,3,0,1,3
300,9,19,4,0,15,4
300,8,93,36,0,57,36
300,7,306,103,0,203,103
300,6,540,160,0,380,160
300,5,186,71,0,115,71
300,4,62,33,0,29,33
300,3,20,10,0,10,10
300,2,14,3,0,11,3
163805,10,29,6,0,23,6
163805,9,110,17,0,93,17
163805,8,420,66,0,354,66
163805,7,363,64,0,299,64
163805,6,233,51,0,182,51
163805,5,55,11,0,44,11
163805,4,27,8,0,19,8
163805,3,8,4,0,4,4
163805,1,1,1,0,0,1
12632,10,3,2,0,1,2
12632,9,26,9,0,17,9
12632,8,208,72,0,136,72
12632,7,385,108,0,277,108
12632,6,399,133,0,266,133
12632,5,116,43,0,73,43
12632,4,68,26,0,42,26
12632,3,21,9,0,12,9
12632,2,10,6,0,4,6
12632,1,6,2,0,4,2
1315,10,3,1,0,2,1
1315,9,11,6,0,5,6
1315,8,131,58,0,73,58
1315,7,272,111,0,161,111
1315,6,470,170,0,300,170
1315,5,192,64,0,128,64
1315,4,100,38,0,62,38
1315,3,50,23,0,27,23
1315,2,9,4,0,5,4
1315,1,3,3,0,0,3
1604,10,17,6,0,11,6
1604,9,16,6,0,10,6
1604,8,50,15,0,35,15
1604,7,116,26,0,90,26
1604,6,239,53,0,186,53
1604,5,297,75,0,222,75
1604,4,243,55,0,188,55
1604,3,157,46,0,111,46
1604,2,79,33,0,46,33
1604,1,26,8,0,18,8
154906,10,20,6,0,14,6
154906,9,47,7,1,40,6
154906,8,322,52,0,270,52
154906,7,428,67,0,361,67
154906,6,297,42,0,255,42
154906,5,78,22,0,56,22
154906,4,30,10,0,20,10
154906,3,12,1,0,11,1
154906,2,2,1,0,1,1
154906,1,2,1,0,1,1
126996,10,50,14,0,36,14
126996,9,92,23,4,69,19
126996,8,346,67,7,279,60
126996,7,329,51,3,278,48
126996,6,277,49,3,228,46
126996,5,84,22,1,62,21
126996,4,42,14,1,28,13
126996,3,9,1,0,8,1
126996,1,6,3,0,3,3
94104,10,48,17,1,31,16
94104,9,143,47,1,96,46
94104,8,466,123,11,343,112
94104,7,326,90,5,236,85
94104,6,170,40,4,130,36
94104,5,51,16,1,35,15
94104,4,24,6,0,18,6
94104,3,2,1,0,1,1
94104,2,6,2,0,4,2
6205,10,123,72,0,51,72
6205,9,195,84,0,111,84
6205,8,415,133,0,282,133
6205,7,233,78,0,155,78
6205,6,135,45,0,90,45
6205,5,61,24,0,37,24
6205,4,37,19,0,18,19
6205,3,13,7,0,6,7
6205,2,10,5,0,5,5
6205,1,12,2,0,10,2
8172,10,10,1,0,9,1
8172,9,47,14,0,33,14
8172,8,239,60,0,179,60
8172,7,342,53,0,289,53
8172,6,420,69,0,351,69
8172,5,120,21,0,99,21
8172,4,37,9,0,28,9
8172,3,15,6,0,9,6
8172,2,1,1,0,0,1
8172,1,2,1,0,1,1
86073,9,21,4,0,17,4
86073,8,79,12,0,67,12
86073,7,161,17,0,144,17
86073,6,398,54,0,344,54
86073,5,277,45,0,232,45
86073,4,169,28,0,141,28
86073,3,86,21,0,65,21
86073,2,24,4,0,20,4
86073,1,8,1,0,7,1
222542,10,22,3,0,19,3
222542,9,62,11,0,51,11
222542,8,412,50,0,362,50
222542,7,377,43,0,334,43
222542,6,261,39,0,222,39
222542,5,67,11,0,56,11
222542,4,23,9,0,14,9
222542,3,4,1,0,3,1
222542,2,6,5,0,1,5
222542,1,1,1,0,0,1
764,10,4,1,0,3,1
764,9,7,1,0,6,1
764,8,56,9,0,47,9
764,7,127,33,0,94,33
764,6,301,58,0,243,58
764,5,313,64,0,249,64
764,4,215,58,0,157,58
764,3,115,27,0,88,27
764,2,64,26,0,38,26
764,1,31,17,0,14,17
1552,10,29,10,0,19,10
1552,9,64,19,0,45,19
1552,8,185,44,0,141,44
1552,7,275,60,0,215,60
1552,6,382,92,0,290,92
1552,5,164,47,0,117,47
1552,4,80,27,0,53,27
1552,3,36,8,0,28,8
1552,2,14,7,0,7,7
1552,1,2,2,0,0,2
12205,9,13,2,0,11,2
12205,8,35,11,0,24,11
12205,7,90,14,0,76,14
12205,6,266,52,0,214,52
12205,5,292,59,0,233,59
12205,4,262,63,0,199,63
12205,3,125,41,0,84,41
12205,2,102,34,0,68,34
12205,1,46,17,0,29,17
963,10,4,2,0,2,2
963,9,11,1,0,10,1
963,8,115,31,0,84,31
963,7,339,72,0,267,72
963,6,474,100,0,374,100
963,5,175,46,0,129,46
963,4,68,25,0,43,25
963,3,32,9,0,23,9
963,2,11,5,0,6,5
963,1,2,2,0,0,2
111732,10,20,9,0,11,9
111732,9,61,14,0,47,14
111732,8,363,77,3,286,74
111732,7,381,82,6,299,76
111732,6,274,58,1,216,57
111732,5,78,27,1,51,26
111732,4,31,8,0,23,8
111732,3,9,2,0,7,2
111732,2,6,2,0,4,2
111732,1,6,3,0,3,3
229265,10,69,17,1,52,16
229265,9,188,17,0,171,17
229265,8,560,57,1,503,56
229265,7,254,27,0,227,27
229265,6,107,15,0,92,15
229265,5,27,9,1,18,8
229265,4,16,3,0,13,3
229265,3,3,1,0,2,1
229265,2,5,4,0,1,4
201248,10,23,7,0,16,7
201248,9,57,16,0,41,16
201248,8,276,67,0,209,67
201248,7,401,64,0,337,64
201248,6,322,49,0,273,49
201248,5,81,15,0,66,15
201248,4,42,14,0,28,14
201248,3,23,7,0,16,7
201248,2,4,1,0,3,1
22532,10,30,10,0,20,10
22532,9,62,12,0,50,12
22532,8,290,66,0,224,66
22532,7,406,74,0,332,74
22532,6,294,65,0,229,65
22532,5,93,31,0,62,31
22532,4,33,11,0,22,11
22532,3,11,4,0,7,4
22532,1,5,2,0,3,2
216094,10,35,3,0,32,3
216094,9,115,16,0,99,16
216094,8,325,38,0,287,38
216094,7,279,32,0,247,32
216094,6,264,45,0,219,45
216094,5,103,23,0,80,23
216094,4,47,13,0,34,13
216094,3,28,9,0,19,9
216094,2,21,7,0,14,7
216094,1,10,4,0,6,4
19989,9,8,5,0,3,5
19989,8,122,39,0,83,39
19989,7,312,94,0,218,94
19989,6,497,129,0,368,129
19989,5,184,42,0,142,42
19989,4,73,25,0,48,25
19989,3,17,3,0,14,3
19989,2,7,6,0,1,6
21287,10,7,2,0,5,2
21287,9,15,7,0,8,7
21287,8,179,56,0,123,56
21287,7,351,93,0,258,93
21287,6,446,113,0,333,113
21287,5,141,43,0,98,43
21287,4,63,26,0,37,26
21287,3,14,8,0,6,8
21287,2,5,3,0,2,3
96007,10,124,23,0,101,23
96007,9,172,24,0,148,24
96007,8,400,54,0,346,54
96007,7,286,50,0,236,50
96007,6,156,31,0,125,31
96007,5,38,10,0,28,10
96007,4,20,3,0,17,3
96007,3,16,2,0,14,2
96007,2,7,2,0,5,2
533,9,8,4,0,4,4
533,8,49,14,0,35,14
533,7,159,43,0,116,43
533,6,494,122,0,372,122
533,5,291,78,0,213,78
533,4,133,36,0,97,36
533,3,56,20,0,36,20
533,2,22,6,0,16,6
533,1,3,1,0,2,1
218293,10,50,6,1,44,5
218293,9,109,13,2,96,11
218293,8,381,46,7,335,39
218293,7,305,46,10,259,36
218293,6,220,38,3,182,35
218293,5,90,21,3,69,18
218293,4,41,12,1,29,11
218293,3,22,6,0,16,6
218293,2,6,4,1,2,3
233676,10,22,2,0,20,2
233676,9,48,5,0,43,5
233676,8,294,36,0,258,36
233676,7,340,42,0,298,42
233676,6,295,42,0,253,42
233676,5,122,18,0,104,18
233676,4,55,11,0,44,11
233676,3,30,6,0,24,6
233676,2,12,2,0,10,2
233676,1,4,1,0,3,1
152053,10,28,2,0,26,2
152053,9,46,9,0,37,9
152053,8,202,45,5,157,40
152053,7,307,57,7,250,50
152053,6,374,59,6,315,53
152053,5,133,37,3,96,34
152053,4,77,24,1,53,23
152053,3,34,8,0,26,8
152053,2,15,5,0,10,5
152053,1,5,4,1,1,3
230303,10,19,1,0,18,1
230303,9,85,14,0,71,14
230303,8,403,53,0,350,53
230303,7,397,55,0,342,55
230303,6,233,29,0,204,29
230303,5,47,7,0,40,7
230303,4,19,6,0,13,6
230303,3,11,2,0,9,2
230303,2,4,1,0,3,1
121073,10,12,3,0,9,3
121073,9,37,4,0,33,4
121073,8,139,15,0,124,15
121073,7,279,25,0,254,25
121073,6,458,50,0,408,50
121073,5,157,17,0,140,17
121073,4,80,12,0,68,12
121073,3,36,3,0,33,3
121073,2,10,2,0,8,2
121073,1,8,2,0,6,2
3139,10,8,5,0,3,5
3139,9,44,23,0,21,23
3139,8,255,86,0,169,86
3139,7,421,149,0,272,149
3139,6,321,103,0,218,103
3139,5,107,39,0,68,39
3139,4,34,18,0,16,18
3139,3,19,9,0,10,9
3139,2,5,1,0,4,1
234477,10,55,12,0,43,12
234477,9,162,33,0,129,33
234477,8,513,89,0,424,89
234477,7,266,38,0,228,38
234477,6,152,33,0,119,33
234477,5,48,12,0,36,12
234477,4,12,5,0,7,5
234477,3,6,2,0,4,2
234477,1,2,2,0,0,2
180592,10,19,6,0,13,6
180592,9,73,16,0,57,16
180592,8,451,61,0,390,61
180592,7,379,71,0,308,71
180592,6,217,46,0,171,46
180592,5,53,15,0,38,15
180592,4,19,8,0,11,8
180592,3,5,2,0,3,2
180592,1,1,1,0,0,1
433,10,18,11,0,7,11
433,9,57,16,0,41,16
433,8,242,66,0,176,66
433,7,382,115,0,267,115
433,6,329,84,0,245,84
433,5,108,39,0,69,39
433,4,51,17,0,34,17
433,3,18,7,0,11,7
433,2,9,4,0,5,4
386,10,10,4,0,6,4
386,9,22,10,0,12,10
386,8,97,36,0,61,36
386,7,203,60,0,143,60
386,6,342,104,0,238,104
386,5,236,74,0,162,74
386,4,148,52,0,96,52
386,3,71,38,0,33,38
386,2,46,23,0,23,23
386,1,39,24,0,15,24
187273,10,52,18,4,34,14
187273,9,141,40,1,101,39
187273,8,358,69,4,289,65
187273,7,289,50,6,239,44
187273,6,235,52,4,183,48
187273,5,72,15,3,57,12
187273,4,38,12,0,26,12
187273,3,16,10,2,6,8
187273,2,12,2,1,10,1
187273,1,2,1,0,1,1
128664,10,11,1,0,10,1
128664,9,25,1,0,24,1
128664,8,177,24,0,153,24
128664,7,375,49,0,326,49
128664,6,429,50,0,379,50
128664,5,125,24,0,101,24
128664,4,48,12,0,36,12
128664,3,16,1,0,15,1
212516,10,32,7,1,25,6
212516,9,138,25,0,113,25
212516,8,504,66,3,438,63
212516,7,279,44,0,235,44
212516,6,176,40,1,136,39
212516,5,43,9,0,34,9
212516,4,27,6,0,21,6
212516,3,11,3,0,8,3
8166,10,9,3,0,6,3
8166,9,33,11,0,22,11
8166,8,151,43,0,108,43
8166,7,336,92,0,244,92
8166,6,406,107,0,299,107
8166,5,167,49,0,118,49
8166,4,76,28,0,48,28
8166,3,22,9,0,13,9
8166,2,4,3,0,1,3
8166,1,7,1,0,6,1
932,10,14,4,0,10,4
932,9,65,24,0,41,24
932,8,272,64,0,208,64
932,7,394,103,0,291,103
932,6,312,73,0,239,73
932,5,85,12,0,73,12
932,4,38,11,0,27,11
932,3,19,9,0,10,9
932,2,8,4,0,4,4
19995,10,15,7,0,8,7
19995,9,64,23,0,41,23
19995,8,350,126,0,224,126
19995,7,371,130,0,241,130
19995,6,278,109,0,169,109
19995,5,70,32,0,38,32
19995,4,38,20,0,18,20
19995,3,16,10,0,6,10
19995,2,4,1,0,3,1
142296,10,37,6,0,31,6
142296,9,104,29,0,75,29
142296,8,313,53,2,260,51
142296,7,324,51,1,273,50
142296,6,258,38,1,220,37
142296,5,79,14,0,65,14
142296,4,46,7,0,39,7
142296,3,29,6,0,23,6
142296,2,16,7,0,9,7
142296,1,3,1,0,2,1
84159,10,22,6,0,16,6
84159,9,32,3,0,29,3
84159,8,193,42,0,151,42
84159,7,334,73,0,261,73
84159,6,396,65,0,331,65
84159,5,128,28,0,100,28
84159,4,68,18,0,50,18
84159,3,25,4,0,21,4
84159,2,6,2,0,4,2
262215,10,47,7,0,40,7
262215,9,186,21,0,165,21
262215,8,511,69,0,442,69
262215,7,248,36,0,212,36
262215,6,153,27,0,126,27
262215,5,41,11,0,30,11
262215,4,17,7,0,10,7
262215,3,6,2,0,4,2
262215,1,3,2,0,1,2
126444,10,7,2,0,5,2
126444,9,8,2,0,6,2
126444,8,39,6,0,33,6
126444,7,167,29,0,138,29
126444,6,370,60,0,310,60
126444,5,278,46,0,232,46
126444,4,167,37,0,130,37
126444,3,93,25,0,68,25
126444,2,56,13,0,43,13
126444,1,22,3,0,19,3
37836,10,106,49,0,57,49
37836,9,201,80,0,121,80
37836,8,496,159,0,337,159
37836,7,235,55,0,180,55
37836,6,114,30,0,84,30
37836,5,22,10,0,12,10
37836,4,16,2,0,14,2
37836,3,8,2,0,6,2
37836,2,5,1,0,4,1
15878,10,19,5,0,14,5
15878,9,21,7,0,14,7
15878,8,88,24,0,64,24
15878,7,213,60,0,153,60
15878,6,370,84,0,286,84
15878,5,264,70,0,194,70
15878,4,141,49,0,92,49
15878,3,59,21,0,38,21
15878,2,18,7,0,11,7
15878,1,12,5,0,7,5
131891,10,17,3,0,14,3
131891,9,40,11,0,29,11
131891,8,235,44,3,191,41
131891,7,347,60,3,287,57
131891,6,360,71,1,289,70
131891,5,101,31,0,70,31
131891,4,51,19,0,32,19
131891,3,24,7,0,17,7
131891,2,23,10,0,13,10
131891,1,7,4,0,3,4
218121,10,33,6,0,27,6
218121,9,103,24,2,79,22
218121,8,432,59,11,373,48
218121,7,365,40,5,325,35
218121,6,202,26,0,176,26
218121,5,36,6,0,30,6
218121,4,20,4,0,16,4
218121,3,12,8,0,4,8
218121,1,5,2,0,3,2
152242,10,115,15,1,100,14
152242,9,137,16,0,121,16
152242,8,304,34,3,270,31
152242,7,282,37,1,245,36
152242,6,225,33,4,192,29
152242,5,61,6,0,55,6
152242,4,36,9,0,27,9
152242,3,19,3,1,16,2
152242,2,11,1,0,10,1
152242,1,15,5,0,10,5
40531,10,14,4,0,10,4
40531,9,19,4,0,15,4
40531,8,90,17,0,73,17
40531,7,137,21,0,116,21
40531,6,168,37,0,131,37
40531,5,58,8,0,50,8
40531,4,35,12,0,23,12
40531,3,15,4,0,11,4
40531,2,5,2,0,3,2
8522,10,6,1,0,5,1
8522,9,23,7,0,16,7
8522,8,113,25,0,88,25
8522,7,200,41,0,159,41
8522,6,360,73,0,287,73
8522,5,231,53,0,178,53
8522,4,128,48,0,80,48
8522,3,83,39,0,44,39
8522,2,46,25,0,21,25
8522,1,13,8,0,5,8
29456,10,3,1,0,2,1
29456,9,18,5,0,13,5
29456,8,103,19,0,84,19
29456,7,256,49,0,207,49
29456,6,441,105,0,336,105
29456,5,190,46,0,144,46
29456,4,117,26,0,91,26
29456,3,45,23,0,22,23
29456,2,25,15,0,10,15
22192,10,140,23,0,117,23
22192,9,122,28,0,94,28
22192,8,263,37,0,226,37
22192,7,292,34,0,258,34
22192,6,253,24,0,229,24
22192,5,85,10,0,75,10
22192,4,27,7,0,20,7
22192,3,13,3,0,10,3
22192,1,2,1,0,1,1
1265,10,10,4,0,6,4
1265,9,37,13,0,24,13
1265,8,212,73,0,139,73
1265,7,417,122,0,295,122
1265,6,369,126,1,243,125
1265,5,104,44,0,60,44
1265,4,31,12,0,19,12
1265,3,13,7,0,6,7
1265,2,5,1,0,4,1
30166,10,33,3,0,30,3
30166,9,39,4,0,35,4
30166,8,163,17,0,146,17
30166,7,273,32,0,241,32
30166,6,370,48,0,322,48
30166,5,156,15,0,141,15
30166,4,96,17,0,79,17
30166,3,34,10,0,24,10
30166,2,23,4,0,19,4
30166,1,12,3,0,9,3
146816,10,24,8,0,16,8
146816,9,84,21,0,63,21
146816,8,394,76,0,318,76
146816,7,383,82,0,301,82
146816,6,229,40,0,189,40
146816,5,49,13,0,36,13
146816,4,19,5,0,14,5
146816,3,14,5,0,9,5
1589,10,73,31,0,42,31
1589,9,112,37,0,75,37
1589,8,233,70,0,163,70
1589,7,290,81,0,209,81
1589,6,291,84,0,207,84
1589,5,89,27,0,62,27
1589,4,53,26,0,27,26
1589,3,33,16,0,17,16
1589,2,15,6,0,9,6
1589,1,9,4,0,5,4
8207,10,11,2,0,9,2
8207,9,38,9,0,29,9
8207,8,159,40,0,119,40
8207,7,305,65,0,240,65
8207,6,414,65,0,349,65
8207,5,157,34,0,123,34
8207,4,79,16,0,63,16
8207,3,28,8,0,20,8
8207,2,4,2,0,2,2
42898,10,16,7,0,9,7
42898,9,43,13,0,30,13
42898,8,181,54,0,127,54
42898,7,338,69,0,269,69
42898,6,394,75,0,319,75
42898,5,124,24,0,100,24
42898,4,64,24,0,40,24
42898,3,21,6,0,15,6
42898,2,12,3,0,9,3
42898,1,1,1,0,0,1
21892,10,5,2,0,3,2
21892,9,25,11,0,14,11
21892,8,200,56,0,144,56
21892,7,393,103,0,290,103
21892,6,364,107,0,257,107
21892,5,116,43,0,73,43
21892,4,56,23,0,33,23
21892,3,26,11,0,15,11
21892,2,9,4,0,5,4
31479,10,15,4,0,11,4
31479,9,47,5,0,42,5
31479,8,305,73,0,232,73
31479,7,376,82,0,294,82
31479,6,321,67,0,254,67
31479,5,83,15,0,68,15
31479,4,30,8,0,22,8
31479,3,9,5,0,4,5
31479,2,5,1,0,4,1
154259,10,7,1,0,6,1
154259,9,23,5,1,18,4
154259,8,183,30,5,153,25
154259,7,318,65,6,253,59
154259,6,426,80,9,346,71
154259,5,141,36,6,105,30
154259,4,61,16,1,45,15
154259,3,20,6,0,14,6
154259,2,8,4,0,4,4
154259,1,4,2,0,2,2
245643,10,31,4,0,27,4
245643,9,108,15,1,93,14
245643,8,418,68,4,350,64
245643,7,369,40,4,329,36
245643,6,184,27,2,157,25
245643,5,53,10,0,43,10
245643,4,11,4,0,7,4
245643,3,13,2,0,11,2
245643,2,3,1,0,2,1
245643,1,4,2,0,2,2
24157,10,13,1,0,12,1
24157,9,21,9,0,12,9
24157,8,118,26,0,92,26
24157,7,217,47,0,170,47
24157,6,389,100,0,289,100
24157,5,194,55,0,139,55
24157,4,128,52,1,76,51
24157,3,63,25,0,38,25
24157,2,37,14,0,23,14
24157,1,11,3,0,8,3
205418,10,27,5,0,22,5
205418,9,91,15,0,76,15
205418,8,400,68,0,332,68
205418,7,392,53,0,339,53
205418,6,203,28,0,175,28
205418,5,49,11,0,38,11
205418,4,18,2,0,16,2
205418,3,4,2,0,2,2
205418,2,2,1,0,1,1
205418,1,4,1,0,3,1
206803,10,22,5,0,17,5
206803,9,110,27,0,83,27
206803,8,496,81,0,415,81
206803,7,344,56,0,288,56
206803,6,171,31,0,140,31
206803,5,30,3,0,27,3
206803,4,16,6,0,10,6
206803,2,1,1,0,0,1
10550,10,63,21,0,42,21
10550,9,88,29,0,59,29
10550,8,248,78,0,170,78
10550,7,300,89,0,211,89
10550,6,308,84,0,224,84
10550,5,101,31,0,70,31
10550,4,43,11,0,32,11
10550,3,24,6,0,18,6
10550,2,8,3,0,5,3
10550,1,4,1,0,3,1
190082,10,60,7,0,53,7
190082,9,187,34,0,153,34
190082,8,531,67,0,464,67
190082,7,275,35,0,240,35
190082,6,95,11,0,84,11
190082,5,29,3,0,26,3
190082,4,4,1,0,3,1
5339,10,7,2,0,5,2
5339,9,9,4,0,5,4
5339,8,25,12,0,13,12
5339,7,77,24,0,53,24
5339,6,170,43,0,127,43
5339,5,234,61,0,173,61
5339,4,303,76,0,227,76
5339,3,169,50,0,119,50
5339,2,127,34,0,93,34
5339,1,65,20,0,45,20
5534,10,12,7,0,5,7
5534,9,41,24,0,17,24
5534,8,170,74,0,96,74
5534,7,321,129,0,192,129
5534,6,404,133,0,271,133
5534,5,133,51,0,82,51
5534,4,55,18,0,37,18
5534,3,37,10,0,27,10
5534,2,9,2,0,7,2
5534,1,3,1,0,2,1
231696,10,41,12,0,29,12
231696,9,51,14,0,37,14
231696,8,302,57,0,245,57
231696,7,395,55,0,340,55
231696,6,305,63,0,242,63
231696,5,58,13,0,45,13
231696,4,21,9,0,12,9
164,10,6,4,0,2,4
164,9,13,3,0,10,3
164,8,75,22,0,53,22
164,7,167,46,0,121,46
164,6,362,108,1,254,107
164,5,266,92,0,174,92
164,4,146,53,0,93,53
164,3,97,48,0,49,48
164,2,28,12,0,16,12
164,1,22,12,0,10,12
128898,10,32,11,1,21,10
128898,9,72,20,0,52,20
128898,8,419,79,0,340,79
128898,7,330,66,1,264,65
128898,6,218,53,1,165,52
128898,5,67,15,0,52,15
128898,4,23,8,0,15,8
128898,3,11,4,0,7,4
128898,2,8,6,0,2,6
128898,1,2,1,0,1,1
124052,10,25,12,0,13,12
124052,9,84,22,0,62,22
124052,8,349,95,0,254,95
124052,7,361,82,0,279,82
124052,6,246,60,0,186,60
124052,5,75,25,0,50,25
124052,4,29,11,0,18,11
124052,3,9,3,0,6,3
124052,2,2,2,0,0,2
93538,10,22,7,0,15,7
93538,9,37,13,0,24,13
93538,8,267,78,0,189,78
93538,7,351,92,0,259,92
93538,6,302,85,0,217,85
93538,5,104,26,0,78,26
93538,4,58,14,0,44,14
93538,3,22,3,0,19,3
93538,2,12,3,0,9,3
93538,1,6,2,0,4,2
178613,10,18,5,0,13,5
178613,9,54,9,0,45,9
178613,8,215,48,0,167,48
178613,7,324,43,0,281,43
178613,6,352,66,0,286,66
178613,5,112,23,0,89,23
178613,4,54,16,0,38,16
178613,3,27,9,0,18,9
178613,2,17,5,0,12,5
178613,1,4,2,0,2,2
31808,10,25,8,0,17,8
31808,9,27,8,0,19,8
31808,8,138,41,0,97,41
31808,7,241,39,0,202,39
31808,6,377,80,0,297,80
31808,5,177,42,0,135,42
31808,4,106,32,0,74,32
31808,3,42,10,0,32,10
31808,2,38,15,0,23,15
31808,1,7,2,0,5,2
142961,10,57,9,0,48,9
142961,9,147,15,0,132,15
142961,8,395,50,0,345,50
142961,7,307,38,0,269,38
142961,6,176,23,0,153,23
142961,5,54,13,0,41,13
142961,4,15,2,0,13,2
142961,3,16,5,0,11,5
142961,2,4,1,0,3,1
157958,10,60,11,0,49,11
157958,9,100,23,0,77,23
157958,8,356,62,0,294,62
157958,7,333,58,0,275,58
157958,6,204,34,0,170,34
157958,5,52,10,0,42,10
157958,4,31,7,0,24,7
157958,3,14,4,0,10,4
157958,2,19,10,0,9,10
157958,1,7,2,0,5,2
158109,10,20,4,0,16,4
158109,9,56,10,0,46,10
158109,8,348,71,0,277,71
158109,7,363,64,0,299,64
158109,6,263,74,0,189,74
158109,5,58,16,0,42,16
158109,4,50,17,1,33,16
158109,3,13,4,0,9,4
158109,2,5,3,0,2,3
207243,10,197,40,5,157,35
207243,9,304,52,5,252,47
207243,8,367,45,5,322,40
207243,7,141,22,1,119,21
207243,6,90,17,2,73,15
207243,5,39,16,0,23,16
207243,4,19,12,0,7,12
207243,3,11,5,0,6,5
207243,2,5,1,0,4,1
207243,1,5,1,0,4,1
118000,10,10,1,0,9,1
118000,9,38,8,0,30,8
118000,8,267,69,0,198,69
118000,7,404,79,0,325,79
118000,6,337,65,0,272,65
118000,5,67,17,0,50,17
118000,4,28,9,0,19,9
118000,3,18,6,0,12,6
118000,2,6,2,0,4,2
8668,10,5,2,0,3,2
8668,9,19,10,0,9,10
8668,8,152,58,0,94,58
8668,7,308,102,0,206,102
8668,6,446,144,0,302,144
8668,5,143,44,0,99,44
8668,4,71,27,0,44,27
8668,3,19,5,0,14,5
8668,2,8,5,0,3,5
10496,10,18,7,0,11,7
10496,9,35,18,0,17,18
10496,8,124,51,0,73,51
10496,7,241,76,0,165,76
10496,6,434,121,0,313,121
10496,5,181,68,0,113,68
10496,4,80,30,0,50,30
10496,3,41,14,0,27,14
10496,2,15,7,0,8,7
10496,1,4,3,0,1,3
1662,10,64,42,2,22,40
1662,9,120,68,2,52,66
1662,8,378,158,1,220,157
1662,7,343,115,1,228,114
1662,6,173,61,0,112,61
1662,5,28,13,0,15,13
9202,9,6,2,0,4,2
9202,8,63,20,0,43,20
9202,7,243,76,0,167,76
9202,6,465,127,0,338,127
9202,5,232,75,0,157,75
9202,4,106,38,0,68,38
9202,3,38,12,0,26,12
9202,2,13,7,0,6,7
9202,1,6,3,0,3,3
109779,10,12,4,0,8,4
109779,9,33,5,1,28,4
109779,8,269,62,3,207,59
109779,7,366,80,3,286,77
109779,6,327,61,1,266,60
109779,5,110,26,1,84,25
109779,4,31,17,1,14,16
109779,3,14,3,0,11,3
109779,1,4,2,0,2,2
223049,10,29,7,0,22,7
223049,9,62,13,0,49,13
223049,8,329,41,0,288,41
223049,7,340,54,0,286,54
223049,6,264,46,0,218,46
223049,5,87,14,0,73,14
223049,4,39,9,0,30,9
223049,3,12,4,0,8,4
223049,2,9,3,0,6,3
7682,10,2,1,0,1,1
7682,7,19,8,0,11,8
7682,6,72,27,0,45,27
7682,5,162,46,0,116,46
7682,4,338,98,0,240,98
7682,3,301,84,0,217,84
7682,2,209,51,0,158,51
7682,1,60,16,0,44,16
15157,10,8,2,0,6,2
15157,9,20,9,0,11,9
15157,8,161,53,0,108,53
15157,7,336,90,0,246,90
15157,6,417,128,0,289,128
15157,5,149,50,0,99,50
15157,4,51,19,0,32,19
15157,3,21,11,0,10,11
15157,2,5,3,0,2,3
15157,1,3,2,0,1,2
19348,10,11,3,0,8,3
19348,9,58,25,0,33,25
19348,8,342,113,0,229,113
19348,7,336,109,0,227,109
19348,6,254,99,0,155,99
19348,5,96,38,0,58,38
19348,4,48,22,0,26,22
19348,3,14,6,0,8,6
19348,2,5,2,0,3,2
19348,1,5,1,0,4,1
84469,10,7,1,0,6,1
84469,9,24,3,0,21,3
84469,8,226,52,0,174,52
84469,7,370,86,0,284,86
84469,6,347,74,0,273,74
84469,5,120,34,0,86,34
84469,4,53,12,0,41,12
84469,3,17,7,0,10,7
84469,2,6,2,0,4,2
24935,10,15,1,0,14,1
24935,9,19,6,0,13,6
24935,8,109,23,0,86,23
24935,7,224,46,0,178,46
24935,6,414,99,0,315,99
24935,5,198,53,0,145,53
24935,4,89,28,0,61,28
24935,3,45,21,0,24,21
24935,2,39,17,0,22,17
24935,1,16,4,0,12,4
143401,10,34,12,0,22,12
143401,9,83,22,0,61,22
143401,8,398,73,0,325,73
143401,7,321,51,0,270,51
143401,6,242,42,0,200,42
143401,5,56,15,0,41,15
143401,4,25,11,0,14,11
143401,3,7,1,0,6,1
143401,1,1,1,0,0,1
4492,10,5,1,0,4,1
4492,8,52,7,0,45,7
4492,7,160,24,0,136,24
4492,6,314,52,0,262,52
4492,5,273,41,0,232,41
4492,4,189,54,0,135,54
4492,3,95,50,0,45,50
4492,2,46,20,0,26,20
4492,1,23,12,0,11,12
187653,10,39,14,0,25,14
187653,9,96,29,0,67,29
187653,8,428,64,0,364,64
187653,7,315,56,0,259,56
187653,6,199,37,0,162,37
187653,5,51,13,0,38,13
187653,4,21,5,0,16,5
187653,3,13,6,0,7,6
187653,2,4,2,0,2,2
187653,1,1,1,0,0,1
227456,10,266,120,8,146,112
227456,9,247,87,8,160,79
227456,8,320,78,9,242,69
227456,7,170,35,2,135,33
227456,6,91,15,0,76,15
227456,5,28,6,0,22,6
227456,4,21,9,0,12,9
227456,3,7,1,0,6,1
227456,2,7,1,0,6,1
227456,1,8,4,0,4,4
127518,10,115,35,0,80,35
127518,9,243,54,0,189,54
127518,8,500,92,0,408,92
127518,7,187,36,0,151,36
127518,6,71,22,0,49,22
127518,5,26,12,0,14,12
127518,4,11,4,0,7,4
127518,3,6,3,0,3,3
127518,2,2,1,0,1,1
127518,1,4,1,0,3,1
251678,10,25,4,0,21,4
251678,9,109,13,0,96,13
251678,8,430,38,0,392,38
251678,7,367,29,0,338,29
251678,6,187,18,0,169,18
251678,5,32,5,0,27,5
251678,4,18,4,0,14,4
251678,3,10,2,0,8,2
19419,10,8,2,0,6,2
19419,9,17,7,0,10,7
19419,8,153,49,0,104,49
19419,7,288,84,0,204,84
19419,6,376,109,0,267,109
19419,5,144,45,0,99,45
19419,4,106,42,0,64,42
19419,3,45,20,0,25,20
19419,2,25,10,0,15,10
19650,9,26,8,0,18,8
19650,8,200,72,0,128,72
19650,7,346,81,0,265,81
19650,6,371,97,0,274,97
19650,5,136,45,0,91,45
19650,4,53,16,0,37,16
19650,3,13,7,0,6,7
19650,2,13,3,0,10,3
30,10,96,37,0,59,37
30,9,87,33,0,54,33
30,8,194,55,0,139,55
30,7,239,78,0,161,78
30,6,302,118,0,184,118
30,5,123,53,0,70,53
30,4,67,37,0,30,37
30,3,39,23,0,16,23
30,2,13,11,0,2,11
30,1,1,1,0,0,1
230408,10,41,8,0,33,8
230408,9,49,13,0,36,13
230408,8,217,45,0,172,45
230408,7,299,39,0,260,39
230408,6,354,74,0,280,74
230408,5,96,25,0,71,25
230408,4,56,12,0,44,12
230408,3,30,8,0,22,8
230408,2,10,5,0,5,5
230408,1,10,4,0,6,4
126100,10,73,15,1,58,14
126100,9,159,25,0,134,25
126100,8,446,65,5,381,60
126100,7,289,42,1,247,41
126100,6,126,24,0,102,24
126100,5,39,8,0,31,8
126100,4,10,5,0,5,5
126100,3,5,2,0,3,2
126100,2,10,4,0,6,4
126100,1,4,3,0,1,3
144761,10,3,1,0,2,1
144761,9,24,7,0,17,7
144761,8,178,40,0,138,40
144761,7,298,63,0,235,63
144761,6,387,64,0,323,64
144761,5,132,31,0,101,31
144761,4,74,20,0,54,20
144761,3,39,14,0,25,14
144761,2,16,9,0,7,9
144761,1,7,1,0,6,1
181761,10,9,2,0,7,2
181761,9,32,7,0,25,7
181761,8,250,50,0,200,50
181761,7,367,44,0,323,44
181761,6,338,55,0,283,55
181761,5,87,25,0,62,25
181761,4,44,9,0,35,9
181761,3,20,8,0,12,8
181761,2,7,3,0,4,3
182340,10,149,36,0,113,36
182340,9,270,46,0,224,46
182340,8,399,71,0,328,71
182340,7,198,33,0,165,33
182340,6,81,16,0,65,16
182340,5,30,7,0,23,7
182340,4,14,4,0,10,4
182340,3,6,2,0,4,2
182340,2,6,1,0,5,1
182340,1,4,1,0,3,1
180198,10,8,2,0,6,2
180198,9,15,4,0,11,4
180198,8,157,34,0,123,34
180198,7,351,48,0,303,48
180198,6,450,83,0,367,83
180198,5,119,12,0,107,12
180198,4,40,9,0,31,9
180198,3,10,3,0,7,3
180198,2,2,1,0,1,1
10799,10,8,2,0,6,2
10799,8,7,3,0,4,3
10799,7,23,4,0,19,4
10799,6,86,24,0,62,24
10799,5,157,43,0,114,43
10799,4,303,90,0,213,90
10799,3,268,77,0,191,77
10799,2,128,46,0,82,46
254,10,164,64,0,100,64
254,9,179,46,0,133,46
254,8,306,99,0,207,99
254,7,245,67,0,178,67
254,6,138,38,0,100,38
254,5,46,13,0,33,13
254,4,23,9,0,14,9
254,3,28,15,0,13,15
254,2,15,9,0,6,9
254,1,6,1,0,5,1
137776,10,17,2,0,15,2
137776,9,40,9,0,31,9
137776,8,250,48,0,202,48
137776,7,355,52,0,303,52
137776,6,305,63,0,242,63
137776,5,100,27,0,73,27
137776,4,44,12,0,32,12
137776,3,22,4,0,18,4
137776,2,11,6,0,5,6
137776,1,3,2,0,1,2
423,10,93,30,0,63,30
423,9,186,60,0,126,60
423,8,406,118,0,288,118
423,7,236,67,0,169,67
423,6,130,46,0,84,46
423,5,38,16,0,22,16
423,4,23,11,0,12,11
423,3,17,7,0,10,7
423,2,6,3,0,3,3
423,1,12,1,0,11,1
3728,10,3,2,0,1,2
3728,9,7,3,0,4,3
3728,8,26,6,0,20,6
3728,7,68,18,0,50,18
3728,6,224,56,0,168,56
3728,5,356,93,0,263,93
3728,4,268,71,0,197,71
3728,3,117,37,0,80,37
3728,2,52,13,0,39,13
3728,1,22,4,0,18,4
168998,10,74,14,0,60,14
168998,9,121,15,0,106,15
168998,8,373,34,0,339,34
168998,7,318,30,0,288,30
168998,6,168,24,0,144,24
168998,5,55,15,0,40,15
168998,3,9,5,0,4,5
168998,2,5,1,0,4,1
168998,1,4,2,0,2,2
168054,10,12,3,1,9,2
168054,9,70,19,2,51,17
168054,8,271,53,3,218,50
168054,7,378,59,2,319,57
168054,6,287,62,4,225,58
168054,5,77,14,1,63,13
168054,4,29,11,0,18,11
168054,3,14,7,0,7,7
168054,1,3,1,0,2,1
2633,10,36,8,0,28,8
2633,9,68,15,0,53,15
2633,8,169,32,0,137,32
2633,7,277,46,0,231,46
2633,6,326,54,0,272,54
2633,5,112,16,0,96,16
2633,4,81,13,0,68,13
2633,3,45,16,0,29,16
2633,2,22,12,0,10,12
2633,1,6,2,0,4,2
230304,10,9,1,0,8,1
230304,9,58,8,0,50,8
230304,8,175,23,0,152,23
230304,7,226,29,0,197,29
230304,6,306,46,0,260,46
230304,5,152,35,0,117,35
230304,4,81,15,0,66,15
230304,3,64,23,0,41,23
230304,2,49,20,0,29,20
230304,1,24,9,0,15,9
692,10,23,11,0,12,11
692,9,68,31,0,37,31
692,8,234,84,0,150,84
692,7,362,118,0,244,118
692,6,273,90,0,183,90
692,5,96,42,0,54,42
692,4,53,30,0,23,30
692,3,23,10,0,13,10
692,2,7,2,0,5,2
29687,10,9,3,0,6,3
29687,9,23,3,0,20,3
29687,8,200,51,0,149,51
29687,7,354,88,0,266,88
29687,6,358,102,0,256,102
29687,5,110,33,0,77,33
29687,4,58,23,0,35,23
29687,3,18,3,0,15,3
29687,2,9,5,0,4,5
29687,1,1,1,0,0,1
16398,10,8,1,0,7,1
16398,8,5,1,0,4,1
16398,7,12,3,0,9,3
16398,6,17,5,0,12,5
16398,5,43,16,0,27,16
16398,4,111,38,0,73,38
16398,3,169,61,0,108,61
16398,2,294,106,0,188,106
16398,1,481,188,0,293,188
109125,10,60,11,0,49,11
109125,9,184,40,0,144,40
109125,8,468,77,0,391,77
109125,7,247,37,0,210,37
109125,6,122,30,0,92,30
109125,5,28,5,0,23,5
109125,4,16,6,0,10,6
109125,2,5,1,0,4,1
109125,1,4,1,0,3,1
31506,9,13,2,0,11,2
31506,8,106,29,0,77,29
31506,7,293,67,0,226,67
31506,6,465,94,0,371,94
31506,5,164,37,0,127,37
31506,4,62,10,0,52,10
31506,3,20,7,0,13,7
31506,2,9,4,0,5,4
31506,1,6,1,0,5,1
179460,10,61,9,0,52,9
179460,9,155,23,0,132,23
179460,8,494,69,0,425,69
179460,7,254,34,0,220,34
179460,6,125,21,0,104,21
179460,5,29,1,0,28,1
179460,4,12,6,0,6,6
179460,3,5,3,0,2,3
163370,10,20,3,0,17,3
163370,9,80,15,0,65,15
163370,8,375,61,0,314,61
163370,7,400,47,0,353,47
163370,6,208,17,0,191,17
163370,5,36,6,0,30,6
163370,4,11,1,0,10,1
163370,3,7,2,0,5,2
244331,10,17,5,0,12,5
244331,9,80,16,0,64,16
244331,8,465,93,0,372,93
244331,7,343,61,0,282,61
244331,6,192,34,0,158,34
244331,5,31,7,0,24,7
244331,4,12,5,0,7,5
244331,3,2,1,0,1,1
199383,10,17,3,0,14,3
199383,9,94,16,0,78,16
199383,8,423,69,0,354,69
199383,7,321,46,0,275,46
199383,6,187,34,0,153,34
199383,5,57,12,0,45,12
199383,4,21,8,0,13,8
199383,3,12,5,0,7,5
199383,2,3,3,0,0,3
42124,10,93,24,0,69,24
42124,9,141,34,0,107,34
42124,8,333,82,0,251,82
42124,7,257,59,0,198,59
42124,6,181,35,0,146,35
42124,5,63,12,0,51,12
42124,4,34,15,0,19,15
42124,3,17,2,0,15,2
42124,2,7,2,0,5,2
42124,1,5,1,0,4,1
5825,10,4,1,0,3,1
5825,9,7,3,0,4,3
5825,8,118,49,0,69,49
5825,7,329,105,0,224,105
5825,6,418,119,0,299,119
5825,5,157,60,0,97,60
5825,4,79,41,0,38,41
5825,3,12,6,0,6,6
5825,2,6,5,0,1,5
5825,1,1,1,0,0,1
1442,10,66,36,0,30,36
1442,9,121,55,0,66,55
1442,8,318,113,0,205,113
1442,7,296,87,0,209,87
1442,6,213,60,0,153,60
1442,5,69,30,0,39,30
1442,4,22,7,0,15,7
1442,3,16,5,0,11,5
1442,2,4,2,0,2,2
1962,9,6,1,0,5,1
1962,8,45,15,0,30,15
1962,7,160,35,0,125,35
1962,6,282,65,0,217,65
1962,5,303,59,0,244,59
1962,4,196,52,0,144,52
1962,3,85,26,0,59,26
1962,2,33,9,0,24,9
1962,1,14,7,0,7,7
162559,10,57,4,0,53,4
162559,9,78,3,0,75,3
162559,8,246,23,0,223,23
162559,7,295,28,0,267,28
162559,6,226,29,0,197,29
162559,5,111,16,0,95,16
162559,4,48,13,0,35,13
162559,3,40,7,0,33,7
162559,2,24,6,0,18,6
162559,1,5,1,0,4,1
38657,10,7,4,0,3,4
38657,9,23,14,0,9,14
38657,8,180,70,0,110,70
38657,7,330,104,0,226,104
38657,6,382,110,0,272,110
38657,5,133,47,0,86,47
38657,4,48,17,0,31,17
38657,3,12,3,0,9,3
38657,2,10,5,0,5,5
38657,1,4,2,0,2,2
1758,10,73,24,0,49,24
1758,9,72,21,0,51,21
1758,8,206,51,0,155,51
1758,7,281,62,0,219,62
1758,6,281,75,0,206,75
1758,5,131,38,0,93,38
1758,4,48,16,0,32,16
1758,3,21,11,0,10,11
1758,2,7,5,0,2,5
1758,1,8,2,0,6,2
37728,10,16,7,0,9,7
37728,9,45,9,0,36,9
37728,8,167,31,0,136,31
37728,7,295,44,0,251,44
37728,6,363,54,0,309,54
37728,5,118,17,0,101,17
37728,4,70,4,0,66,4
37728,3,28,2,0,26,2
37728,2,17,3,0,14,3
37728,1,9,1,0,8,1
227515,10,30,2,0,28,2
227515,9,109,21,0,88,21
227515,8,505,55,0,450,55
227515,7,316,51,0,265,51
227515,6,127,13,0,114,13
227515,5,27,8,0,19,8
227515,4,14,4,0,10,4
112869,10,51,4,0,47,4
112869,9,69,3,0,66,3
112869,8,202,23,0,179,23
112869,7,245,27,0,218,27
112869,6,300,31,0,269,31
112869,5,118,8,0,110,8
112869,4,82,15,0,67,15
112869,3,32,3,0,29,3
112869,2,15,8,0,7,8
112869,1,11,1,0,10,1
240196,10,240,42,0,198,42
240196,9,308,37,0,271,37
240196,8,331,46,0,285,46
240196,7,124,15,0,109,15
240196,6,65,13,0,52,13
240196,5,18,3,0,15,3
240196,4,13,2,0,11,2
240196,3,12,6,0,6,6
240196,2,9,2,0,7,2
240196,1,11,3,0,8,3
22245,10,10,7,0,3,7
22245,9,38,22,0,16,22
22245,8,175,68,0,107,68
22245,7,269,93,0,176,93
22245,6,379,102,0,277,102
22245,5,147,45,0,102,45
22245,4,62,28,0,34,28
22245,3,22,11,0,11,11
22245,2,18,6,0,12,6
22245,1,3,1,0,2,1
1459,10,9,4,0,5,4
1459,9,34,11,0,23,11
1459,8,147,41,0,106,41
1459,7,320,103,0,217,103
1459,6,415,114,0,301,114
1459,5,123,45,0,78,45
1459,4,54,13,0,41,13
1459,3,16,7,0,9,7
1459,1,3,2,0,1,2
123885,10,10,1,0,9,1
123885,9,26,6,0,20,6
123885,8,117,16,0,101,16
123885,7,266,43,0,223,43
123885,6,449,77,0,372,77
123885,5,157,24,0,133,24
123885,4,62,7,0,55,7
123885,3,21,4,0,17,4
158742,10,8,1,0,7,1
158742,9,15,3,0,12,3
158742,8,99,34,8,65,26
158742,7,210,59,10,151,49
158742,6,428,92,10,336,82
158742,5,181,47,4,134,43
158742,4,97,36,3,61,33
158742,3,54,19,1,35,18
158742,2,24,8,0,16,8
158742,1,7,3,2,4,1
1561,10,50,10,0,40,10
1561,9,47,12,0,35,12
1561,8,185,51,0,134,51
1561,7,270,80,0,190,80
1561,6,366,96,0,270,96
1561,5,131,39,0,92,39
1561,4,49,17,0,32,17
1561,3,15,8,0,7,8
1561,2,7,4,0,3,4
1561,1,3,1,0,2,1
129459,10,185,71,0,114,71
129459,9,161,34,0,127,34
129459,8,273,62,1,211,61
129459,7,196,39,0,157,39
129459,6,167,35,0,132,35
129459,5,53,12,0,41,12
129459,4,40,6,0,34,6
129459,3,21,8,0,13,8
129459,2,19,5,0,14,5
129459,1,6,2,0,4,2
155173,10,6,1,0,5,1
155173,9,26,5,0,21,5
155173,8,219,46,0,173,46
155173,7,342,47,0,295,47
155173,6,341,59,0,282,59
155173,5,116,30,0,86,30
155173,4,41,4,0,37,4
155173,3,26,8,0,18,8
155173,2,6,1,0,5,1
242639,10,47,9,0,38,9
242639,9,116,12,0,104,12
242639,8,454,54,0,400,54
242639,7,282,27,0,255,27
242639,6,145,21,0,124,21
242639,5,43,8,0,35,8
242639,4,29,6,0,23,6
242639,3,14,5,0,9,5
158572,10,22,9,0,13,9
158572,9,63,13,1,50,12
158572,8,343,72,1,271,71
158572,7,377,60,2,317,58
158572,6,229,40,2,189,38
158572,5,51,17,0,34,17
158572,4,24,8,0,16,8
158572,3,7,1,0,6,1
24396,10,34,10,0,24,10
24396,9,41,9,0,32,9
24396,8,152,37,0,115,37
24396,7,246,71,0,175,71
24396,6,326,84,0,242,84
24396,5,141,35,0,106,35
24396,4,89,27,0,62,27
24396,3,44,19,0,25,19
24396,2,32,12,0,20,12
24396,1,15,1,0,14,1
936,10,38,16,0,22,16
936,9,94,40,0,54,40
936,8,296,96,0,200,96
936,7,300,60,0,240,60
936,6,237,62,0,175,62
936,5,81,28,0,53,28
936,4,40,14,0,26,14
936,3,19,7,0,12,7
936,2,5,1,0,4,1
936,1,9,3,0,6,3
144415,9,60,14,0,46,14
144415,8,321,55,0,266,55
144415,7,386,77,0,309,77
144415,6,234,53,0,181,53
144415,5,75,25,0,50,25
144415,4,25,10,0,15,10
144415,3,5,3,0,2,3
239464,10,61,22,2,39,20
239464,9,126,42,5,84,37
239464,8,441,74,4,367,70
239464,7,315,55,9,260,46
239464,6,130,20,1,110,19
239464,5,32,6,0,26,6
239464,3,6,3,0,3,3
239464,2,2,1,0,1,1
239464,1,1,1,0,0,1
25584,10,3,3,0,0,3
25584,9,20,5,0,15,5
25584,8,183,77,0,106,77
25584,7,357,102,0,255,102
25584,6,395,116,0,279,116
25584,5,102,31,0,71,31
25584,4,43,15,0,28,15
25584,3,8,2,0,6,2
1491,10,42,13,0,29,13
1491,9,94,20,0,74,20
1491,8,295,73,0,222,73
1491,7,266,72,0,194,72
1491,6,227,70,1,157,69
1491,5,83,35,0,48,35
1491,4,50,21,0,29,21
1491,3,31,16,0,15,16
1491,2,23,10,0,13,10
1491,1,5,1,0,4,1
542,10,1,1,0,0,1
542,9,12,2,0,10,2
542,8,64,20,0,44,20
542,7,162,42,0,120,42
542,6,387,109,0,278,109
542,5,239,56,0,183,56
542,4,148,58,0,90,58
542,3,66,30,0,36,30
542,2,30,14,0,16,14
542,1,6,4,0,2,4
56707,10,21,2,0,19,2
56707,9,42,9,0,33,9
56707,8,255,48,0,207,48
56707,7,296,55,0,241,55
56707,6,301,65,0,236,65
56707,5,105,31,0,74,31
56707,4,49,18,0,31,18
56707,3,31,10,0,21,10
56707,2,13,5,0,8,5
56707,1,1,1,0,0,1
392,10,30,14,0,16,14
392,9,51,22,0,29,22
392,8,160,54,1,106,53
392,7,254,88,0,166,88
392,6,354,114,0,240,114
392,5,144,42,0,102,42
392,4,74,21,0,53,21
392,3,33,19,0,14,19
392,2,11,2,0,9,2
5130,10,6,4,0,2,4
5130,9,16,3,0,13,3
5130,8,34,12,0,22,12
5130,7,72,14,0,58,14
5130,6,183,44,0,139,44
5130,5,256,58,0,198,58
5130,4,291,79,0,212,79
5130,3,152,39,0,113,39
5130,2,90,23,0,67,23
5130,1,15,7,0,8,7
98242,10,36,2,0,34,2
98242,9,58,12,0,46,12
98242,8,210,39,0,171,39
98242,7,284,54,0,230,54
98242,6,279,55,0,224,55
98242,5,109,27,0,82,27
98242,4,64,15,0,49,15
98242,3,42,11,0,31,11
98242,2,23,10,0,13,10
98242,1,6,2,0,4,2
670,10,24,11,0,13,11
670,9,53,17,0,36,17
670,8,161,52,0,109,52
670,7,298,93,0,205,93
670,6,354,95,0,259,95
670,5,139,40,0,99,40
670,4,47,18,0,29,18
670,3,26,8,0,18,8
670,2,5,2,0,3,2
670,1,4,1,0,3,1
227758,10,12,2,0,10,2
227758,9,42,9,0,33,9
227758,8,275,36,4,239,32
227758,7,435,73,4,362,69
227758,6,250,31,1,219,30
227758,5,59,8,0,51,8
227758,4,24,7,0,17,7
227758,3,10,8,0,2,8
227758,2,4,1,0,3,1
227758,1,1,1,0,0,1
2818,10,8,1,0,7,1
2818,9,21,3,0,18,3
2818,8,70,18,0,52,18
2818,7,152,31,0,121,31
2818,6,314,73,0,241,73
2818,5,263,63,0,200,63
2818,4,156,44,0,112,44
2818,3,49,14,0,35,14
2818,2,55,29,0,26,29
2818,1,22,12,0,10,12
170624,10,41,5,0,36,5
170624,9,145,28,0,117,28
170624,8,544,84,8,460,76
170624,7,266,52,4,214,48
170624,6,93,24,2,69,22
170624,5,18,5,0,13,5
170624,4,6,2,0,4,2
296,10,12,5,0,7,5
296,9,50,19,0,31,19
296,8,242,71,0,171,71
296,7,373,104,0,269,104
296,6,289,74,0,215,74
296,5,83,25,0,58,25
296,4,39,15,0,24,15
296,3,12,6,0,6,6
296,2,3,1,0,2,1
76247,10,6,4,0,2,4
76247,9,22,5,0,17,5
76247,8,135,41,2,94,39
76247,7,225,61,3,164,58
76247,6,347,85,4,262,81
76247,5,171,40,3,131,37
76247,4,109,39,4,70,35
76247,3,50,14,1,36,13
76247,2,26,11,0,15,11
76247,1,14,7,1,7,6
1157,9,18,2,0,16,2
1157,8,91,28,0,63,28
1157,7,221,32,0,189,32
1157,6,387,78,0,309,78
1157,5,200,38,0,162,38
1157,4,112,31,0,81,31
1157,3,45,20,0,25,20
1157,2,18,6,0,12,6
1157,1,6,4,0,2,4
235375,10,42,11,1,31,10
235375,9,90,23,4,67,19
235375,8,289,59,10,230,49
235375,7,347,50,6,297,44
235375,6,251,34,2,217,32
235375,5,60,10,2,50,8
235375,4,18,1,0,17,1
235375,2,3,1,0,2,1
235375,1,2,1,0,1,1
34320,10,6,1,0,5,1
34320,9,23,4,0,19,4
34320,8,214,62,0,152,62
34320,7,367,103,0,264,103
34320,6,339,71,0,268,71
34320,5,89,23,0,66,23
34320,4,47,19,0,28,19
34320,3,13,4,0,9,4
34320,2,3,2,0,1,2
26457,10,71,21,0,50,21
26457,9,169,47,0,122,47
26457,8,386,115,0,271,115
26457,7,262,62,0,200,62
26457,6,138,38,0,100,38
26457,5,30,10,0,20,10
26457,4,18,5,0,13,5
26457,3,13,6,0,7,6
26457,2,5,2,0,3,2
26457,1,9,1,0,8,1
133528,10,39,11,0,28,11
133528,9,81,15,0,66,15
133528,8,311,58,0,253,58
133528,7,264,59,0,205,59
133528,6,226,57,0,169,57
133528,5,82,21,0,61,21
133528,4,58,16,0,42,16
133528,3,25,11,0,14,11
133528,2,8,5,0,3,5
133528,1,6,2,0,4,2
118610,10,12,3,0,9,3
118610,9,33,6,0,27,6
118610,8,260,45,0,215,45
118610,7,343,53,0,290,53
118610,6,318,56,0,262,56
118610,5,78,14,0,64,14
118610,4,38,8,0,30,8
118610,3,10,3,0,7,3
118610,2,5,2,0,3,2
118610,1,3,2,0,1,2
59753,10,13,5,0,8,5
59753,9,63,15,0,48,15
59753,8,273,74,0,199,74
59753,7,365,85,0,280,85
59753,6,263,57,0,206,57
59753,5,71,24,0,47,24
59753,4,31,12,0,19,12
59753,3,11,6,0,5,6
59753,1,7,1,0,6,1
35572,10,12,4,0,8,4
35572,9,26,9,0,17,9
35572,8,229,72,0,157,72
35572,7,390,103,0,287,103
35572,6,325,88,0,237,88
35572,5,84,22,0,62,22
35572,4,24,14,0,10,14
35572,3,9,3,0,6,3
223215,10,32,6,0,26,6
223215,9,69,9,0,60,9
223215,8,395,73,0,322,73
223215,7,309,47,0,262,47
223215,6,209,37,0,172,37
223215,5,48,11,0,37,11
223215,4,23,3,0,20,3
223215,3,11,4,0,7,4
3886,10,12,6,0,6,6
3886,9,21,7,0,14,7
3886,8,47,15,0,32,15
3886,7,151,34,0,117,34
3886,6,305,77,0,228,77
3886,5,250,68,0,182,68
3886,4,193,53,0,140,53
3886,3,74,16,0,58,16
3886,2,36,12,0,24,12
3886,1,10,3,0,7,3
137,9,13,4,0,9,4
137,8,102,26,0,76,26
137,7,193,51,0,142,51
137,6,406,85,0,321,85
137,5,211,41,0,170,41
137,4,103,29,0,74,29
137,3,37,9,0,28,9
137,2,19,7,0,12,7
163920,9,23,7,0,16,7
163920,8,157,17,0,140,17
163920,7,288,33,0,255,33
163920,6,381,47,0,334,47
163920,5,146,17,0,129,17
163920,4,51,6,0,45,6
163920,3,32,6,0,26,6
163920,2,9,2,0,7,2
25685,10,5,1,0,4,1
25685,9,32,12,0,20,12
25685,8,163,41,0,122,41
25685,7,195,57,0,138,57
25685,6,244,67,0,177,67
25685,5,112,44,0,68,44
25685,4,71,34,0,37,34
25685,3,50,26,0,24,26
25685,2,23,12,0,11,12
25685,1,7,2,0,5,2
169318,10,32,13,0,19,13
169318,9,85,17,0,68,17
169318,8,362,64,0,298,64
169318,7,315,40,0,275,40
169318,6,203,34,0,169,34
169318,5,57,10,0,47,10
169318,4,26,4,0,22,4
169318,3,12,4,0,8,4
169318,2,4,3,0,1,3
65200,10,10,2,0,8,2
65200,9,21,3,0,18,3
65200,8,178,45,0,133,45
65200,7,318,61,0,257,61
65200,6,356,88,0,268,88
65200,5,124,26,0,98,26
65200,4,51,19,0,32,19
65200,3,21,6,0,15,6
65200,2,10,6,0,4,6
65200,1,6,2,0,4,2
11825,10,199,71,0,128,71
11825,9,248,64,0,184,64
11825,8,317,96,0,221,96
11825,7,173,48,0,125,48
11825,6,79,30,0,49,30
11825,5,38,12,0,26,12
11825,4,15,9,0,6,9
11825,3,13,6,0,7,6
11825,2,6,3,0,3,3
11825,1,7,4,0,3,4
244995,10,10,1,0,9,1
244995,9,34,8,0,26,8
244995,8,258,23,0,235,23
244995,7,408,52,0,356,52
244995,6,291,36,0,255,36
244995,5,57,18,0,39,18
244995,4,26,7,0,19,7
244995,3,6,2,0,4,2
244995,2,8,3,0,5,3
620,10,63,31,0,32,31
620,9,114,58,0,56,58
620,8,344,131,0,213,131
620,7,325,99,0,226,99
620,6,156,53,0,103,53
620,5,48,10,0,38,10
620,4,23,7,0,16,7
620,3,11,8,0,3,8
620,1,7,1,0,6,1
36739,10,5,1,0,4,1
36739,9,11,2,0,9,2
36739,8,76,23,0,53,23
36739,7,218,51,0,167,51
36739,6,484,109,0,375,109
36739,5,183,44,0,139,44
36739,4,71,28,0,43,28
36739,3,33,10,0,23,10
36739,2,10,5,0,5,5
36739,1,2,1,0,1,1
2456,10,3,2,0,1,2
2456,9,6,1,0,5,1
2456,8,25,9,0,16,9
2456,7,76,18,0,58,18
2456,6,264,79,0,185,79
2456,5,297,84,0,213,84
2456,4,215,67,0,148,67
2456,3,128,45,0,83,45
2456,2,62,26,0,36,26
2456,1,16,6,0,10,6
171835,10,29,7,1,22,6
171835,9,63,14,2,49,12
171835,8,243,46,5,197,41
171835,7,260,47,11,213,36
171835,6,291,55,9,236,46
171835,5,95,26,5,69,21
171835,4,65,14,2,51,12
171835,3,29,11,4,18,7
171835,2,8,4,1,4,3
171835,1,7,3,0,4,3
128063,10,7,2,0,5,2
128063,9,23,7,0,16,7
128063,8,252,48,0,204,48
128063,7,292,59,0,233,59
128063,6,321,68,0,253,68
128063,5,111,29,0,82,29
128063,4,52,16,0,36,16
128063,3,21,7,0,14,7
128063,1,2,1,0,1,1
8481,10,32,11,0,21,11
8481,9,92,45,0,47,45
8481,8,364,136,0,228,136
8481,7,318,111,0,207,111
8481,6,173,68,0,105,68
8481,5,62,27,0,35,27
8481,4,28,11,0,17,11
8481,3,8,5,0,3,5
8481,2,10,6,0,4,6
8481,1,2,1,0,1,1
102148,10,26,5,0,21,5
102148,9,54,15,0,39,15
102148,8,216,43,1,173,42
102148,7,299,47,0,252,47
102148,6,315,39,0,276,39
102148,5,107,22,0,85,22
102148,4,45,11,0,34,11
102148,3,17,4,0,13,4
102148,1,5,2,0,3,2
205045,9,61,15,0,46,15
205045,8,291,47,0,244,47
205045,7,367,59,0,308,59
205045,6,276,41,0,235,41
205045,5,60,12,1,48,11
205045,4,13,4,0,9,4
205045,3,10,2,0,8,2
205045,2,2,2,0,0,2
205045,1,2,1,0,1,1
205317,10,80,19,0,61,19
205317,9,166,40,0,126,40
205317,8,427,65,0,362,65
205317,7,222,29,0,193,29
205317,6,120,17,0,103,17
205317,5,37,5,0,32,5
205317,4,17,5,0,12,5
205317,3,12,4,0,8,4
205317,2,4,2,0,2,2
205317,1,5,1,0,4,1
129293,9,36,5,0,31,5
129293,8,137,33,1,104,32
129293,7,216,33,3,183,30
129293,6,363,87,5,276,82
129293,5,151,37,1,114,36
129293,4,90,33,4,57,29
129293,3,49,18,0,31,18
129293,2,30,11,0,19,11
129293,1,5,2,0,3,2
58798,9,19,2,0,17,2
58798,8,154,45,0,109,45
58798,7,296,62,0,234,62
58798,6,379,80,0,299,80
58798,5,135,31,0,104,31
58798,4,60,13,0,47,13
58798,3,24,3,0,21,3
58798,2,8,4,0,4,4
58798,1,6,2,0,4,2
249381,10,63,16,0,47,16
249381,9,184,33,0,151,33
249381,8,426,95,9,331,86
249381,7,209,37,2,172,35
249381,6,141,22,1,119,21
249381,5,34,3,0,31,3
249381,4,15,7,0,8,7
249381,3,15,9,1,6,8
249381,2,5,2,0,3,2
249381,1,2,1,0,1,1
1376,10,2,1,0,1,1
1376,9,16,6,0,10,6
1376,8,111,42,0,69,42
1376,7,289,75,0,214,75
1376,6,427,136,0,291,136
1376,5,154,49,0,105,49
1376,4,49,13,0,36,13
1376,3,26,9,0,17,9
1376,2,7,3,0,4,3
164949,10,54,14,0,40,14
164949,9,193,48,0,145,48
164949,8,458,88,0,370,88
164949,7,208,30,0,178,30
164949,6,107,33,0,74,33
164949,5,33,10,0,23,10
164949,4,19,9,0,10,9
164949,3,9,6,0,3,6
164949,1,3,1,0,2,1
247236,10,57,9,3,48,6
247236,9,117,17,0,100,17
247236,8,447,64,12,383,52
247236,7,293,40,5,253,35
247236,6,122,24,5,98,19
247236,5,29,6,0,23,6
247236,4,16,4,0,12,4
247236,3,4,3,0,1,3
247236,2,2,1,0,1,1
226522,10,90,10,0,80,10
226522,9,263,40,0,223,40
226522,8,439,59,0,380,59
226522,7,168,19,0,149,19
226522,6,84,13,0,71,13
226522,5,22,3,0,19,3
226522,4,4,1,0,3,1
226522,1,8,2,0,6,2
13362,10,42,6,0,36,6
13362,9,61,17,0,44,17
13362,8,233,43,0,190,43
13362,7,263,59,0,204,59
13362,6,245,51,0,194,51
13362,5,88,21,0,67,21
13362,4,52,13,0,39,13
13362,3,44,17,0,27,17
13362,2,23,10,0,13,10
13362,1,29,7,0,22,7
31552,10,57,14,0,43,14
31552,9,96,20,0,76,20
31552,8,351,62,0,289,62
31552,7,306,50,0,256,50
31552,6,191,35,0,156,35
31552,5,47,5,0,42,5
31552,4,16,4,0,12,4
31552,1,4,1,0,3,1
242804,10,31,9,0,22,9
242804,9,138,22,0,116,22
242804,8,442,65,0,377,65
242804,7,268,29,0,239,29
242804,6,146,23,0,123,23
242804,5,34,11,0,23,11
242804,4,10,3,0,7,3
242804,3,8,5,0,3,5
242804,2,4,3,0,1,3
242804,1,2,1,0,1,1
130899,10,8,2,0,6,2
130899,9,22,7,0,15,7
130899,8,177,46,0,131,46
130899,7,325,63,1,262,62
130899,6,408,98,0,310,98
130899,5,101,23,0,78,23
130899,4,29,9,0,20,9
130899,3,4,2,0,2,2
130899,2,3,2,0,1,2
3353,10,51,21,0,30,21
3353,9,141,45,0,96,45
3353,8,341,112,0,229,112
3353,7,269,75,0,194,75
3353,6,158,43,0,115,43
3353,5,60,24,0,36,24
3353,4,33,9,0,24,9
3353,3,11,5,0,6,5
3353,2,6,3,0,3,3
3353,1,7,2,0,5,2
75547,10,13,3,2,10,1
75547,9,42,7,0,35,7
75547,8,219,43,4,176,39
75547,7,305,48,3,257,45
75547,6,286,57,6,229,51
75547,5,98,23,0,75,23
75547,4,58,16,0,42,16
75547,3,33,9,2,24,7
75547,2,15,4,0,11,4
75547,1,7,4,0,3,4
8195,10,24,5,0,19,5
8195,9,55,18,0,37,18
8195,8,238,81,0,157,81
8195,7,355,108,0,247,108
8195,6,288,81,0,207,81
8195,5,73,14,0,59,14
8195,4,36,11,0,25,11
8195,2,3,1,0,2,1
2535,10,13,4,0,9,4
2535,9,48,12,0,36,12
2535,8,178,56,0,122,56
2535,7,299,67,0,232,67
2535,6,308,64,0,244,64
2535,5,106,35,0,71,35
2535,4,70,28,0,42,28
2535,3,33,8,0,25,8
2535,2,17,6,0,11,6
2535,1,4,2,0,2,2
8490,10,48,32,0,16,32
8490,9,72,21,0,51,21
8490,8,284,102,0,182,102
8490,7,278,87,0,191,87
8490,6,233,92,0,141,92
8490,5,76,34,0,42,34
8490,4,37,17,0,20,17
8490,3,26,17,0,9,17
8490,2,16,11,0,5,11
8490,1,5,1,0,4,1
35248,9,13,2,0,11,2
35248,8,151,48,0,103,48
35248,7,341,64,0,277,64
35248,6,358,78,0,280,78
35248,5,125,23,0,102,23
35248,4,46,12,0,34,12
35248,3,19,2,0,17,2
35248,2,7,4,0,3,4
71676,10,9,1,0,8,1
71676,9,12,4,0,8,4
71676,8,87,14,0,73,14
71676,7,215,43,0,172,43
71676,6,382,72,0,310,72
71676,5,189,43,0,146,43
71676,4,110,31,0,79,31
71676,3,42,17,0,25,17
71676,2,24,8,0,16,8
71676,1,4,4,0,0,4
227072,10,30,4,0,26,4
227072,9,37,8,0,29,8
227072,8,258,41,0,217,41
227072,7,329,50,0,279,50
227072,6,262,35,0,227,35
227072,5,92,14,0,78,14
227072,4,46,10,0,36,10
227072,3,13,2,0,11,2
227072,2,6,4,0,2,4
227072,1,2,1,0,1,1
244115,10,64,19,0,45,19
244115,9,144,28,0,116,28
244115,8,425,65,0,360,65
244115,7,258,31,0,227,31
244115,6,125,25,0,100,25
244115,5,41,11,0,30,11
244115,4,9,2,0,7,2
244115,3,4,2,0,2,2
244115,2,3,2,0,1,2
230251,10,21,2,0,19,2
230251,9,25,2,0,23,2
230251,8,125,17,5,108,12
230251,7,346,45,7,301,38
230251,6,338,46,12,292,34
230251,5,129,26,2,103,24
230251,4,56,10,0,46,10
230251,3,24,12,0,12,12
230251,2,5,1,0,4,1
128721,10,55,14,2,41,12
128721,9,164,30,4,134,26
128721,8,462,76,8,386,68
128721,7,239,39,3,200,36
128721,6,109,24,1,85,23
128721,5,24,2,0,22,2
128721,4,11,5,0,6,5
128721,3,6,1,0,5,1
128721,1,2,1,0,1,1
22398,10,12,7,0,5,7
22398,9,26,6,0,20,6
22398,8,196,70,0,126,70
22398,7,383,111,0,272,111
22398,6,337,108,0,229,108
22398,5,70,25,0,45,25
22398,4,32,14,0,18,14
22398,3,10,3,0,7,3
22398,2,2,1,0,1,1
13286,10,8,2,0,6,2
13286,9,22,10,0,12,10
13286,8,144,47,0,97,47
13286,7,283,83,0,200,83
13286,6,324,96,0,228,96
13286,5,126,36,0,90,36
13286,4,89,40,0,49,40
13286,3,38,19,0,19,19
13286,2,25,13,0,12,13
13286,1,10,8,0,2,8
17970,10,44,15,0,29,15
17970,9,53,13,0,40,13
17970,8,182,54,0,128,54
17970,7,262,74,0,188,74
17970,6,275,86,0,189,86
17970,5,142,49,0,93,49
17970,4,64,28,0,36,28
17970,3,29,14,0,15,14
17970,2,12,9,0,3,9
17970,1,6,3,0,3,3
17557,10,15,2,0,13,2
17557,9,23,3,0,20,3
17557,8,70,13,0,57,13
17557,7,170,20,0,150,20
17557,6,368,35,0,333,35
17557,5,206,17,0,189,17
17557,4,104,13,0,91,13
17557,3,59,10,0,49,10
17557,2,42,13,0,29,13
17557,1,12,7,0,5,7
244916,10,20,6,0,14,6
244916,9,53,12,0,41,12
244916,8,304,41,0,263,41
244916,7,339,46,0,293,46
244916,6,250,45,0,205,45
244916,5,65,10,0,55,10
244916,4,19,5,0,14,5
244916,3,13,2,0,11,2
244916,2,5,2,0,3,2
101,10,10,2,0,8,2
101,9,43,15,0,28,15
101,8,234,80,0,154,80
101,7,375,141,0,234,141
101,6,285,119,0,166,119
101,5,76,27,0,49,27
101,4,32,15,0,17,15
101,3,10,4,0,6,4
39813,10,16,5,0,11,5
39813,9,29,3,0,26,3
39813,8,211,45,0,166,45
39813,7,339,71,0,268,71
39813,6,311,56,0,255,56
39813,5,93,18,0,75,18
39813,4,44,14,0,30,14
39813,3,15,3,0,12,3
39813,2,4,1,0,3,1
39813,1,5,1,0,4,1
119632,9,20,7,0,13,7
119632,8,123,22,0,101,22
119632,7,284,52,0,232,52
119632,6,387,65,0,322,65
119632,5,154,20,0,134,20
119632,4,52,15,0,37,15
119632,3,29,5,0,24,5
119632,2,9,5,0,4,5
119632,1,3,1,0,2,1
427,10,20,6,0,14,6
427,9,25,10,0,15,10
427,8,113,27,0,86,27
427,7,196,48,0,148,48
427,6,366,87,0,279,87
427,5,166,45,0,121,45
427,4,95,26,0,69,26
427,3,50,20,0,30,20
427,2,24,7,0,17,7
427,1,10,4,0,6,4
2081,10,124,54,0,70,54
2081,9,159,70,0,89,70
2081,8,345,116,0,229,116
2081,7,247,65,0,182,65
2081,6,116,27,0,89,27
2081,5,47,13,0,34,13
2081,4,11,4,0,7,4
2081,3,10,6,0,4,6
2081,2,4,3,0,1,3
171662,10,49,8,0,41,8
171662,9,150,39,0,111,39
171662,8,408,76,0,332,76
171662,7,253,52,1,201,51
171662,6,133,34,0,99,34
171662,5,32,7,0,25,7
171662,4,21,6,0,15,6
171662,3,12,4,0,8,4
171662,2,5,2,0,3,2
171662,1,3,2,0,1,2
58602,10,7,2,0,5,2
58602,9,34,10,0,24,10
58602,8,220,49,0,171,49
58602,7,370,91,0,279,91
58602,6,304,68,0,236,68
58602,5,91,25,0,66,25
58602,4,24,7,0,17,7
58602,3,10,4,0,6,4
58602,2,3,2,0,1,2
129904,9,13,3,0,10,3
129904,8,85,12,0,73,12
129904,7,220,31,0,189,31
129904,6,373,60,0,313,60
129904,5,165,27,0,138,27
129904,4,114,32,0,82,32
129904,3,55,25,0,30,25
129904,2,26,5,0,21,5
129904,1,10,2,0,8,2
218509,10,69,16,0,53,16
218509,9,175,30,1,145,29
218509,8,408,63,8,345,55
218509,7,236,39,9,197,30
218509,6,120,18,1,102,17
218509,5,35,7,0,28,7
218509,4,13,5,0,8,5
218509,3,5,3,0,2,3
218509,2,3,1,0,2,1
218509,1,8,5,0,3,5
4553,10,15,4,0,11,4
4553,9,37,19,0,18,19
4553,8,159,71,0,88,71
4553,7,282,105,0,177,105
4553,6,350,126,0,224,126
4553,5,124,38,0,86,38
4553,4,58,19,0,39,19
4553,3,20,8,0,12,8
4553,2,10,2,0,8,2
4553,1,8,5,0,3,5
980,10,7,3,0,4,3
980,9,16,6,0,10,6
980,8,101,30,0,71,30
980,7,221,55,0,166,55
980,6,406,85,0,321,85
980,5,176,34,0,142,34
980,4,81,23,0,58,23
980,3,33,10,0,23,10
980,2,16,3,0,13,3
980,1,4,1,0,3,1
19996,10,14,3,0,11,3
19996,9,48,12,0,36,12
19996,8,203,55,0,148,55
19996,7,320,99,0,221,99
19996,6,333,95,0,238,95
19996,5,83,30,0,53,30
19996,4,37,11,0,26,11
19996,3,18,3,0,15,3
19996,2,3,1,0,2,1
194232,10,18,5,0,13,5
194232,9,35,8,0,27,8
194232,8,167,16,0,151,16
194232,7,246,19,0,227,19
194232,6,344,40,0,304,40
194232,5,145,21,0,124,21
194232,4,62,7,0,55,7
194232,3,28,5,0,23,5
194232,2,8,2,0,6,2
194232,1,6,1,0,5,1
3343,10,4,2,0,2,2
3343,9,6,1,0,5,1
3343,8,17,4,0,13,4
3343,7,60,8,0,52,8
3343,6,230,32,0,198,32
3343,5,286,47,0,239,47
3343,4,215,42,0,173,42
3343,3,135,33,0,102,33
3343,2,78,23,0,55,23
3343,1,28,11,0,17,11
76417,9,73,14,0,59,14
76417,8,362,76,0,286,76
76417,7,323,85,0,238,85
76417,6,194,55,0,139,55
76417,5,54,20,0,34,20
76417,4,26,12,0,14,12
76417,3,6,1,0,5,1
76417,2,8,5,0,3,5
41003,10,7,1,0,6,1
41003,9,20,7,0,13,7
41003,8,182,49,0,133,49
41003,7,304,63,0,241,63
41003,6,362,66,0,296,66
41003,5,108,16,0,92,16
41003,4,46,11,0,35,11
41003,3,18,4,0,14,4
41003,2,6,1,0,5,1
41003,1,2,1,0,1,1
2533,10,23,9,0,14,9
2533,9,52,24,0,28,24
2533,8,245,96,0,149,96
2533,7,373,96,0,277,96
2533,6,271,69,0,202,69
2533,5,68,21,0,47,21
2533,4,10,3,0,7,3
230383,10,21,5,0,16,5
230383,9,44,11,0,33,11
230383,8,310,38,0,272,38
230383,7,373,32,0,341,32
230383,6,232,31,0,201,31
230383,5,47,10,0,37,10
230383,4,18,3,0,15,3
1194,10,49,26,0,23,26
1194,9,76,28,0,48,28
1194,8,200,76,0,124,76
1194,7,326,83,0,243,83
1194,6,268,76,0,192,76
1194,5,85,19,0,66,19
1194,4,35,8,0,27,8
1194,3,9,4,0,5,4
1194,2,2,1,0,1,1
1194,1,3,1,0,2,1
941,10,7,1,0,6,1
941,9,17,4,0,13,4
941,8,92,28,0,64,28
941,7,243,72,0,171,72
941,6,424,120,0,304,120
941,5,151,35,0,116,35
941,4,73,29,0,44,29
941,3,27,10,0,17,10
941,2,15,6,0,9,6
941,1,2,1,0,1,1
88827,10,81,23,0,58,23
88827,9,145,38,0,107,38
88827,8,381,81,0,300,81
88827,7,272,66,0,206,66
88827,6,124,38,0,86,38
88827,5,28,5,0,23,5
88827,4,14,3,0,11,3
170587,10,49,6,1,43,5
170587,9,76,15,0,61,15
170587,8,272,54,1,218,53
170587,7,296,52,1,244,51
170587,6,228,24,0,204,24
170587,5,69,12,0,57,12
170587,4,33,4,0,29,4
170587,3,15,2,0,13,2
170587,2,9,5,0,4,5
170587,1,6,1,0,5,1
119407,10,11,1,0,10,1
119407,8,105,20,0,85,20
119407,7,192,29,0,163,29
119407,6,366,47,0,319,47
119407,5,170,25,0,145,25
119407,4,111,23,0,88,23
119407,3,54,14,0,40,14
119407,2,24,8,0,16,8
119407,1,11,2,0,9,2
192638,10,16,3,0,13,3
192638,9,42,15,0,27,15
192638,8,203,34,1,169,33
192638,7,364,47,6,317,41
192638,6,305,44,0,261,44
192638,5,74,11,0,63,11
192638,4,28,5,0,23,5
192638,3,11,1,0,10,1
192638,2,8,1,0,7,1
798,10,62,28,0,34,28
798,9,79,30,0,49,30
798,8,214,79,0,135,79
798,7,316,94,1,222,93
798,6,265,80,0,185,80
798,5,75,20,0,55,20
798,4,27,12,0,15,12
798,3,9,5,0,4,5
198830,10,146,30,3,116,27
198830,9,245,45,4,200,41
198830,8,345,52,6,293,46
198830,7,140,22,2,118,20
198830,6,108,21,2,87,19
198830,5,28,8,0,20,8
198830,4,17,11,0,6,11
198830,3,14,7,1,7,6
198830,2,6,3,0,3,3
198830,1,9,3,1,6,2
7098,10,29,5,0,24,5
7098,9,14,3,0,11,3
7098,8,50,9,0,41,9
7098,7,125,24,0,101,24
7098,6,261,48,0,213,48
7098,5,245,39,0,206,39
7098,4,162,39,0,123,39
7098,3,94,20,0,74,20
7098,2,43,20,0,23,20
7098,1,25,6,0,19,6
6738,10,7,1,0,6,1
6738,9,17,8,0,9,8
6738,8,99,45,0,54,45
6738,7,243,100,0,143,100
6738,6,405,151,0,254,151
6738,5,167,61,0,106,61
6738,4,79,31,0,48,31
6738,3,25,10,0,15,10
6738,2,3,3,0,0,3
6738,1,2,2,0,0,2
223,10,16,8,0,8,8
223,9,46,16,0,30,16
223,8,254,71,0,183,71
223,7,356,93,0,263,93
223,6,249,70,0,179,70
223,5,82,32,0,50,32
223,4,24,8,0,16,8
223,3,14,8,0,6,8
223,2,2,1,0,1,1
165872,10,107,19,0,88,19
165872,9,213,27,0,186,27
165872,8,422,84,0,338,84
165872,7,181,32,0,149,32
165872,6,67,20,0,47,20
165872,5,30,11,0,19,11
165872,4,11,3,0,8,3
165872,3,8,5,0,3,5
165872,2,3,2,0,1,2
165872,1,4,2,0,2,2
15126,10,151,37,0,114,37
15126,9,224,44,0,180,44
15126,8,364,74,0,290,74
15126,7,181,36,0,145,36
15126,6,58,16,0,42,16
15126,5,25,2,0,23,2
15126,4,11,6,0,5,6
15126,2,7,3,0,4,3
15126,1,19,2,0,17,2
29903,10,6,1,0,5,1
29903,9,5,2,0,3,2
29903,8,104,41,0,63,41
29903,7,293,88,0,205,88
29903,6,394,118,0,276,118
29903,5,147,36,0,111,36
29903,4,61,27,0,34,27
29903,3,25,6,0,19,6
29903,2,6,5,0,1,5
29903,1,1,1,0,0,1
3234,10,6,2,0,4,2
3234,9,33,5,0,28,5
3234,8,225,53,0,172,53
3234,7,363,80,0,283,80
3234,6,257,62,0,195,62
3234,5,108,24,0,84,24
3234,4,35,11,0,24,11
3234,3,9,3,0,6,3
136594,10,23,4,0,19,4
136594,9,31,8,0,23,8
136594,8,173,41,3,132,38
136594,7,282,47,5,235,42
136594,6,334,57,5,277,52
136594,5,118,22,2,96,20
136594,4,48,16,3,32,13
136594,3,22,4,0,18,4
136594,2,9,2,0,7,2
136594,1,2,1,0,1,1
1860,10,44,22,0,22,22
1860,9,47,18,0,29,18
1860,8,109,34,1,75,33
1860,7,140,39,0,101,39
1860,6,262,79,0,183,79
1860,5,196,56,0,140,56
1860,4,122,31,0,91,31
1860,3,66,17,0,49,17
1860,2,40,19,0,21,19
1860,1,14,7,0,7,7
71655,10,13,1,0,12,1
71655,9,53,15,1,38,14
71655,8,257,62,5,195,57
71655,7,297,67,3,230,64
71655,6,272,62,7,210,55
71655,5,89,25,1,64,24
71655,4,36,10,1,26,9
71655,3,15,5,0,10,5
71655,2,6,2,0,4,2
125046,10,45,18,1,27,17
125046,9,79,33,0,46,33
125046,8,301,77,3,224,74
125046,7,244,56,2,188,54
125046,6,248,66,0,182,66
125046,5,77,23,0,54,23
125046,4,29,12,0,17,12
125046,3,13,2,0,11,2
206504,10,18,2,0,16,2
206504,9,26,9,0,17,9
206504,8,228,51,0,177,51
206504,7,364,48,0,316,48
206504,6,291,60,0,231,60
206504,5,71,10,0,61,10
206504,4,26,5,0,21,5
206504,3,12,7,0,5,7
206504,2,3,2,0,1,2
128931,10,16,4,0,12,4
128931,9,44,6,0,38,6
128931,8,312,48,0,264,48
128931,7,336,56,0,280,56
128931,6,230,48,0,182,48
128931,5,68,19,0,49,19
128931,4,21,6,0,15,6
128931,2,2,1,0,1,1
28396,10,7,3,0,4,3
28396,9,18,8,0,10,8
28396,8,132,51,0,81,51
28396,7,289,96,0,193,96
28396,6,361,115,0,246,115
28396,5,142,42,0,100,42
28396,4,59,20,0,39,20
28396,3,21,7,0,14,7
28396,2,6,2,0,4,2
25491,10,9,1,0,8,1
25491,9,23,7,0,16,7
25491,8,141,34,0,107,34
25491,7,268,62,0,206,62
25491,6,349,81,0,268,81
25491,5,118,45,0,73,45
25491,4,75,37,0,38,37
25491,3,30,20,0,10,20
25491,2,19,9,0,10,9
25491,1,4,2,0,2,2
149809,10,23,4,1,19,3
149809,9,50,6,0,44,6
149809,8,271,52,0,219,52
149809,7,314,50,1,264,49
149809,6,268,49,1,219,48
149809,5,69,7,0,62,7
149809,4,24,9,0,15,9
149809,3,10,3,0,7,3
149809,2,5,1,0,4,1
166857,10,65,18,0,47,18
166857,9,105,15,0,90,15
166857,8,409,72,0,337,72
166857,7,273,50,0,223,50
166857,6,138,26,0,112,26
166857,5,30,6,0,24,6
166857,4,14,4,0,10,4
166857,1,2,1,0,1,1
251420,10,33,5,0,28,5
251420,9,50,10,0,40,10
251420,8,235,38,0,197,38
251420,7,303,53,0,250,53
251420,6,257,46,0,211,46
251420,5,103,26,0,77,26
251420,4,24,7,0,17,7
251420,3,22,11,0,11,11
251420,2,10,4,0,6,4
251420,1,1,1,0,0,1
90870,10,16,5,0,11,5
90870,9,40,7,0,33,7
90870,8,233,53,0,180,53
90870,7,337,57,0,280,57
90870,6,280,48,0,232,48
90870,5,77,17,0,60,17
90870,4,29,12,0,17,12
90870,3,14,2,0,12,2
90870,2,7,3,0,4,3
37165,10,69,17,0,52,17
37165,9,76,8,0,68,8
37165,8,247,49,0,198,49
37165,7,252,30,0,222,30
37165,6,175,27,0,148,27
37165,5,90,14,0,76,14
37165,4,48,10,0,38,10
37165,3,32,9,0,23,9
37165,2,8,2,0,6,2
37165,1,36,6,0,30,6
250442,10,31,9,1,22,8
250442,9,35,13,1,22,12
250442,8,289,51,8,238,43
250442,7,384,54,7,330,47
250442,6,221,25,5,196,20
250442,5,57,9,1,48,8
250442,4,24,3,1,21,2
250442,3,4,3,0,1,3
250442,1,1,1,0,0,1
7929,10,29,7,0,22,7
7929,9,62,18,0,44,18
7929,8,187,51,0,136,51
7929,7,245,53,0,192,53
7929,6,294,84,0,210,84
7929,5,125,46,0,79,46
7929,4,53,14,0,39,14
7929,3,22,8,0,14,8
7929,2,11,6,0,5,6
7929,1,5,4,0,1,4
163154,10,99,31,0,68,31
163154,9,247,42,0,205,42
163154,8,417,73,0,344,73
163154,7,155,31,0,124,31
163154,6,79,28,0,51,28
163154,5,13,1,0,12,1
163154,4,8,2,0,6,2
163154,3,8,5,0,3,5
163154,2,2,2,0,0,2
22948,10,22,3,0,19,3
22948,9,32,5,0,27,5
22948,8,113,12,0,101,12
22948,7,196,18,0,178,18
22948,6,327,31,0,296,31
22948,5,157,18,0,139,18
22948,4,111,16,0,95,16
22948,3,43,7,0,36,7
22948,2,17,2,0,15,2
22948,1,10,1,0,9,1
1933,10,19,5,0,14,5
1933,8,72,11,0,61,11
1933,7,134,30,0,104,30
1933,6,264,73,0,191,73
1933,5,225,51,0,174,51
1933,4,165,55,0,110,55
1933,3,82,37,0,45,37
1933,2,44,19,0,25,19
1933,1,8,4,0,4,4
26859,9,21,5,0,16,5
26859,8,83,11,0,72,11
26859,7,213,38,0,175,38
26859,6,333,50,0,283,50
26859,5,156,23,0,133,23
26859,4,105,25,0,80,25
26859,3,54,11,0,43,11
26859,2,37,13,0,24,13
26859,1,8,3,0,5,3
154443,10,9,2,0,7,2
154443,9,25,9,0,16,9
154443,8,142,25,0,117,25
154443,7,362,58,0,304,58
154443,6,326,52,0,274,52
154443,5,98,23,0,75,23
154443,4,41,10,0,31,10
154443,3,18,7,0,11,7
154443,2,5,2,0,3,2
31503,10,13,5,0,8,5
31503,9,31,7,0,24,7
31503,8,172,54,0,118,54
31503,7,317,104,0,213,104
31503,6,320,97,0,223,97
31503,5,112,30,0,82,30
31503,4,37,13,0,24,13
31503,3,17,8,0,9,8
31503,2,5,3,0,2,3
31503,1,2,2,0,0,2
633,10,5,1,0,4,1
633,9,14,2,0,12,2
633,8,70,11,0,59,11
633,7,159,32,0,127,32
633,6,344,71,0,273,71
633,5,203,29,0,174,29
633,4,118,34,0,84,34
633,3,67,21,0,46,21
633,2,39,16,0,23,16
633,1,7,3,0,4,3
75212,10,18,7,0,11,7
75212,9,51,9,0,42,9
75212,8,266,61,0,205,61
75212,7,322,53,0,269,53
75212,6,233,49,0,184,49
75212,5,76,13,0,63,13
75212,4,40,14,0,26,14
75212,3,13,4,0,9,4
75212,1,4,1,0,3,1
173156,10,15,2,0,13,2
173156,9,65,11,0,54,11
173156,8,317,42,0,275,42
173156,7,349,42,0,307,42
173156,6,208,32,0,176,32
173156,5,47,6,0,41,6
173156,4,19,6,0,13,6
230305,10,42,3,0,39,3
230305,9,132,26,0,106,26
230305,8,323,47,0,276,47
230305,7,242,36,0,206,36
230305,6,165,23,0,142,23
230305,5,56,11,0,45,11
230305,4,22,5,0,17,5
230305,3,20,6,0,14,6
230305,2,13,3,0,10,3
230305,1,9,2,0,7,2
45748,10,48,10,0,38,10
45748,9,74,17,0,57,17
45748,8,263,38,0,225,38
45748,7,313,67,0,246,67
45748,6,226,35,0,191,35
45748,5,64,9,0,55,9
45748,4,17,4,0,13,4
45748,3,10,3,0,7,3
45748,1,3,1,0,2,1
3632,10,8,5,0,3,5
3632,9,18,3,0,15,3
3632,8,136,36,0,100,36
3632,7,302,97,0,205,97
3632,6,365,109,0,256,109
3632,5,112,33,0,79,33
3632,4,50,25,0,25,25
3632,3,16,5,0,11,5
3632,2,10,6,0,4,6
3632,1,5,2,0,3,2
223779,10,17,2,0,15,2
223779,9,24,7,0,17,7
223779,8,179,27,0,152,27
223779,7,330,39,0,291,39
223779,6,320,39,1,281,38
223779,5,102,17,0,85,17
223779,4,31,2,0,29,2
223779,3,12,4,0,8,4
93724,10,12,3,0,9,3
93724,9,30,8,0,22,8
93724,8,294,72,0,222,72
93724,7,326,70,0,256,70
93724,6,256,43,0,213,43
93724,5,71,22,0,49,22
93724,4,22,7,0,15,7
93724,3,6,1,0,5,1
6955,10,12,4,0,8,4
6955,9,15,5,0,10,5
6955,8,109,41,0,68,41
6955,7,253,94,0,159,94
6955,6,422,147,0,275,147
6955,5,128,51,0,77,51
6955,4,61,33,0,28,33
6955,3,15,8,0,7,8
6955,2,6,2,0,4,2
217780,10,22,6,1,16,5
217780,9,159,23,0,136,23
217780,8,469,67,2,402,65
217780,7,237,35,1,202,34
217780,6,108,22,0,86,22
217780,5,18,5,0,13,5
217780,4,10,1,0,9,1
217780,3,3,1,0,2,1
217780,1,3,1,0,2,1
30932,9,22,12,0,10,12
30932,8,142,46,0,96,46
30932,7,278,82,0,196,82
30932,6,373,96,0,277,96
30932,5,131,37,0,94,37
30932,4,42,16,0,26,16
30932,3,20,8,0,12,8
30932,1,5,1,0,4,1
25574,10,31,11,0,20,11
25574,9,29,8,0,21,8
25574,8,131,30,0,101,30
25574,7,208,48,0,160,48
25574,6,322,73,0,249,73
25574,5,177,28,0,149,28
25574,4,81,19,0,62,19
25574,3,20,6,0,14,6
25574,2,14,2,0,12,2
25574,1,5,1,0,4,1
63740,10,9,1,0,8,1
63740,9,11,3,0,8,3
63740,8,113,31,0,82,31
63740,7,290,63,0,227,63
63740,6,392,81,0,311,81
63740,5,135,30,0,105,30
63740,4,41,9,0,32,9
63740,3,22,7,0,15,7
63740,2,3,1,0,2,1
626,10,24,11,0,13,11
626,9,59,19,0,40,19
626,8,197,64,0,133,64
626,7,267,64,0,203,64
626,6,299,77,0,222,77
626,5,118,34,0,84,34
626,4,30,9,0,21,9
626,3,18,5,0,13,5
626,2,3,2,0,1,2
145308,10,33,5,0,28,5
145308,9,41,11,0,30,11
145308,8,168,35,2,133,33
145308,7,235,63,1,172,62
145308,6,306,70,2,236,68
145308,5,112,27,1,85,26
145308,4,60,19,0,41,19
145308,3,37,10,0,27,10
145308,2,20,3,0,17,3
145308,1,5,3,0,2,3
172547,10,8,1,0,7,1
172547,9,39,5,0,34,5
172547,8,299,41,0,258,41
172547,7,343,44,0,299,44
172547,6,232,42,0,190,42
172547,5,64,12,1,52,11
172547,4,19,5,0,14,5
172547,3,10,5,0,5,5
172547,2,2,1,0,1,1
17104,10,34,10,0,24,10
17104,9,37,13,0,24,13
17104,8,147,35,0,112,35
17104,7,235,49,0,186,49
17104,6,315,82,0,233,82
17104,5,149,48,0,101,48
17104,4,60,16,0,44,16
17104,3,27,5,0,22,5
17104,2,10,3,0,7,3
17104,1,2,1,0,1,1
7708,10,6,3,0,3,3
7708,9,13,6,0,7,6
7708,8,74,38,0,36,38
7708,7,147,72,0,75,72
7708,6,328,111,0,217,111
7708,5,251,81,0,170,81
7708,4,129,46,0,83,46
7708,3,40,17,0,23,17
7708,2,19,5,0,14,5
7708,1,7,4,0,3,4
230267,10,22,3,0,19,3
230267,9,61,9,1,52,8
230267,8,365,48,4,317,44
230267,7,256,41,6,215,35
230267,6,205,24,1,181,23
230267,5,60,9,0,51,9
230267,4,27,10,0,17,10
230267,3,16,5,0,11,5
166571,10,53,9,1,44,8
166571,9,154,25,2,129,23
166571,8,403,83,1,320,82
166571,7,197,30,2,167,28
166571,6,125,19,0,106,19
166571,5,42,9,0,33,9
166571,4,21,4,0,17,4
166571,3,11,2,0,9,2
166571,2,5,3,0,2,3
159406,10,10,3,0,7,3
159406,9,28,6,0,22,6
159406,8,156,31,0,125,31
159406,7,280,27,0,253,27
159406,6,307,51,0,256,51
159406,5,116,20,0,96,20
159406,4,63,16,0,47,16
159406,3,38,8,0,30,8
159406,2,8,2,0,6,2
159406,1,4,1,0,3,1
1426,10,1,1,0,0,1
1426,9,6,1,0,5,1
1426,8,24,6,0,18,6
1426,7,107,25,0,82,25
1426,6,297,82,0,215,82
1426,5,241,58,0,183,58
1426,4,186,51,0,135,51
1426,3,83,32,0,51,32
1426,2,46,18,0,28,18
1426,1,19,9,0,10,9
258244,10,33,9,0,24,9
258244,9,54,8,0,46,8
258244,8,176,29,0,147,29
258244,7,215,34,0,181,34
258244,6,207,37,0,170,37
258244,5,109,24,0,85,24
258244,4,75,8,0,67,8
258244,3,60,18,0,42,18
258244,2,47,15,0,32,15
258244,1,38,19,0,19,19
103660,10,27,8,0,19,8
103660,9,52,12,1,40,11
103660,8,291,77,5,214,72
103660,7,295,66,4,229,62
103660,6,216,48,1,168,47
103660,5,68,14,0,54,14
103660,4,41,13,2,28,11
103660,3,11,5,0,6,5
103660,2,5,1,0,4,1
103660,1,4,1,0,3,1
192945,10,13,1,0,12,1
192945,9,66,9,0,57,9
192945,8,355,49,0,306,49
192945,7,361,52,0,309,52
192945,6,168,33,0,135,33
192945,5,32,8,0,24,8
192945,4,12,2,0,10,2
192945,3,3,2,0,1,2
75091,10,15,5,0,10,5
75091,9,39,4,0,35,4
75091,8,269,55,0,214,55
75091,7,314,66,0,248,66
75091,6,251,51,0,200,51
75091,5,65,17,0,48,17
75091,4,36,12,0,24,12
75091,3,10,5,0,5,5
75091,2,5,2,0,3,2
193840,10,14,3,0,11,3
193840,9,24,4,0,20,4
193840,8,212,39,0,173,39
193840,7,290,52,0,238,52
193840,6,290,48,0,242,48
193840,5,77,12,0,65,12
193840,4,60,12,0,48,12
193840,3,22,7,0,15,7
193840,2,15,3,0,12,3
3510,10,2,2,0,0,2
3510,9,2,1,0,1,1
3510,8,10,1,0,9,1
3510,7,19,4,0,15,4
3510,6,105,26,0,79,26
3510,5,138,25,0,113,25
3510,4,201,48,0,153,48
3510,3,212,63,0,149,63
3510,2,179,68,0,111,68
3510,1,139,71,0,68,71
37231,9,36,5,0,31,5
37231,8,247,62,0,185,62
37231,7,321,53,0,268,53
37231,6,255,67,0,188,67
37231,5,78,29,0,49,29
37231,4,37,12,0,25,12
37231,3,15,8,0,7,8
37231,2,6,2,0,4,2
37231,1,3,1,0,2,1
99120,9,23,2,0,21,2
99120,8,98,14,0,84,14
99120,7,184,29,0,155,29
99120,6,320,60,1,260,59
99120,5,157,24,0,133,24
99120,4,106,27,0,79,27
99120,3,66,21,0,45,21
99120,2,31,11,0,20,11
99120,1,11,3,0,8,3
4741,10,94,27,0,67,27
4741,9,149,41,0,108,41
4741,8,284,63,0,221,63
4741,7,210,40,0,170,40
4741,6,145,37,0,108,37
4741,5,53,12,0,41,12
4741,4,31,8,0,23,8
4741,3,18,3,0,15,3
4741,2,12,2,0,10,2
4741,1,8,6,0,2,6
206940,10,30,6,0,24,6
206940,9,69,9,0,60,9
206940,8,300,37,0,263,37
206940,7,360,54,0,306,54
206940,6,186,27,0,159,27
206940,5,38,9,0,29,9
206940,4,14,1,0,13,1
206940,3,5,2,0,3,2
1381,10,61,19,0,42,19
1381,9,23,5,0,18,5
1381,8,68,11,0,57,11
1381,7,135,27,0,108,27
1381,6,306,55,0,251,55
1381,5,172,41,0,131,41
1381,4,139,38,0,101,38
1381,3,60,17,0,43,17
1381,2,32,10,0,22,10
1381,1,9,4,0,5,4
5795,10,8,5,0,3,5
5795,9,28,11,0,17,11
5795,8,213,76,0,137,76
5795,7,297,91,0,206,91
5795,6,303,85,0,218,85
5795,5,106,27,0,79,27
5795,4,33,12,0,21,12
5795,3,12,5,0,7,5
224821,10,42,4,0,38,4
224821,9,97,21,1,76,20
224821,8,363,46,1,317,45
224821,7,302,38,0,264,38
224821,6,162,25,2,137,23
224821,5,25,5,0,20,5
224821,4,11,5,0,6,5
224821,3,5,3,0,2,3
224821,1,2,1,0,1,1
113873,10,94,35,0,59,35
113873,9,164,56,0,108,56
113873,8,381,89,0,292,89
113873,7,199,48,0,151,48
113873,6,104,36,0,68,36
113873,5,32,15,0,17,15
113873,4,14,8,0,6,8
113873,3,8,5,0,3,5
113873,2,5,3,0,2,3
113873,1,2,1,0,1,1
62853,10,21,10,0,11,10
62853,9,36,15,0,21,15
62853,8,170,57,0,113,57
62853,7,212,62,0,150,62
62853,6,301,74,0,227,74
62853,5,128,40,0,88,40
62853,4,74,22,0,52,22
62853,3,37,8,0,29,8
62853,2,15,6,0,9,6
62853,1,7,2,0,5,2
42244,9,15,1,0,14,1
42244,8,135,24,0,111,24
42244,7,264,56,0,208,56
42244,6,371,83,0,288,83
42244,5,120,12,0,108,12
42244,4,60,12,0,48,12
42244,3,20,6,0,14,6
42244,2,9,2,0,7,2
247,10,4,3,0,1,3
247,9,12,4,0,8,4
247,8,132,55,0,77,55
247,7,306,73,0,233,73
247,6,373,111,0,262,111
247,5,108,42,0,66,42
247,4,42,12,0,30,12
247,3,15,3,0,12,3
247,2,5,1,0,4,1
156548,10,64,11,1,53,10
156548,9,101,21,0,80,21
156548,8,278,33,3,245,30
156548,7,233,36,3,197,33
156548,6,184,31,0,153,31
156548,5,64,10,0,54,10
156548,4,40,7,3,33,4
156548,3,16,6,1,10,5
156548,2,8,3,0,5,3
156548,1,10,3,0,7,3
368,10,7,3,0,4,3
368,9,15,9,0,6,9
368,8,104,42,0,62,42
368,7,287,109,0,178,109
368,6,362,138,0,224,138
368,5,125,46,0,79,46
368,4,57,23,0,34,23
368,3,22,12,0,10,12
368,2,13,5,0,8,5
368,1,6,1,0,5,1
147,10,20,7,0,13,7
147,9,57,15,0,42,15
147,8,232,68,0,164,68
147,7,309,76,0,233,76
147,6,220,62,0,158,62
147,5,81,28,0,53,28
147,4,49,20,0,29,20
147,3,18,11,0,7,11
147,2,8,1,0,7,1
147,1,3,1,0,2,1
29198,9,25,7,0,18,7
29198,8,111,32,0,79,32
29198,7,198,47,0,151,47
29198,6,337,71,0,266,71
29198,5,164,41,0,123,41
29198,4,79,25,0,54,25
29198,3,45,19,0,26,19
29198,2,25,12,0,13,12
29198,1,5,1,0,4,1
144388,10,11,3,1,8,2
144388,9,21,7,0,14,7
144388,8,142,36,4,106,32
144388,7,255,48,1,207,47
144388,6,322,63,2,259,61
144388,5,142,38,4,104,34
144388,4,75,20,0,55,20
144388,3,19,7,0,12,7
144388,2,5,1,0,4,1
202732,10,9,2,0,7,2
202732,9,25,4,0,21,4
202732,8,121,13,0,108,13
202732,7,274,30,0,244,30
202732,6,321,37,0,284,37
202732,5,103,14,0,89,14
202732,4,70,17,0,53,17
202732,3,37,7,0,30,7
202732,2,22,4,0,18,4
202732,1,12,4,0,8,4
220775,10,16,2,0,14,2
220775,9,48,6,0,42,6
220775,8,252,22,0,230,22
220775,7,299,47,0,252,47
220775,6,263,32,0,231,32
220775,5,82,11,0,71,11
220775,4,17,1,0,16,1
220775,3,11,6,0,5,6
220775,2,6,3,0,3,3
18333,10,19,3,0,16,3
18333,9,21,3,0,18,3
18333,8,101,17,0,84,17
18333,7,195,32,0,163,32
18333,6,317,68,0,249,68
18333,5,167,32,0,135,32
18333,4,91,26,0,65,26
18333,3,48,13,0,35,13
18333,2,24,8,0,16,8
18333,1,11,3,0,8,3
511,10,34,14,0,20,14
511,9,95,41,0,54,41
511,8,306,110,0,196,110
511,7,275,89,0,186,89
511,6,165,55,0,110,55
511,5,57,21,0,36,21
511,4,37,14,0,23,14
511,3,16,9,0,7,9
511,2,3,2,0,1,2
23985,10,5,3,0,2,3
23985,9,19,9,0,10,9
23985,8,186,74,0,112,74
23985,7,335,101,0,234,101
23985,6,303,100,0,203,100
23985,5,98,41,0,57,41
23985,4,35,16,0,19,16
23985,3,5,3,0,2,3
5767,9,10,5,0,5,5
5767,8,105,37,0,68,37
5767,7,258,74,0,184,74
5767,6,374,108,0,266,108
5767,5,149,42,0,107,42
5767,4,55,26,0,29,26
5767,3,27,9,0,18,9
5767,2,9,4,0,5,4
5767,1,1,1,0,0,1
174476,10,11,3,0,8,3
174476,9,27,7,0,20,7
174476,8,153,29,4,124,25
174476,7,259,46,6,213,40
174476,6,339,50,3,289,47
174476,5,115,16,0,99,16
174476,4,53,14,0,39,14
174476,3,25,5,0,20,5
174476,2,7,1,0,6,1
1302,10,36,14,0,22,14
1302,9,42,18,0,24,18
1302,8,98,29,0,69,29
1302,7,179,54,0,125,54
1302,6,278,98,0,180,98
1302,5,164,67,0,97,67
1302,4,107,40,0,67,40
1302,3,45,19,0,26,19
1302,2,32,20,0,12,20
1302,1,8,4,0,4,4
23679,10,40,15,0,25,15
23679,9,124,53,0,71,53
23679,8,384,134,0,250,134
23679,7,246,71,0,175,71
23679,6,126,38,0,88,38
23679,5,33,12,0,21,12
23679,4,23,9,0,14,9
23679,3,10,4,0,6,4
23679,2,2,1,0,1,1
23679,1,2,1,0,1,1
100679,10,9,2,0,7,2
100679,9,42,3,0,39,3
100679,8,253,44,0,209,44
100679,7,321,42,0,279,42
100679,6,246,26,0,220,26
100679,5,64,10,0,54,10
100679,4,35,10,0,25,10
100679,3,12,3,0,9,3
100679,1,2,2,0,0,2
3870,10,87,37,0,50,37
3870,9,128,56,0,72,56
3870,8,258,85,0,173,85
3870,7,209,78,0,131,78
3870,6,142,47,0,95,47
3870,5,59,20,0,39,20
3870,4,35,16,0,19,16
3870,3,38,23,0,15,23
3870,2,18,14,0,4,14
3870,1,14,7,0,7,7
4154,10,54,15,0,39,15
4154,9,47,9,0,38,9
4154,8,131,27,0,104,27
4154,7,140,28,0,112,28
4154,6,226,58,0,168,58
4154,5,161,49,0,112,49
4154,4,107,31,0,76,31
4154,3,53,22,0,31,22
4154,2,46,20,0,26,20
4154,1,23,8,0,15,8
57660,10,53,7,0,46,7
57660,9,102,9,0,93,9
57660,8,307,40,0,267,40
57660,7,268,24,0,244,24
57660,6,183,22,0,161,22
57660,5,49,2,0,47,2
631,10,38,14,0,24,14
631,9,67,39,0,28,39
631,8,290,113,0,177,113
631,7,330,122,0,208,122
631,6,179,64,0,115,64
631,5,59,19,0,40,19
631,4,11,4,0,7,4
631,2,3,1,0,2,1
180771,10,104,23,4,81,19
180771,9,126,28,3,98,25
180771,8,347,58,3,289,55
180771,7,225,40,3,185,37
180771,6,116,26,4,90,22
180771,5,40,3,1,37,2
180771,4,16,7,0,9,7
180771,3,5,1,0,4,1
180771,1,6,4,1,2,3
116858,10,10,1,0,9,1
116858,9,31,5,0,26,5
116858,8,155,28,0,127,28
116858,7,292,42,0,250,42
116858,6,348,42,0,306,42
116858,5,96,14,0,82,14
116858,4,37,8,0,29,8
116858,3,13,1,0,12,1
116858,2,3,1,0,2,1
95,10,13,7,0,6,7
95,9,37,12,0,25,12
95,8,126,37,0,89,37
95,7,278,81,0,197,81
95,6,347,95,0,252,95
95,5,104,36,0,68,36
95,4,56,25,0,31,25
95,3,18,9,0,9,9
95,2,6,1,0,5,1
95,1,1,1,0,0,1
6546,8,19,5,0,14,5
6546,7,35,7,0,28,7
6546,6,120,27,0,93,27
6546,5,143,31,0,112,31
6546,4,121,25,0,96,25
6546,3,70,17,0,53,17
6546,2,49,20,0,29,20
6546,1,19,5,0,14,5
83667,10,21,7,0,14,7
83667,9,56,15,0,41,15
83667,8,344,85,0,259,85
83667,7,284,64,0,220,64
83667,6,203,56,0,147,56
83667,5,43,10,0,33,10
83667,4,21,12,0,9,12
83667,3,8,2,0,6,2
83667,2,4,1,0,3,1
248158,10,54,11,0,43,11
248158,9,72,16,0,56,16
248158,8,332,59,0,273,59
248158,7,291,37,0,254,37
248158,6,162,29,0,133,29
248158,5,45,9,0,36,9
248158,4,15,5,0,10,5
248158,3,9,5,0,4,5
248158,1,4,1,0,3,1
143075,10,26,8,0,18,8
143075,9,40,11,0,29,11
143075,8,186,46,3,140,43
143075,7,246,43,2,203,41
143075,6,285,48,2,237,46
143075,5,100,26,1,74,25
143075,4,57,13,0,44,13
143075,3,24,7,0,17,7
143075,2,15,4,0,11,4
143075,1,5,1,0,4,1
27389,9,13,2,0,11,2
27389,8,60,8,0,52,8
27389,7,142,30,0,112,30
27389,6,286,54,0,232,54
27389,5,203,36,0,167,36
27389,4,157,34,0,123,34
27389,3,59,16,0,43,16
27389,2,40,8,0,32,8
27389,1,19,6,0,13,6
97357,10,12,3,0,9,3
97357,9,51,16,1,35,15
97357,8,225,54,4,171,50
97357,7,287,56,3,231,53
97357,6,258,60,2,198,58
97357,5,68,19,1,49,18
97357,4,46,15,1,31,14
97357,3,23,10,0,13,10
97357,2,11,4,1,7,3
123955,10,142,42,0,100,42
123955,9,248,71,0,177,71
123955,8,342,85,0,257,85
123955,7,141,36,0,105,36
123955,6,72,28,0,44,28
123955,5,19,7,0,12,7
123955,4,5,1,0,4,1
123955,3,6,1,0,5,1
123955,2,5,2,0,3,2
171129,10,14,2,0,12,2
171129,9,24,4,0,20,4
171129,8,176,31,0,145,31
171129,7,273,43,0,230,43
171129,6,335,54,0,281,54
171129,5,95,9,0,86,9
171129,4,47,10,0,37,10
171129,3,15,1,0,14,1
171129,2,4,2,0,2,2
20750,9,40,5,0,35,5
20750,8,120,15,0,105,15
20750,7,207,24,0,183,24
20750,6,384,41,0,343,41
20750,5,124,19,0,105,19
20750,4,51,5,0,46,5
20750,3,26,5,0,21,5
20750,2,13,7,0,6,7
20750,1,9,2,0,7,2
110524,10,13,6,0,7,6
110524,9,25,2,0,23,2
110524,8,196,38,0,158,38
110524,7,257,32,0,225,32
110524,6,298,52,0,246,52
110524,5,109,18,0,91,18
110524,4,49,18,0,31,18
110524,3,19,5,0,14,5
110524,2,12,6,0,6,6
16497,10,5,1,0,4,1
16497,9,17,5,0,12,5
16497,8,140,56,0,84,56
16497,7,244,93,0,151,93
16497,6,381,115,0,266,115
16497,5,130,43,0,87,43
16497,4,36,12,0,24,12
16497,3,22,9,0,13,9
184491,10,28,3,0,25,3
184491,9,65,10,0,55,10
184491,8,192,29,1,163,28
184491,7,278,42,0,236,42
184491,6,265,46,2,219,44
184491,5,86,16,0,70,16
184491,4,35,8,0,27,8
184491,3,17,10,0,7,10
184491,2,11,4,0,7,4
184491,1,3,1,0,2,1
145588,10,6,4,0,2,4
145588,9,63,18,0,45,18
145588,8,329,67,0,262,67
145588,7,312,59,0,253,59
145588,6,193,46,0,147,46
145588,5,55,16,0,39,16
145588,4,14,6,0,8,6
145588,3,7,1,0,6,1
145588,1,1,1,0,0,1
161226,10,15,3,0,12,3
161226,9,36,9,0,27,9
161226,8,214,44,0,170,44
161226,7,340,37,0,303,37
161226,6,285,48,0,237,48
161226,5,58,8,0,50,8
161226,4,19,4,0,15,4
161226,3,9,2,0,7,2
34969,10,13,4,0,9,4
34969,9,57,17,0,40,17
34969,8,251,77,0,174,77
34969,7,323,69,0,254,69
34969,6,226,57,0,169,57
34969,5,72,19,0,53,19
34969,4,25,2,0,23,2
34969,3,4,1,0,3,1
1621,10,59,29,0,30,29
1621,9,87,30,0,57,30
1621,8,228,75,1,153,74
1621,7,248,64,0,184,64
1621,6,233,71,0,162,71
1621,5,65,15,0,50,15
1621,4,33,12,0,21,12
1621,3,14,8,0,6,8
173275,10,31,5,1,26,4
173275,9,50,8,2,42,6
173275,8,187,26,4,161,22
173275,7,243,40,9,203,31
173275,6,240,45,6,195,39
173275,5,115,29,0,86,29
173275,4,50,13,1,37,12
173275,3,30,7,0,23,7
173275,2,22,8,1,14,7
173275,1,8,4,0,4,4
184346,10,16,5,1,11,4
184346,9,54,14,1,40,13
184346,8,203,39,2,164,37
184346,7,275,45,1,230,44
184346,6,289,51,2,238,49
184346,5,76,12,0,64,12
184346,4,29,10,0,19,10
184346,3,23,10,1,13,9
184346,2,10,4,1,6,3
75789,10,15,6,0,9,6
75789,9,32,6,0,26,6
75789,8,157,27,0,130,27
75789,7,312,37,0,275,37
75789,6,314,57,0,257,57
75789,5,88,18,0,70,18
75789,4,41,10,0,31,10
75789,3,13,1,0,12,1
75789,2,2,2,0,0,2
75789,1,2,1,0,1,1
150926,10,8,1,0,7,1
150926,9,28,3,0,25,3
150926,8,205,32,1,173,31
150926,7,341,58,0,283,58
150926,6,257,49,0,208,49
150926,5,83,19,1,64,18
150926,4,32,10,0,22,10
150926,3,13,2,0,11,2
150926,2,5,3,0,2,3
150926,1,5,2,0,3,2
27532,10,7,4,0,3,4
27532,9,17,5,0,12,5
27532,8,126,24,0,102,24
27532,7,247,59,0,188,59
27532,6,348,71,0,277,71
27532,5,132,37,0,95,37
27532,4,59,21,0,38,21
27532,3,26,8,0,18,8
27532,2,9,5,0,4,5
112092,10,44,14,0,30,14
112092,9,107,27,1,80,26
112092,8,310,74,4,236,70
112092,7,236,44,2,192,42
112092,6,179,49,3,130,46
112092,5,54,17,0,37,17
112092,4,22,5,0,17,5
112092,3,13,3,0,10,3
112092,2,4,1,0,3,1
112092,1,3,1,0,2,1
192,10,7,1,0,6,1
192,9,40,8,0,32,8
192,8,162,41,0,121,41
192,7,260,65,0,195,65
192,6,298,70,0,228,70
192,5,96,27,0,69,27
192,4,66,23,0,43,23
192,3,26,11,0,15,11
192,2,13,7,0,6,7
192,1,4,3,0,1,3
9851,10,12,2,0,10,2
9851,9,9,1,0,8,1
9851,8,36,11,0,25,11
9851,7,97,24,0,73,24
9851,6,225,62,0,163,62
9851,5,251,68,0,183,68
9851,4,172,53,0,119,53
9851,3,100,43,0,57,43
9851,2,52,19,0,33,19
9851,1,17,7,0,10,7
153737,10,10,1,0,9,1
153737,9,69,12,0,57,12
153737,8,313,53,0,260,53
153737,7,247,49,0,198,49
153737,6,219,54,0,165,54
153737,5,53,16,0,37,16
153737,4,35,8,0,27,8
153737,3,15,7,0,8,7
153737,2,5,1,0,4,1
153737,1,4,2,0,2,2
7719,9,9,4,0,5,4
7719,8,69,30,0,39,30
7719,7,211,85,0,126,85
7719,6,372,135,0,237,135
7719,5,186,56,0,130,56
7719,4,87,36,0,51,36
7719,3,21,9,0,12,9
7719,2,12,5,0,7,5
7719,1,3,1,0,2,1
286,10,51,19,0,32,19
286,9,105,32,0,73,32
286,8,231,58,0,173,58
286,7,295,67,0,228,67
286,6,173,35,0,138,35
286,5,56,11,0,45,11
286,4,32,11,0,21,11
286,3,19,8,0,11,8
286,2,4,2,0,2,2
286,1,4,1,0,3,1
202977,10,38,8,0,30,8
202977,9,76,22,3,54,19
202977,8,308,57,7,251,50
202977,7,283,45,5,238,40
202977,6,191,39,3,152,36
202977,5,49,20,1,29,19
202977,4,18,9,0,9,9
202977,3,5,2,0,3,2
202977,2,2,1,0,1,1
54361,10,78,17,0,61,17
54361,9,107,25,0,82,25
54361,8,309,65,0,244,65
54361,7,279,58,0,221,58
54361,6,145,25,0,120,25
54361,5,34,4,0,30,4
54361,4,9,1,0,8,1
54361,3,5,2,0,3,2
155693,8,50,8,0,42,8
155693,7,134,25,0,109,25
155693,6,300,37,0,263,37
155693,5,190,32,0,158,32
155693,4,151,30,0,121,30
155693,3,71,13,0,58,13
155693,2,48,3,0,45,3
155693,1,14,4,0,10,4
42743,10,16,3,0,13,3
42743,9,35,9,0,26,9
42743,8,225,54,0,171,54
42743,7,279,55,0,224,55
42743,6,246,67,0,179,67
42743,5,89,30,0,59,30
42743,4,52,11,0,41,11
42743,3,14,5,0,9,5
42743,2,7,5,0,2,5
27172,10,14,5,0,9,5
27172,9,38,16,0,22,16
27172,8,160,53,0,107,53
27172,7,276,69,0,207,69
27172,6,330,99,0,231,99
27172,5,98,30,0,68,30
27172,4,28,15,0,13,15
27172,3,17,6,0,11,6
27172,2,5,1,0,4,1
27172,1,1,1,0,0,1
3852,10,42,10,0,32,10
3852,9,53,10,0,43,10
3852,8,101,29,0,72,29
3852,7,171,43,0,128,43
3852,6,245,64,0,181,64
3852,5,169,54,0,115,54
3852,4,109,43,0,66,43
3852,3,48,17,0,31,17
3852,2,21,12,0,9,12
3852,1,8,6,0,2,6
17851,10,6,3,0,3,3
17851,9,25,11,0,14,11
17851,8,153,70,0,83,70
17851,7,262,81,0,181,81
17851,6,306,105,0,201,105
17851,5,100,40,0,60,40
17851,4,77,37,0,40,37
17851,3,26,18,0,8,18
17851,2,10,4,0,6,4
17851,1,2,2,0,0,2
215312,10,26,7,0,19,7
215312,9,64,20,3,44,17
215312,8,262,43,2,219,41
215312,7,357,55,4,302,51
215312,6,182,20,0,162,20
215312,5,51,10,1,41,9
215312,4,15,5,0,10,5
215312,2,3,2,0,1,2
215312,1,3,2,0,1,2
13172,10,16,5,0,11,5
13172,9,25,7,0,18,7
13172,8,106,40,0,66,40
13172,7,215,68,0,147,68
13172,6,344,127,0,217,127
13172,5,143,47,0,96,47
13172,4,70,27,0,43,27
13172,3,36,20,0,16,20
13172,2,11,5,0,6,5
191597,10,38,3,0,35,3
191597,9,101,15,0,86,15
191597,8,325,49,4,276,45
191597,7,313,43,5,270,38
191597,6,129,16,0,113,16
191597,5,36,6,1,30,5
191597,4,10,2,0,8,2
191597,3,13,3,0,10,3
191597,1,2,1,0,1,1
22551,10,42,14,0,28,14
22551,9,56,15,0,41,15
22551,8,238,74,0,164,74
22551,7,272,65,0,207,65
22551,6,228,44,0,184,44
22551,5,64,21,0,43,21
22551,4,35,5,0,30,5
22551,3,18,3,0,15,3
22551,1,9,1,0,8,1
148601,10,42,10,0,32,10
148601,9,107,29,0,78,29
148601,8,318,66,0,252,66
148601,7,277,48,0,229,48
148601,6,145,27,0,118,27
148601,5,40,14,0,26,14
148601,4,22,6,0,16,6
148601,3,6,4,0,2,4
148601,2,6,2,0,4,2
16499,10,3,1,0,2,1
16499,9,4,1,0,3,1
16499,8,50,24,0,26,24
16499,7,141,48,0,93,48
16499,6,381,107,0,274,107
16499,5,202,60,0,142,60
16499,4,100,38,0,62,38
16499,3,53,18,0,35,18
16499,2,24,10,0,14,10
16499,1,6,1,0,5,1
3804,10,3,1,0,2,1
3804,9,9,1,0,8,1
3804,8,36,15,0,21,15
3804,7,99,35,0,64,35
3804,6,233,65,0,168,65
3804,5,271,64,0,207,64
3804,4,191,60,0,131,60
3804,3,80,31,0,49,31
3804,2,28,5,0,23,5
3804,1,15,7,0,8,7
142121,9,59,11,0,48,11
142121,8,366,59,0,307,59
142121,7,301,52,0,249,52
142121,6,166,29,0,137,29
142121,5,36,7,0,29,7
142121,4,14,4,0,10,4
142121,3,7,1,0,6,1
142121,2,2,1,0,1,1
142121,1,1,1,0,0,1
185196,10,14,4,0,10,4
185196,9,51,9,1,42,8
185196,8,263,33,4,230,29
185196,7,286,31,2,255,29
185196,6,211,30,2,181,28
185196,5,74,21,2,53,19
185196,4,44,12,0,32,12
185196,3,16,5,0,11,5
97,10,7,3,0,4,3
97,9,26,11,0,15,11
97,8,90,30,0,60,30
97,7,177,46,0,131,46
97,6,247,76,0,171,76
97,5,85,35,0,50,35
97,4,40,15,0,25,15
97,3,21,14,0,7,14
97,2,10,5,0,5,5
97,1,3,2,0,1,2
2932,10,29,10,0,19,10
2932,9,50,17,0,33,17
2932,8,146,43,0,103,43
2932,7,255,70,0,185,70
2932,6,284,76,0,208,76
2932,5,131,39,0,92,39
2932,4,41,17,0,24,17
2932,3,17,9,0,8,9
2932,2,5,3,0,2,3
10206,10,5,1,0,4,1
10206,9,19,10,0,9,10
10206,8,99,35,0,64,35
10206,7,230,51,0,179,51
10206,6,354,71,0,283,71
10206,5,150,27,0,123,27
10206,4,77,16,0,61,16
10206,3,19,6,0,13,6
10206,2,8,1,0,7,1
10206,1,2,1,0,1,1
205507,10,17,3,0,14,3
205507,9,72,13,0,59,13
205507,8,336,51,0,285,51
205507,7,271,42,0,229,42
205507,6,179,35,0,144,35
205507,5,51,19,0,32,19
205507,4,22,9,0,13,9
205507,3,11,2,0,9,2
205507,2,4,1,0,3,1
117914,9,21,3,0,18,3
117914,8,191,44,0,147,44
117914,7,321,64,0,257,64
117914,6,285,67,0,218,67
117914,5,93,26,0,67,26
117914,4,31,12,0,19,12
117914,3,6,3,0,3,3
117914,2,7,2,0,5,2
175549,10,41,8,1,33,7
175549,9,75,8,0,67,8
175549,8,269,44,2,225,42
175549,7,255,33,1,222,32
175549,6,212,30,1,182,29
175549,5,54,11,0,43,11
175549,4,30,8,0,22,8
175549,3,16,7,0,9,7
175549,2,9,3,1,6,2
32674,10,81,29,0,52,29
32674,9,121,38,0,83,38
32674,8,243,70,0,173,70
32674,7,231,53,0,178,53
32674,6,158,39,0,119,39
32674,5,61,17,0,44,17
32674,4,35,14,0,21,14
32674,3,20,3,0,17,3
32674,2,4,1,0,3,1
32674,1,7,3,0,4,3
66193,9,11,1,0,10,1
66193,8,115,21,1,94,20
66193,7,276,58,1,218,57
66193,6,322,67,6,255,61
66193,5,145,35,2,110,33
66193,4,61,15,0,46,15
66193,3,14,4,0,10,4
66193,2,12,2,0,10,2
3086,10,33,9,0,24,9
3086,9,28,9,0,19,9
3086,8,129,42,0,87,42
3086,7,222,69,0,153,69
3086,6,320,97,0,223,97
3086,5,147,42,0,105,42
3086,4,46,18,0,28,18
3086,3,21,8,0,13,8
3086,2,12,8,0,4,8
3086,1,1,1,0,0,1
24565,10,21,9,0,12,9
24565,9,32,13,0,19,13
24565,8,166,63,0,103,63
24565,7,262,73,0,189,73
24565,6,292,87,0,205,87
24565,5,100,37,0,63,37
24565,4,51,16,0,35,16
24565,3,21,8,0,13,8
24565,2,11,2,0,9,2
24565,1,3,1,0,2,1
132428,10,20,1,0,19,1
132428,9,46,8,0,38,8
132428,8,246,51,0,195,51
132428,7,292,51,0,241,51
132428,6,236,43,0,193,43
132428,5,60,10,0,50,10
132428,4,40,14,0,26,14
132428,3,12,4,0,8,4
234396,10,28,5,0,23,5
234396,9,44,14,0,30,14
234396,8,241,28,0,213,28
234396,7,306,31,0,275,31
234396,6,226,23,0,203,23
234396,5,68,10,0,58,10
234396,4,31,5,0,26,5
234396,3,13,6,0,7,6
156501,10,26,8,0,18,8
156501,9,76,20,0,56,20
156501,8,310,87,1,223,86
156501,7,272,60,1,212,59
156501,6,174,54,0,120,54
156501,5,57,14,0,43,14
156501,4,15,4,0,11,4
156501,3,13,7,0,6,7
156501,2,12,5,0,7,5
156501,1,3,1,0,2,1
19622,10,63,31,0,32,31
19622,9,162,77,0,85,77
19622,8,392,153,0,239,153
19622,7,201,67,0,134,67
19622,6,76,23,0,53,23
19622,5,30,16,0,14,16
19622,4,15,8,0,7,8
19622,3,9,7,0,2,7
19622,2,3,1,0,2,1
19622,1,5,1,0,4,1
181797,10,28,11,0,17,11
181797,9,72,13,0,59,13
181797,8,295,59,2,236,57
181797,7,283,53,1,230,52
181797,6,176,45,1,131,44
181797,5,48,15,0,33,15
181797,4,35,16,0,19,16
181797,3,14,3,0,11,3
181797,2,3,3,0,0,3
26696,10,13,2,0,11,2
26696,9,19,3,0,16,3
26696,8,42,6,0,36,6
26696,7,93,12,0,81,12
26696,6,233,29,0,204,29
26696,5,245,41,0,204,41
26696,4,176,45,0,131,45
26696,3,76,17,0,59,17
26696,2,41,11,0,30,11
26696,1,17,4,0,13,4
22897,10,91,45,0,46,45
22897,9,105,42,0,63,42
22897,8,253,93,0,160,93
22897,7,198,60,0,138,60
22897,6,170,63,0,107,63
22897,5,66,19,0,47,19
22897,4,38,11,0,27,11
22897,3,20,6,0,14,6
22897,2,6,1,0,5,1
22897,1,7,3,0,4,3
10681,10,8,2,0,6,2
10681,9,18,4,0,14,4
10681,8,98,27,0,71,27
10681,7,187,57,0,130,57
10681,6,316,80,0,236,80
10681,5,173,51,0,122,51
10681,4,82,12,0,70,12
10681,3,42,14,0,28,14
10681,2,15,6,0,9,6
10681,1,16,5,0,11,5
4370,10,10,4,0,6,4
4370,9,32,11,0,21,11
4370,8,194,64,0,130,64
4370,7,296,87,0,209,87
4370,6,274,63,0,211,63
4370,5,89,26,0,63,26
4370,4,37,16,0,21,16
4370,3,13,7,0,6,7
4370,2,6,1,0,5,1
137397,10,12,3,0,9,3
137397,9,20,6,0,14,6
137397,8,185,38,0,147,38
137397,7,321,69,0,252,69
137397,6,288,52,0,236,52
137397,5,73,19,0,54,19
137397,4,38,10,0,28,10
137397,3,14,4,0,10,4
39927,10,21,7,0,14,7
39927,9,63,16,0,47,16
39927,8,336,79,0,257,79
39927,7,277,80,0,197,80
39927,6,178,54,0,124,54
39927,5,42,13,0,29,13
39927,4,22,8,0,14,8
39927,3,4,2,0,2,2
39927,2,3,2,0,1,2
39927,1,5,1,0,4,1
8552,10,6,2,0,4,2
8552,9,25,13,0,12,13
8552,8,151,44,0,107,44
8552,7,271,103,0,168,103
8552,6,319,114,0,205,114
8552,5,99,44,0,55,44
8552,4,52,25,0,27,25
8552,3,18,8,0,10,8
8552,2,10,4,0,6,4
145645,10,16,4,0,12,4
145645,9,56,12,0,44,12
145645,8,285,53,0,232,53
145645,7,306,43,0,263,43
145645,6,225,41,0,184,41
145645,5,40,3,0,37,3
145645,4,15,4,0,11,4
145645,3,7,3,0,4,3
28086,10,11,4,0,7,4
28086,9,14,8,0,6,8
28086,8,128,56,0,72,56
28086,7,236,88,0,148,88
28086,6,354,119,0,235,119
28086,5,111,42,0,69,42
28086,4,69,19,0,50,19
28086,3,18,7,0,11,7
28086,2,7,4,0,3,4
197572,10,104,19,0,85,19
197572,9,148,30,0,118,30
197572,8,311,51,0,260,51
197572,7,186,33,0,153,33
197572,6,115,20,0,95,20
197572,5,38,9,0,29,9
197572,4,19,8,0,11,8
197572,3,14,5,0,9,5
197572,2,8,2,0,6,2
197572,1,6,3,0,3,3
2604,10,20,8,0,12,8
2604,9,40,8,0,32,8
2604,8,171,43,0,128,43
2604,7,228,56,0,172,56
2604,6,292,59,0,233,59
2604,5,118,20,0,98,20
2604,4,54,12,0,42,12
2604,3,17,3,0,14,3
2604,2,7,1,0,6,1
2251,10,182,81,0,101,81
2251,9,130,47,0,83,47
2251,8,234,79,0,155,79
2251,7,185,56,0,129,56
2251,6,126,43,0,83,43
2251,5,51,14,0,37,14
2251,4,16,2,0,14,2
2251,3,9,5,0,4,5
2251,2,6,3,0,3,3
2251,1,8,1,0,7,1
173047,10,23,3,0,20,3
173047,9,38,7,0,31,7
173047,8,221,31,0,190,31
173047,7,275,34,0,241,34
173047,6,243,40,0,203,40
173047,5,76,19,0,57,19
173047,4,49,18,0,31,18
173047,3,12,4,0,8,4
173047,2,8,2,0,6,2
147768,10,7,1,0,6,1
147768,9,16,2,0,14,2
147768,8,103,15,0,88,15
147768,7,188,26,0,162,26
147768,6,325,50,0,275,50
147768,5,159,31,0,128,31
147768,4,71,16,0,55,16
147768,3,46,10,0,36,10
147768,2,19,7,0,12,7
147768,1,13,5,0,8,5
169704,10,20,4,0,16,4
169704,9,31,8,0,23,8
169704,8,261,59,8,202,51
169704,7,304,46,3,258,43
169704,6,239,42,2,197,40
169704,5,54,10,0,44,10
169704,4,25,7,1,18,6
169704,2,5,3,0,2,3
40529,10,38,10,0,28,10
40529,9,40,11,0,29,11
40529,8,61,14,0,47,14
40529,7,92,16,0,76,16
40529,6,63,13,0,50,13
40529,5,19,2,0,17,2
40529,4,5,3,0,2,3
40529,3,5,2,0,3,2
40529,1,1,1,0,0,1
207207,10,22,11,0,11,11
207207,9,63,12,0,51,12
207207,8,305,50,0,255,50
207207,7,320,57,0,263,57
207207,6,166,22,0,144,22
207207,5,49,9,0,40,9
207207,3,7,2,0,5,2
207207,1,3,1,0,2,1
119012,10,19,3,0,16,3
119012,9,79,13,0,66,13
119012,8,308,60,0,248,60
119012,7,245,44,0,201,44
119012,6,179,39,0,140,39
119012,5,49,10,0,39,10
119012,4,36,12,0,24,12
119012,3,21,8,0,13,8
119012,2,7,2,0,5,2
119012,1,3,1,0,2,1
2472,10,18,7,0,11,7
2472,9,28,6,0,22,6
2472,8,79,27,0,52,27
2472,7,162,38,0,124,38
2472,6,300,67,0,233,67
2472,5,170,61,0,109,61
2472,4,107,40,0,67,40
2472,3,53,31,0,22,31
2472,2,24,13,0,11,13
2472,1,4,3,0,1,3
127095,10,7,2,0,5,2
127095,9,31,10,0,21,10
127095,8,199,46,0,153,46
127095,7,333,56,0,277,56
127095,6,257,60,0,197,60
127095,5,84,18,0,66,18
127095,4,21,6,0,15,6
127095,3,5,1,0,4,1
127095,2,4,1,0,3,1
127095,1,3,1,0,2,1
90041,9,13,4,0,9,4
90041,8,126,27,0,99,27
90041,7,280,54,0,226,54
90041,6,300,56,0,244,56
90041,5,124,29,0,95,29
90041,4,65,22,0,43,22
90041,3,24,9,0,15,9
90041,2,9,2,0,7,2
137423,10,37,9,0,28,9
137423,9,87,11,0,76,11
137423,8,305,38,0,267,38
137423,7,260,30,1,230,29
137423,6,154,25,0,129,25
137423,5,55,9,0,46,9
137423,4,24,4,0,20,4
137423,3,13,2,0,11,2
137423,2,3,1,0,2,1
137423,1,3,3,0,0,3
229892,10,63,11,0,52,11
229892,9,207,41,0,166,41
229892,8,380,73,2,307,71
229892,7,163,30,2,133,28
229892,6,85,16,2,69,14
229892,5,28,4,0,24,4
229892,4,4,2,0,2,2
229892,3,7,2,0,5,2
229892,2,2,2,1,0,1
3495,10,29,10,0,19,10
3495,9,34,14,0,20,14
3495,8,131,55,0,76,55
3495,7,186,63,0,123,63
3495,6,294,79,0,215,79
3495,5,138,35,0,103,35
3495,4,68,19,0,49,19
3495,3,33,11,0,22,11
3495,2,18,5,0,13,5
3495,1,7,2,0,5,2
109451,9,12,2,0,10,2
109451,8,79,20,0,59,20
109451,7,235,66,0,169,66
109451,6,350,79,0,271,79
109451,5,158,49,0,109,49
109451,4,65,16,0,49,16
109451,3,25,9,0,16,9
109451,2,9,4,0,5,4
249259,10,118,23,0,95,23
249259,9,201,42,0,159,42
249259,8,369,56,0,313,56
249259,7,144,19,0,125,19
249259,6,69,14,0,55,14
249259,5,21,9,0,12,9
249259,4,12,6,0,6,6
249259,2,2,1,0,1,1
730,10,93,50,0,43,50
730,9,173,69,0,104,69
730,8,303,95,0,208,95
730,7,198,56,0,142,56
730,6,101,24,0,77,24
730,5,38,16,0,22,16
730,4,9,6,0,3,6
730,3,8,6,0,2,6
730,2,5,1,0,4,1
225818,10,12,4,0,8,4
225818,9,67,12,0,55,12
225818,8,298,65,0,233,65
225818,7,252,48,0,204,48
225818,6,210,41,0,169,41
225818,5,49,9,0,40,9
225818,4,30,9,0,21,9
225818,3,12,5,0,7,5
225818,2,8,1,0,7,1
41636,10,6,2,0,4,2
41636,9,14,7,0,7,7
41636,8,118,36,0,82,36
41636,7,264,82,0,182,82
41636,6,355,90,0,265,90
41636,5,116,35,0,81,35
41636,4,40,13,0,27,13
41636,3,19,7,0,12,7
41636,2,4,2,0,2,2
1299,10,7,1,0,6,1
1299,9,19,1,0,18,1
1299,8,64,11,0,53,11
1299,7,148,29,0,119,29
1299,6,268,52,0,216,52
1299,5,193,29,0,164,29
1299,4,146,33,0,113,33
1299,3,59,27,0,32,27
1299,2,21,5,0,16,5
1299,1,11,3,0,8,3
149776,10,72,21,3,51,18
149776,9,139,29,3,110,26
149776,8,359,53,8,306,45
149776,7,192,27,1,165,26
149776,6,113,20,2,93,18
149776,5,25,1,0,24,1
149776,4,18,5,0,13,5
149776,3,11,4,0,7,4
149776,2,6,1,0,5,1
149776,1,3,1,0,2,1
1263,9,5,3,0,2,3
1263,8,56,19,0,37,19
1263,7,139,40,0,99,40
1263,6,358,99,0,259,99
1263,5,200,57,0,143,57
1263,4,113,45,0,68,45
1263,3,41,25,0,16,25
1263,2,19,8,0,11,8
1263,1,4,2,0,2,2
150783,10,16,6,0,10,6
150783,9,36,10,0,26,10
150783,8,131,14,3,117,11
150783,7,260,51,3,209,48
150783,6,296,54,3,242,51
150783,5,114,20,2,94,18
150783,4,50,17,0,33,17
150783,3,23,8,1,15,7
150783,2,8,3,0,5,3
150783,1,2,1,0,1,1
1116,10,31,11,0,20,11
1116,9,52,15,0,37,15
1116,8,209,78,0,131,78
1116,7,274,86,0,188,86
1116,6,217,61,0,156,61
1116,5,99,37,0,62,37
1116,4,38,12,0,26,12
1116,3,7,2,0,5,2
1116,2,7,3,0,4,3
153497,10,3,1,0,2,1
153497,9,5,3,0,2,3
153497,8,84,21,0,63,21
153497,7,220,49,5,171,44
153497,6,388,77,13,311,64
153497,5,145,34,4,111,30
153497,4,71,23,1,48,22
153497,3,16,6,0,10,6
38032,10,4,3,0,1,3
38032,9,20,5,0,15,5
38032,8,153,41,0,112,41
38032,7,320,73,0,247,73
38032,6,337,65,0,272,65
38032,5,70,16,0,54,16
38032,4,21,8,0,13,8
38032,3,8,2,0,6,2
38032,2,1,1,0,0,1
4888,10,5,2,0,3,2
4888,9,4,4,0,0,4
4888,8,38,13,0,25,13
4888,7,63,21,0,42,21
4888,6,161,49,0,112,49
4888,5,249,78,0,171,78
4888,4,226,75,0,151,75
4888,3,119,31,0,88,31
4888,2,50,13,0,37,13
4888,1,19,6,0,13,6
84,10,61,33,0,28,33
84,9,149,76,0,73,76
84,8,325,117,0,208,117
84,7,217,63,0,154,63
84,6,112,36,0,76,36
84,5,36,15,0,21,15
84,4,19,9,0,10,9
84,2,2,1,0,1,1
1213,10,25,7,0,18,7
1213,9,53,15,0,38,15
1213,8,135,34,0,101,34
1213,7,277,48,0,229,48
1213,6,275,52,0,223,52
1213,5,108,28,0,80,28
1213,4,35,8,0,27,8
1213,3,10,3,0,7,3
1213,2,13,9,0,4,9
233955,10,10,2,0,8,2
233955,9,32,9,0,23,9
233955,8,244,42,3,202,39
233955,7,307,45,3,262,42
233955,6,226,33,2,193,31
233955,5,67,12,0,55,12
233955,4,30,10,0,20,10
233955,3,12,5,0,7,5
233955,1,1,1,0,0,1
38872,10,9,3,0,6,3
38872,9,32,13,0,19,13
38872,8,221,67,0,154,67
38872,7,306,103,1,203,102
38872,6,251,66,0,185,66
38872,5,72,27,0,45,27
38872,4,18,7,0,11,7
38872,3,16,7,0,9,7
38872,2,4,2,0,2,2
25420,10,12,7,0,5,7
25420,9,32,12,0,20,12
25420,8,172,59,0,113,59
25420,7,256,88,0,168,88
25420,6,302,98,0,204,98
25420,5,82,30,0,52,30
25420,4,47,22,0,25,22
25420,3,19,9,0,10,9
25420,2,6,4,0,2,4
25420,1,3,1,0,2,1
159492,10,10,5,0,5,5
159492,9,24,4,0,20,4
159492,8,169,38,1,131,37
159492,7,269,58,1,211,57
159492,6,279,60,0,219,60
159492,5,103,21,0,82,21
159492,4,52,18,0,34,18
159492,3,17,5,0,12,5
159492,2,7,1,0,6,1
202077,10,237,66,7,171,59
202077,9,241,46,5,195,41
202077,8,252,48,6,204,42
202077,7,79,9,1,70,8
202077,6,52,8,2,44,6
202077,5,19,3,1,16,2
202077,4,9,3,1,6,2
202077,3,13,5,1,8,4
202077,2,7,3,1,4,2
202077,1,22,10,1,12,9
255507,10,10,3,0,7,3
255507,9,35,4,0,31,4
255507,8,222,34,0,188,34
255507,7,319,32,0,287,32
255507,6,233,22,0,211,22
255507,5,78,15,0,63,15
255507,4,23,6,0,17,6
255507,3,10,4,0,6,4
255507,1,3,1,0,2,1
133437,10,4,1,0,3,1
133437,9,21,4,0,17,4
133437,8,115,22,0,93,22
133437,7,198,29,0,169,29
133437,6,319,50,0,269,50
133437,5,151,23,0,128,23
133437,4,72,16,0,56,16
133437,3,31,9,0,22,9
133437,2,15,2,0,13,2
133437,1,3,2,0,1,2
128445,10,39,16,0,23,16
128445,9,90,36,1,54,35
128445,8,296,75,0,221,75
128445,7,230,46,0,184,46
128445,6,170,46,0,124,46
128445,5,61,24,0,37,24
128445,4,22,9,0,13,9
128445,3,14,2,0,12,2
128445,2,6,3,0,3,3
1044,10,61,36,0,25,36
1044,9,89,33,0,56,33
1044,8,239,80,0,159,80
1044,7,252,69,0,183,69
1044,6,167,52,0,115,52
1044,5,66,23,0,43,23
1044,4,26,9,0,17,9
1044,3,13,4,0,9,4
1044,2,12,6,0,6,6
1044,1,4,1,0,3,1
104994,10,9,3,0,6,3
104994,9,27,2,0,25,2
104994,8,173,31,0,142,31
104994,7,289,57,0,232,57
104994,6,271,54,0,217,54
104994,5,100,22,0,78,22
104994,4,32,12,0,20,12
104994,3,13,6,0,7,6
104994,2,12,6,0,6,6
2272,10,7,4,0,3,4
2272,9,8,3,0,5,3
2272,8,31,14,0,17,14
2272,7,69,21,0,48,21
2272,6,174,58,0,116,58
2272,5,240,66,0,174,66
2272,4,208,76,0,132,76
2272,3,105,45,0,60,45
2272,2,73,34,0,39,34
2272,1,15,8,0,7,8
146149,8,116,14,0,102,14
146149,7,199,21,0,178,21
146149,6,379,44,0,335,44
146149,5,122,19,0,103,19
146149,4,56,10,0,46,10
146149,3,16,2,0,14,2
485,10,5,2,0,3,2
485,9,12,4,0,8,4
485,8,53,11,0,42,11
485,7,177,61,0,116,61
485,6,344,89,0,255,89
485,5,181,66,0,115,66
485,4,93,24,0,69,24
485,3,43,16,0,27,16
485,2,16,6,0,10,6
485,1,5,1,0,4,1
216597,10,30,7,0,23,7
216597,9,72,13,0,59,13
216597,8,355,54,0,301,54
216597,7,272,36,0,236,36
216597,6,133,22,0,111,22
216597,5,42,14,0,28,14
216597,4,15,4,0,11,4
216597,3,4,1,0,3,1
216597,1,1,1,0,0,1
68247,9,16,3,0,13,3
68247,8,183,42,0,141,42
68247,7,296,64,0,232,64
68247,6,298,65,0,233,65
68247,5,76,21,0,55,21
68247,4,35,7,0,28,7
68247,3,7,3,0,4,3
68247,2,5,1,0,4,1
172503,10,55,11,0,44,11
172503,9,87,11,0,76,11
172503,8,315,38,0,277,38
172503,7,229,36,0,193,36
172503,6,159,22,0,137,22
172503,5,54,7,0,47,7
172503,4,17,5,0,12,5
172503,3,7,2,0,5,2
92643,10,5,1,0,4,1
92643,9,11,3,0,8,3
92643,8,148,42,0,106,42
92643,7,255,60,0,195,60
92643,6,314,89,0,225,89
92643,5,109,29,0,80,29
92643,4,48,16,0,32,16
92643,3,20,8,0,12,8
92643,2,13,5,0,8,5
162263,10,9,1,0,8,1
162263,9,30,7,0,23,7
162263,8,148,33,0,115,33
162263,7,256,49,0,207,49
162263,6,288,62,0,226,62
162263,5,115,34,0,81,34
162263,4,54,23,0,31,23
162263,3,16,3,0,13,3
162263,2,9,3,0,6,3
193210,10,14,3,0,11,3
193210,9,27,9,0,18,9
193210,8,189,43,0,146,43
193210,7,337,52,0,285,52
193210,6,258,34,0,224,34
193210,5,68,10,0,58,10
193210,4,21,9,0,12,9
193210,3,9,2,0,7,2
1705,10,13,4,0,9,4
1705,9,37,15,0,22,15
1705,8,129,41,0,88,41
1705,7,217,71,0,146,71
1705,6,316,105,0,211,105
1705,5,113,26,0,87,26
1705,4,68,28,0,40,28
1705,3,22,8,0,14,8
1705,2,4,1,0,3,1
1705,1,5,5,0,0,5
132251,10,6,1,0,5,1
132251,9,13,6,0,7,6
132251,8,91,18,0,73,18
132251,7,182,21,0,161,21
132251,6,284,44,0,240,44
132251,5,153,24,0,129,24
132251,4,85,21,0,64,21
132251,3,53,18,0,35,18
132251,2,43,19,0,24,19
132251,1,13,3,0,10,3
24770,10,3,2,0,1,2
24770,9,10,1,0,9,1
24770,8,86,27,0,59,27
24770,7,264,86,0,178,86
24770,6,359,112,0,247,112
24770,5,127,44,0,83,44
24770,4,43,19,0,24,19
24770,3,22,13,0,9,13
24770,2,7,4,0,3,4
312,10,9,4,0,5,4
312,9,13,5,0,8,5
312,8,81,19,0,62,19
312,7,194,38,0,156,38
312,6,343,91,0,252,91
312,5,134,34,0,100,34
312,4,99,39,0,60,39
312,3,29,12,0,17,12
312,2,14,7,0,7,7
312,1,5,1,0,4,1
145371,10,138,55,0,83,55
145371,9,188,43,0,145,43
145371,8,336,71,0,265,71
145371,7,130,26,0,104,26
145371,6,92,24,0,68,24
145371,5,23,8,0,15,8
145371,4,8,3,0,5,3
145371,3,2,1,0,1,1
145371,1,3,1,0,2,1
13511,10,4,1,0,3,1
13511,9,22,8,0,14,8
13511,8,84,27,0,57,27
13511,7,189,57,0,132,57
13511,6,357,85,0,272,85
13511,5,170,47,0,123,47
13511,4,58,17,0,41,17
13511,3,23,12,0,11,12
13511,2,12,4,0,8,4
864,10,33,12,0,21,12
864,9,30,8,0,22,8
864,8,101,20,0,81,20
864,7,184,50,0,134,50
864,6,281,74,0,207,74
864,5,153,43,0,110,43
864,4,81,34,0,47,34
864,3,32,10,0,22,10
864,2,13,9,0,4,9
864,1,10,6,0,4,6
244049,9,109,20,0,89,20
244049,8,381,46,0,335,46
244049,7,198,24,0,174,24
244049,6,145,27,0,118,27
244049,5,32,7,0,25,7
244049,4,13,8,0,5,8
244049,3,6,3,0,3,3
244049,2,6,1,0,5,1
22497,10,12,3,0,9,3
22497,9,23,2,0,21,2
22497,8,104,25,0,79,25
22497,7,234,54,0,180,54
22497,6,317,69,0,248,69
22497,5,136,27,0,109,27
22497,4,70,24,0,46,24
22497,3,17,3,0,14,3
22497,2,4,2,0,2,2
155255,10,80,26,0,54,26
155255,9,140,40,0,100,40
155255,8,360,68,0,292,68
155255,7,168,34,0,134,34
155255,6,99,25,0,74,25
155255,5,31,6,0,25,6
155255,4,22,9,0,13,9
155255,3,10,2,0,8,2
155255,2,3,2,0,1,2
149951,10,87,24,1,63,23
149951,9,158,38,0,120,38
149951,8,361,85,3,276,82
149951,7,165,32,0,133,32
149951,6,99,15,1,84,14
149951,5,26,13,0,13,13
149951,4,10,6,0,4,6
149951,3,7,5,0,2,5
149951,2,4,1,0,3,1
1431,10,13,6,0,7,6
1431,9,31,8,0,23,8
1431,8,156,55,0,101,55
1431,7,269,102,0,167,102
1431,6,269,83,0,186,83
1431,5,107,39,0,68,39
1431,4,39,14,0,25,14
1431,3,19,6,0,13,6
1431,2,9,5,0,4,5
1431,1,4,4,0,0,4
20542,10,159,36,0,123,36
20542,9,203,33,0,170,33
20542,8,311,69,0,242,69
20542,7,142,27,0,115,27
20542,6,46,16,0,30,16
20542,5,17,4,0,13,4
20542,4,7,3,0,4,3
20542,3,7,1,0,6,1
20542,2,6,2,0,4,2
20542,1,19,2,0,17,2
22237,10,11,3,0,8,3
22237,9,27,5,0,22,5
22237,8,160,41,0,119,41
22237,7,250,65,0,185,65
22237,6,301,77,0,224,77
22237,5,91,30,0,61,30
22237,4,50,19,0,31,19
22237,3,14,7,0,7,7
22237,2,9,2,0,7,2
22237,1,3,1,0,2,1
269385,10,278,43,0,235,43
269385,9,343,47,0,296,47
269385,8,247,24,0,223,24
269385,7,54,10,0,44,10
269385,6,38,8,0,30,8
269385,5,16,5,0,11,5
199966,10,36,7,0,29,7
199966,9,113,17,0,96,17
199966,8,408,42,0,366,42
199966,7,235,19,0,216,19
199966,6,87,10,0,77,10
199966,5,20,2,0,18,2
199966,4,13,4,0,9,4
199966,3,2,1,0,1,1
199966,2,1,1,0,0,1
29773,10,13,12,0,1,12
29773,9,32,13,0,19,13
29773,8,169,65,0,104,65
29773,7,272,78,0,194,78
29773,6,296,96,0,200,96
29773,5,82,25,0,57,25
29773,4,28,9,0,19,9
29773,3,16,9,0,7,9
29773,2,5,2,0,3,2
196202,10,77,17,2,60,15
196202,9,187,34,4,153,30
196202,8,385,62,4,323,58
196202,7,123,10,1,113,9
196202,6,90,8,1,82,7
196202,5,27,1,0,26,1
196202,4,8,1,0,7,1
196202,3,6,3,0,3,3
16,10,5,3,0,2,3
16,9,34,15,0,19,15
16,8,229,92,0,137,92
16,7,313,81,0,232,81
16,6,236,68,0,168,68
16,5,57,15,0,42,15
16,4,26,7,0,19,7
16,3,9,5,0,4,5
384,10,57,25,0,32,25
384,9,109,39,0,70,39
384,8,254,67,0,187,67
384,7,238,60,0,178,60
384,6,160,46,0,114,46
384,5,51,18,0,33,18
384,4,21,10,0,11,10
384,3,12,6,0,6,6
384,2,8,2,0,6,2
12350,10,61,28,0,33,28
12350,9,107,47,0,60,47
12350,8,251,90,2,161,88
12350,7,211,65,0,146,65
12350,6,151,51,0,100,51
12350,5,63,24,0,39,24
12350,4,41,14,0,27,14
12350,3,12,4,0,8,4
12350,2,10,4,0,6,4
12350,1,4,1,0,3,1
3128,10,2,1,0,1,1
3128,9,34,17,0,17,17
3128,8,178,72,0,106,72
3128,7,293,95,0,198,95
3128,6,262,93,0,169,93
3128,5,83,35,0,48,35
3128,4,46,20,0,26,20
3128,3,10,3,0,7,3
3128,2,2,1,0,1,1
150293,10,31,10,0,21,10
150293,9,96,27,0,69,27
150293,8,319,78,0,241,78
150293,7,239,44,0,195,44
150293,6,164,33,0,131,33
150293,5,34,8,0,26,8
150293,4,14,1,0,13,1
150293,3,10,3,0,7,3
150293,2,4,1,0,3,1
14017,10,6,1,0,5,1
14017,9,7,3,0,4,3
14017,8,61,27,0,34,27
14017,7,163,59,0,104,59
14017,6,359,121,0,238,121
14017,5,179,68,0,111,68
14017,4,88,42,0,46,42
14017,3,31,11,0,20,11
14017,2,9,1,0,8,1
14017,1,7,4,0,3,4
37141,10,83,24,0,59,24
37141,9,129,36,0,93,36
37141,8,298,62,0,236,62
37141,7,203,37,0,166,37
37141,6,120,20,0,100,20
37141,5,34,7,0,27,7
37141,4,20,2,0,18,2
37141,1,5,2,0,3,2
231665,10,12,2,0,10,2
231665,9,23,10,0,13,10
231665,8,164,21,0,143,21
231665,7,253,29,0,224,29
231665,6,272,42,0,230,42
231665,5,101,21,0,80,21
231665,4,53,13,0,40,13
231665,3,25,3,0,22,3
231665,2,7,2,0,5,2
56933,10,9,3,0,6,3
56933,9,24,5,0,19,5
56933,8,121,22,0,99,22
56933,7,253,51,0,202,51
56933,6,333,63,0,270,63
56933,5,113,17,0,96,17
56933,4,33,8,0,25,8
56933,3,18,5,0,13,5
176565,10,16,3,0,13,3
176565,9,28,9,1,19,8
176565,8,220,50,4,170,46
176565,7,303,42,0,261,42
176565,6,255,40,0,215,40
176565,5,53,8,0,45,8
176565,4,27,5,0,22,5
176565,1,3,1,0,2,1
147370,10,12,4,1,8,3
147370,9,28,8,0,20,8
147370,8,116,40,1,76,39
147370,7,164,39,1,125,38
147370,6,288,58,6,230,52
147370,5,177,40,2,137,38
147370,4,78,22,0,56,22
147370,3,30,14,2,16,12
147370,2,14,8,0,6,8
147370,1,2,1,0,1,1
65225,10,13,3,0,10,3
65225,9,34,9,0,25,9
65225,8,154,40,0,114,40
65225,7,251,62,0,189,62
65225,6,272,62,0,210,62
65225,5,92,27,0,65,27
65225,4,52,19,0,33,19
65225,3,24,10,0,14,10
65225,2,12,4,0,8,4
65225,1,3,1,0,2,1
3242,10,5,3,0,2,3
3242,9,18,6,0,12,6
3242,8,73,29,0,44,29
3242,7,186,74,0,112,74
3242,6,328,132,0,196,132
3242,5,157,53,0,104,53
3242,4,84,36,0,48,36
3242,3,34,17,0,17,17
3242,2,18,9,0,9,9
3242,1,4,1,0,3,1
9342,10,3,3,0,0,3
9342,9,9,7,0,2,7
9342,8,107,43,0,64,43
9342,7,215,68,0,147,68
9342,6,305,101,0,204,101
9342,5,147,62,0,85,62
9342,4,66,19,0,47,19
9342,3,38,11,0,27,11
9342,2,14,7,0,7,7
178210,10,28,2,0,26,2
178210,9,37,3,0,34,3
178210,8,146,19,0,127,19
178210,7,214,28,0,186,28
178210,6,281,29,0,252,29
178210,5,94,18,0,76,18
178210,4,53,5,0,48,5
178210,3,27,5,0,22,5
178210,2,23,10,0,13,10
220792,10,17,3,0,14,3
220792,9,95,16,0,79,16
220792,8,338,52,0,286,52
220792,7,239,37,0,202,37
220792,6,143,26,0,117,26
220792,5,43,11,0,32,11
220792,4,23,8,0,15,8
220792,3,4,1,0,3,1
220792,2,2,2,0,0,2
220792,1,3,1,0,2,1
48979,10,14,3,0,11,3
48979,9,21,6,0,15,6
48979,8,88,10,0,78,10
48979,7,164,17,0,147,17
48979,6,317,32,0,285,32
48979,5,148,17,0,131,17
48979,4,86,21,0,65,21
48979,3,30,6,0,24,6
48979,2,26,9,0,17,9
215613,10,40,10,0,30,10
215613,9,67,12,2,55,10
215613,8,263,39,7,224,32
215613,7,257,37,5,220,32
215613,6,184,24,2,160,22
215613,5,51,13,3,38,10
215613,4,25,10,2,15,8
215613,3,10,4,0,6,4
215613,2,4,2,0,2,2
36888,10,20,3,0,17,3
36888,9,47,14,0,33,14
36888,8,278,77,0,201,77
36888,7,234,63,0,171,63
36888,6,200,76,0,124,76
36888,5,66,30,0,36,30
36888,4,41,23,0,18,23
36888,3,11,5,0,6,5
36888,2,2,1,0,1,1
188866,10,88,13,0,75,13
188866,9,154,14,0,140,14
188866,8,355,31,2,324,29
188866,7,188,19,0,169,19
188866,6,86,11,1,75,10
188866,4,9,1,0,8,1
145633,10,40,11,0,29,11
145633,9,54,18,0,36,18
145633,8,266,47,0,219,47
145633,7,260,57,0,203,57
145633,6,205,47,0,158,47
145633,5,51,13,0,38,13
145633,4,15,4,0,11,4
145633,3,4,3,0,1,3
231280,10,7,2,0,5,2
231280,9,29,5,0,24,5
231280,8,173,31,0,142,31
231280,7,333,41,0,292,41
231280,6,269,35,0,234,35
231280,5,61,13,0,48,13
231280,4,23,2,0,21,2
28218,10,9,2,0,7,2
28218,9,13,5,0,8,5
28218,8,107,27,0,80,27
28218,7,252,59,0,193,59
28218,6,342,87,0,255,87
28218,5,112,35,0,77,35
28218,4,45,10,0,35,10
28218,3,11,3,0,8,3
28218,2,7,2,0,5,2
277,10,7,2,0,5,2
277,9,23,10,0,13,10
277,8,84,26,0,58,26
277,7,183,54,0,129,54
277,6,307,72,0,235,72
277,5,158,40,0,118,40
277,4,82,35,0,47,35
277,3,34,11,0,23,11
277,2,17,9,0,8,9
277,1,4,1,0,3,1
157917,10,100,13,0,87,13
157917,9,152,19,0,133,19
157917,8,309,30,1,279,29
157917,7,169,16,0,153,16
157917,6,113,13,0,100,13
157917,5,30,3,0,27,3
157917,4,17,5,0,12,5
157917,3,7,1,0,6,1
129320,10,9,1,0,8,1
129320,9,42,14,1,28,13
129320,8,204,45,2,159,43
129320,7,275,46,2,229,44
129320,6,241,60,3,181,57
129320,5,76,25,3,51,22
129320,4,33,9,0,24,9
129320,3,14,5,0,9,5
129320,2,3,1,0,2,1
129320,1,3,1,0,2,1
119781,10,22,6,0,16,6
119781,9,57,16,1,41,15
119781,8,301,75,1,226,74
119781,7,232,48,1,184,47
119781,6,211,46,1,165,45
119781,5,48,17,1,31,16
119781,4,19,3,0,16,3
119781,3,3,1,0,2,1
119781,2,2,1,0,1,1
9215,10,62,18,0,44,18
9215,9,118,39,0,79,39
9215,8,288,96,0,192,96
9215,7,203,50,0,153,50
9215,6,137,41,0,96,41
9215,5,43,20,0,23,20
9215,4,20,6,0,14,6
9215,3,15,8,0,7,8
9215,2,5,3,0,2,3
9215,1,6,2,0,4,2
18985,10,30,16,0,14,16
18985,9,93,38,1,55,37
18985,8,239,95,0,144,95
18985,7,210,81,0,129,81
18985,6,193,66,0,127,66
18985,5,78,32,0,46,32
18985,4,21,12,0,9,12
18985,3,16,9,1,7,8
18985,2,10,8,0,2,8
18985,1,6,1,0,5,1
2652,10,23,6,0,17,6
2652,9,63,23,0,40,23
2652,8,182,60,0,122,60
2652,7,207,61,0,146,61
2652,6,247,67,0,180,67
2652,5,105,29,0,76,29
2652,4,45,23,0,22,23
2652,3,18,4,0,14,4
4424,10,7,3,0,4,3
4424,9,27,9,0,18,9
4424,8,127,46,0,81,46
4424,7,223,81,0,142,81
4424,6,303,89,0,214,89
4424,5,111,29,0,82,29
4424,4,59,15,0,44,15
4424,3,26,6,0,20,6
4424,2,12,1,0,11,1
169416,10,81,11,0,70,11
169416,9,142,21,0,121,21
169416,8,295,50,0,245,50
169416,7,183,23,0,160,23
169416,6,122,18,0,104,18
169416,5,35,5,0,30,5
169416,4,11,1,0,10,1
169416,3,11,4,0,7,4
169416,2,9,2,0,7,2
169416,1,5,2,1,3,1
81640,10,39,7,0,32,7
81640,9,114,13,0,101,13
81640,8,362,55,0,307,55
81640,7,185,37,0,148,37
81640,6,127,28,0,99,28
81640,5,36,11,0,25,11
81640,4,19,5,1,14,4
81640,3,5,2,0,3,2
81640,1,5,1,0,4,1
1511,10,11,7,0,4,7
1511,9,12,3,0,9,3
1511,8,28,9,0,19,9
1511,7,63,17,0,46,17
1511,6,168,49,0,119,49
1511,5,203,64,0,139,64
1511,4,185,61,0,124,61
1511,3,131,60,0,71,60
1511,2,57,28,0,29,28
1511,1,35,21,0,14,21
198487,10,62,2,0,60,2
198487,9,106,4,0,102,4
198487,8,328,23,0,305,23
198487,7,248,13,0,235,13
198487,6,99,7,0,92,7
198487,5,30,5,0,25,5
198487,4,11,1,0,10,1
198487,3,4,1,0,3,1
198487,2,3,1,0,2,1
198487,1,3,1,0,2,1
54735,10,8,3,0,5,3
54735,9,12,3,0,9,3
54735,8,98,20,0,78,20
54735,7,236,48,0,188,48
54735,6,339,56,0,283,56
54735,5,117,17,0,100,17
54735,4,51,13,0,38,13
54735,3,22,4,0,18,4
54735,2,10,4,0,6,4
31056,10,19,7,0,12,7
31056,9,35,9,0,26,9
31056,8,181,60,0,121,60
31056,7,243,68,0,175,68
31056,6,274,61,0,213,61
31056,5,80,10,0,70,10
31056,4,37,8,0,29,8
31056,3,13,2,0,11,2
31056,2,8,1,0,7,1
160968,10,8,1,0,7,1
160968,9,42,10,0,32,10
160968,8,234,52,0,182,52
160968,7,232,46,0,186,46
160968,6,231,43,0,188,43
160968,5,85,21,0,64,21
160968,4,28,4,0,24,4
160968,3,19,3,0,16,3
160968,2,10,3,0,7,3
160968,1,1,1,0,0,1
231664,10,11,1,0,10,1
231664,9,18,5,0,13,5
231664,8,131,17,0,114,17
231664,7,227,27,0,200,27
231664,6,291,44,0,247,44
231664,5,114,29,0,85,29
231664,4,49,14,0,35,14
231664,3,27,9,0,18,9
231664,2,21,10,0,11,10
231664,1,3,3,0,0,3
404,9,11,5,0,6,5
404,8,59,19,0,40,19
404,7,168,56,0,112,56
404,6,365,85,0,280,85
404,5,173,33,0,140,33
404,4,80,19,0,61,19
404,3,21,4,0,17,4
404,2,8,2,0,6,2
153623,10,14,4,0,10,4
153623,9,42,12,0,30,12
153623,8,234,53,0,181,53
153623,7,314,69,0,245,69
153623,6,198,41,0,157,41
153623,5,60,6,0,54,6
153623,4,17,6,0,11,6
153623,3,7,3,0,4,3
153623,2,3,1,0,2,1
2838,10,23,8,0,15,8
2838,9,24,5,0,19,5
2838,8,95,31,0,64,31
2838,7,148,32,0,116,32
2838,6,278,71,0,207,71
2838,5,173,30,0,143,30
2838,4,82,17,0,65,17
2838,3,35,16,0,19,16
2838,2,25,5,0,20,5
2838,1,6,2,0,4,2
3967,10,40,11,0,29,11
3967,9,69,16,0,53,16
3967,8,235,60,0,175,60
3967,7,253,55,0,198,55
3967,6,177,51,0,126,51
3967,5,59,17,0,42,17
3967,4,34,10,0,24,10
3967,3,10,5,0,5,5
3967,2,7,3,0,4,3
3967,1,5,1,0,4,1
59149,10,9,2,0,7,2
59149,9,27,5,0,22,5
59149,8,130,40,0,90,40
59149,7,197,54,0,143,54
59149,6,298,75,0,223,75
59149,5,102,26,0,76,26
59149,4,70,20,0,50,20
59149,3,30,5,0,25,5
59149,2,22,5,0,17,5
59149,1,4,1,0,3,1
55601,10,7,1,0,6,1
55601,9,12,2,0,10,2
55601,8,146,32,0,114,32
55601,7,246,59,0,187,59
55601,6,305,66,0,239,66
55601,5,92,17,0,75,17
55601,4,43,9,0,34,9
55601,3,21,6,0,15,6
55601,2,12,5,0,7,5
55601,1,4,1,0,3,1
3312,10,23,9,0,14,9
3312,9,35,19,0,16,19
3312,8,115,46,0,69,46
3312,7,252,84,0,168,84
3312,6,289,99,0,190,99
3312,5,117,29,0,88,29
3312,4,30,7,0,23,7
3312,3,21,6,0,15,6
3312,2,4,2,0,2,2
5588,9,3,1,0,2,1
5588,8,14,5,0,9,5
5588,7,46,16,0,30,16
5588,6,124,36,0,88,36
5588,5,196,48,0,148,48
5588,4,238,64,0,174,64
5588,3,143,41,0,102,41
5588,2,88,16,0,72,16
5588,1,33,8,0,25,8
2259,10,20,11,0,9,11
2259,9,32,17,0,15,17
2259,8,94,36,0,58,36
2259,7,199,83,0,116,83
2259,6,286,88,0,198,88
2259,5,156,59,0,97,59
2259,4,59,22,0,37,22
2259,3,19,13,0,6,13
2259,2,16,6,0,10,6
2259,1,3,1,0,2,1
8273,10,7,2,0,5,2
8273,9,14,8,0,6,8
8273,8,90,34,0,56,34
8273,7,244,72,0,172,72
8273,6,327,99,0,228,99
8273,5,117,32,0,85,32
8273,4,54,26,0,28,26
8273,3,19,7,0,12,7
8273,2,9,6,0,3,6
8273,1,3,1,0,2,1
3818,10,22,8,0,14,8
3818,9,29,7,0,22,7
3818,8,74,14,0,60,14
3818,7,153,19,0,134,19
3818,6,254,36,0,218,36
3818,5,163,29,0,134,29
3818,4,115,20,0,95,20
3818,3,48,5,0,43,5
3818,2,21,7,0,14,7
3818,1,5,3,0,2,3
150146,10,11,6,0,5,6
150146,9,37,8,0,29,8
150146,8,175,49,0,126,49
150146,7,260,55,0,205,55
150146,6,243,50,0,193,50
150146,5,91,26,0,65,26
150146,4,40,14,0,26,14
150146,3,12,4,0,8,4
150146,2,9,4,0,5,4
2578,10,8,1,0,7,1
2578,8,38,6,0,32,6
2578,7,109,21,0,88,21
2578,6,267,60,0,207,60
2578,5,221,45,0,176,45
2578,4,132,35,0,97,35
2578,3,56,16,0,40,16
2578,2,36,13,0,23,13
2578,1,12,5,0,7,5
120605,10,20,4,0,16,4
120605,9,30,7,0,23,7
120605,8,231,38,0,193,38
120605,7,250,32,0,218,32
120605,6,230,47,0,183,47
120605,5,71,15,0,56,15
120605,4,31,11,0,20,11
120605,3,8,2,0,6,2
120605,2,8,2,0,6,2
5457,10,10,2,0,8,2
5457,9,12,4,0,8,4
5457,8,55,12,0,43,12
5457,7,105,30,0,75,30
5457,6,237,67,0,170,67
5457,5,189,59,0,130,59
5457,4,136,47,0,89,47
5457,3,78,31,0,47,31
5457,2,39,24,0,15,24
5457,1,20,15,0,5,15
155463,10,53,7,0,46,7
155463,9,105,13,0,92,13
155463,8,251,32,0,219,32
155463,7,225,28,0,197,28
155463,6,163,19,0,144,19
155463,5,45,7,0,38,7
155463,4,25,9,0,16,9
155463,3,6,2,0,4,2
155463,2,6,2,0,4,2
155463,1,3,1,0,2,1
181960,10,15,3,0,12,3
181960,9,23,7,0,16,7
181960,8,194,26,0,168,26
181960,7,304,41,0,263,41
181960,6,250,37,0,213,37
181960,5,60,9,0,51,9
181960,4,25,2,0,23,2
181960,3,8,2,0,6,2
6541,10,23,1,0,22,1
6541,9,41,11,0,30,11
6541,8,150,19,0,131,19
6541,7,227,48,0,179,48
6541,6,293,48,0,245,48
6541,5,75,16,0,59,16
6541,4,44,8,0,36,8
6541,3,18,5,0,13,5
6541,2,7,4,0,3,4
6541,1,3,1,0,2,1
122891,10,11,3,0,8,3
122891,9,31,3,0,28,3
122891,8,198,35,0,163,35
122891,7,296,53,0,243,53
122891,6,213,46,0,167,46
122891,5,68,20,0,48,20
122891,4,40,11,0,29,11
122891,3,16,4,0,12,4
122891,1,5,2,0,3,2
6932,10,4,3,0,1,3
6932,9,3,2,0,1,2
6932,8,8,6,0,2,6
6932,7,22,4,0,18,4
6932,6,52,20,0,32,20
6932,5,131,52,0,79,52
6932,4,244,79,0,165,79
6932,3,186,61,0,125,61
6932,2,144,49,0,95,49
6932,1,86,31,0,55,31
1017,10,20,8,0,12,8
1017,9,50,23,0,27,23
1017,8,197,87,0,110,87
1017,7,253,100,0,153,100
1017,6,207,69,0,138,69
1017,5,79,29,0,50,29
1017,4,42,23,0,19,23
1017,3,19,8,0,11,8
1017,2,10,6,0,4,6
108722,10,55,10,0,45,10
108722,9,66,17,0,49,17
108722,8,224,35,0,189,35
108722,7,216,32,0,184,32
108722,6,196,30,0,166,30
108722,5,59,15,0,44,15
108722,4,30,7,0,23,7
108722,3,18,3,0,15,3
108722,2,6,1,0,5,1
108722,1,9,5,0,4,5
6539,10,6,2,0,4,2
6539,9,24,11,0,13,11
6539,8,154,61,0,93,61
6539,7,285,88,0,197,88
6539,6,263,107,0,156,107
6539,5,82,36,0,46,36
6539,4,41,22,0,19,22
6539,3,15,7,0,8,7
6539,2,5,1,0,4,1
200057,10,23,4,0,19,4
200057,9,80,6,0,74,6
200057,8,351,46,0,305,46
200057,7,256,48,1,208,47
200057,6,120,22,0,98,22
200057,5,33,10,0,23,10
200057,4,11,4,0,7,4
99392,10,68,15,0,53,15
99392,9,93,22,0,71,22
99392,8,255,72,2,183,70
99392,7,210,48,1,162,47
99392,6,157,44,0,113,44
99392,5,50,21,0,29,21
99392,4,22,6,0,16,6
99392,3,15,7,0,8,7
99392,2,5,2,0,3,2
35369,10,11,3,0,8,3
35369,9,30,5,0,25,5
35369,8,125,24,0,101,24
35369,7,198,30,0,168,30
35369,6,303,53,0,250,53
35369,5,111,23,0,88,23
35369,4,41,9,0,32,9
35369,3,28,6,0,22,6
35369,2,17,6,0,11,6
35369,1,13,6,0,7,6
168215,9,15,4,0,11,4
168215,8,105,6,0,99,6
168215,7,223,17,0,206,17
168215,6,316,27,0,289,27
168215,5,101,14,0,87,14
168215,4,51,6,0,45,6
168215,3,32,5,0,27,5
168215,2,20,3,0,17,3
168215,1,6,1,0,5,1
46007,10,18,7,0,11,7
46007,9,60,18,0,42,18
46007,8,256,80,0,176,80
46007,7,254,74,0,180,74
46007,6,180,54,0,126,54
46007,5,58,17,0,41,17
46007,4,31,12,0,19,12
46007,3,12,2,0,10,2
46007,2,6,2,0,4,2
46007,1,2,1,0,1,1
157026,10,70,16,0,54,16
157026,9,125,20,0,105,20
157026,8,321,56,0,265,56
157026,7,205,36,0,169,36
157026,6,107,12,0,95,12
157026,5,23,6,0,17,6
157026,4,18,4,0,14,4
157026,3,6,1,0,5,1
159504,10,162,36,1,126,35
159504,9,234,41,3,193,38
159504,8,245,35,3,210,32
159504,7,107,13,0,94,13
159504,6,60,11,4,49,7
159504,5,32,10,0,22,10
159504,4,18,10,2,8,8
159504,3,8,3,0,5,3
159504,2,4,3,1,1,2
159504,1,7,3,2,4,1
109291,10,63,10,1,53,9
109291,9,133,24,1,109,23
109291,8,302,62,3,240,59
109291,7,197,35,1,162,34
109291,6,125,22,0,103,22
109291,5,31,4,0,27,4
109291,4,10,2,0,8,2
109291,3,9,3,0,6,3
109291,2,2,1,0,1,1
109291,1,4,1,0,3,1
1986,10,9,4,0,5,4
1986,9,13,5,0,8,5
1986,8,68,18,0,50,18
1986,7,130,33,0,97,33
1986,6,286,63,0,223,63
1986,5,198,37,0,161,37
1986,4,101,33,0,68,33
1986,3,50,19,0,31,19
1986,2,14,3,0,11,3
1986,1,6,1,0,5,1
241831,10,16,2,0,14,2
241831,9,40,4,0,36,4
241831,8,226,29,0,197,29
241831,7,295,32,0,263,32
241831,6,210,42,0,168,42
241831,5,58,11,0,47,11
241831,4,23,6,0,17,6
241831,3,14,5,0,9,5
241831,1,5,2,0,3,2
22877,10,110,47,0,63,47
22877,9,231,73,0,158,73
22877,8,239,78,0,161,78
22877,7,131,47,0,84,47
22877,6,80,31,0,49,31
22877,5,29,8,0,21,8
22877,4,26,12,0,14,12
22877,3,14,8,0,6,8
22877,2,7,6,0,1,6
22877,1,8,3,0,5,3
195503,10,25,3,0,22,3
195503,9,91,16,0,75,16
195503,8,350,58,2,292,56
195503,7,218,35,0,183,35
195503,6,138,28,0,110,28
195503,5,33,8,0,25,8
195503,4,13,1,0,12,1
195503,3,3,1,0,2,1
195503,2,3,1,0,2,1
25823,10,9,2,0,7,2
25823,9,18,7,0,11,7
25823,8,123,32,0,91,32
25823,7,284,77,0,207,77
25823,6,310,66,0,244,66
25823,5,81,22,0,59,22
25823,4,32,15,0,17,15
25823,3,8,2,0,6,2
25823,2,8,2,0,6,2
21704,9,10,2,0,8,2
21704,8,89,28,0,61,28
21704,7,160,37,0,123,37
21704,6,317,97,0,220,97
21704,5,154,50,0,104,50
21704,4,85,36,0,49,36
21704,3,36,18,0,18,18
21704,2,13,6,0,7,6
21704,1,5,2,0,3,2
244271,10,182,40,1,142,39
244271,9,217,29,4,188,25
244271,8,310,38,1,272,37
244271,7,96,17,1,79,16
244271,6,38,11,0,27,11
244271,5,18,7,1,11,6
244271,4,9,6,1,3,5
244271,3,4,2,0,2,2
3318,10,5,2,0,3,2
3318,9,18,2,0,16,2
3318,8,113,41,0,72,41
3318,7,223,70,0,153,70
3318,6,310,96,0,214,96
3318,5,130,47,0,83,47
3318,4,51,22,0,29,22
3318,3,15,8,0,7,8
3318,2,7,3,0,4,3
3318,1,1,1,0,0,1
8059,10,13,7,0,6,7
8059,9,37,12,0,25,12
8059,8,115,30,0,85,30
8059,7,201,51,0,150,51
8059,6,251,60,0,191,60
8059,5,127,38,0,89,38
8059,4,74,29,0,45,29
8059,3,40,15,0,25,15
8059,2,10,5,0,5,5
8059,1,4,2,0,2,2
37589,10,28,2,0,26,2
37589,9,18,2,0,16,2
37589,8,82,14,0,68,14
37589,7,169,38,0,131,38
37589,6,325,63,0,262,63
37589,5,136,26,0,110,26
37589,4,70,12,0,58,12
37589,3,28,6,0,22,6
37589,2,10,2,0,8,2
37589,1,5,2,0,3,2
2228,10,37,16,0,21,16
2228,9,47,16,0,31,16
2228,8,164,52,0,112,52
2228,7,222,48,0,174,48
2228,6,224,57,0,167,57
2228,5,99,30,0,69,30
2228,4,41,15,0,26,15
2228,3,30,17,0,13,17
2228,2,7,3,0,4,3
2228,1,1,1,0,0,1
22889,10,2,1,0,1,1
22889,9,6,3,0,3,3
22889,8,41,3,0,38,3
22889,7,112,25,0,87,25
22889,6,294,59,0,235,59
22889,5,233,49,0,184,49
22889,4,116,24,0,92,24
22889,3,33,13,0,20,13
22889,2,28,7,0,21,7
22889,1,7,4,0,3,4
218920,9,43,5,0,38,5
218920,8,274,40,0,234,40
218920,7,297,46,0,251,46
218920,6,194,34,0,160,34
218920,5,42,10,0,32,10
218920,4,7,4,0,3,4
218920,3,6,2,0,4,2
218920,2,2,1,0,1,1
122240,10,75,9,0,66,9
122240,9,135,18,0,117,18
122240,8,289,45,0,244,45
122240,7,209,33,0,176,33
122240,6,119,20,0,99,20
122240,5,29,4,0,25,4
122240,3,5,1,0,4,1
122240,2,2,1,0,1,1
230498,9,18,3,0,15,3
230498,8,141,21,0,120,21
230498,7,274,17,0,257,17
230498,6,261,27,0,234,27
230498,5,89,13,0,76,13
230498,4,41,9,0,32,9
230498,3,29,5,0,24,5
230498,2,11,3,0,8,3
230498,1,1,1,0,0,1
424,10,60,16,0,44,16
424,9,130,32,0,98,32
424,8,303,91,0,212,91
424,7,196,43,0,153,43
424,6,103,41,0,62,41
424,5,34,13,0,21,13
424,4,16,6,0,10,6
424,3,16,7,0,9,7
424,2,7,2,0,5,2
424,1,5,3,0,2,3
189,10,18,4,0,14,4
189,9,44,9,0,35,9
189,8,250,71,0,179,71
189,7,281,60,0,221,60
189,6,193,49,0,144,49
189,5,50,9,0,41,9
189,4,21,5,0,16,5
189,3,3,1,0,2,1
1950,10,12,3,0,9,3
1950,9,14,2,0,12,2
1950,8,62,16,0,46,16
1950,7,128,27,0,101,27
1950,6,311,51,0,260,51
1950,5,185,48,0,137,48
1950,4,94,22,0,72,22
1950,3,47,8,0,39,8
1950,2,12,2,0,10,2
3208,10,9,4,0,5,4
3208,9,10,6,0,4,6
3208,8,103,48,0,55,48
3208,7,244,90,0,154,90
3208,6,325,106,0,219,106
3208,5,119,40,0,79,40
3208,4,46,13,0,33,13
3208,3,9,5,0,4,5
3208,1,2,1,0,1,1
171672,10,4,1,0,3,1
171672,9,18,4,0,14,4
171672,8,101,13,0,88,13
171672,7,189,22,0,167,22
171672,6,354,58,0,296,58
171672,5,105,9,0,96,9
171672,4,56,8,0,48,8
171672,3,21,4,0,17,4
171672,2,15,5,0,10,5
171672,1,4,2,0,2,2
136587,10,10,1,0,9,1
136587,9,7,1,0,6,1
136587,8,93,25,3,68,22
136587,7,191,25,0,166,25
136587,6,308,43,1,265,42
136587,5,152,22,0,130,22
136587,4,69,14,0,55,14
136587,3,23,3,0,20,3
136587,2,11,3,0,8,3
136587,1,3,1,0,2,1
180231,9,21,5,0,16,5
180231,8,164,33,0,131,33
180231,7,283,52,0,231,52
180231,6,270,46,0,224,46
180231,5,69,10,0,59,10
180231,4,37,9,0,28,9
180231,3,11,2,0,9,2
118410,10,7,2,0,5,2
118410,9,24,5,0,19,5
118410,8,85,13,0,72,13
118410,7,195,30,0,165,30
118410,6,302,36,0,266,36
118410,5,137,18,0,119,18
118410,4,80,20,0,60,20
118410,3,26,3,0,23,3
118410,2,8,3,0,5,3
192927,10,22,3,0,19,3
192927,9,36,4,0,32,4
192927,8,165,29,0,136,29
192927,7,225,31,0,194,31
192927,6,243,27,0,216,27
192927,5,90,12,0,78,12
192927,4,48,6,0,42,6
192927,3,22,4,0,18,4
192927,2,10,3,0,7,3
192927,1,7,2,0,5,2
224783,10,97,24,3,73,21
224783,9,190,33,2,157,31
224783,8,326,54,4,272,50
224783,7,114,17,2,97,15
224783,6,100,22,1,78,21
224783,5,24,5,0,19,5
224783,4,10,5,1,5,4
224783,3,6,1,0,5,1
224783,2,2,2,0,0,2
224783,1,3,1,0,2,1
97803,10,18,6,0,12,6
97803,9,40,6,0,34,6
97803,8,151,29,0,122,29
97803,7,220,44,0,176,44
97803,6,260,49,0,211,49
97803,5,101,25,0,76,25
97803,4,45,13,0,32,13
97803,3,20,7,0,13,7
97803,2,6,4,0,2,4
97803,1,4,2,0,2,2
4583,10,60,18,0,42,18
4583,9,66,16,0,50,16
4583,8,190,56,0,134,56
4583,7,186,43,0,143,43
4583,6,204,51,0,153,51
4583,5,81,23,0,58,23
4583,4,39,12,0,27,12
4583,3,24,9,0,15,9
4583,2,10,7,0,3,7
68228,10,8,2,0,6,2
68228,9,38,6,0,32,6
68228,8,178,50,0,128,50
68228,7,292,67,0,225,67
68228,6,245,69,0,176,69
68228,5,60,27,0,33,27
68228,4,32,12,0,20,12
68228,3,9,5,0,4,5
68228,2,1,1,0,0,1
92120,10,10,4,0,6,4
92120,9,33,10,0,23,10
92120,8,205,47,0,158,47
92120,7,227,45,1,182,44
92120,6,223,66,0,157,66
92120,5,94,18,0,76,18
92120,4,42,16,0,26,16
92120,3,18,7,0,11,7
92120,2,11,7,0,4,7
92120,1,2,1,0,1,1
174614,10,29,12,2,17,10
174614,9,46,8,2,38,6
174614,8,193,34,8,159,26
174614,7,242,43,7,199,36
174614,6,246,57,7,189,50
174614,5,74,13,0,61,13
174614,4,25,5,0,20,5
174614,3,8,3,0,5,3
174614,1,1,1,1,0,0
15839,10,45,28,0,17,28
15839,9,113,57,0,56,57
15839,8,309,156,0,153,156
15839,7,212,91,0,121,91
15839,6,100,50,0,50,50
15839,5,46,29,0,17,29
15839,4,22,13,0,9,13
15839,3,8,3,0,5,3
15839,2,6,1,0,5,1
15839,1,2,1,0,1,1
3230,10,7,4,0,3,4
3230,9,11,3,0,8,3
3230,8,141,44,0,97,44
3230,7,280,64,0,216,64
3230,6,279,70,0,209,70
3230,5,93,19,0,74,19
3230,4,38,14,0,24,14
3230,3,12,3,0,9,3
3230,2,2,1,0,1,1
1549,10,22,5,0,17,5
1549,9,36,9,0,27,9
1549,8,91,33,0,58,33
1549,7,186,60,0,126,60
1549,6,261,78,0,183,78
1549,5,134,24,0,110,24
1549,4,91,23,0,68,23
1549,3,20,7,0,13,7
1549,2,6,1,0,5,1
189067,10,39,8,2,31,6
189067,9,51,8,1,43,7
189067,8,270,62,12,208,50
189067,7,225,33,6,192,27
189067,6,168,28,4,140,24
189067,5,52,10,1,42,9
189067,4,33,13,1,20,12
189067,3,14,5,1,9,4
189067,2,6,4,0,2,4
189067,1,3,1,0,2,1
241451,10,194,52,2,142,50
241451,9,295,57,3,238,54
241451,8,249,47,2,202,45
241451,7,71,13,0,58,13
241451,6,38,7,0,31,7
241451,5,8,2,0,6,2
241451,4,6,3,0,3,3
241451,3,1,1,0,0,1
241451,2,1,1,0,0,1
241451,1,6,3,0,3,3
31449,9,3,1,0,2,1
31449,8,90,30,0,60,30
31449,7,194,50,0,144,50
31449,6,319,89,0,230,89
31449,5,146,50,0,96,50
31449,4,63,27,0,36,27
31449,3,29,17,0,12,17
31449,2,12,3,0,9,3
31449,1,2,1,0,1,1
96792,10,20,10,0,10,10
96792,9,42,10,0,32,10
96792,8,235,59,4,176,55
96792,7,244,56,2,188,54
96792,6,227,59,2,168,57
96792,5,64,26,0,38,26
96792,4,18,8,0,10,8
96792,3,6,1,0,5,1
230253,10,100,19,1,81,18
230253,9,206,26,4,180,22
230253,8,371,57,4,314,53
230253,7,126,14,3,112,11
230253,6,46,7,2,39,5
230253,5,10,2,0,8,2
230253,4,5,1,0,4,1
230253,2,2,1,0,1,1
11945,10,30,7,0,23,7
11945,9,60,8,0,52,8
11945,8,214,30,0,184,30
11945,7,267,42,0,225,42
11945,6,164,26,0,138,26
11945,5,55,15,0,40,15
11945,4,44,10,0,34,10
11945,3,10,3,0,7,3
11945,2,8,1,0,7,1
11945,1,7,3,0,4,3
27165,10,5,3,0,2,3
27165,9,17,5,0,12,5
27165,8,103,24,0,79,24
27165,7,268,70,0,198,70
27165,6,317,90,0,227,90
27165,5,93,28,0,65,28
27165,4,40,17,0,23,17
27165,3,9,4,0,5,4
27165,2,4,1,0,3,1
27165,1,2,1,0,1,1
33150,9,25,1,0,24,1
33150,8,114,20,0,94,20
33150,7,179,35,0,144,35
33150,6,283,41,0,242,41
33150,5,143,26,0,117,26
33150,4,68,15,0,53,15
33150,3,18,4,0,14,4
33150,2,14,4,0,10,4
33150,1,2,1,0,1,1
36708,10,28,7,0,21,7
36708,9,56,14,0,42,14
36708,8,257,59,0,198,59
36708,7,232,55,0,177,55
36708,6,185,39,0,146,39
36708,5,55,19,0,36,19
36708,4,27,11,0,16,11
36708,3,9,4,0,5,4
171726,10,87,34,8,53,26
171726,9,166,35,5,131,30
171726,8,312,66,6,246,60
171726,7,140,19,3,121,16
171726,6,94,21,1,73,20
171726,5,23,5,0,18,5
171726,4,16,3,0,13,3
171726,3,4,1,0,3,1
171726,2,8,2,0,6,2
171726,1,8,4,2,4,2
2322,10,8,3,0,5,3
2322,9,11,3,0,8,3
2322,8,46,9,0,37,9
2322,7,96,19,0,77,19
2322,6,294,49,0,245,49
2322,5,175,33,0,142,33
2322,4,128,29,0,99,29
2322,3,56,12,0,44,12
2322,2,36,11,0,25,11
2322,1,6,2,0,4,2
255692,10,66,10,0,56,10
255692,9,150,29,0,121,29
255692,8,376,69,0,307,69
255692,7,176,37,0,139,37
255692,6,74,14,0,60,14
255692,5,21,7,0,14,7
255692,4,2,1,0,1,1
255692,3,3,1,0,2,1
28829,10,22,6,0,16,6
28829,9,54,17,0,37,17
28829,8,245,66,0,179,66
28829,7,259,62,0,197,62
28829,6,177,48,0,129,48
28829,5,59,17,0,42,17
28829,4,28,10,0,18,10
28829,3,7,3,0,4,3
28829,2,2,1,0,1,1
1245,9,4,1,0,3,1
1245,8,57,12,0,45,12
1245,7,161,30,0,131,30
1245,6,342,53,0,289,53
1245,5,174,26,0,148,26
1245,4,78,18,0,60,18
1245,3,23,6,0,17,6
1245,2,13,3,0,10,3
1245,1,1,1,0,0,1
26884,10,8,5,0,3,5
26884,9,11,5,0,6,5
26884,8,75,32,0,43,32
26884,7,136,51,0,85,51
26884,6,297,94,0,203,94
26884,5,173,64,0,109,64
26884,4,84,34,0,50,34
26884,3,41,18,0,23,18
26884,2,24,13,0,11,13
26884,1,6,3,0,3,3
166158,9,36,6,0,30,6
166158,8,159,15,0,144,15
166158,7,257,32,0,225,32
166158,6,251,26,0,225,26
166158,5,82,14,0,68,14
166158,4,35,5,0,30,5
166158,3,13,4,0,9,4
166158,2,9,2,0,7,2
41749,10,25,9,0,16,9
41749,9,88,27,0,61,27
41749,8,357,98,0,259,98
41749,7,229,51,0,178,51
41749,6,125,30,0,95,30
41749,5,12,4,0,8,4
41749,4,13,6,0,7,6
41749,3,4,1,0,3,1
109764,10,7,1,0,6,1
109764,8,113,20,0,93,20
109764,7,206,43,0,163,43
109764,6,310,62,0,248,62
109764,5,107,27,0,80,27
109764,4,63,20,0,43,20
109764,3,31,9,0,22,9
109764,2,11,5,0,6,5
172971,10,16,3,0,13,3
172971,9,35,8,0,27,8
172971,8,176,41,0,135,41
172971,7,242,38,0,204,38
172971,6,257,33,0,224,33
172971,5,60,10,0,50,10
172971,4,38,4,0,34,4
172971,3,19,1,0,18,1
172971,2,10,3,0,7,3
18243,10,17,7,0,10,7
18243,9,26,13,0,13,13
18243,8,152,55,0,97,55
18243,7,238,80,0,158,80
18243,6,228,97,0,131,97
18243,5,84,32,0,52,32
18243,4,59,32,0,27,32
18243,3,32,17,0,15,17
18243,2,16,9,0,7,9
18243,1,2,1,0,1,1
238638,10,24,5,0,19,5
238638,9,125,15,0,110,15
238638,8,368,56,0,312,56
238638,7,178,21,0,157,21
238638,6,113,24,0,89,24
238638,5,29,10,0,19,10
238638,4,13,3,0,10,3
238638,3,4,1,0,3,1
238638,2,1,1,0,0,1
238638,1,1,1,0,0,1
191982,10,8,1,0,7,1
191982,9,15,1,0,14,1
191982,8,117,20,0,97,20
191982,7,222,34,0,188,34
191982,6,287,46,0,241,46
191982,5,111,19,0,92,19
191982,4,49,9,0,40,9
191982,3,30,4,0,26,4
191982,2,12,3,0,9,3
191982,1,3,1,0,2,1
38318,10,57,13,0,44,13
38318,9,44,10,0,34,10
38318,8,131,42,0,89,42
38318,7,154,39,0,115,39
38318,6,225,52,0,173,52
38318,5,138,38,0,100,38
38318,4,46,14,1,32,13
38318,3,22,9,0,13,9
38318,2,14,6,0,8,6
38318,1,22,11,0,11,11
144325,10,37,5,0,32,5
144325,9,45,3,0,42,3
144325,8,144,12,0,132,12
144325,7,195,11,0,184,11
144325,6,231,28,0,203,28
144325,5,107,15,0,92,15
144325,4,61,14,0,47,14
144325,3,19,5,0,14,5
144325,2,10,2,0,8,2
144325,1,4,1,0,3,1
122588,10,49,6,0,43,6
122588,9,79,15,0,64,15
122588,8,283,43,0,240,43
122588,7,226,21,0,205,21
122588,6,150,28,0,122,28
122588,5,40,10,0,30,10
122588,4,20,6,0,14,6
11618,10,1,1,0,0,1
11618,9,12,5,0,7,5
11618,8,23,4,0,19,4
11618,7,87,23,0,64,23
11618,6,281,84,0,197,84
11618,5,248,78,0,170,78
11618,4,120,36,0,84,36
11618,3,59,23,0,36,23
11618,2,19,4,0,15,4
11618,1,3,1,0,2,1
98918,10,47,16,0,31,16
98918,9,105,25,0,80,25
98918,8,288,51,0,237,51
98918,7,207,35,4,172,31
98918,6,101,28,0,73,28
98918,5,34,4,0,30,4
98918,4,40,17,0,23,17
98918,3,11,4,0,7,4
98918,2,15,7,0,8,7
102,10,4,2,0,2,2
102,9,12,6,0,6,6
102,8,115,37,0,78,37
102,7,232,69,0,163,69
102,6,288,87,0,201,87
102,5,110,36,0,74,36
102,4,56,21,0,35,21
102,3,23,9,0,14,9
102,2,8,4,0,4,4
102,1,3,2,0,1,2
22347,10,8,4,0,4,4
22347,9,21,6,0,15,6
22347,8,117,42,0,75,42
22347,7,254,81,0,173,81
22347,6,294,97,0,197,97
22347,5,102,40,0,62,40
22347,4,38,14,0,24,14
22347,3,8,1,0,7,1
22347,2,4,1,0,3,1
22347,1,4,1,0,3,1
205125,10,19,4,0,15,4
205125,9,50,7,0,43,7
205125,8,221,59,0,162,59
205125,7,300,59,0,241,59
205125,6,194,28,0,166,28
205125,5,43,11,0,32,11
205125,4,16,2,0,14,2
205125,3,5,1,0,4,1
205125,2,2,1,0,1,1
37208,10,18,10,0,8,10
37208,9,32,14,0,18,14
37208,8,174,82,0,92,82
37208,7,224,79,0,145,79
37208,6,249,94,0,155,94
37208,5,85,30,0,55,30
37208,4,46,24,0,22,24
37208,3,13,6,0,7,6
37208,2,5,1,0,4,1
37208,1,2,1,0,1,1
146,9,17,4,0,13,4
146,8,80,35,0,45,35
146,7,219,76,0,143,76
146,6,322,105,0,217,105
146,5,135,52,0,83,52
146,4,56,23,0,33,23
146,3,8,3,0,5,3
146,2,6,3,0,3,3
146,1,2,1,0,1,1
31745,10,4,1,0,3,1
31745,8,118,33,0,85,33
31745,7,261,71,0,190,71
31745,6,275,57,0,218,57
31745,5,94,29,0,65,29
31745,4,57,27,0,30,27
31745,3,15,5,0,10,5
31745,2,5,1,0,4,1
31745,1,2,1,0,1,1
56786,10,15,3,0,12,3
56786,9,37,6,0,31,6
56786,8,176,27,0,149,27
56786,7,283,42,0,241,42
56786,6,229,25,0,204,25
56786,5,63,8,0,55,8
56786,4,28,6,0,22,6
56786,3,10,1,0,9,1
56786,2,4,1,0,3,1
9825,10,18,3,0,15,3
9825,9,40,7,0,33,7
9825,8,137,35,0,102,35
9825,7,256,33,0,223,33
9825,6,267,51,0,216,51
9825,5,68,14,0,54,14
9825,4,33,8,0,25,8
9825,3,17,7,0,10,7
9825,2,8,2,0,6,2
154880,10,18,2,0,16,2
154880,9,31,4,0,27,4
154880,8,135,10,0,125,10
154880,7,197,14,0,183,14
154880,6,280,19,0,261,19
154880,5,88,8,0,80,8
154880,4,44,9,0,35,9
154880,3,29,5,0,24,5
154880,2,15,3,0,12,3
154880,1,7,2,0,5,2
42111,10,4,1,0,3,1
42111,9,12,7,0,5,7
42111,8,81,29,0,52,29
42111,7,252,70,0,182,70
42111,6,316,88,0,228,88
42111,5,120,33,0,87,33
42111,4,31,10,0,21,10
42111,3,19,5,0,14,5
42111,2,5,2,0,3,2
41186,10,13,3,0,10,3
41186,9,13,2,0,11,2
41186,8,84,15,0,69,15
41186,7,123,22,0,101,22
41186,6,260,46,0,214,46
41186,5,155,24,0,131,24
41186,4,100,18,0,82,18
41186,3,54,8,0,46,8
41186,2,24,7,0,17,7
41186,1,15,4,0,11,4
1150,10,11,5,0,6,5
1150,9,11,2,0,9,2
1150,8,55,19,0,36,19
1150,7,144,53,0,91,53
1150,6,261,80,0,181,80
1150,5,198,56,0,142,56
1150,4,89,24,0,65,24
1150,3,46,17,0,29,17
1150,2,20,8,0,12,8
1150,1,5,2,0,3,2
154905,10,4,1,0,3,1
154905,9,13,2,0,11,2
154905,8,106,28,1,78,27
154905,7,257,41,0,216,41
154905,6,324,57,0,267,57
154905,5,91,19,2,72,17
154905,4,29,7,0,22,7
154905,3,16,4,0,12,4
269210,10,38,7,0,31,7
269210,9,130,18,0,112,18
269210,8,396,59,0,337,59
269210,7,191,32,0,159,32
269210,6,72,15,0,57,15
269210,5,18,5,0,13,5
269210,4,9,3,0,6,3
269210,3,3,1,0,2,1
55952,10,30,8,0,22,8
55952,9,76,19,0,57,19
55952,8,259,77,0,182,77
55952,7,207,57,0,150,57
55952,6,147,54,0,93,54
55952,5,65,26,0,39,26
55952,4,27,13,0,14,13
55952,3,15,7,0,8,7
55952,2,10,5,0,5,5
55952,1,4,1,0,3,1
431,10,12,4,0,8,4
431,9,19,6,0,13,6
431,8,122,40,0,82,40
431,7,257,65,0,192,65
431,6,280,65,0,215,65
431,5,97,16,0,81,16
431,4,33,11,0,22,11
431,3,13,5,0,8,5
431,1,2,1,1,1,0
5749,10,7,2,0,5,2
5749,9,7,3,0,4,3
5749,8,17,6,0,11,6
5749,7,38,10,0,28,10
5749,6,119,24,0,95,24
5749,5,185,44,0,141,44
5749,4,187,46,0,141,46
5749,3,125,30,0,95,30
5749,2,107,25,0,82,25
5749,1,47,13,0,34,13
96152,10,33,5,0,28,5
96152,9,74,7,0,67,7
96152,8,250,24,0,226,24
96152,7,213,33,0,180,33
96152,6,160,37,0,123,37
96152,5,57,8,0,49,8
96152,4,26,4,0,22,4
96152,3,9,2,0,7,2
96152,2,10,1,0,9,1
3321,9,6,4,0,2,4
3321,8,64,18,0,46,18
3321,7,229,59,0,170,59
3321,6,343,86,0,257,86
3321,5,124,39,0,85,39
3321,4,53,16,0,37,16
3321,3,13,5,0,8,5
3321,2,4,1,0,3,1
102835,8,62,20,0,42,20
102835,7,191,35,0,156,35
102835,6,309,72,0,237,72
102835,5,154,35,0,119,35
102835,4,76,23,0,53,23
102835,3,26,12,0,14,12
102835,2,9,3,0,6,3
102835,1,2,1,0,1,1
206915,10,29,4,0,25,4
206915,9,74,12,0,62,12
206915,8,253,20,0,233,20
206915,7,245,27,0,218,27
206915,6,155,16,0,139,16
206915,5,43,5,0,38,5
206915,4,19,2,0,17,2
206915,3,13,4,0,9,4
206915,2,5,1,0,4,1
206915,1,2,2,0,0,2
131111,10,234,92,8,142,84
131111,9,176,32,0,144,32
131111,8,192,41,1,151,40
131111,7,99,19,1,80,18
131111,6,77,17,0,60,17
131111,5,24,5,0,19,5
131111,4,17,4,0,13,4
131111,3,7,5,0,2,5
131111,2,2,1,0,1,1
226518,10,26,4,0,22,4
226518,9,77,11,0,66,11
226518,8,293,35,0,258,35
226518,7,252,25,0,227,25
226518,6,141,19,0,122,19
226518,5,31,8,0,23,8
226518,4,9,5,0,4,5
226518,3,4,2,0,2,2
226518,2,3,1,0,2,1
226518,1,5,1,0,4,1
160081,10,69,12,2,57,10
160081,9,95,19,2,76,17
160081,8,265,51,3,214,48
160081,7,196,24,3,172,21
160081,6,125,18,2,107,16
160081,5,42,7,1,35,6
160081,4,18,3,0,15,3
160081,3,14,3,0,11,3
160081,2,5,4,0,1,4
160081,1,6,3,0,3,3
191972,10,18,3,0,15,3
191972,9,55,9,0,46,9
191972,8,308,46,0,262,46
191972,7,269,42,0,227,42
191972,6,134,29,0,105,29
191972,5,34,11,0,23,11
191972,4,9,4,0,5,4
191972,3,4,1,0,3,1
191972,2,4,2,0,2,2
129976,10,13,1,0,12,1
129976,9,33,2,0,31,2
129976,8,118,27,0,91,27
129976,7,219,39,0,180,39
129976,6,249,37,0,212,37
129976,5,103,18,0,85,18
129976,4,54,15,0,39,15
129976,3,34,7,0,27,7
129976,2,10,3,0,7,3
200454,10,15,1,0,14,1
200454,9,62,8,1,54,7
200454,8,265,42,5,223,37
200454,7,259,56,9,203,47
200454,6,173,28,3,145,25
200454,5,32,9,1,23,8
200454,4,23,5,0,18,5
200454,3,6,2,0,4,2
181494,9,16,5,0,11,5
181494,8,142,25,0,117,25
181494,7,239,51,0,188,51
181494,6,276,49,0,227,49
181494,5,89,14,0,75,14
181494,4,49,8,0,41,8
181494,3,13,5,0,8,5
181494,2,3,1,0,2,1
3348,10,12,3,0,9,3
3348,9,33,14,0,19,14
3348,8,202,66,0,136,66
3348,7,283,73,0,210,73
3348,6,197,73,0,124,73
3348,5,57,25,0,32,25
3348,4,37,19,0,18,19
3348,3,9,8,0,1,8
188547,10,58,14,2,44,12
188547,9,119,23,2,96,21
188547,8,342,64,9,278,55
188547,7,192,33,9,159,24
188547,6,84,22,3,62,19
188547,5,28,6,0,22,6
188547,4,6,1,0,5,1
188547,3,4,1,0,3,1
188547,2,2,2,0,0,2
188547,1,3,1,0,2,1
184424,10,238,61,0,177,61
184424,9,171,38,0,133,38
184424,8,217,41,0,176,41
184424,7,99,20,0,79,20
184424,6,63,14,0,49,14
184424,5,16,2,0,14,2
184424,4,13,4,0,9,4
184424,3,4,1,0,3,1
184424,2,4,2,0,2,2
114903,10,5,3,0,2,3
114903,9,13,1,0,12,1
114903,8,93,21,0,72,21
114903,7,239,48,0,191,48
114903,6,309,70,0,239,70
114903,5,121,27,0,94,27
114903,4,36,10,0,26,10
114903,3,12,4,0,8,4
177478,10,41,20,1,21,19
177478,9,114,28,1,86,27
177478,8,334,71,6,263,65
177478,7,198,30,0,168,30
177478,6,100,14,1,86,13
177478,5,26,6,0,20,6
177478,4,10,2,0,8,2
177478,3,4,2,0,2,2
177478,2,2,1,0,1,1
177478,1,1,1,0,0,1
9021,9,8,3,0,5,3
9021,8,92,41,0,51,41
9021,7,215,71,0,144,71
9021,6,320,109,0,211,109
9021,5,110,39,0,71,39
9021,4,62,25,0,37,25
9021,3,17,14,0,3,14
9021,2,2,1,0,1,1
9021,1,1,1,0,0,1
182704,10,5,1,0,4,1
182704,9,31,5,0,26,5
182704,8,235,39,3,196,36
182704,7,288,50,1,238,49
182704,6,190,34,2,156,32
182704,5,41,8,0,33,8
182704,4,27,7,0,20,7
182704,3,9,2,0,7,2
200853,10,34,15,1,19,14
200853,9,58,18,1,40,17
200853,8,324,69,6,255,63
200853,7,241,44,5,197,39
200853,6,124,24,0,100,24
200853,5,32,4,0,28,4
200853,4,11,4,1,7,3
200853,1,1,1,0,0,1
25277,10,36,12,0,24,12
25277,9,75,34,0,41,34
25277,8,346,103,0,243,103
25277,7,220,59,0,161,59
25277,6,99,36,0,63,36
25277,5,23,6,0,17,6
25277,4,15,5,0,10,5
25277,3,6,1,0,5,1
25277,1,4,2,0,2,2
190639,10,5,1,0,4,1
190639,9,29,5,0,24,5
190639,8,185,29,0,156,29
190639,7,265,23,0,242,23
190639,6,248,35,0,213,35
190639,5,59,10,0,49,10
190639,4,25,6,0,19,6
190639,3,10,2,0,8,2
176606,10,20,3,0,17,3
176606,9,31,8,0,23,8
176606,8,136,25,0,111,25
176606,7,195,26,0,169,26
176606,6,254,35,0,219,35
176606,5,85,12,0,73,12
176606,4,61,8,0,53,8
176606,3,27,6,0,21,6
176606,2,13,7,0,6,7
176606,1,4,1,0,3,1
39217,10,60,23,0,37,23
39217,9,145,39,0,106,39
39217,8,288,68,0,220,68
39217,7,178,45,0,133,45
39217,6,86,28,0,58,28
39217,5,39,19,0,20,19
39217,4,14,8,0,6,8
39217,3,9,5,0,4,5
39217,2,4,3,0,1,3
153425,9,23,7,0,16,7
153425,8,138,15,0,123,15
153425,7,257,44,0,213,44
153425,6,257,34,0,223,34
153425,5,88,18,0,70,18
153425,4,33,11,0,22,11
153425,3,16,5,0,11,5
153425,2,7,1,0,6,1
153425,1,2,2,0,0,2
202288,10,4,1,0,3,1
202288,9,37,8,0,29,8
202288,8,183,52,6,131,46
202288,7,293,56,4,237,52
202288,6,228,49,4,179,45
202288,5,52,7,0,45,7
202288,4,20,5,0,15,5
202288,3,7,1,0,6,1
202288,2,2,1,0,1,1
94389,10,13,1,0,12,1
94389,9,43,14,0,29,14
94389,8,229,58,0,171,58
94389,7,241,60,0,181,60
94389,6,220,58,0,162,58
94389,5,48,12,0,36,12
94389,4,17,10,0,7,10
94389,3,12,6,0,6,6
94389,2,3,1,0,2,1
94389,1,2,1,0,1,1
2555,10,2,1,0,1,1
2555,9,13,4,0,9,4
2555,8,89,27,0,62,27
2555,7,269,67,0,202,67
2555,6,295,80,0,215,80
2555,5,91,22,0,69,22
2555,4,43,16,0,27,16
2555,3,15,10,0,5,10
2555,2,6,3,0,3,3
187700,10,96,17,4,79,13
187700,9,188,33,0,155,33
187700,8,248,45,3,203,42
187700,7,149,28,3,121,25
187700,6,94,14,2,80,12
187700,5,24,2,0,22,2
187700,4,13,5,0,8,5
187700,3,5,2,0,3,2
187700,2,5,1,0,4,1
187700,1,3,1,0,2,1
140457,10,17,3,0,14,3
140457,9,35,6,0,29,6
140457,8,175,28,0,147,28
140457,7,225,36,0,189,36
140457,6,225,33,0,192,33
140457,5,72,16,0,56,16
140457,4,45,11,0,34,11
140457,3,21,6,0,15,6
140457,2,5,2,0,3,2
140457,1,4,1,0,3,1
149853,10,22,4,0,18,4
149853,9,34,7,0,27,7
149853,8,190,37,2,153,35
149853,7,265,45,1,220,44
149853,6,228,35,1,193,34
149853,5,61,10,1,51,9
149853,4,18,2,0,16,2
149853,3,3,1,0,2,1
1420,9,4,2,0,2,2
1420,8,47,17,0,30,17
1420,7,136,49,0,87,49
1420,6,326,110,0,216,110
1420,5,189,65,0,124,65
1420,4,67,19,0,48,19
1420,3,31,10,0,21,10
1420,2,16,2,0,14,2
1420,1,7,2,0,5,2
140951,10,24,2,0,22,2
140951,9,54,2,0,52,2
140951,8,206,27,0,179,27
140951,7,267,36,0,231,36
140951,6,178,23,0,155,23
140951,5,64,9,0,55,9
140951,4,18,7,0,11,7
140951,3,8,3,0,5,3
210274,10,16,3,0,13,3
210274,9,54,14,2,40,12
210274,8,293,36,4,257,32
210274,7,217,32,3,185,29
210274,6,172,25,0,147,25
210274,5,41,11,1,30,10
210274,4,19,1,0,18,1
210274,2,3,1,0,2,1
210274,1,4,1,0,3,1
161546,10,15,1,0,14,1
161546,9,33,2,0,31,2
161546,8,145,21,0,124,21
161546,7,275,37,0,238,37
161546,6,258,40,0,218,40
161546,5,69,11,0,58,11
161546,4,16,4,0,12,4
161546,3,7,2,0,5,2
156496,10,42,12,1,30,11
156496,9,66,20,1,46,19
156496,8,254,55,8,199,47
156496,7,230,34,4,196,30
156496,6,147,23,1,124,22
156496,5,43,12,1,31,11
156496,4,29,11,0,18,11
156496,3,10,1,0,9,1
156496,1,1,1,0,0,1
147930,10,15,3,0,12,3
147930,9,53,8,0,45,8
147930,8,229,48,0,181,48
147930,7,268,36,0,232,36
147930,6,183,28,0,155,28
147930,5,39,2,0,37,2
147930,4,20,6,0,14,6
147930,2,5,2,0,3,2
147930,1,2,1,0,1,1
6819,10,82,26,0,56,26
6819,9,106,23,0,83,23
6819,8,201,40,0,161,40
6819,7,183,45,0,138,45
6819,6,141,31,0,110,31
6819,5,59,10,0,49,10
6819,4,23,4,0,19,4
6819,3,17,4,0,13,4
6819,2,7,2,0,5,2
6819,1,4,1,0,3,1
257759,10,10,1,0,9,1
257759,9,25,7,0,18,7
257759,8,172,18,0,154,18
257759,7,261,35,0,226,35
257759,6,241,37,0,204,37
257759,5,80,22,0,58,22
257759,4,28,5,0,23,5
257759,3,7,2,0,5,2
1489,10,8,2,0,6,2
1489,9,15,5,1,10,4
1489,8,67,19,1,48,18
1489,7,180,50,0,130,50
1489,6,291,82,0,209,82
1489,5,146,45,1,101,44
1489,4,59,28,0,31,28
1489,3,34,18,0,16,18
1489,2,15,7,0,8,7
1489,1,6,6,0,0,6
191963,10,26,5,0,21,5
191963,9,58,10,0,48,10
191963,8,307,43,0,264,43
191963,7,262,30,0,232,30
191963,6,122,21,0,101,21
191963,5,22,7,0,15,7
191963,4,17,2,0,15,2
191963,3,4,2,0,2,2
191963,2,2,1,0,1,1
59429,10,42,22,3,20,19
59429,9,45,17,3,28,14
59429,8,173,45,6,128,39
59429,7,156,38,6,118,32
59429,6,181,53,7,128,46
59429,5,91,18,0,73,18
59429,4,55,17,0,38,17
59429,3,39,12,0,27,12
59429,2,22,11,1,11,10
59429,1,16,4,0,12,4
141791,10,11,4,0,7,4
141791,9,27,7,0,20,7
141791,8,215,52,0,163,52
141791,7,270,48,0,222,48
141791,6,222,48,0,174,48
141791,5,47,8,0,39,8
141791,4,22,5,0,17,5
141791,3,6,1,0,5,1
141791,2,1,1,0,0,1
124965,10,55,7,0,48,7
124965,9,78,15,0,63,15
124965,8,272,42,0,230,42
124965,7,209,23,0,186,23
124965,6,144,27,0,117,27
124965,5,41,7,0,34,7
124965,4,13,3,0,10,3
124965,3,4,1,0,3,1
42939,10,33,10,0,23,10
42939,9,57,8,0,49,8
42939,8,248,56,0,192,56
42939,7,242,34,0,208,34
42939,6,157,39,0,118,39
42939,5,46,8,0,38,8
42939,4,21,5,0,16,5
42939,3,9,3,0,6,3
42939,2,4,2,0,2,2
113293,10,10,2,0,8,2
113293,9,29,7,0,22,7
113293,8,154,36,1,118,35
113293,7,231,47,0,184,47
113293,6,254,62,0,192,62
113293,5,84,15,0,69,15
113293,4,27,10,0,17,10
113293,3,18,8,0,10,8
113293,2,8,4,0,4,4
113293,1,3,1,0,2,1
36399,10,65,18,0,47,18
36399,9,100,26,0,74,26
36399,8,285,54,0,231,54
36399,7,191,45,0,146,45
36399,6,110,28,0,82,28
36399,5,32,8,0,24,8
36399,4,18,7,0,11,7
36399,3,10,4,0,6,4
36399,2,3,3,0,0,3
130792,10,20,5,0,15,5
130792,9,57,21,0,36,21
130792,8,139,38,0,101,38
130792,7,250,46,0,204,46
130792,6,234,41,0,193,41
130792,5,77,14,0,63,14
130792,4,30,6,0,24,6
130792,2,2,2,0,0,2
130792,1,1,1,0,0,1
80979,10,6,2,0,4,2
80979,9,17,4,0,13,4
80979,8,145,29,0,116,29
80979,7,262,44,0,218,44
80979,6,259,31,0,228,31
80979,5,87,15,0,72,15
80979,4,25,8,0,17,8
80979,3,10,2,0,8,2
80979,2,6,3,0,3,3
1423,10,39,19,0,20,19
1423,9,56,29,0,27,29
1423,8,238,86,0,152,86
1423,7,271,69,0,202,69
1423,6,141,42,0,99,42
1423,5,45,9,0,36,9
1423,4,16,5,0,11,5
1423,3,8,2,0,6,2
1423,2,4,1,0,3,1
10814,10,4,1,0,3,1
10814,9,16,4,0,12,4
10814,8,102,29,0,73,29
10814,7,253,85,0,168,85
10814,6,293,96,0,197,96
10814,5,89,33,0,56,33
10814,4,39,14,0,25,14
10814,3,12,6,0,6,6
10814,2,5,2,0,3,2
135281,10,16,5,0,11,5
135281,9,50,9,0,41,9
135281,8,247,46,0,201,46
135281,7,209,29,0,180,29
135281,6,213,40,0,173,40
135281,5,47,7,0,40,7
135281,4,20,4,0,16,4
135281,3,8,2,0,6,2
135281,2,3,1,0,2,1
696,10,15,7,0,8,7
696,9,42,20,0,22,20
696,8,109,42,0,67,42
696,7,186,61,0,125,61
696,6,255,98,0,157,98
696,5,121,40,0,81,40
696,4,57,20,0,37,20
696,3,18,6,0,12,6
696,2,9,4,0,5,4
21955,10,11,4,0,7,4
21955,9,8,3,0,5,3
21955,8,70,25,0,45,25
21955,7,141,44,0,97,44
21955,6,295,103,0,192,103
21955,5,149,45,0,104,45
21955,4,95,53,0,42,53
21955,3,29,18,0,11,18
21955,2,11,10,0,1,10
21955,1,4,1,0,3,1
7262,10,8,1,0,7,1
7262,9,8,3,0,5,3
7262,8,16,8,0,8,8
7262,7,31,11,0,20,11
7262,6,102,31,0,71,31
7262,5,186,69,0,117,69
7262,4,200,67,0,133,67
7262,3,124,46,0,78,46
7262,2,45,19,0,26,19
34004,10,6,2,0,4,2
34004,9,18,8,0,10,8
34004,8,121,32,0,89,32
34004,7,241,65,0,176,65
34004,6,294,70,0,224,70
34004,5,90,16,0,74,16
34004,4,30,11,0,19,11
34004,3,9,3,0,6,3
34004,1,1,1,0,0,1
18289,10,15,2,0,13,2
18289,9,26,8,0,18,8
18289,8,128,26,0,102,26
18289,7,270,50,0,220,50
18289,6,260,57,0,203,57
18289,5,59,11,0,48,11
18289,4,33,12,0,21,12
18289,3,15,4,0,11,4
18289,2,5,2,0,3,2
89415,10,22,4,0,18,4
89415,9,41,5,0,36,5
89415,8,120,12,0,108,12
89415,7,175,21,0,154,21
89415,6,279,50,0,229,50
89415,5,121,11,0,110,11
89415,4,33,5,0,28,5
89415,3,10,2,0,8,2
89415,2,6,1,0,5,1
136000,10,37,12,1,25,11
136000,9,70,17,1,53,16
136000,8,227,46,5,181,41
136000,7,230,27,2,203,25
136000,6,153,29,2,124,27
136000,5,48,12,1,36,11
136000,4,27,4,1,23,3
136000,3,8,3,0,5,3
136000,2,5,1,0,4,1
136000,1,4,1,0,3,1
192947,10,14,2,0,12,2
192947,9,24,9,0,15,9
192947,8,174,27,0,147,27
192947,7,268,38,0,230,38
192947,6,223,36,0,187,36
192947,5,64,7,0,57,7
192947,4,30,10,0,20,10
192947,3,7,3,0,4,3
192947,2,4,1,0,3,1
192947,1,1,1,0,0,1
99081,10,10,1,0,9,1
99081,9,10,3,0,7,3
99081,8,58,14,0,44,14
99081,7,138,38,0,100,38
99081,6,312,73,0,239,73
99081,5,155,38,0,117,38
99081,4,80,14,0,66,14
99081,3,29,10,0,19,10
99081,2,16,2,0,14,2
8229,10,8,2,0,6,2
8229,9,17,4,0,13,4
8229,8,118,28,0,90,28
8229,7,219,40,0,179,40
8229,6,299,54,0,245,54
8229,5,95,18,0,77,18
8229,4,34,7,0,27,7
8229,3,12,3,0,9,3
8229,2,6,3,0,3,3
8229,1,1,1,0,0,1
2529,10,69,39,0,30,39
2529,9,110,38,0,72,38
2529,8,211,59,0,152,59
2529,7,216,53,0,163,53
2529,6,111,29,0,82,29
2529,5,43,16,0,27,16
2529,4,22,11,0,11,11
2529,3,16,6,0,10,6
2529,2,4,3,0,1,3
2529,1,6,1,0,5,1
254591,10,65,9,0,56,9
254591,9,125,18,0,107,18
254591,8,368,35,0,333,35
254591,7,163,25,0,138,25
254591,6,60,10,0,50,10
254591,5,18,2,0,16,2
254591,4,10,5,0,5,5
254591,3,4,2,0,2,2
3646,10,10,3,0,7,3
3646,9,10,2,0,8,2
3646,8,40,6,0,34,6
3646,7,121,29,0,92,29
3646,6,268,88,0,180,88
3646,5,195,51,0,144,51
3646,4,95,24,0,71,24
3646,3,42,21,0,21,21
3646,2,23,12,0,11,12
3646,1,3,2,0,1,2
183896,10,31,6,0,25,6
183896,9,42,6,0,36,6
183896,8,148,13,0,135,13
183896,7,226,30,0,196,30
183896,6,236,26,0,210,26
183896,5,64,17,0,47,17
183896,4,35,11,0,24,11
183896,3,14,5,0,9,5
183896,2,8,2,0,6,2
198836,9,6,1,0,5,1
198836,8,44,10,0,34,10
198836,7,134,28,0,106,28
198836,6,321,55,0,266,55
198836,5,154,23,0,131,23
198836,4,81,16,0,65,16
198836,3,34,7,0,27,7
198836,2,18,3,0,15,3
198836,1,7,1,0,6,1
18500,10,19,4,0,15,4
18500,9,35,8,0,27,8
18500,8,215,53,0,162,53
18500,7,248,64,0,184,64
18500,6,194,54,0,140,54
18500,5,69,27,0,42,27
18500,4,14,7,0,7,7
18500,3,10,1,0,9,1
161547,10,13,2,0,11,2
161547,9,33,4,0,29,4
161547,8,145,20,0,125,20
161547,7,263,21,0,242,21
161547,6,265,24,0,241,24
161547,5,61,13,0,48,13
161547,3,7,2,0,5,2
169147,10,21,4,0,17,4
169147,9,62,14,0,48,14
169147,8,223,42,0,181,42
169147,7,241,37,0,204,37
169147,6,178,31,0,147,31
169147,5,44,11,0,33,11
169147,4,23,8,0,15,8
169147,3,9,4,0,5,4
5205,10,42,17,0,25,17
5205,9,58,18,0,40,18
5205,8,188,53,0,135,53
5205,7,220,63,0,157,63
5205,6,180,58,0,122,58
5205,5,85,28,0,57,28
5205,4,18,4,0,14,4
5205,3,6,1,0,5,1
5205,2,5,1,0,4,1
149241,10,39,11,0,28,11
149241,9,87,25,0,62,25
149241,8,246,77,4,169,73
149241,7,181,35,3,146,32
149241,6,159,41,0,118,41
149241,5,39,18,1,21,17
149241,4,29,10,1,19,9
149241,3,14,5,0,9,5
149241,2,6,2,0,4,2
149241,1,6,1,0,5,1
138317,9,14,4,0,10,4
138317,8,71,10,0,61,10
138317,7,160,37,0,123,37
138317,6,288,57,0,231,57
138317,5,128,29,0,99,29
138317,4,85,26,0,59,26
138317,3,39,15,0,24,15
138317,2,12,4,0,8,4
138317,1,3,3,0,0,3
13713,10,8,2,0,6,2
13713,9,6,1,0,5,1
13713,8,15,3,0,12,3
13713,7,39,15,0,24,15
13713,6,120,23,0,97,23
13713,5,172,38,0,134,38
13713,4,199,55,0,144,55
13713,3,132,39,0,93,39
13713,2,73,26,0,47,26
13713,1,39,14,0,25,14
552,10,28,4,0,24,4
552,9,76,23,0,53,23
552,8,219,74,0,145,74
552,7,204,60,0,144,60
552,6,166,62,0,104,62
552,5,53,22,0,31,22
552,4,34,13,0,21,13
552,3,13,5,0,8,5
552,2,5,1,0,4,1
552,1,5,2,0,3,2
279,10,6,3,0,3,3
279,9,17,2,0,15,2
279,8,83,35,0,48,35
279,7,207,75,0,132,75
279,6,305,94,0,211,94
279,5,124,40,0,84,40
279,4,47,21,0,26,21
279,3,10,8,0,2,8
279,2,4,1,0,3,1
168433,10,24,5,1,19,4
168433,9,43,11,0,32,11
168433,8,245,44,3,201,41
168433,7,213,37,5,176,32
168433,6,180,39,2,141,37
168433,5,55,12,0,43,12
168433,4,17,5,0,12,5
168433,3,19,4,0,15,4
168433,2,3,2,0,1,2
168433,1,4,3,0,1,3
122889,10,21,6,0,15,6
122889,9,78,17,0,61,17
122889,8,209,47,0,162,47
122889,7,190,33,0,157,33
122889,6,181,54,0,127,54
122889,5,46,13,0,33,13
122889,4,40,16,0,24,16
122889,3,23,10,0,13,10
122889,2,12,8,0,4,8
122889,1,3,2,0,1,2
177079,10,13,2,0,11,2
177079,9,31,7,0,24,7
177079,8,189,24,0,165,24
177079,7,269,24,0,245,24
177079,6,209,21,0,188,21
177079,5,53,7,0,46,7
177079,4,24,4,0,20,4
177079,3,5,1,0,4,1
31759,10,84,19,0,65,19
31759,9,123,37,0,86,37
31759,8,263,55,1,208,54
31759,7,181,40,0,141,40
31759,6,100,20,0,80,20
31759,5,34,10,0,24,10
31759,4,10,2,0,8,2
31759,3,4,1,0,3,1
245271,10,10,3,0,7,3
245271,9,37,8,0,29,8
245271,8,230,22,0,208,22
245271,7,264,35,0,229,35
245271,6,171,32,0,139,32
245271,5,56,15,0,41,15
245271,4,25,8,0,17,8
245271,3,6,3,0,3,3
4378,8,7,2,0,5,2
4378,7,14,2,0,12,2
4378,6,50,21,0,29,21
4378,5,95,27,0,68,27
4378,4,183,56,0,127,56
4378,3,165,71,0,94,71
4378,2,175,70,0,105,70
4378,1,108,48,0,60,48
127784,10,13,7,0,6,7
127784,9,25,6,0,19,6
127784,8,111,13,0,98,13
127784,7,188,26,0,162,26
127784,6,272,30,0,242,30
127784,5,120,18,0,102,18
127784,4,55,14,0,41,14
127784,3,13,3,0,10,3
127784,2,4,2,0,2,2
179719,10,39,7,0,32,7
179719,9,58,18,0,40,18
179719,8,198,27,0,171,27
179719,7,194,24,0,170,24
179719,6,201,22,0,179,22
179719,5,51,8,0,43,8
179719,4,30,7,0,23,7
179719,3,20,1,0,19,1
179719,2,5,1,0,4,1
179719,1,5,2,0,3,2
149119,10,9,4,1,5,3
149119,9,32,8,1,24,7
149119,8,203,33,5,170,28
149119,7,253,49,6,204,43
149119,6,196,39,3,157,36
149119,5,54,14,0,40,14
149119,4,38,12,1,26,11
149119,3,10,4,1,6,3
149119,2,5,2,1,3,1
144728,10,42,4,0,38,4
144728,9,23,8,0,15,8
144728,8,84,16,0,68,16
144728,7,144,17,0,127,17
144728,6,278,55,0,223,55
144728,5,142,16,0,126,16
144728,4,44,6,0,38,6
144728,3,33,8,0,25,8
144728,2,8,2,0,6,2
102898,10,8,1,0,7,1
102898,9,25,9,0,16,9
102898,8,162,38,0,124,38
102898,7,238,44,1,194,43
102898,6,269,52,0,217,52
102898,5,64,11,0,53,11
102898,4,20,4,0,16,4
102898,3,9,4,0,5,4
72420,10,20,9,0,11,9
72420,9,27,9,0,18,9
72420,8,136,38,1,98,37
72420,7,195,47,1,148,46
72420,6,257,58,0,199,58
72420,5,88,25,0,63,25
72420,4,44,14,0,30,14
72420,3,20,8,0,12,8
72420,2,8,3,0,5,3
72420,1,5,4,0,1,4
230191,10,97,36,2,61,34
230191,9,104,34,8,70,26
230191,8,201,40,6,161,34
230191,7,144,21,1,123,20
230191,6,133,24,2,109,22
230191,5,49,13,2,36,11
230191,4,38,14,1,24,13
230191,3,23,9,0,14,9
230191,2,15,3,0,12,3
230191,1,3,2,0,1,2
4753,9,11,3,0,8,3
4753,8,90,31,0,59,31
4753,7,217,71,0,146,71
4753,6,297,90,0,207,90
4753,5,119,41,0,78,41
4753,4,44,13,0,31,13
4753,3,19,9,0,10,9
4753,2,2,2,0,0,2
204184,10,62,26,0,36,26
204184,9,102,35,0,67,35
204184,8,287,65,0,222,65
204184,7,199,28,0,171,28
204184,6,98,15,0,83,15
204184,5,30,7,0,23,7
204184,4,12,2,0,10,2
204184,3,4,1,0,3,1
204184,1,2,1,0,1,1
57163,9,30,10,0,20,10
57163,8,141,38,0,103,38
57163,7,245,73,0,172,73
57163,6,251,69,0,182,69
57163,5,77,20,0,57,20
57163,4,31,12,0,19,12
57163,3,8,3,0,5,3
57163,2,3,3,0,0,3
57163,1,2,1,0,1,1
123576,9,28,5,0,23,5
123576,8,95,19,0,76,19
123576,7,230,40,0,190,40
123576,6,305,52,0,253,52
123576,5,77,10,0,67,10
123576,4,23,5,0,18,5
123576,2,5,1,0,4,1
607,10,14,5,0,9,5
607,9,12,3,0,9,3
607,8,80,26,0,54,26
607,7,167,49,0,118,49
607,6,262,71,0,191,71
607,5,129,44,0,85,44
607,4,72,31,0,41,31
607,3,39,15,0,24,15
607,2,17,8,0,9,8
607,1,5,2,0,3,2
125658,10,13,4,0,9,4
125658,9,17,8,0,9,8
125658,8,118,22,0,96,22
125658,7,173,26,0,147,26
125658,6,223,45,0,178,45
125658,5,123,22,0,101,22
125658,4,67,14,0,53,14
125658,3,42,13,0,29,13
125658,2,15,3,0,12,3
125658,1,5,2,0,3,2
118402,9,22,4,0,18,4
118402,8,153,33,1,120,32
118402,7,253,52,1,201,51
118402,6,257,40,1,217,39
118402,5,67,15,0,52,15
118402,4,28,8,0,20,8
118402,3,11,3,0,8,3
118402,2,2,1,0,1,1
181260,10,19,1,0,18,1
181260,9,40,3,0,37,3
181260,8,228,30,0,198,30
181260,7,216,23,0,193,23
181260,6,178,36,0,142,36
181260,5,65,17,0,48,17
181260,4,32,9,0,23,9
181260,3,12,2,0,10,2
181260,2,3,2,0,1,2
156180,10,7,1,0,6,1
156180,9,26,9,0,17,9
156180,8,196,53,4,143,49
156180,7,240,41,5,199,36
156180,6,232,48,1,184,47
156180,5,63,10,2,53,8
156180,4,20,4,0,16,4
156180,3,10,6,0,4,6
156180,2,1,1,0,0,1
14035,10,5,1,0,4,1
14035,9,20,3,0,17,3
14035,8,90,26,0,64,26
14035,7,220,52,0,168,52
14035,6,277,79,0,198,79
14035,5,115,31,0,84,31
14035,4,35,12,0,23,12
14035,3,21,11,0,10,11
14035,2,7,5,0,2,5
124847,10,20,4,0,16,4
124847,9,25,3,0,22,3
124847,8,181,32,0,149,32
124847,7,231,33,0,198,33
124847,6,256,47,0,209,47
124847,5,54,15,0,39,15
124847,4,18,6,0,12,6
124847,3,8,3,0,5,3
124847,2,1,1,0,0,1
5419,10,5,1,0,4,1
5419,9,34,14,0,20,14
5419,8,170,59,0,111,59
5419,7,234,83,0,151,83
5419,6,204,76,0,128,76
5419,5,87,31,0,56,31
5419,4,38,21,0,17,21
5419,3,17,8,0,9,8
5419,2,5,3,0,2,3
5419,1,1,1,0,0,1
10659,10,8,4,0,4,4
10659,9,35,9,0,26,9
10659,8,81,22,0,59,22
10659,7,163,50,0,113,50
10659,6,233,62,0,171,62
10659,5,119,41,0,78,41
10659,4,70,21,0,49,21
10659,3,56,29,0,27,29
10659,2,21,9,0,12,9
10659,1,9,4,0,5,4
11168,10,56,13,0,43,13
11168,9,107,25,0,82,25
11168,8,201,44,0,157,44
11168,7,183,33,0,150,33
11168,6,122,37,0,85,37
11168,5,54,15,0,39,15
11168,4,32,12,0,20,12
11168,3,20,5,0,15,5
11168,2,15,6,0,9,6
11168,1,4,2,0,2,2
165662,10,10,3,0,7,3
165662,9,27,3,0,24,3
165662,8,171,29,0,142,29
165662,7,254,32,0,222,32
165662,6,252,46,0,206,46
165662,5,45,8,0,37,8
165662,4,30,4,0,26,4
139033,10,12,1,0,11,1
139033,9,35,5,0,30,5
139033,8,266,55,7,211,48
139033,7,248,46,1,202,45
139033,6,157,35,2,122,33
139033,5,46,11,2,35,9
139033,4,19,7,2,12,5
139033,3,5,3,0,2,3
139033,2,3,1,0,2,1
144734,10,23,11,0,12,11
144734,9,29,7,0,22,7
144734,8,199,41,0,158,41
144734,7,261,35,0,226,35
144734,6,183,29,0,154,29
144734,5,57,9,0,48,9
144734,4,34,8,0,26,8
144734,3,3,1,0,2,1
41627,10,26,9,0,17,9
41627,9,71,23,0,48,23
41627,8,302,100,0,202,100
41627,7,231,76,1,155,75
41627,6,127,38,0,89,38
41627,5,20,6,0,14,6
41627,4,10,6,0,4,6
41627,2,3,2,0,1,2
199793,10,17,7,0,10,7
199793,9,48,8,0,40,8
199793,8,281,48,0,233,48
199793,7,234,40,0,194,40
199793,6,150,19,0,131,19
199793,5,46,10,0,36,10
199793,4,9,1,0,8,1
199793,3,4,1,0,3,1
200785,10,11,1,0,10,1
200785,9,23,4,0,19,4
200785,8,115,15,0,100,15
200785,7,224,25,0,199,25
200785,6,288,38,0,250,38
200785,5,79,12,0,67,12
200785,4,30,6,0,24,6
200785,3,13,3,0,10,3
200785,2,4,2,0,2,2
1992,10,14,5,0,9,5
1992,9,35,16,0,19,16
1992,8,106,26,0,80,26
1992,7,168,54,0,114,54
1992,6,279,67,0,212,67
1992,5,119,39,0,80,39
1992,4,44,15,0,29,15
1992,3,16,8,0,8,8
1992,2,7,2,0,5,2
32114,10,8,3,0,5,3
32114,9,12,4,0,8,4
32114,8,139,31,0,108,31
32114,7,265,59,0,206,59
32114,6,256,65,0,191,65
32114,5,81,26,0,55,26
32114,4,16,3,0,13,3
32114,3,12,2,0,10,2
165,10,16,5,0,11,5
165,9,26,7,0,19,7
165,8,115,35,0,80,35
165,7,185,63,0,122,63
165,6,277,79,0,198,79
165,5,97,32,0,65,32
165,4,52,22,0,30,22
165,3,16,7,0,9,7
165,1,2,2,0,0,2
67254,10,109,27,0,82,27
67254,9,173,23,0,150,23
67254,8,243,37,0,206,37
67254,7,138,24,0,114,24
67254,6,66,12,0,54,12
67254,5,31,8,0,23,8
67254,4,14,3,0,11,3
67254,3,8,1,0,7,1
67254,1,4,1,0,3,1
2718,10,9,5,0,4,5
2718,9,13,6,0,7,6
2718,8,76,30,0,46,30
2718,7,131,35,0,96,35
2718,6,240,71,0,169,71
2718,5,133,37,0,96,37
2718,4,92,40,0,52,40
2718,3,47,20,0,27,20
2718,2,31,21,0,10,21
2718,1,17,11,0,6,11
164865,10,42,16,1,26,15
164865,9,48,11,1,37,10
164865,8,167,27,4,140,23
164865,7,186,30,7,156,23
164865,6,182,33,6,149,27
164865,5,69,9,1,60,8
164865,4,53,15,0,38,15
164865,3,27,9,1,18,8
164865,1,5,3,0,2,3
5314,10,3,2,0,1,2
5314,9,2,1,0,1,1
5314,7,30,9,0,21,9
5314,6,114,26,0,88,26
5314,5,175,55,0,120,55
5314,4,215,56,0,159,56
5314,3,124,38,0,86,38
5314,2,87,27,0,60,27
5314,1,30,9,0,21,9
193322,10,19,3,0,16,3
193322,9,50,10,0,40,10
193322,8,219,33,0,186,33
193322,7,261,39,1,222,38
193322,6,152,22,0,130,22
193322,5,57,5,0,52,5
193322,4,18,8,0,10,8
193322,3,7,2,0,5,2
193322,2,4,2,0,2,2
193322,1,3,1,0,2,1
194523,10,5,2,0,3,2
194523,9,22,1,0,21,1
194523,8,113,19,0,94,19
194523,7,205,28,0,177,28
194523,6,251,35,0,216,35
194523,5,112,21,0,91,21
194523,4,54,11,0,43,11
194523,3,16,4,0,12,4
194523,1,4,1,0,3,1
1613,10,16,8,0,8,8
1613,9,15,7,0,8,7
1613,8,39,9,0,30,9
1613,7,85,26,0,59,26
1613,6,218,51,0,167,51
1613,5,166,34,0,132,34
1613,4,138,37,0,101,37
1613,3,72,22,0,50,22
1613,2,31,8,0,23,8
1613,1,6,3,0,3,3
163474,10,80,37,2,43,35
163474,9,177,40,0,137,40
163474,8,299,49,8,250,41
163474,7,126,17,1,109,16
163474,6,61,13,0,48,13
163474,5,23,3,1,20,2
163474,3,8,4,0,4,4
163474,2,2,1,0,1,1
129556,10,9,3,0,6,3
129556,9,15,4,0,11,4
129556,8,117,21,0,96,21
129556,7,199,28,0,171,28
129556,6,300,50,0,250,50
129556,5,96,22,0,74,22
129556,4,40,5,0,35,5
129556,3,8,2,0,6,2
120515,10,12,2,0,10,2
120515,9,10,4,0,6,4
120515,8,66,12,0,54,12
120515,7,122,16,0,106,16
120515,6,215,50,0,165,50
120515,5,172,33,0,139,33
120515,4,94,23,0,71,23
120515,3,52,16,0,36,16
120515,2,31,14,0,17,14
120515,1,11,4,0,7,4
176803,10,23,1,0,22,1
176803,9,33,11,0,22,11
176803,8,177,30,2,147,28
176803,7,255,41,5,214,36
176803,6,197,34,2,163,32
176803,5,56,7,0,49,7
176803,4,27,7,0,20,7
176803,3,12,1,0,11,1
176803,1,3,1,1,2,0
214887,10,82,13,2,69,11
214887,9,162,29,2,133,27
214887,8,334,49,4,285,45
214887,7,108,14,0,94,14
214887,6,56,11,2,45,9
214887,5,21,5,0,16,5
214887,4,7,1,0,6,1
214887,3,9,2,0,7,2
214887,2,3,1,0,2,1
214887,1,10,5,1,5,4
194,10,23,9,0,14,9
194,9,29,5,0,24,5
194,8,78,22,0,56,22
194,7,193,68,0,125,68
194,6,269,66,0,203,66
194,5,108,34,0,74,34
194,4,53,23,0,30,23
194,3,18,10,0,8,10
194,2,12,7,0,5,7
194,1,1,1,0,0,1
782,10,19,10,0,9,10
782,9,46,18,0,28,18
782,8,164,61,0,103,61
782,7,216,60,0,156,60
782,6,208,54,0,154,54
782,5,83,26,0,57,26
782,4,33,10,0,23,10
782,3,7,3,0,4,3
782,2,6,4,0,2,4
144864,10,50,8,0,42,8
144864,9,97,10,0,87,10
144864,8,279,31,0,248,31
144864,7,201,20,0,181,20
144864,6,117,21,0,96,21
144864,5,23,2,0,21,2
144864,4,10,3,0,7,3
178134,10,25,7,0,18,7
178134,9,38,12,0,26,12
178134,8,209,27,0,182,27
178134,7,230,37,0,193,37
178134,6,178,27,0,151,27
178134,5,51,12,0,39,12
178134,4,27,7,0,20,7
178134,3,12,2,0,10,2
178134,2,9,2,0,7,2
178134,1,3,2,0,1,2
140865,10,5,2,0,3,2
140865,9,5,1,0,4,1
140865,8,38,9,0,29,9
140865,7,144,36,0,108,36
140865,6,333,77,0,256,77
140865,5,147,31,0,116,31
140865,4,67,12,0,55,12
140865,3,27,7,0,20,7
140865,2,13,3,0,10,3
140865,1,3,1,0,2,1
22864,10,5,2,0,3,2
22864,9,9,4,0,5,4
22864,8,69,18,0,51,18
22864,7,156,36,0,120,36
22864,6,321,105,0,216,105
22864,5,135,30,0,105,30
22864,4,60,20,0,40,20
22864,3,20,6,0,14,6
22864,2,8,4,0,4,4
22864,1,1,1,0,0,1
55597,9,10,1,0,9,1
55597,8,58,11,0,47,11
55597,7,110,23,0,87,23
55597,6,257,56,0,201,56
55597,5,159,29,0,130,29
55597,4,90,22,0,68,22
55597,3,60,11,0,49,11
55597,2,21,10,0,11,10
55597,1,11,6,0,5,6
66081,10,18,6,0,12,6
66081,9,32,10,0,22,10
66081,8,122,24,0,98,24
66081,7,256,41,0,215,41
66081,6,226,37,0,189,37
66081,5,75,18,0,57,18
66081,4,29,6,0,23,6
66081,3,13,1,0,12,1
66081,2,6,2,0,4,2
321,10,9,2,0,7,2
321,9,14,7,0,7,7
321,8,84,34,0,50,34
321,7,221,49,0,172,49
321,6,293,72,0,221,72
321,5,106,26,0,80,26
321,4,43,8,0,35,8
321,3,10,1,0,9,1
232666,10,46,9,1,37,8
232666,9,72,12,1,60,11
232666,8,262,33,7,229,26
232666,7,177,29,3,148,26
232666,6,122,18,1,104,17
232666,5,49,10,2,39,8
232666,4,22,7,0,15,7
232666,3,21,6,0,15,6
232666,2,7,4,2,3,2
232666,1,4,2,0,2,2
13293,10,54,16,0,38,16
13293,9,66,15,0,51,15
13293,8,143,40,0,103,40
13293,7,165,51,0,114,51
13293,6,198,42,0,156,42
13293,5,87,26,0,61,26
13293,4,41,13,0,28,13
13293,3,15,1,0,14,1
13293,2,6,1,0,5,1
13293,1,3,3,0,0,3
211716,10,63,20,0,43,20
211716,9,158,27,0,131,27
211716,8,264,54,0,210,54
211716,7,118,21,0,97,21
211716,6,89,21,0,68,21
211716,5,33,10,0,23,10
211716,4,23,12,0,11,12
211716,3,17,8,0,9,8
211716,2,10,4,0,6,4
211716,1,3,1,0,2,1
123185,10,26,3,0,23,3
123185,9,35,10,0,25,10
123185,8,116,24,0,92,24
123185,7,191,26,0,165,26
123185,6,237,46,0,191,46
123185,5,90,18,0,72,18
123185,4,51,10,0,41,10
123185,3,21,7,0,14,7
123185,2,5,2,0,3,2
123185,1,7,2,0,5,2
218479,10,131,21,0,110,21
218479,9,181,36,2,145,34
218479,8,245,31,1,214,30
218479,7,99,10,0,89,10
218479,6,70,10,0,60,10
218479,5,21,3,1,18,2
218479,4,14,5,0,9,5
218479,3,12,8,0,4,8
218479,1,4,2,1,2,1
788,10,33,20,0,13,20
788,9,44,23,0,21,23
788,8,127,38,0,89,38
788,7,124,38,0,86,38
788,6,93,28,0,65,28
788,5,32,10,0,22,10
788,4,18,8,0,10,8
788,3,13,6,0,7,6
788,2,5,3,0,2,3
788,1,2,1,0,1,1
78954,10,19,4,0,15,4
78954,9,46,7,0,39,7
78954,8,214,59,0,155,59
78954,7,236,47,0,189,47
78954,6,163,25,0,138,25
78954,5,50,12,0,38,12
78954,4,29,8,0,21,8
78954,3,10,6,0,4,6
78954,2,7,2,0,5,2
78954,1,2,1,0,1,1
118497,10,5,4,0,1,4
118497,9,42,14,0,28,14
118497,8,198,53,1,145,52
118497,7,234,42,2,192,40
118497,6,185,45,1,140,44
118497,5,63,20,0,43,20
118497,4,32,9,0,23,9
118497,3,11,5,0,6,5
118497,2,5,3,0,2,3
129731,10,67,14,0,53,14
129731,9,101,24,2,77,22
129731,8,234,38,1,196,37
129731,7,172,33,0,139,33
129731,6,125,34,0,91,34
129731,5,41,8,0,33,8
129731,4,16,4,0,12,4
129731,3,7,2,0,5,2
129731,2,7,2,0,5,2
129731,1,6,2,0,4,2
17,10,30,9,0,21,9
17,9,30,11,0,19,11
17,8,102,42,0,60,42
17,7,169,68,1,101,67
17,6,234,80,0,154,80
17,5,135,47,0,88,47
17,4,56,20,0,36,20
17,3,10,3,0,7,3
17,2,6,2,0,4,2
143176,10,15,3,0,12,3
143176,9,68,10,0,58,10
143176,8,237,44,0,193,44
143176,7,222,35,0,187,35
143176,6,153,31,0,122,31
143176,5,42,7,0,35,7
143176,4,24,10,0,14,10
143176,3,8,1,0,7,1
143176,1,3,2,0,1,2
125315,9,7,2,0,5,2
125315,8,94,26,0,68,26
125315,7,164,47,0,117,47
125315,6,286,71,3,215,68
125315,5,118,23,0,95,23
125315,4,59,14,0,45,14
125315,3,24,8,0,16,8
125315,2,11,2,0,9,2
125315,1,4,2,0,2,2
5641,10,26,8,0,18,8
5641,9,26,7,0,19,7
5641,8,97,16,0,81,16
5641,7,103,17,0,86,17
5641,6,215,54,0,161,54
5641,5,138,27,0,111,27
5641,4,84,25,0,59,25
5641,3,38,10,0,28,10
5641,2,29,12,0,17,12
5641,1,17,4,0,13,4
46782,10,6,1,0,5,1
46782,9,18,4,0,14,4
46782,8,144,48,0,96,48
46782,7,184,44,0,140,44
46782,6,241,53,0,188,53
46782,5,111,34,0,77,34
46782,4,47,18,0,29,18
46782,3,14,4,0,10,4
46782,2,5,1,0,4,1
46782,1,2,1,0,1,1
125675,9,10,2,0,8,2
125675,8,68,14,0,54,14
125675,7,161,27,0,134,27
125675,6,262,50,0,212,50
125675,5,121,27,0,94,27
125675,4,75,17,0,58,17
125675,3,50,13,0,37,13
125675,2,14,4,0,10,4
125675,1,6,2,0,4,2
12166,10,54,10,0,44,10
12166,9,154,24,0,130,24
12166,8,245,49,0,196,49
12166,7,167,32,0,135,32
12166,6,94,30,0,64,30
12166,5,24,6,0,18,6
12166,4,15,9,0,6,9
12166,3,8,1,0,7,1
189660,10,41,11,2,30,9
189660,9,77,12,3,65,9
189660,8,299,48,4,251,44
189660,7,205,33,3,172,30
189660,6,99,14,0,85,14
189660,5,31,10,2,21,8
189660,4,8,5,0,3,5
189660,3,9,3,0,6,3
189660,2,3,1,0,2,1
219708,9,32,8,0,24,8
219708,8,172,31,0,141,31
219708,7,234,22,0,212,22
219708,6,196,22,0,174,22
219708,5,66,10,0,56,10
219708,4,33,10,0,23,10
219708,3,20,4,0,16,4
219708,2,5,2,0,3,2
219708,1,1,1,0,0,1
1711,10,15,4,0,11,4
1711,9,18,6,0,12,6
1711,8,74,27,0,47,27
1711,7,148,46,0,102,46
1711,6,267,80,0,187,80
1711,5,127,43,0,84,43
1711,4,73,30,0,43,30
1711,3,30,11,0,19,11
1711,2,16,10,0,6,10
1711,1,3,2,0,1,2
35964,10,2,1,0,1,1
35964,9,6,1,0,5,1
35964,8,64,19,0,45,19
35964,7,184,61,0,123,61
35964,6,308,92,0,216,92
35964,5,123,34,0,89,34
35964,4,54,19,0,35,19
35964,3,22,6,0,16,6
35964,2,8,2,0,6,2
5942,10,12,3,0,9,3
5942,9,28,11,0,17,11
5942,8,191,67,0,124,67
5942,7,271,93,1,178,92
5942,6,187,70,0,117,70
5942,5,60,25,0,35,25
5942,4,14,6,0,8,6
5942,3,5,2,0,3,2
5942,2,1,1,0,0,1
160559,10,13,1,0,12,1
160559,9,38,9,0,29,9
160559,8,208,28,1,180,27
160559,7,204,35,4,169,31
160559,6,214,34,0,180,34
160559,5,48,10,0,38,10
160559,4,29,9,0,20,9
160559,3,10,3,0,7,3
160559,2,4,2,0,2,2
160559,1,1,1,0,0,1
11017,10,2,1,0,1,1
11017,9,10,3,0,7,3
11017,8,15,8,0,7,8
11017,7,32,12,0,20,12
11017,6,97,35,0,62,35
11017,5,173,49,0,124,49
11017,4,238,71,0,167,71
11017,3,127,40,0,87,40
11017,2,60,17,0,43,17
11017,1,16,3,0,13,3
148205,10,10,3,0,7,3
148205,9,26,3,0,23,3
148205,8,141,30,4,111,26
148205,7,253,37,4,216,33
148205,6,225,34,0,191,34
148205,5,79,19,1,60,18
148205,4,23,12,1,11,11
148205,3,9,4,0,5,4
148205,2,3,1,0,2,1
508,10,48,20,0,28,20
508,9,56,24,0,32,24
508,8,190,66,0,124,66
508,7,240,62,0,178,62
508,6,152,28,0,124,28
508,5,54,14,0,40,14
508,4,20,7,0,13,7
508,3,5,1,0,4,1
1800,10,30,13,0,17,13
1800,9,58,20,0,38,20
1800,8,141,40,0,101,40
1800,7,190,42,0,148,42
1800,6,188,57,0,131,57
1800,5,97,24,0,73,24
1800,4,40,15,0,25,15
1800,3,22,11,0,11,11
1800,2,2,1,0,1,1
1800,1,2,1,0,1,1
192834,10,12,2,0,10,2
192834,9,29,5,0,24,5
192834,8,177,21,0,156,21
192834,7,265,34,0,231,34
192834,6,203,27,0,176,27
192834,5,53,8,0,45,8
192834,4,20,4,0,16,4
192834,3,6,1,0,5,1
192834,2,4,2,0,2,2
226634,10,57,15,0,42,15
226634,9,111,28,0,83,28
226634,8,224,36,0,188,36
226634,7,182,39,0,143,39
226634,6,106,25,0,81,25
226634,5,38,3,0,35,3
226634,4,31,12,0,19,12
226634,3,8,4,0,4,4
226634,2,8,2,0,6,2
226634,1,3,2,0,1,2
21804,10,55,20,0,35,20
21804,9,38,13,0,25,13
21804,8,117,35,0,82,35
21804,7,152,39,0,113,39
21804,6,228,71,0,157,71
21804,5,110,26,0,84,26
21804,4,42,8,0,34,8
21804,3,15,6,0,9,6
21804,2,6,2,0,4,2
21804,1,4,2,0,2,2
115293,10,14,5,0,9,5
115293,9,22,6,0,16,6
115293,8,154,45,0,109,45
115293,7,167,34,0,133,34
115293,6,169,28,0,141,28
115293,5,42,13,0,29,13
115293,4,18,7,0,11,7
115293,3,10,3,0,7,3
115293,2,7,2,0,5,2
2250,10,27,10,0,17,10
2250,9,26,12,0,14,12
2250,8,113,50,0,63,50
2250,7,217,74,0,143,74
2250,6,257,77,0,180,77
2250,5,84,30,0,54,30
2250,4,28,7,0,21,7
2250,3,7,2,0,5,2
2250,2,5,2,0,3,2
2250,1,2,1,0,1,1
548,10,17,6,0,11,6
548,9,30,11,0,19,11
548,8,111,36,0,75,36
548,7,209,61,0,148,61
548,6,240,63,0,177,63
548,5,98,31,0,67,31
548,4,37,14,0,23,14
548,3,16,4,0,12,4
548,2,6,3,0,3,3
548,1,2,1,0,1,1
1233,10,20,6,0,14,6
1233,9,25,4,0,21,4
1233,8,87,29,0,58,29
1233,7,169,61,0,108,61
1233,6,224,70,0,154,70
1233,5,120,37,0,83,37
1233,4,65,34,0,31,34
1233,3,30,8,0,22,8
1233,2,21,8,0,13,8
1233,1,4,1,0,3,1
1324,9,11,2,0,9,2
1324,8,59,15,0,44,15
1324,7,138,27,0,111,27
1324,6,263,48,0,215,48
1324,5,153,31,0,122,31
1324,4,77,22,0,55,22
1324,3,42,15,0,27,15
1324,2,14,8,0,6,8
1324,1,5,2,0,3,2
146910,10,40,8,0,32,8
146910,9,117,20,0,97,20
146910,8,306,60,0,246,60
146910,7,168,35,0,133,35
146910,6,91,23,0,68,23
146910,5,22,7,0,15,7
146910,4,12,5,0,7,5
146910,3,4,1,0,3,1
146910,2,3,3,0,0,3
150485,10,7,2,0,5,2
150485,9,17,7,1,10,6
150485,8,82,19,1,63,18
150485,7,136,25,0,111,25
150485,6,296,62,1,234,61
150485,5,115,16,1,99,15
150485,4,59,12,1,47,11
150485,3,31,12,0,19,12
150485,2,14,6,0,8,6
150485,1,8,2,0,6,2
8041,10,15,4,0,11,4
8041,9,12,2,0,10,2
8041,8,44,6,0,38,6
8041,7,99,16,0,83,16
8041,6,211,48,0,163,48
8041,5,172,41,0,131,41
8041,4,108,34,0,74,34
8041,3,63,17,0,46,17
8041,2,27,6,0,21,6
8041,1,12,4,0,8,4
251658,10,24,7,0,17,7
251658,9,87,21,0,66,21
251658,8,308,86,8,222,78
251658,7,207,52,7,155,45
251658,6,108,17,3,91,14
251658,5,21,6,1,15,5
251658,4,5,1,0,4,1
251658,3,1,1,0,0,1
1855,10,4,1,0,3,1
1855,9,10,1,0,9,1
1855,8,43,10,0,33,10
1855,7,101,23,0,78,23
1855,6,233,49,0,184,49
1855,5,179,34,0,145,34
1855,4,109,26,0,83,26
1855,3,42,11,0,31,11
1855,2,24,8,0,16,8
1855,1,15,3,0,12,3
231666,9,21,3,0,18,3
231666,8,79,10,0,69,10
231666,7,169,16,0,153,16
231666,6,265,49,0,216,49
231666,5,115,17,0,98,17
231666,4,54,7,0,47,7
231666,3,30,9,0,21,9
231666,2,12,8,0,4,8
231666,1,5,3,0,2,3
29410,10,7,3,0,4,3
29410,9,31,14,0,17,14
29410,8,152,72,0,80,72
29410,7,251,83,0,168,83
29410,6,230,70,0,160,70
29410,5,48,15,0,33,15
29410,4,21,8,0,13,8
29410,3,9,3,0,6,3
29410,2,6,2,0,4,2
260605,10,47,6,0,41,6
260605,9,131,23,0,108,23
260605,8,364,60,0,304,60
260605,7,151,17,0,134,17
260605,6,52,7,0,45,7
260605,5,11,3,0,8,3
260605,3,2,2,0,0,2
260605,2,2,1,0,1,1
107190,10,28,11,0,17,11
107190,9,58,19,0,39,19
107190,8,193,50,0,143,50
107190,7,203,49,0,154,49
107190,6,173,36,0,137,36
107190,5,52,14,0,38,14
107190,4,29,10,0,19,10
107190,3,11,9,0,2,9
107190,2,6,2,0,4,2
189848,10,51,13,0,38,13
189848,9,63,11,0,52,11
189848,8,176,21,0,155,21
189848,7,204,22,0,182,22
189848,6,152,14,0,138,14
189848,5,71,7,0,64,7
189848,4,24,5,0,19,5
189848,3,6,3,0,3,3
189848,2,11,2,0,9,2
1574,10,16,9,0,7,9
1574,9,12,9,0,3,9
1574,8,36,16,0,20,16
1574,7,76,26,0,50,26
1574,6,221,64,0,157,64
1574,5,183,57,0,126,57
1574,4,121,45,0,76,45
1574,3,58,23,0,35,23
1574,2,29,13,0,16,13
1574,1,5,4,0,1,4
130911,10,6,2,0,4,2
130911,9,14,1,0,13,1
130911,8,104,15,0,89,15
130911,7,164,40,0,124,40
130911,6,244,53,0,191,53
130911,5,126,27,0,99,27
130911,4,61,11,0,50,11
130911,3,24,7,0,17,7
130911,2,11,4,0,7,4
130911,1,3,3,0,0,3
2542,10,5,1,0,4,1
2542,9,6,3,0,3,3
2542,8,65,17,0,48,17
2542,7,193,61,0,132,61
2542,6,272,72,0,200,72
2542,5,128,34,0,94,34
2542,4,55,18,0,37,18
2542,3,24,7,0,17,7
2542,2,5,5,0,0,5
2542,1,4,3,0,1,3
262712,10,96,24,1,72,23
262712,9,192,40,0,152,40
262712,8,278,45,0,233,45
262712,7,122,23,0,99,23
262712,6,62,15,0,47,15
262712,5,9,5,0,4,5
152765,10,66,13,0,53,13
152765,9,136,22,0,114,22
152765,8,307,37,0,270,37
152765,7,164,30,0,134,30
152765,6,55,8,0,47,8
152765,5,17,4,0,13,4
152765,1,5,1,0,4,1
371,10,11,5,0,6,5
371,9,22,6,0,16,6
371,8,168,59,0,109,59
371,7,247,66,0,181,66
371,6,210,58,1,152,57
371,5,69,34,0,35,34
371,4,18,9,0,9,9
371,3,4,3,0,1,3
20079,10,11,6,0,5,6
20079,9,34,16,0,18,16
20079,8,178,50,0,128,50
20079,7,231,55,0,176,55
20079,6,176,61,0,115,61
20079,5,53,18,0,35,18
20079,4,36,17,0,19,17
20079,3,22,8,0,14,8
20079,2,13,7,0,6,7
20079,1,2,2,0,0,2
61484,10,8,5,0,3,5
61484,9,46,12,0,34,12
61484,8,177,39,0,138,39
61484,7,176,28,0,148,28
61484,6,188,55,0,133,55
61484,5,78,20,0,58,20
61484,4,50,18,0,32,18
61484,3,17,8,0,9,8
61484,2,13,6,0,7,6
61484,1,4,1,0,3,1
22457,10,27,5,0,22,5
22457,9,33,11,0,22,11
22457,8,167,47,0,120,47
22457,7,232,63,0,169,63
22457,6,180,44,0,136,44
22457,5,62,19,0,43,19
22457,4,28,11,0,17,11
22457,3,12,1,0,11,1
22457,2,9,3,0,6,3
35285,10,9,3,0,6,3
35285,9,61,32,0,29,32
35285,8,223,73,0,150,73
35285,7,207,65,1,142,64
35285,6,157,45,0,112,45
35285,5,38,8,0,30,8
35285,4,30,17,0,13,17
35285,3,17,11,0,6,11
35285,2,10,2,0,8,2
47082,10,36,16,0,20,16
47082,9,29,10,0,19,10
47082,8,56,19,0,37,19
47082,7,78,28,0,50,28
47082,6,191,68,0,123,68
47082,5,125,42,0,83,42
47082,4,95,19,0,76,19
47082,3,53,12,0,41,12
47082,2,51,19,0,32,19
47082,1,40,19,0,21,19
217398,10,39,14,0,25,14
217398,9,96,17,0,79,17
217398,8,325,58,3,267,55
217398,7,150,19,2,131,17
217398,6,103,25,1,78,24
217398,5,24,6,1,18,5
217398,4,13,6,1,7,5
217398,3,3,2,0,1,2
217398,2,2,1,0,1,1
125924,10,10,4,0,6,4
125924,9,19,1,0,18,1
125924,8,150,51,0,99,51
125924,7,213,43,0,170,43
125924,6,239,69,0,170,69
125924,5,78,21,0,57,21
125924,4,29,12,0,17,12
125924,3,10,3,0,7,3
125924,2,5,3,0,2,3
9139,9,10,3,0,7,3
9139,8,72,28,0,44,28
9139,7,225,72,0,153,72
9139,6,284,94,0,190,94
9139,5,93,36,0,57,36
9139,4,45,22,0,23,22
9139,3,15,9,0,6,9
9139,2,7,3,0,4,3
9139,1,2,1,0,1,1
115233,10,23,6,0,17,6
115233,9,41,6,0,35,6
115233,8,134,18,0,116,18
115233,7,178,26,0,152,26
115233,6,246,32,0,214,32
115233,5,91,15,0,76,15
115233,4,24,2,0,22,2
115233,3,7,3,0,4,3
115233,2,6,1,0,5,1
94731,10,12,2,0,10,2
94731,9,18,7,0,11,7
94731,8,86,21,0,65,21
94731,7,126,29,0,97,29
94731,6,258,55,0,203,55
94731,5,144,43,0,101,43
94731,4,76,22,0,54,22
94731,3,26,9,0,17,9
94731,2,8,4,0,4,4
19363,10,7,5,0,2,5
19363,9,29,16,0,13,16
19363,8,152,69,0,83,69
19363,7,244,98,0,146,98
19363,6,220,90,0,130,90
19363,5,67,31,0,36,31
19363,4,21,9,0,12,9
19363,3,13,5,0,8,5
131118,10,28,12,0,16,12
131118,9,53,13,0,40,13
131118,8,190,41,0,149,41
131118,7,216,29,0,187,29
131118,6,160,34,0,126,34
131118,5,54,17,0,37,17
131118,4,30,7,0,23,7
131118,3,12,2,0,10,2
131118,2,8,2,0,6,2
4077,10,4,1,0,3,1
4077,9,8,5,0,3,5
4077,8,26,2,0,24,2
4077,7,41,8,0,33,8
4077,6,136,28,0,108,28
4077,5,181,29,0,152,29
4077,4,169,38,0,131,38
4077,3,104,27,0,77,27
4077,2,61,19,0,42,19
4077,1,22,6,0,16,6
10660,10,12,5,0,7,5
10660,9,35,20,0,15,20
10660,8,165,62,0,103,62
10660,7,235,108,0,127,108
10660,6,213,84,0,129,84
10660,5,62,21,0,41,21
10660,4,18,11,0,7,11
10660,3,9,3,0,6,3
10660,2,3,2,0,1,2
106999,9,16,4,0,12,4
106999,8,129,19,0,110,19
106999,7,212,42,0,170,42
106999,6,274,60,0,214,60
106999,5,69,19,0,50,19
106999,4,29,9,0,20,9
106999,3,14,4,0,10,4
106999,2,4,4,0,0,4
12453,10,14,4,0,10,4
12453,9,12,4,0,8,4
12453,8,58,11,0,47,11
12453,7,86,21,0,65,21
12453,6,242,56,0,186,56
12453,5,157,28,0,129,28
12453,4,94,26,0,68,26
12453,3,55,11,0,44,11
12453,2,21,4,0,17,4
12453,1,11,6,0,5,6
18931,10,2,1,0,1,1
18931,9,15,7,0,8,7
18931,8,86,23,0,63,23
18931,7,175,43,0,132,43
18931,6,244,78,0,166,78
18931,5,113,37,0,76,37
18931,4,61,27,0,34,27
18931,3,31,13,0,18,13
18931,2,20,9,0,11,9
18931,1,2,1,0,1,1
147623,10,19,1,0,18,1
147623,9,20,3,0,17,3
147623,8,125,19,0,106,19
147623,7,223,26,0,197,26
147623,6,230,28,0,202,28
147623,5,74,7,0,67,7
147623,4,38,9,0,29,9
147623,3,13,3,0,10,3
147623,2,5,1,0,4,1
147623,1,2,2,0,0,2
223278,10,15,6,0,9,6
223278,9,44,5,0,39,5
223278,8,222,30,0,192,30
223278,7,229,38,0,191,38
223278,6,155,25,0,130,25
223278,5,46,9,0,37,9
223278,4,19,4,0,15,4
223278,3,12,4,0,8,4
223278,2,7,2,0,5,2
223278,1,1,1,0,0,1
97915,10,30,9,0,21,9
97915,9,80,24,0,56,24
97915,8,220,49,0,171,49
97915,7,165,42,0,123,42
97915,6,141,42,0,99,42
97915,5,44,11,0,33,11
97915,4,36,15,0,21,15
97915,3,19,8,0,11,8
97915,2,9,7,0,2,7
97915,1,5,4,0,1,4
142267,10,10,3,0,7,3
142267,9,21,5,0,16,5
142267,8,163,41,4,122,37
142267,7,218,38,4,180,34
142267,6,215,46,0,169,46
142267,5,72,13,0,59,13
142267,4,26,6,0,20,6
142267,3,13,5,0,8,5
142267,2,5,1,0,4,1
142267,1,6,1,0,5,1
1836,10,31,9,0,22,9
1836,9,11,6,0,5,6
1836,8,71,23,1,48,22
1836,7,114,42,0,72,42
1836,6,231,62,0,169,62
1836,5,147,52,0,95,52
1836,4,90,27,0,63,27
1836,3,30,13,0,17,13
1836,2,18,9,0,9,9
1836,1,5,4,0,1,4
1212,10,22,8,0,14,8
1212,9,39,7,0,32,7
1212,8,112,29,0,83,29
1212,7,218,32,0,186,32
1212,6,215,44,0,171,44
1212,5,82,20,0,62,20
1212,4,37,11,0,26,11
1212,3,11,4,0,7,4
1212,2,9,5,0,4,5
464,10,17,9,0,8,9
464,9,32,15,0,17,15
464,8,179,57,0,122,57
464,7,250,58,0,192,58
464,6,196,57,0,139,57
464,5,45,12,0,33,12
464,4,19,3,0,16,3
464,3,6,1,0,5,1
2539,10,4,2,0,2,2
2539,9,18,2,0,16,2
2539,8,136,41,0,95,41
2539,7,265,63,0,202,63
2539,6,212,53,0,159,53
2539,5,59,18,0,41,18
2539,4,40,16,0,24,16
2539,3,11,2,0,9,2
2539,1,1,1,0,0,1
103132,10,13,3,0,10,3
103132,9,27,8,0,19,8
103132,8,192,44,1,148,43
103132,7,232,42,0,190,42
103132,6,199,40,0,159,40
103132,5,53,5,0,48,5
103132,4,17,1,0,16,1
103132,3,11,3,0,8,3
42673,10,57,17,0,40,17
42673,9,138,36,0,102,36
42673,8,278,55,0,223,55
42673,7,158,39,0,119,39
42673,6,80,23,0,57,23
42673,5,17,5,0,12,5
42673,4,7,3,0,4,3
42673,3,6,3,0,3,3
42673,2,4,1,0,3,1
203828,10,2,1,0,1,1
203828,9,18,7,0,11,7
203828,8,129,28,0,101,28
203828,7,255,46,0,209,46
203828,6,225,39,0,186,39
203828,5,77,19,0,58,19
203828,4,30,12,0,18,12
203828,3,7,1,0,6,1
203828,2,3,1,0,2,1
101020,9,16,2,0,14,2
101020,8,180,56,0,124,56
101020,7,283,72,0,211,72
101020,6,195,41,0,154,41
101020,5,43,10,0,33,10
101020,4,16,5,0,11,5
101020,3,5,2,0,3,2
101020,2,1,1,0,0,1
184459,10,23,4,0,19,4
184459,9,74,19,3,55,16
184459,8,262,38,7,224,31
184459,7,194,29,1,165,28
184459,6,130,27,0,103,27
184459,5,33,12,1,21,11
184459,4,14,4,0,10,4
184459,3,8,1,0,7,1
184459,2,5,4,0,1,4
17804,10,56,13,0,43,13
17804,9,41,8,0,33,8
17804,8,140,34,0,106,34
17804,7,174,28,0,146,28
17804,6,193,31,0,162,31
17804,5,78,15,0,63,15
17804,4,38,7,0,31,7
17804,3,11,2,0,9,2
17804,1,6,2,0,4,2
114387,10,8,2,0,6,2
114387,9,24,3,0,21,3
114387,8,209,44,0,165,44
114387,7,253,56,1,197,55
114387,6,184,39,0,145,39
114387,5,40,10,0,30,10
114387,4,15,5,0,10,5
114387,3,7,3,0,4,3
114387,2,2,2,0,0,2
109932,10,9,4,0,5,4
109932,9,14,2,0,12,2
109932,8,65,6,0,59,6
109932,7,122,19,2,103,17
109932,6,226,50,5,176,45
109932,5,112,19,2,93,17
109932,4,82,16,2,66,14
109932,3,58,19,4,39,15
109932,2,47,18,2,29,16
109932,1,8,4,0,4,4
32944,10,39,19,0,20,19
32944,9,95,37,0,58,37
32944,8,230,76,0,154,76
32944,7,178,51,0,127,51
32944,6,132,46,0,86,46
32944,5,30,10,0,20,10
32944,4,30,11,0,19,11
32944,3,9,3,0,6,3
32944,2,1,1,0,0,1
135243,10,15,7,0,8,7
135243,9,43,13,0,30,13
135243,8,215,54,1,161,53
135243,7,228,44,0,184,44
135243,6,175,37,0,138,37
135243,5,40,7,0,33,7
135243,4,16,5,1,11,4
135243,3,5,1,0,4,1
135243,2,4,1,0,3,1
21380,10,18,10,0,8,10
21380,9,36,13,0,23,13
21380,8,165,71,0,94,71
21380,7,235,70,0,165,70
21380,6,204,82,0,122,82
21380,5,46,19,0,27,19
21380,4,20,9,0,11,9
21380,3,14,6,0,8,6
21380,2,4,2,0,2,2
76,10,14,6,0,8,6
76,9,32,10,0,22,10
76,8,115,34,0,81,34
76,7,215,69,0,146,69
76,6,206,69,0,137,69
76,5,75,31,0,44,31
76,4,40,21,0,19,21
76,3,28,11,0,17,11
76,2,15,4,0,11,4
76,1,1,1,0,0,1
23053,10,6,2,0,4,2
23053,9,11,2,0,9,2
23053,8,96,30,0,66,30
23053,7,209,52,0,157,52
23053,6,256,81,0,175,81
23053,5,99,25,0,74,25
23053,4,39,18,0,21,18
23053,3,20,8,0,12,8
23053,2,4,1,0,3,1
207062,10,20,5,0,15,5
207062,9,34,7,0,27,7
207062,8,169,35,0,134,35
207062,7,225,32,0,193,32
207062,6,204,24,0,180,24
207062,5,46,5,0,41,5
207062,4,31,4,0,27,4
207062,3,12,1,0,11,1
539,9,31,4,0,27,4
539,8,104,22,0,82,22
539,7,177,36,0,141,36
539,6,246,55,0,191,55
539,5,108,24,0,84,24
539,4,36,8,0,28,8
539,3,21,7,0,14,7
539,2,8,1,0,7,1
539,1,5,1,0,4,1
364,9,20,9,0,11,9
364,8,103,40,0,63,40
364,7,252,71,0,181,71
364,6,244,77,0,167,77
364,5,75,25,0,50,25
364,4,29,15,0,14,15
364,3,11,7,0,4,7
364,2,3,1,0,2,1
127312,10,6,1,0,5,1
127312,9,20,2,0,18,2
127312,8,132,19,0,113,19
127312,7,224,42,0,182,42
127312,6,221,41,0,180,41
127312,5,71,17,0,54,17
127312,4,31,10,0,21,10
127312,3,23,6,0,17,6
127312,2,7,5,0,2,5
198190,10,29,3,0,26,3
198190,9,83,13,1,70,12
198190,8,307,46,2,261,44
198190,7,188,24,0,164,24
198190,6,95,16,0,79,16
198190,5,29,5,1,24,4
198190,4,4,1,0,3,1
198190,3,4,1,0,3,1
173761,10,46,8,0,38,8
173761,9,61,4,0,57,4
173761,8,186,32,0,154,32
173761,7,188,21,0,167,21
173761,6,182,32,0,150,32
173761,5,41,6,0,35,6
173761,4,22,4,0,18,4
173761,3,7,3,0,4,3
173761,2,3,3,0,0,3
173761,1,4,2,0,2,2
105624,10,14,3,0,11,3
105624,9,34,6,0,28,6
105624,8,196,47,4,149,43
105624,7,219,55,1,164,54
105624,6,189,48,1,141,47
105624,5,58,20,0,38,20
105624,4,15,8,0,7,8
105624,3,7,3,0,4,3
105624,2,3,1,0,2,1
105624,1,3,1,0,2,1
166372,10,7,1,0,6,1
166372,8,78,17,0,61,17
166372,7,186,46,0,140,46
166372,6,262,44,0,218,44
166372,5,107,20,0,87,20
166372,4,52,16,0,36,16
166372,3,25,8,0,17,8
166372,2,11,6,0,5,6
376,9,14,8,0,6,8
376,8,87,40,0,47,40
376,7,166,47,0,119,47
376,6,223,65,0,158,65
376,5,107,32,0,75,32
376,4,85,33,0,52,33
376,3,33,9,0,24,9
376,2,14,5,0,9,5
376,1,4,3,0,1,3
141430,10,9,3,0,6,3
141430,9,23,2,0,21,2
141430,8,66,8,0,58,8
141430,7,116,11,0,105,11
141430,6,234,34,0,200,34
141430,5,132,20,0,112,20
141430,4,93,11,0,82,11
141430,3,42,10,0,32,10
141430,2,19,6,0,13,6
141430,1,4,2,0,2,2
1445,10,12,5,0,7,5
1445,9,17,9,0,8,9
1445,8,112,46,0,66,46
1445,7,181,60,0,121,60
1445,6,250,69,0,181,69
1445,5,106,35,0,71,35
1445,4,34,10,0,24,10
1445,3,15,5,0,10,5
1445,2,7,1,0,6,1
1445,1,1,1,0,0,1
63539,10,27,3,0,24,3
63539,9,40,6,0,34,6
63539,8,121,19,0,102,19
63539,7,159,20,0,139,20
63539,6,241,37,0,204,37
63539,5,77,7,0,70,7
63539,4,35,5,0,30,5
63539,1,13,2,0,11,2
4356,10,4,2,0,2,2
4356,9,8,2,0,6,2
4356,8,96,43,0,53,43
4356,7,204,74,0,130,74
4356,6,257,77,0,180,77
4356,5,102,47,0,55,47
4356,4,38,11,0,27,11
4356,3,18,7,0,11,7
4356,2,6,1,0,5,1
4356,1,3,2,0,1,2
117838,10,18,2,0,16,2
117838,9,24,2,0,22,2
117838,8,109,9,0,100,9
117838,7,176,25,0,151,25
117838,6,232,30,0,202,30
117838,5,108,15,0,93,15
117838,4,31,4,0,27,4
117838,3,15,3,0,12,3
117838,2,16,5,0,11,5
117838,1,6,1,0,5,1
53168,10,3,2,0,1,2
53168,9,23,9,0,14,9
53168,8,179,74,0,105,74
53168,7,234,78,0,156,78
53168,6,209,75,0,134,75
53168,5,53,26,0,27,26
53168,4,24,5,0,19,5
53168,3,8,5,0,3,5
53168,2,1,1,0,0,1
53168,1,1,1,0,0,1
63167,10,9,3,0,6,3
63167,9,18,6,0,12,6
63167,8,97,25,0,72,25
63167,7,238,56,0,182,56
63167,6,245,60,0,185,60
63167,5,77,21,0,56,21
63167,4,31,10,0,21,10
63167,3,14,7,0,7,7
63167,2,3,2,0,1,2
63167,1,2,1,0,1,1
38713,10,45,7,0,38,7
38713,9,88,7,0,81,7
38713,8,244,22,0,222,22
38713,7,194,18,0,176,18
38713,6,111,14,0,97,14
38713,5,37,4,0,33,4
151771,10,62,13,0,49,13
151771,9,122,23,1,99,22
151771,8,302,46,2,256,44
151771,7,150,19,0,131,19
151771,6,68,8,0,60,8
151771,5,25,7,0,18,7
3409,10,49,19,0,30,19
3409,9,68,29,0,39,29
3409,8,197,59,0,138,59
3409,7,178,51,0,127,51
3409,6,121,41,0,80,41
3409,5,62,28,0,34,28
3409,4,30,14,0,16,14
3409,3,13,8,0,5,8
3409,2,11,9,0,2,9
3409,1,5,2,0,3,2
237087,10,42,16,0,26,16
237087,9,82,14,0,68,14
237087,8,200,32,0,168,32
237087,7,180,39,0,141,39
237087,6,146,34,0,112,34
237087,5,48,11,0,37,11
237087,4,21,6,0,15,6
237087,3,14,3,0,11,3
237087,2,3,2,0,1,2
1674,10,21,8,0,13,8
1674,9,30,8,0,22,8
1674,8,90,32,0,58,32
1674,7,151,49,0,102,49
1674,6,239,75,0,164,75
1674,5,101,31,0,70,31
1674,4,67,23,0,44,23
1674,3,25,12,0,13,12
1674,2,8,5,0,3,5
436,10,6,2,0,4,2
436,9,15,6,0,9,6
436,8,89,30,0,59,30
436,7,203,65,0,138,65
436,6,250,63,0,187,63
436,5,96,33,0,63,33
436,4,48,22,0,26,22
436,3,20,13,0,7,13
436,2,5,4,0,1,4
436,1,1,1,0,0,1
8920,10,5,3,0,2,3
8920,9,20,12,0,8,12
8920,8,114,50,0,64,50
8920,7,189,87,0,102,87
8920,6,250,105,0,145,105
8920,5,85,36,0,49,36
8920,4,47,24,0,23,24
8920,3,14,6,0,8,6
8920,2,7,4,0,3,4
8920,1,2,1,0,1,1
244608,10,20,6,0,14,6
244608,9,82,14,0,68,14
244608,8,309,35,0,274,35
244608,7,225,24,0,201,24
244608,6,66,10,0,56,10
244608,5,25,6,0,19,6
244608,3,4,1,0,3,1
244608,2,2,1,0,1,1
13728,10,5,1,0,4,1
13728,9,5,1,0,4,1
13728,8,64,18,0,46,18
13728,7,183,54,0,129,54
13728,6,258,71,0,187,71
13728,5,102,32,0,70,32
13728,4,66,25,0,41,25
13728,3,33,15,0,18,15
13728,2,12,7,0,5,7
13728,1,3,2,0,1,2
2296,10,4,2,0,2,2
2296,9,7,2,0,5,2
2296,8,52,23,0,29,23
2296,7,98,38,0,60,38
2296,6,242,82,0,160,82
2296,5,171,57,0,114,57
2296,4,101,38,0,63,38
2296,3,38,21,0,17,21
2296,2,17,4,0,13,4
41835,10,7,3,0,4,3
41835,9,4,2,0,2,2
41835,8,45,11,0,34,11
41835,7,108,19,0,89,19
41835,6,246,52,0,194,52
41835,5,192,38,0,154,38
41835,4,83,18,0,65,18
41835,3,25,7,0,18,7
41835,2,17,7,0,10,7
40209,10,86,28,0,58,28
40209,9,147,35,0,112,35
40209,8,279,66,0,213,66
40209,7,138,27,0,111,27
40209,6,60,21,0,39,21
40209,5,9,2,0,7,2
40209,4,7,2,0,5,2
40209,3,4,2,0,2,2
834,9,37,15,0,22,15
834,8,112,39,0,73,39
834,7,190,51,0,139,51
834,6,231,73,0,158,73
834,5,88,33,0,55,33
834,4,34,7,0,27,7
834,3,17,6,0,11,6
834,2,7,3,0,4,3
834,1,4,1,0,3,1
178944,10,108,25,2,83,23
178944,9,98,23,0,75,23
178944,8,216,42,3,174,39
178944,7,121,15,2,106,13
178944,6,106,14,0,92,14
178944,5,41,7,2,34,5
178944,4,20,8,0,12,8
178944,3,17,10,1,7,9
178944,2,4,2,0,2,2
205867,10,18,3,0,15,3
205867,9,42,11,0,31,11
205867,8,225,37,0,188,37
205867,7,242,34,0,208,34
205867,6,141,20,0,121,20
205867,5,37,9,0,28,9
205867,4,13,2,0,11,2
205867,3,7,2,0,5,2
205867,2,6,3,0,3,3
98527,10,78,24,2,54,22
98527,9,139,43,2,96,41
98527,8,247,56,9,191,47
98527,7,128,26,1,102,25
98527,6,81,20,1,61,19
98527,5,18,10,0,8,10
98527,4,17,9,0,8,9
98527,3,16,10,1,6,9
98527,2,7,2,0,5,2
98527,1,6,1,0,5,1
29602,10,17,5,0,12,5
29602,9,38,9,0,29,9
29602,8,155,39,0,116,39
29602,7,202,32,0,170,32
29602,6,203,41,0,162,41
29602,5,69,12,0,57,12
29602,4,28,3,0,25,3
29602,3,12,2,0,10,2
29602,2,4,2,0,2,2
29602,1,2,1,0,1,1
206084,10,29,4,0,25,4
206084,9,64,18,0,46,18
206084,8,246,44,0,202,44
206084,7,242,42,0,200,42
206084,6,126,28,0,98,28
206084,5,13,5,0,8,5
206084,3,3,1,0,2,1
8790,9,33,3,0,30,3
8790,8,64,10,0,54,10
8790,7,157,20,0,137,20
8790,6,234,36,0,198,36
8790,5,111,15,0,96,15
8790,4,64,7,0,57,7
8790,3,36,6,0,30,6
8790,2,12,3,0,9,3
8790,1,6,2,0,4,2
5195,10,15,4,0,11,4
5195,9,19,8,0,11,8
5195,8,71,15,0,56,15
5195,7,117,24,0,93,24
5195,6,254,62,0,192,62
5195,5,116,34,0,82,34
5195,4,80,25,0,55,25
5195,3,33,14,0,19,14
5195,2,22,11,0,11,11
5195,1,4,1,0,3,1
2770,10,3,2,0,1,2
2770,8,20,8,0,12,8
2770,7,46,11,0,35,11
2770,6,171,43,0,128,43
2770,5,237,75,0,162,75
2770,4,157,45,0,112,45
2770,3,64,24,0,40,24
2770,2,23,10,0,13,10
2770,1,6,1,0,5,1
132497,10,13,2,0,11,2
132497,9,18,3,0,15,3
132497,8,105,13,0,92,13
132497,7,186,27,0,159,27
132497,6,250,36,0,214,36
132497,5,90,19,0,71,19
132497,4,39,2,0,37,2
132497,3,22,2,0,20,2
132497,2,6,1,0,5,1
194789,10,9,2,0,7,2
194789,9,16,4,0,12,4
194789,8,106,27,1,79,26
194789,7,250,42,5,208,37
194789,6,254,35,2,219,33
194789,5,66,16,0,50,16
194789,4,26,9,0,17,9
194789,3,3,1,0,2,1
64204,9,5,2,0,3,2
64204,8,45,8,0,37,8
64204,7,85,14,0,71,14
64204,6,185,32,0,153,32
64204,5,170,26,0,144,26
64204,4,131,30,0,101,30
64204,3,56,6,0,50,6
64204,2,33,6,0,27,6
64204,1,16,7,0,9,7
126,10,9,5,0,4,5
126,9,22,7,0,15,7
126,8,101,44,0,57,44
126,7,193,54,0,139,54
126,6,231,76,0,155,76
126,5,93,22,0,71,22
126,4,50,18,0,32,18
126,3,17,8,0,9,8
126,2,9,6,0,3,6
126,1,3,2,0,1,2
215463,10,14,4,0,10,4
215463,9,46,6,0,40,6
215463,8,205,28,0,177,28
215463,7,235,21,0,214,21
215463,6,154,32,0,122,32
215463,5,36,8,0,28,8
215463,4,23,1,0,22,1
215463,3,11,5,0,6,5
215463,2,9,4,0,5,4
804,10,25,11,0,14,11
804,9,30,12,0,18,12
804,8,138,56,0,82,56
804,7,169,53,0,116,53
804,6,231,81,0,150,81
804,5,88,29,0,59,29
804,4,29,13,0,16,13
804,3,13,7,0,6,7
177965,10,15,3,0,12,3
177965,9,31,4,0,27,4
177965,8,169,21,0,148,21
177965,7,247,29,0,218,29
177965,6,193,12,0,181,12
177965,5,46,6,0,40,6
177965,4,14,4,0,10,4
177965,3,7,2,0,5,2
177965,2,5,3,0,2,3
177965,1,1,1,0,0,1
200890,10,28,5,2,23,3
200890,9,77,16,2,61,14
200890,8,267,38,5,229,33
200890,7,177,24,2,153,22
200890,6,106,25,2,81,23
200890,5,46,10,0,36,10
200890,4,12,6,0,6,6
200890,3,7,2,0,5,2
200890,2,4,1,0,3,1
200890,1,3,1,0,2,1
135,9,15,3,0,12,3
135,8,70,23,0,47,23
135,7,139,38,0,101,38
135,6,289,62,0,227,62
135,5,123,32,0,91,32
135,4,47,14,0,33,14
135,3,27,10,0,17,10
135,2,15,4,0,11,4
216070,10,45,15,0,30,15
216070,9,87,18,0,69,18
216070,8,243,38,0,205,38
216070,7,183,18,0,165,18
216070,6,110,18,0,92,18
216070,5,27,7,0,20,7
216070,4,17,7,0,10,7
216070,3,10,3,0,7,3
216070,2,6,1,0,5,1
216070,1,1,1,0,0,1
14992,9,9,3,0,6,3
14992,8,52,22,0,30,22
14992,7,90,32,0,58,32
14992,6,230,80,0,150,80
14992,5,179,64,0,115,64
14992,4,93,37,0,56,37
14992,3,36,20,0,16,20
14992,2,30,17,0,13,17
14992,1,4,1,0,3,1
125752,10,117,36,0,81,36
125752,9,154,35,0,119,35
125752,8,257,52,0,205,52
125752,7,104,18,0,86,18
125752,6,59,9,0,50,9
125752,5,18,5,0,13,5
125752,4,11,4,1,7,3
145928,10,2,1,0,1,1
145928,9,7,2,0,5,2
145928,8,64,25,0,39,25
145928,7,140,32,0,108,32
145928,6,266,50,0,216,50
145928,5,126,18,0,108,18
145928,4,84,15,0,69,15
145928,3,26,7,0,19,7
145928,2,10,3,0,7,3
124668,10,14,3,0,11,3
124668,9,52,11,1,41,10
124668,8,185,20,1,165,19
124668,7,225,25,0,200,25
124668,6,168,22,0,146,22
124668,5,49,7,1,42,6
124668,4,19,6,0,13,6
124668,3,4,1,0,3,1
124668,2,4,1,0,3,1
124668,1,5,2,1,3,1
206156,10,16,3,0,13,3
206156,9,25,6,0,19,6
206156,8,135,31,6,104,25
206156,7,203,36,4,167,32
206156,6,206,33,6,173,27
206156,5,75,8,0,67,8
206156,4,41,12,3,29,9
206156,3,16,4,0,12,4
206156,2,4,3,0,1,3
206156,1,3,1,0,2,1
171630,10,13,4,0,9,4
171630,9,36,6,0,30,6
171630,8,127,19,0,108,19
171630,7,186,31,0,155,31
171630,6,248,35,0,213,35
171630,5,67,5,0,62,5
171630,4,25,3,0,22,3
171630,3,13,2,0,11,2
171630,2,4,3,0,1,3
218804,10,19,3,0,16,3
218804,9,67,12,0,55,12
218804,8,253,29,0,224,29
218804,7,192,21,0,171,21
218804,6,136,16,0,120,16
218804,5,31,8,0,23,8
218804,4,13,5,0,8,5
218804,3,5,1,0,4,1
218804,1,2,1,0,1,1
109969,10,20,5,0,15,5
109969,9,32,11,0,21,11
109969,8,150,31,0,119,31
109969,7,216,45,1,171,44
109969,6,183,33,0,150,33
109969,5,69,10,1,59,9
109969,4,23,7,0,16,7
109969,3,16,7,0,9,7
109969,2,10,2,0,8,2
89953,10,6,2,0,4,2
89953,8,28,9,0,19,9
89953,7,69,15,0,54,15
89953,6,184,28,0,156,28
89953,5,178,26,0,152,26
89953,4,130,35,0,95,35
89953,3,62,11,0,51,11
89953,2,36,12,0,24,12
89953,1,25,6,0,19,6
1425,10,32,19,0,13,19
1425,9,81,32,0,49,32
1425,8,166,60,0,106,60
1425,7,207,55,0,152,55
1425,6,169,51,0,118,51
1425,5,46,14,0,32,14
1425,4,8,4,0,4,4
1425,3,10,4,0,6,4
1425,2,3,1,0,2,1
338,10,14,11,0,3,11
338,9,25,14,0,11,14
338,8,172,64,0,108,64
338,7,239,81,0,158,81
338,6,176,49,0,127,49
338,5,59,25,0,34,25
338,4,23,8,0,15,8
338,3,9,3,0,6,3
338,2,4,4,0,0,4
160958,10,25,5,0,20,5
160958,9,42,7,0,35,7
160958,8,204,31,0,173,31
160958,7,229,28,0,201,28
160958,6,159,26,0,133,26
160958,5,42,9,0,33,9
160958,4,10,3,0,7,3
210900,10,9,6,0,3,6
210900,9,25,5,0,20,5
210900,8,178,27,0,151,27
210900,7,254,32,0,222,32
210900,6,175,24,0,151,24
210900,5,56,8,0,48,8
210900,4,12,2,0,10,2
210900,3,5,1,0,4,1
12063,10,9,5,0,4,5
12063,9,6,2,0,4,2
12063,8,32,11,0,21,11
12063,7,69,21,0,48,21
12063,6,231,70,0,161,70
12063,5,178,44,0,134,44
12063,4,121,32,0,89,32
12063,3,46,18,0,28,18
12063,2,21,8,0,13,8
12063,1,5,1,0,4,1
99437,10,3,1,0,2,1
99437,9,21,5,0,16,5
99437,8,91,19,0,72,19
99437,7,172,29,0,143,29
99437,6,239,34,0,205,34
99437,5,95,15,0,80,15
99437,4,49,10,0,39,10
99437,3,31,6,0,25,6
99437,2,9,4,0,5,4
99437,1,7,4,0,3,4
216632,10,37,19,0,18,19
216632,9,84,24,0,60,24
216632,8,220,33,0,187,33
216632,7,169,17,0,152,17
216632,6,142,24,0,118,24
216632,5,28,3,0,25,3
216632,4,20,8,0,12,8
216632,3,7,3,0,4,3
216632,2,10,7,0,3,7
854,10,7,5,0,2,5
854,9,22,9,0,13,9
854,8,130,39,0,91,39
854,7,216,46,0,170,46
854,6,217,58,0,159,58
854,5,75,21,0,54,21
854,4,38,17,0,21,17
854,3,10,5,0,5,5
854,2,1,1,0,0,1
2516,10,45,20,0,25,20
2516,9,84,28,0,56,28
2516,8,180,54,0,126,54
2516,7,186,34,0,152,34
2516,6,137,27,0,110,27
2516,5,44,9,0,35,9
2516,4,18,4,0,14,4
2516,3,12,3,0,9,3
2516,2,2,1,0,1,1
2516,1,8,1,0,7,1
43264,8,97,24,0,73,24
43264,7,222,50,0,172,50
43264,6,265,53,0,212,53
43264,5,78,12,0,66,12
43264,4,31,7,0,24,7
43264,3,12,2,0,10,2
43264,2,4,2,0,2,2
43264,1,2,1,0,1,1
17855,10,3,1,0,2,1
17855,9,4,1,0,3,1
17855,8,30,13,0,17,13
17855,7,114,36,0,78,36
17855,6,287,98,0,189,98
17855,5,165,44,0,121,44
17855,4,79,26,0,53,26
17855,3,24,8,0,16,8
17855,2,8,2,0,6,2
203102,10,33,13,0,20,13
203102,9,51,17,0,34,17
203102,8,184,34,0,150,34
203102,7,207,27,0,180,27
203102,6,153,26,0,127,26
203102,5,51,18,0,33,18
203102,4,19,7,0,12,7
203102,3,7,5,0,2,5
203102,2,8,3,0,5,3
203102,1,2,2,0,0,2
63632,10,7,2,0,5,2
63632,9,27,5,0,22,5
63632,8,186,41,0,145,41
63632,7,206,35,0,171,35
63632,6,189,34,0,155,34
63632,5,56,15,0,41,15
63632,4,27,9,0,18,9
63632,3,14,2,0,12,2
226322,9,11,1,0,10,1
226322,8,68,8,0,60,8
226322,7,152,20,0,132,20
226322,6,244,45,0,199,45
226322,5,106,18,0,88,18
226322,4,72,15,0,57,15
226322,3,37,6,0,31,6
226322,2,15,5,0,10,5
226322,1,6,1,0,5,1
102897,10,10,5,1,5,4
102897,9,19,5,0,14,5
102897,8,91,29,2,62,27
102897,7,168,40,5,128,35
102897,6,242,60,5,182,55
102897,5,103,26,1,77,25
102897,4,56,16,3,40,13
102897,3,14,4,0,10,4
102897,2,8,4,0,4,4
25794,10,36,15,0,21,15
25794,9,71,29,0,42,29
25794,8,183,52,0,131,52
25794,7,178,57,0,121,57
25794,6,148,43,0,105,43
25794,5,51,20,0,31,20
25794,4,26,8,0,18,8
25794,3,9,4,0,5,4
25794,2,6,2,0,4,2
25794,1,5,1,0,4,1
923,10,2,1,0,1,1
923,9,15,6,0,9,6
923,8,80,12,0,68,12
923,7,181,50,0,131,50
923,6,270,69,0,201,69
923,5,87,30,0,57,30
923,4,45,15,0,30,15
923,3,18,5,0,13,5
923,2,10,6,0,4,6
923,1,4,3,0,1,3
96188,9,12,3,0,9,3
96188,8,56,10,0,46,10
96188,7,119,25,0,94,25
96188,6,229,44,0,185,44
96188,5,152,36,0,116,36
96188,4,80,19,0,61,19
96188,3,33,8,0,25,8
96188,2,19,7,0,12,7
96188,1,9,6,0,3,6
10947,10,10,2,0,8,2
10947,9,22,11,0,11,11
10947,8,147,38,0,109,38
10947,7,201,54,0,147,54
10947,6,207,51,0,156,51
10947,5,57,19,0,38,19
10947,4,34,11,0,23,11
10947,3,22,11,0,11,11
10947,2,9,3,0,6,3
10947,1,3,3,0,0,3
162107,9,18,4,0,14,4
162107,8,99,23,0,76,23
162107,7,194,29,0,165,29
162107,6,273,50,0,223,50
162107,5,77,19,0,58,19
162107,4,30,9,0,21,9
162107,3,7,2,0,5,2
162107,2,8,6,0,2,6
509,10,2,1,0,1,1
509,9,11,5,0,6,5
509,8,52,19,0,33,19
509,7,136,35,0,101,35
509,6,231,74,0,157,74
509,5,149,45,0,104,45
509,4,73,30,0,43,30
509,3,38,17,0,21,17
509,2,18,14,0,4,14
509,1,2,1,0,1,1
179182,10,20,5,0,15,5
179182,9,56,10,0,46,10
179182,8,224,31,0,193,31
179182,7,202,13,0,189,13
179182,6,146,16,0,130,16
179182,5,31,11,0,20,11
179182,4,17,3,0,14,3
179182,3,7,1,0,6,1
179182,2,7,2,0,5,2
104377,10,4,1,0,3,1
104377,9,12,4,0,8,4
104377,8,115,20,0,95,20
104377,7,194,37,0,157,37
104377,6,255,50,0,205,50
104377,5,92,15,0,77,15
104377,4,20,5,0,15,5
104377,3,13,4,0,9,4
104377,2,4,2,0,2,2
214029,10,57,18,0,39,18
214029,9,147,36,0,111,36
214029,8,284,48,0,236,48
214029,7,104,30,0,74,30
214029,6,73,23,0,50,23
214029,5,30,12,0,18,12
214029,4,11,4,0,7,4
214029,3,8,7,0,1,7
134711,10,8,1,0,7,1
134711,9,16,3,0,13,3
134711,8,120,32,10,88,22
134711,7,200,43,6,157,37
134711,6,247,56,6,191,50
134711,5,79,18,2,61,16
134711,4,26,5,0,21,5
134711,3,9,3,0,6,3
134711,2,4,2,0,2,2
140343,10,30,9,0,21,9
140343,9,74,19,0,55,19
140343,8,224,56,0,168,56
140343,7,191,43,0,148,43
140343,6,119,22,0,97,22
140343,5,42,10,0,32,10
140343,4,18,7,0,11,7
140343,3,5,2,0,3,2
140343,2,4,3,0,1,3
3487,10,25,9,0,16,9
3487,9,29,14,0,15,14
3487,8,123,40,0,83,40
3487,7,146,39,0,107,39
3487,6,226,64,0,162,64
3487,5,84,16,0,68,16
3487,4,44,16,0,28,16
3487,3,23,13,0,10,13
3487,2,6,2,0,4,2
3487,1,4,1,0,3,1
99312,10,9,4,0,5,4
99312,9,23,9,0,14,9
99312,8,125,35,0,90,35
99312,7,201,30,0,171,30
99312,6,229,49,0,180,49
99312,5,68,21,0,47,21
99312,4,31,8,0,23,8
99312,3,12,4,0,8,4
99312,2,11,4,0,7,4
192673,10,18,6,0,12,6
192673,9,46,16,2,30,14
192673,8,150,30,3,120,27
192673,7,196,36,6,160,30
192673,6,171,27,1,144,26
192673,5,53,13,0,40,13
192673,4,33,14,4,19,10
192673,3,20,9,2,11,7
192673,2,17,6,1,11,5
192673,1,6,5,0,1,5
34496,10,34,9,0,25,9
34496,9,33,7,0,26,7
34496,8,133,29,0,104,29
34496,7,182,37,0,145,37
34496,6,173,37,0,136,37
34496,5,95,21,0,74,21
34496,4,31,6,0,25,6
34496,3,16,3,0,13,3
34496,2,4,1,0,3,1
34496,1,8,4,0,4,4
15474,9,10,1,0,9,1
15474,8,80,5,0,75,5
15474,7,184,16,0,168,16
15474,6,253,32,0,221,32
15474,5,103,11,0,92,11
15474,4,42,11,0,31,11
15474,3,15,2,0,13,2
2060,10,9,3,0,6,3
2060,9,11,2,0,9,2
2060,8,52,22,0,30,22
2060,7,124,48,0,76,48
2060,6,243,75,0,168,75
2060,5,143,44,0,99,44
2060,4,85,23,0,62,23
2060,3,25,17,0,8,17
2060,2,10,3,0,7,3
42448,10,21,5,0,16,5
42448,9,26,4,0,22,4
42448,8,93,13,0,80,13
42448,7,114,17,0,97,17
42448,6,223,29,0,194,29
42448,5,109,15,0,94,15
42448,4,62,15,0,47,15
42448,3,28,6,0,22,6
42448,2,16,3,0,13,3
42448,1,17,2,0,15,2
1209,10,27,7,0,20,7
1209,9,55,14,0,41,14
1209,8,149,34,0,115,34
1209,7,181,36,0,145,36
1209,6,156,45,0,111,45
1209,5,68,23,0,45,23
1209,4,39,15,0,24,15
1209,3,20,9,0,11,9
1209,2,7,4,0,3,4
1209,1,6,3,0,3,3
40235,9,4,1,0,3,1
40235,8,71,21,0,50,21
40235,7,157,49,0,108,49
40235,6,285,63,0,222,63
40235,5,120,27,0,93,27
40235,4,44,15,0,29,15
40235,3,15,5,0,10,5
40235,2,10,4,0,6,4
74390,10,6,1,0,5,1
74390,9,40,14,0,26,14
74390,8,204,57,2,147,55
74390,7,201,48,1,153,47
74390,6,161,51,1,110,50
74390,5,54,22,0,32,22
74390,4,28,8,1,20,7
74390,3,7,2,0,5,2
74390,2,5,1,0,4,1
176530,10,12,5,0,7,5
176530,9,54,19,0,35,19
176530,8,251,54,2,197,52
176530,7,219,41,2,178,39
176530,6,130,35,0,95,35
176530,5,28,8,0,20,8
176530,4,10,3,0,7,3
176530,3,3,1,0,2,1
117663,10,16,4,0,12,4
117663,9,30,6,0,24,6
117663,8,104,16,0,88,16
117663,7,184,22,0,162,22
117663,6,230,33,0,197,33
117663,5,77,5,0,72,5
117663,4,32,7,0,25,7
117663,3,19,6,0,13,6
117663,2,12,3,0,9,3
21293,8,43,11,0,32,11
21293,7,126,43,0,83,43
21293,6,236,71,0,165,71
21293,5,157,43,0,114,43
21293,4,61,21,0,40,21
21293,3,49,21,0,28,21
21293,2,23,14,0,9,14
21293,1,3,2,0,1,2
5770,10,11,3,0,8,3
5770,9,35,12,0,23,12
5770,8,117,45,0,72,45
5770,7,172,53,0,119,53
5770,6,200,51,0,149,51
5770,5,97,29,0,68,29
5770,4,48,16,0,32,16
5770,3,16,3,0,13,3
5770,2,10,3,0,7,3
3595,10,3,1,0,2,1
3595,9,23,6,0,17,6
3595,8,60,24,0,36,24
3595,7,139,43,0,96,43
3595,6,280,77,0,203,77
3595,5,108,31,0,77,31
3595,4,65,22,0,43,22
3595,3,23,6,0,17,6
3595,2,6,1,0,5,1
137155,10,7,3,0,4,3
137155,9,19,5,0,14,5
137155,8,164,62,0,102,62
137155,7,212,48,0,164,48
137155,6,213,49,0,164,49
137155,5,62,15,0,47,15
137155,4,19,6,0,13,6
137155,3,6,3,0,3,3
137155,2,4,2,0,2,2
4853,10,14,4,0,10,4
4853,9,13,4,0,9,4
4853,8,35,11,0,24,11
4853,7,111,33,0,78,33
4853,6,216,57,0,159,57
4853,5,147,35,0,112,35
4853,4,90,20,0,70,20
4853,3,46,19,0,27,19
4853,2,23,7,0,16,7
4853,1,11,5,0,6,5
789,10,19,5,0,14,5
789,9,27,13,0,14,13
789,8,101,38,0,63,38
789,7,193,54,0,139,54
789,6,226,64,0,162,64
789,5,79,25,0,54,25
789,4,38,9,0,29,9
789,3,14,3,0,11,3
789,2,6,2,0,4,2
3864,10,14,4,0,10,4
3864,9,31,11,0,20,11
3864,8,110,30,0,80,30
3864,7,139,46,0,93,46
3864,6,216,60,0,156,60
3864,5,99,32,0,67,32
3864,4,56,21,0,35,21
3864,3,28,13,0,15,13
3864,2,9,5,0,4,5
3864,1,3,2,0,1,2
8569,10,4,1,0,3,1
8569,9,2,1,0,1,1
8569,8,39,11,0,28,11
8569,7,68,17,0,51,17
8569,6,209,44,0,165,44
8569,5,148,43,0,105,43
8569,4,107,47,0,60,47
8569,3,63,25,0,38,25
8569,2,47,21,0,26,21
8569,1,17,12,0,5,12
41052,10,8,1,0,7,1
41052,9,22,3,0,19,3
41052,8,122,18,0,104,18
41052,7,206,35,0,171,35
41052,6,233,24,0,209,24
41052,5,62,11,0,51,11
41052,4,37,5,0,32,5
41052,3,10,3,0,7,3
41052,1,1,1,0,0,1
545,10,15,4,0,11,4
545,9,34,8,0,26,8
545,8,137,23,0,114,23
545,7,209,30,0,179,30
545,6,214,36,0,178,36
545,5,56,12,0,44,12
545,4,27,5,0,22,5
545,2,5,1,0,4,1
179835,9,28,6,0,22,6
179835,8,130,27,0,103,27
179835,7,200,36,0,164,36
179835,6,247,44,0,203,44
179835,5,59,10,0,49,10
179835,4,26,11,0,15,11
179835,3,10,3,0,7,3
179835,1,2,1,0,1,1
38026,10,12,2,0,10,2
38026,9,20,2,0,18,2
38026,8,81,18,0,63,18
38026,7,163,25,0,138,25
38026,6,272,52,0,220,52
38026,5,99,18,0,81,18
38026,4,36,10,0,26,10
38026,3,15,4,0,11,4
38026,2,5,1,0,4,1
38026,1,1,1,0,0,1
198609,10,29,6,1,23,5
198609,9,65,14,4,51,10
198609,8,291,40,4,251,36
198609,7,155,24,5,131,19
198609,6,106,23,0,83,23
198609,5,32,7,1,25,6
198609,4,15,8,0,7,8
198609,3,5,2,1,3,1
198609,2,7,4,0,3,4
198609,1,1,1,0,0,1
192802,10,27,8,0,19,8
192802,9,68,20,2,48,18
192802,8,290,59,2,231,57
192802,7,169,24,2,145,22
192802,6,123,26,1,97,25
192802,5,18,4,0,14,4
192802,4,5,2,0,3,2
192802,3,1,1,0,0,1
65564,10,82,33,0,49,33
65564,9,137,43,0,94,43
65564,8,260,74,0,186,74
65564,7,136,27,0,109,27
65564,6,59,19,0,40,19
65564,5,16,4,0,12,4
65564,4,1,1,0,0,1
65564,2,5,1,0,4,1
4395,10,2,1,0,1,1
4395,9,3,1,0,2,1
4395,8,51,21,0,30,21
4395,7,164,44,0,120,44
4395,6,229,75,0,154,75
4395,5,145,43,0,102,43
4395,4,65,21,0,44,21
4395,3,30,10,0,20,10
4395,2,12,7,0,5,7
4395,1,1,1,0,0,1
4035,8,24,6,0,18,6
4035,7,45,8,0,37,8
4035,6,154,38,0,116,38
4035,5,177,38,0,139,38
4035,4,128,38,0,90,38
4035,3,87,35,0,52,35
4035,2,67,30,0,37,30
4035,1,14,8,0,6,8
119337,10,9,3,0,6,3
119337,9,28,9,0,19,9
119337,8,172,47,0,125,47
119337,7,185,53,0,132,53
119337,6,180,47,0,133,47
119337,5,66,20,0,46,20
119337,4,39,15,0,24,15
119337,3,15,6,0,9,6
1126,10,7,2,0,5,2
1126,9,14,7,0,7,7
1126,8,50,14,0,36,14
1126,7,103,23,0,80,23
1126,6,206,57,0,149,57
1126,5,144,41,0,103,41
1126,4,74,28,0,46,28
1126,3,56,23,0,33,23
1126,2,31,25,0,6,25
1126,1,15,6,0,9,6
129359,10,30,4,0,26,4
129359,9,32,2,0,30,2
129359,8,115,10,0,105,10
129359,7,160,20,0,140,20
129359,6,183,23,0,160,23
129359,5,86,13,0,73,13
129359,4,45,9,0,36,9
129359,3,29,8,0,21,8
129359,2,12,3,0,9,3
129359,1,8,1,0,7,1
23604,10,26,11,0,15,11
23604,9,61,30,0,31,30
23604,8,213,74,0,139,74
23604,7,180,42,0,138,42
23604,6,137,42,0,95,42
23604,5,43,14,0,29,14
23604,4,21,10,0,11,10
23604,3,7,1,0,6,1
23604,2,7,3,0,4,3
23604,1,5,1,0,4,1
1350,10,5,1,0,4,1
1350,9,19,6,0,13,6
1350,8,122,41,0,81,41
1350,7,215,49,0,166,49
1350,6,209,57,0,152,57
1350,5,81,17,0,64,17
1350,4,24,10,0,14,10
1350,3,14,5,0,9,5
1350,2,7,6,0,1,6
1350,1,3,2,0,1,2
17816,10,7,1,0,6,1
17816,9,11,2,0,9,2
17816,8,50,17,0,33,17
17816,7,120,21,0,99,21
17816,6,245,48,0,197,48
17816,5,146,34,0,112,34
17816,4,60,16,0,44,16
17816,3,34,8,0,26,8
17816,2,18,4,0,14,4
17816,1,7,1,0,6,1
13530,10,4,1,0,3,1
13530,9,19,4,0,15,4
13530,8,89,29,0,60,29
13530,7,175,40,0,135,40
13530,6,266,70,0,196,70
13530,5,78,18,0,60,18
13530,4,40,11,0,29,11
13530,3,19,4,0,15,4
13530,2,6,2,0,4,2
13530,1,2,1,0,1,1
34169,10,16,2,0,14,2
34169,9,25,3,0,22,3
34169,8,78,16,0,62,16
34169,7,163,26,0,137,26
34169,6,228,42,0,186,42
34169,5,104,14,0,90,14
34169,4,45,15,0,30,15
34169,3,24,4,0,20,4
34169,2,10,4,0,6,4
34169,1,4,1,0,3,1
363,10,1,1,0,0,1
363,9,8,3,0,5,3
363,8,65,28,0,37,28
363,7,154,48,0,106,48
363,6,231,80,0,151,80
363,5,132,32,0,100,32
363,4,72,19,0,53,19
363,3,25,12,0,13,12
363,2,3,2,0,1,2
363,1,6,4,0,2,4
160561,10,6,2,0,4,2
160561,9,22,6,0,16,6
160561,8,146,22,0,124,22
160561,7,200,30,0,170,30
160561,6,183,36,0,147,36
160561,5,83,19,0,64,19
160561,4,39,11,0,28,11
160561,3,10,3,0,7,3
160561,2,4,1,0,3,1
160561,1,3,1,0,2,1
146408,10,26,9,0,17,9
146408,9,47,9,0,38,9
146408,8,157,23,2,134,21
146408,7,181,25,1,156,24
146408,6,163,39,0,124,39
146408,5,60,14,0,46,14
146408,4,38,10,0,28,10
146408,3,14,2,0,12,2
146408,2,8,3,0,5,3
7571,10,4,2,0,2,2
7571,9,21,7,0,14,7
7571,8,133,49,0,84,49
7571,7,208,70,0,138,70
7571,6,199,74,0,125,74
7571,5,63,21,0,42,21
7571,4,38,20,0,18,20
7571,3,16,10,0,6,10
7571,2,11,4,0,7,4
7571,1,2,1,0,1,1
256570,10,16,5,0,11,5
256570,9,68,9,0,59,9
256570,8,312,43,0,269,43
256570,7,177,21,0,156,21
256570,6,97,14,0,83,14
256570,5,22,7,0,15,7
256570,4,5,2,0,3,2
213266,10,21,9,0,12,9
213266,9,56,23,3,33,20
213266,8,227,51,2,176,49
213266,7,237,57,2,180,55
213266,6,137,17,1,120,16
213266,5,13,4,0,9,4
213266,4,4,1,0,3,1
1748,10,4,1,0,3,1
1748,9,9,3,0,6,3
1748,8,30,10,0,20,10
1748,7,62,10,0,52,10
1748,6,135,29,0,106,29
1748,5,130,32,0,98,32
1748,4,127,38,0,89,38
1748,3,85,34,0,51,34
1748,2,64,34,0,30,34
1748,1,47,25,0,22,25
84772,10,5,4,0,1,4
84772,9,23,8,0,15,8
84772,8,199,51,0,148,51
84772,7,255,58,0,197,58
84772,6,159,46,0,113,46
84772,5,32,13,0,19,13
84772,4,14,5,0,9,5
84772,3,5,2,0,3,2
125048,10,25,3,0,22,3
125048,9,36,3,0,33,3
125048,8,94,5,0,89,5
125048,7,187,11,0,176,11
125048,6,235,22,0,213,22
125048,5,70,9,0,61,9
125048,4,27,4,0,23,4
125048,3,12,2,0,10,2
125048,2,5,1,0,4,1
125048,1,3,2,0,1,2
186265,10,10,3,0,7,3
186265,9,8,2,0,6,2
186265,8,39,10,0,29,10
186265,7,115,22,0,93,22
186265,6,253,42,0,211,42
186265,5,162,29,0,133,29
186265,4,63,7,0,56,7
186265,3,27,9,0,18,9
186265,2,14,5,0,9,5
13071,10,7,2,0,5,2
13071,9,29,13,0,16,13
13071,8,118,37,0,81,37
13071,7,168,50,0,118,50
13071,6,212,50,0,162,50
13071,5,74,24,0,50,24
13071,4,44,16,0,28,16
13071,3,27,14,0,13,14
13071,2,9,5,0,4,5
13071,1,5,2,0,3,2
38718,10,56,18,0,38,18
38718,9,131,37,0,94,37
38718,8,301,64,0,237,64
38718,7,122,28,0,94,28
38718,6,56,16,0,40,16
38718,5,16,10,0,6,10
38718,4,5,3,0,2,3
38718,2,1,1,0,0,1
34166,10,4,1,0,3,1
34166,9,13,4,0,9,4
34166,8,103,36,0,67,36
34166,7,158,55,0,103,55
34166,6,236,63,0,173,63
34166,5,101,33,0,68,33
34166,4,44,11,0,33,11
34166,3,22,11,0,11,11
34166,2,10,2,0,8,2
34166,1,1,1,0,0,1
15889,10,19,5,0,14,5
15889,9,34,15,0,19,15
15889,8,133,51,0,82,51
15889,7,176,43,3,133,40
15889,6,187,44,0,143,44
15889,5,74,18,0,56,18
15889,4,43,14,0,29,14
15889,3,19,8,0,11,8
15889,2,7,3,0,4,3
15889,1,2,1,0,1,1
1036,10,12,3,1,9,2
1036,9,28,8,1,20,7
1036,8,163,35,2,128,33
1036,7,224,57,2,167,55
1036,6,166,34,0,132,34
1036,5,51,17,0,34,17
1036,4,28,7,0,21,7
1036,3,9,1,0,8,1
1036,2,10,3,0,7,3
33732,10,8,2,0,6,2
33732,9,13,2,0,11,2
33732,8,77,22,0,55,22
33732,7,184,52,0,132,52
33732,6,238,57,0,181,57
33732,5,89,36,0,53,36
33732,4,50,18,0,32,18
33732,3,20,5,0,15,5
33732,2,9,3,0,6,3
33732,1,3,1,0,2,1
484,10,9,7,0,2,7
484,9,18,4,0,14,4
484,8,53,18,0,35,18
484,7,114,34,0,80,34
484,6,227,60,0,167,60
484,5,140,42,0,98,42
484,4,76,37,0,39,37
484,3,37,19,0,18,19
484,2,17,7,0,10,7
39832,10,5,2,0,3,2
39832,9,19,5,0,14,5
39832,8,124,42,0,82,42
39832,7,219,60,0,159,60
39832,6,232,66,0,166,66
39832,5,58,25,0,33,25
39832,4,19,10,0,9,10
39832,3,9,4,0,5,4
39832,2,3,3,0,0,3
39832,1,2,1,0,1,1
204431,10,43,4,0,39,4
204431,9,70,10,1,60,9
204431,8,212,20,2,192,18
204431,7,173,26,2,147,24
204431,6,118,14,0,104,14
204431,5,31,5,0,26,5
204431,4,27,9,0,18,9
204431,3,9,5,0,4,5
13945,9,6,2,0,4,2
13945,8,26,1,0,25,1
13945,7,69,16,0,53,16
13945,6,185,34,0,151,34
13945,5,184,29,0,155,29
13945,4,111,36,0,75,36
13945,3,60,22,0,38,22
13945,2,33,11,0,22,11
13945,1,10,2,0,8,2
21133,10,135,29,0,106,29
21133,9,173,25,0,148,25
21133,8,185,32,0,153,32
21133,7,91,20,0,71,20
21133,6,61,11,0,50,11
21133,5,24,5,0,19,5
21133,4,7,4,0,3,4
21133,3,9,2,0,7,2
185,10,7,2,0,5,2
185,9,11,6,0,5,6
185,8,31,14,0,17,14
185,7,97,28,0,69,28
185,6,201,61,0,140,61
185,5,166,44,0,122,44
185,4,103,36,0,67,36
185,3,48,24,0,24,24
185,2,15,3,0,12,3
185,1,11,7,0,4,7
283,10,45,16,0,29,16
283,9,62,26,0,36,26
283,8,145,48,0,97,48
283,7,168,46,0,122,46
283,6,132,36,0,96,36
283,5,69,24,0,45,24
283,4,37,21,0,16,21
283,3,20,7,0,13,7
283,2,5,4,0,1,4
283,1,5,2,0,3,2
4953,9,15,3,0,12,3
4953,8,57,21,0,36,21
4953,7,92,37,0,55,37
4953,6,267,81,0,186,81
4953,5,137,48,0,89,48
4953,4,80,33,0,47,33
4953,3,22,7,0,15,7
4953,2,9,3,0,6,3
36367,10,70,16,0,54,16
36367,9,74,14,0,60,14
36367,8,169,34,0,135,34
36367,7,164,30,0,134,30
36367,6,122,23,0,99,23
36367,5,43,8,0,35,8
36367,4,24,4,0,20,4
36367,3,9,2,0,7,2
36367,2,3,2,0,1,2
36367,1,11,2,1,9,1
7336,10,6,2,0,4,2
7336,9,15,2,0,13,2
7336,8,48,8,0,40,8
7336,7,90,13,0,77,13
7336,6,209,41,0,168,41
7336,5,157,43,0,114,43
7336,4,89,23,0,66,23
7336,3,47,14,0,33,14
7336,2,19,9,0,10,9
7336,1,8,2,0,6,2
1770,10,58,24,0,34,24
1770,9,81,35,0,46,35
1770,8,181,62,0,119,62
1770,7,166,48,0,118,48
1770,6,120,43,0,77,43
1770,5,42,15,0,27,15
1770,4,19,3,0,16,3
1770,3,15,4,0,11,4
1770,2,5,2,0,3,2
1751,10,9,1,0,8,1
1751,9,6,2,0,4,2
1751,8,16,7,0,9,7
1751,7,44,6,0,38,6
1751,6,116,23,0,93,23
1751,5,131,30,0,101,30
1751,4,170,39,0,131,39
1751,3,96,26,0,70,26
1751,2,71,18,0,53,18
1751,1,28,7,0,21,7
334,10,2,1,0,1,1
334,9,8,2,0,6,2
334,8,25,8,0,17,8
334,7,88,27,0,61,27
334,6,222,84,0,138,84
334,5,169,46,0,123,46
334,4,106,36,0,70,36
334,3,47,15,0,32,15
334,2,15,8,0,7,8
334,1,5,3,0,2,3
24,10,25,7,0,18,7
24,9,48,20,0,28,20
24,8,141,49,0,92,49
24,7,179,49,0,130,49
24,6,151,47,0,104,47
24,5,71,27,0,44,27
24,4,39,14,0,25,14
24,3,19,11,0,8,11
24,2,11,3,0,8,3
24,1,2,1,0,1,1
142830,10,44,15,1,29,14
142830,9,43,10,1,33,9
142830,8,183,39,6,144,33
142830,7,163,31,2,132,29
142830,6,157,42,3,115,39
142830,5,55,10,0,45,10
142830,4,24,5,0,19,5
142830,3,14,1,0,13,1
191055,10,11,3,0,8,3
191055,9,26,7,0,19,7
191055,8,148,31,0,117,31
191055,7,238,30,0,208,30
191055,6,201,34,0,167,34
191055,5,50,13,0,37,13
191055,4,10,1,0,9,1
176334,9,12,2,0,10,2
176334,8,119,23,1,96,22
176334,7,208,38,0,170,38
176334,6,217,38,1,179,37
176334,5,77,11,0,66,11
176334,4,25,4,1,21,3
176334,3,16,5,0,11,5
176334,1,2,2,0,0,2
1463,10,12,4,0,8,4
1463,9,18,8,0,10,8
1463,8,77,16,0,61,16
1463,7,144,47,0,97,47
1463,6,233,69,0,164,69
1463,5,105,36,0,69,36
1463,4,51,17,0,34,17
1463,3,26,10,0,16,10
1463,2,13,7,0,6,7
1463,1,5,2,0,3,2
8804,10,10,1,0,9,1
8804,9,21,4,0,17,4
8804,8,76,10,0,66,10
8804,7,115,19,0,96,19
8804,6,184,36,0,148,36
8804,5,130,18,0,112,18
8804,4,58,10,0,48,10
8804,3,34,14,0,20,14
8804,2,33,13,0,20,13
8804,1,23,7,0,16,7
4149,10,7,4,0,3,4
4149,8,9,4,0,5,4
4149,7,16,5,0,11,5
4149,6,49,16,0,33,16
4149,5,99,36,0,63,36
4149,4,163,54,0,109,54
4149,3,146,48,0,98,48
4149,2,127,46,0,81,46
4149,1,66,26,0,40,26
48,9,8,5,0,3,5
48,8,75,19,0,56,19
48,7,192,41,0,151,41
48,6,226,35,0,191,35
48,5,112,37,0,75,37
48,4,42,15,0,27,15
48,3,17,5,0,12,5
48,2,10,2,0,8,2
137290,9,32,3,0,29,3
137290,8,141,25,0,116,25
137290,7,187,16,0,171,16
137290,6,192,19,0,173,19
137290,5,63,12,0,51,12
137290,4,35,7,0,28,7
137290,3,13,2,0,11,2
137290,1,2,1,0,1,1
235802,10,300,43,1,257,42
235802,9,199,25,2,174,23
235802,8,120,24,3,96,21
235802,7,34,5,0,29,5
235802,6,16,2,0,14,2
235802,5,8,1,0,7,1
235802,4,2,1,0,1,1
235802,3,2,2,0,0,2
32014,10,15,5,0,10,5
32014,9,37,8,0,29,8
32014,8,210,68,0,142,68
32014,7,158,50,0,108,50
32014,6,162,60,0,102,60
32014,5,52,20,0,32,20
32014,4,32,15,0,17,15
32014,3,10,3,0,7,3
32014,2,3,2,0,1,2
8147,10,6,2,0,4,2
8147,9,25,9,0,16,9
8147,8,130,29,0,101,29
8147,7,211,42,0,169,42
8147,6,214,26,0,188,26
8147,5,60,22,0,38,22
8147,4,23,7,0,16,7
8147,3,10,6,0,4,6
8147,2,3,2,0,1,2
2129,10,37,14,0,23,14
2129,9,33,8,0,25,8
2129,8,109,44,0,65,44
2129,7,157,52,0,105,52
2129,6,186,64,0,122,64
2129,5,88,30,0,58,30
2129,4,47,24,0,23,24
2129,3,17,5,0,12,5
2129,2,7,4,0,3,4
254018,10,27,8,0,19,8
254018,9,59,8,0,51,8
254018,8,246,31,0,215,31
254018,7,210,29,0,181,29
254018,6,103,14,0,89,14
254018,5,29,5,0,24,5
254018,4,7,2,0,5,2
99097,10,12,3,0,9,3
99097,9,21,3,0,18,3
99097,8,86,17,0,69,17
99097,7,138,22,0,116,22
99097,6,211,42,0,169,42
99097,5,110,19,0,91,19
99097,4,52,15,0,37,15
99097,3,35,13,0,22,13
99097,2,11,2,0,9,2
99097,1,5,1,0,4,1
252929,10,13,3,0,10,3
252929,9,29,8,0,21,8
252929,8,161,19,0,142,19
252929,7,224,33,0,191,33
252929,6,178,15,0,163,15
252929,5,46,9,0,37,9
252929,4,19,5,0,14,5
252929,3,7,2,0,5,2
252929,2,6,1,0,5,1
18932,10,12,7,0,5,7
18932,9,28,8,0,20,8
18932,8,105,41,0,64,41
18932,7,147,40,0,107,40
18932,6,194,60,0,134,60
18932,5,87,31,0,56,31
18932,4,48,24,0,24,24
18932,3,38,17,0,21,17
18932,2,16,13,0,3,13
18932,1,5,3,0,2,3
26235,9,6,3,0,3,3
26235,8,105,38,0,67,38
26235,7,224,63,0,161,63
26235,6,246,67,0,179,67
26235,5,70,23,0,47,23
26235,4,21,8,0,13,8
26235,3,4,1,0,3,1
192547,10,18,2,0,16,2
192547,9,43,10,0,33,10
192547,8,151,20,0,131,20
192547,7,200,18,0,182,18
192547,6,181,22,0,159,22
192547,5,57,9,0,48,9
192547,4,18,5,0,13,5
192547,3,6,1,0,5,1
192547,2,5,1,0,4,1
192547,1,1,1,0,0,1
35350,10,15,4,0,11,4
35350,9,42,14,0,28,14
35350,8,224,65,0,159,65
35350,7,210,65,0,145,65
35350,6,123,34,0,89,34
35350,5,31,8,0,23,8
35350,4,17,10,0,7,10
35350,3,11,5,0,6,5
35350,2,5,2,0,3,2
35350,1,1,1,0,0,1
41541,9,17,7,0,10,7
41541,8,31,6,0,25,6
41541,7,91,22,0,69,22
41541,6,181,52,0,129,52
41541,5,116,37,0,79,37
41541,4,99,28,0,71,28
41541,3,64,18,0,46,18
41541,2,40,14,0,26,14
41541,1,37,16,0,21,16
441,10,8,3,0,5,3
441,9,25,6,0,19,6
441,8,114,36,0,78,36
441,7,189,51,0,138,51
441,6,201,57,0,144,57
441,5,65,18,0,47,18
441,4,39,15,0,24,15
441,3,26,12,0,14,12
441,2,8,2,0,6,2
441,1,3,2,0,1,2
207687,10,31,10,3,21,7
207687,9,30,6,1,24,5
207687,8,116,29,4,87,25
207687,7,170,32,6,138,26
207687,6,184,32,7,152,25
207687,5,59,8,0,51,8
207687,4,49,7,0,42,7
207687,3,20,8,2,12,6
207687,2,14,6,1,8,5
207687,1,6,3,0,3,3
30356,10,5,3,0,2,3
30356,9,25,6,0,19,6
30356,8,164,49,0,115,49
30356,7,245,58,0,187,58
30356,6,182,38,0,144,38
30356,5,35,9,0,26,9
30356,4,14,4,0,10,4
30356,3,6,2,0,4,2
3608,10,19,7,0,12,7
3608,9,21,8,0,13,8
3608,8,99,47,0,52,47
3608,7,180,45,0,135,45
3608,6,205,61,0,144,61
3608,5,101,34,0,67,34
3608,4,34,12,0,22,12
3608,3,13,8,0,5,8
3608,2,6,5,0,1,5
216,10,6,2,0,4,2
216,9,7,2,0,5,2
216,8,56,21,0,35,21
216,7,127,54,0,73,54
216,6,243,82,0,161,82
216,5,131,55,0,76,55
216,4,68,30,0,38,30
216,3,31,17,0,14,17
216,2,7,4,0,3,4
216,1,3,2,0,1,2
177197,10,21,5,0,16,5
177197,9,50,11,0,39,11
177197,8,198,39,0,159,39
177197,7,188,27,0,161,27
177197,6,137,17,0,120,17
177197,5,54,15,0,39,15
177197,4,18,1,0,17,1
177197,3,10,2,0,8,2
1545,10,9,6,0,3,6
1545,9,19,8,0,11,8
1545,8,136,63,0,73,63
1545,7,212,88,0,124,88
1545,6,186,54,0,132,54
1545,5,73,28,0,45,28
1545,4,30,17,0,13,17
1545,3,7,3,0,4,3
1545,2,1,1,0,0,1
187104,10,8,3,0,5,3
187104,9,18,4,0,14,4
187104,8,108,21,0,87,21
187104,7,162,24,0,138,24
187104,6,204,24,0,180,24
187104,5,82,14,0,68,14
187104,4,53,15,0,38,15
187104,3,25,6,0,19,6
187104,1,10,2,0,8,2
38309,10,35,8,0,27,8
38309,9,82,26,0,56,26
38309,8,264,81,0,183,81
38309,7,161,49,0,112,49
38309,6,88,26,0,62,26
38309,5,25,13,0,12,13
38309,4,12,7,0,5,7
38309,3,5,3,0,2,3
38309,2,3,1,0,2,1
198522,10,28,7,0,21,7
198522,9,60,13,0,47,13
198522,8,193,38,0,155,38
198522,7,198,43,0,155,43
198522,6,144,23,0,121,23
198522,5,41,13,0,28,13
198522,4,6,1,0,5,1
198522,3,4,2,0,2,2
4168,10,8,4,0,4,4
4168,9,20,9,0,11,9
4168,8,55,31,0,24,31
4168,7,119,38,0,81,38
4168,6,236,80,0,156,80
4168,5,127,46,0,81,46
4168,4,71,37,0,34,37
4168,3,28,10,0,18,10
4168,2,9,6,0,3,6
4168,1,3,1,0,2,1
88594,10,6,1,0,5,1
88594,9,12,4,0,8,4
88594,8,105,22,0,83,22
88594,7,199,46,0,153,46
88594,6,218,53,0,165,53
88594,5,86,21,0,65,21
88594,4,29,14,0,15,14
88594,3,11,2,0,9,2
88594,2,8,2,0,6,2
64826,10,15,8,2,7,6
64826,9,32,8,0,24,8
64826,8,172,50,6,122,44
64826,7,183,54,5,129,49
64826,6,168,33,4,135,29
64826,5,61,15,0,46,15
64826,4,24,7,1,17,6
64826,3,15,2,0,13,2
148291,10,7,2,0,5,2
148291,9,36,8,0,28,8
148291,8,169,36,0,133,36
148291,7,185,36,0,149,36
148291,6,168,31,0,137,31
148291,5,58,9,0,49,9
148291,4,38,12,0,26,12
148291,2,7,5,0,2,5
148291,1,3,1,0,2,1
204837,10,27,4,0,23,4
204837,9,55,12,0,43,12
204837,8,172,29,0,143,29
204837,7,185,29,0,156,29
204837,6,140,21,0,119,21
204837,5,48,7,0,41,7
204837,4,18,1,0,17,1
204837,3,20,4,0,16,4
204837,2,6,3,0,3,3
204837,1,5,1,0,4,1
139992,10,23,8,0,15,8
139992,9,41,8,0,33,8
139992,8,188,33,4,155,29
139992,7,167,31,2,136,29
139992,6,138,32,3,106,29
139992,5,57,18,0,39,18
139992,4,26,12,1,14,11
139992,3,23,5,0,18,5
139992,2,7,1,0,6,1
139992,1,4,3,0,1,3
42490,10,5,1,0,4,1
42490,9,20,4,0,16,4
42490,8,132,34,0,98,34
42490,7,172,46,0,126,46
42490,6,222,42,0,180,42
42490,5,64,19,0,45,19
42490,4,37,9,0,28,9
42490,3,15,3,0,12,3
42490,2,7,2,0,5,2
18291,10,153,81,1,72,80
18291,9,44,26,0,18,26
18291,8,96,47,0,49,47
18291,7,114,48,0,66,48
18291,6,106,46,0,60,46
18291,5,72,29,0,43,29
18291,4,32,19,0,13,19
18291,3,8,1,0,7,1
35935,10,19,7,0,12,7
35935,9,31,13,0,18,13
35935,8,137,37,0,100,37
35935,7,185,42,0,143,42
35935,6,183,59,0,124,59
35935,5,70,24,0,46,24
35935,4,28,8,0,20,8
35935,3,9,2,0,7,2
35935,2,9,2,0,7,2
207016,10,13,2,0,11,2
207016,9,33,2,0,31,2
207016,8,196,24,0,172,24
207016,7,210,19,0,191,19
207016,6,144,15,0,129,15
207016,5,44,7,0,37,7
207016,4,19,3,0,16,3
207016,3,9,2,0,7,2
207016,2,5,1,0,4,1
126239,10,10,3,1,7,2
126239,9,23,7,2,16,5
126239,8,135,30,1,105,29
126239,7,167,32,1,135,31
126239,6,194,43,4,151,39
126239,5,76,16,0,60,16
126239,4,35,10,0,25,10
126239,3,19,7,0,12,7
126239,2,11,4,0,7,4
135262,10,24,5,0,19,5
135262,9,35,7,0,28,7
135262,8,102,23,0,79,23
135262,7,154,23,0,131,23
135262,6,234,55,0,179,55
135262,5,72,10,0,62,10
135262,4,33,9,0,24,9
135262,3,10,3,0,7,3
135262,1,3,2,0,1,2
220517,10,37,12,1,25,11
220517,9,110,30,3,80,27
220517,8,245,40,5,205,35
220517,7,143,26,2,117,24
220517,6,96,15,0,81,15
220517,5,28,5,0,23,5
220517,4,12,5,0,7,5
38391,9,12,1,0,11,1
38391,8,78,10,0,68,10
38391,7,160,24,0,136,24
38391,6,265,42,0,223,42
38391,5,89,9,0,80,9
38391,4,34,8,0,26,8
38391,3,21,1,0,20,1
38391,2,9,2,0,7,2
56885,10,34,4,0,30,4
56885,9,63,5,0,58,5
56885,8,186,27,0,159,27
56885,7,158,18,0,140,18
56885,6,140,15,0,125,15
56885,5,42,6,0,36,6
56885,4,17,1,0,16,1
56885,2,11,1,0,10,1
56885,1,9,1,0,8,1
214396,10,22,8,0,14,8
214396,9,43,12,1,31,11
214396,8,203,35,5,168,30
214396,7,208,32,3,176,29
214396,6,141,18,3,123,15
214396,5,38,9,1,29,8
214396,4,9,2,0,7,2
214396,3,5,1,0,4,1
6209,10,15,6,0,9,6
6209,9,30,13,0,17,13
6209,8,85,34,0,51,34
6209,7,182,50,0,132,50
6209,6,210,63,0,147,63
6209,5,68,17,0,51,17
6209,4,44,19,0,25,19
6209,3,23,15,0,8,15
6209,2,13,7,0,6,7
130680,10,8,2,0,6,2
130680,9,40,4,0,36,4
130680,8,106,8,0,98,8
130680,7,173,15,0,158,15
130680,6,180,24,0,156,24
130680,5,83,12,0,71,12
130680,4,46,4,0,42,4
130680,3,19,2,0,17,2
130680,2,12,1,0,11,1
130680,1,5,2,0,3,2
145012,10,10,2,0,8,2
145012,9,16,2,0,14,2
145012,8,132,25,0,107,25
145012,7,198,32,0,166,32
145012,6,214,31,0,183,31
145012,5,62,11,0,51,11
145012,4,31,7,0,24,7
145012,3,8,1,0,7,1
145012,1,1,1,0,0,1
831,10,7,4,0,3,4
831,9,27,12,0,15,12
831,8,109,40,0,69,40
831,7,204,58,0,146,58
831,6,193,56,0,137,56
831,5,78,27,0,51,27
831,4,35,10,0,25,10
831,3,16,2,0,14,2
831,2,2,1,0,1,1
31,10,8,2,0,6,2
31,9,8,4,0,4,4
31,8,34,9,0,25,9
31,7,86,21,0,65,21
31,6,177,45,0,132,45
31,5,158,43,0,115,43
31,4,99,36,0,63,36
31,3,65,31,0,34,31
31,2,31,15,0,16,15
31,1,5,2,0,3,2
4475,8,74,14,1,60,13
4475,7,169,25,0,144,25
4475,6,271,61,0,210,61
4475,5,96,20,0,76,20
4475,4,32,9,0,23,9
4475,3,10,2,0,8,2
4475,2,4,2,0,2,2
3190,10,9,1,0,8,1
3190,9,12,2,0,10,2
3190,8,59,11,0,48,11
3190,7,162,28,0,134,28
3190,6,259,58,0,201,58
3190,5,93,18,0,75,18
3190,4,54,15,0,39,15
3190,3,16,7,0,9,7
3190,2,5,3,0,2,3
13005,10,4,3,0,1,3
13005,9,25,6,0,19,6
13005,8,107,24,0,83,24
13005,7,213,60,0,153,60
13005,6,221,57,0,164,57
13005,5,62,18,0,44,18
13005,4,21,7,0,14,7
13005,3,9,5,0,4,5
13005,2,6,2,0,4,2
231999,10,22,5,0,17,5
231999,9,45,15,0,30,15
231999,8,144,27,0,117,27
231999,7,192,25,0,167,25
231999,6,193,32,0,161,32
231999,5,42,7,0,35,7
231999,4,22,5,0,17,5
231999,3,9,6,0,3,6
231999,1,1,1,0,0,1
1827,10,12,6,0,6,6
1827,9,20,6,0,14,6
1827,8,76,23,0,53,23
1827,7,116,39,0,77,39
1827,6,208,69,0,139,69
1827,5,111,30,0,81,30
1827,4,62,17,0,45,17
1827,3,34,15,0,19,15
1827,2,19,8,0,11,8
1827,1,12,8,0,4,8
154600,10,10,3,0,7,3
154600,9,8,3,0,5,3
154600,8,81,12,0,69,12
154600,7,163,21,0,142,21
154600,6,247,37,0,210,37
154600,5,91,18,0,73,18
154600,4,46,7,0,39,7
154600,3,12,5,0,7,5
154600,2,10,4,0,6,4
35188,10,54,9,0,45,9
35188,9,38,10,0,28,10
35188,8,90,14,0,76,14
35188,7,119,16,0,103,16
35188,6,137,21,0,116,21
35188,5,65,11,0,54,11
35188,4,35,7,0,28,7
35188,3,25,6,0,19,6
35188,2,15,2,0,13,2
35188,1,91,33,0,58,33
209325,9,37,3,0,34,3
209325,8,196,18,0,178,18
209325,7,241,21,0,220,21
209325,6,161,20,0,141,20
209325,5,21,3,0,18,3
209325,4,8,1,0,7,1
17709,10,3,2,0,1,2
17709,9,8,1,0,7,1
17709,8,32,9,0,23,9
17709,7,96,24,0,72,24
17709,6,194,42,0,152,42
17709,5,163,29,0,134,29
17709,4,103,18,0,85,18
17709,3,41,12,0,29,12
17709,2,24,9,0,15,9
17709,1,4,1,0,3,1
174837,10,50,15,1,35,14
174837,9,106,31,1,75,30
174837,8,268,59,6,209,53
174837,7,127,21,0,106,21
174837,6,79,12,1,67,11
174837,5,19,6,0,13,6
174837,4,16,4,0,12,4
174837,2,2,2,0,0,2
130060,10,18,2,0,16,2
130060,9,48,7,0,41,7
130060,8,171,12,0,159,12
130060,7,234,11,0,223,11
130060,6,157,10,0,147,10
130060,5,23,3,0,20,3
130060,4,15,2,0,13,2
12830,9,8,2,0,6,2
12830,8,58,16,0,42,16
12830,7,189,47,0,142,47
12830,6,273,73,0,200,73
12830,5,85,29,0,56,29
12830,4,36,13,0,23,13
12830,3,9,4,0,5,4
12830,2,7,5,0,2,5
28258,9,6,3,0,3,3
28258,8,29,6,0,23,6
28258,7,85,14,0,71,14
28258,6,245,41,0,204,41
28258,5,181,34,0,147,34
28258,4,63,21,0,42,21
28258,3,34,12,0,22,12
28258,2,18,7,0,11,7
28258,1,4,2,0,2,2
198138,10,22,5,0,17,5
198138,9,51,8,1,43,7
198138,8,197,31,4,166,27
198138,7,216,25,2,191,23
198138,6,121,24,3,97,21
198138,5,32,1,0,31,1
198138,4,21,5,0,16,5
198138,3,5,1,0,4,1
216428,10,23,9,0,14,9
216428,9,45,9,0,36,9
216428,8,236,44,0,192,44
216428,7,208,30,0,178,30
216428,6,112,15,0,97,15
216428,5,30,7,0,23,7
216428,4,7,2,0,5,2
216428,1,2,2,0,0,2
106753,8,70,10,0,60,10
106753,7,124,12,0,112,12
106753,6,255,31,0,224,31
106753,5,101,10,0,91,10
106753,4,55,4,0,51,4
106753,2,9,1,0,8,1
106753,1,2,1,0,1,1
6481,10,3,2,0,1,2
6481,9,8,5,0,3,5
6481,8,103,49,0,54,49
6481,7,205,97,0,108,97
6481,6,228,91,0,137,91
6481,5,69,26,0,43,26
6481,4,36,20,0,16,20
6481,3,12,9,0,3,9
191538,10,6,1,0,5,1
191538,9,25,3,0,22,3
191538,8,139,31,0,108,31
191538,7,196,27,0,169,27
191538,6,227,34,0,193,34
191538,5,53,4,0,49,4
191538,4,10,1,0,9,1
191538,3,7,2,0,5,2
15180,10,2,2,0,0,2
15180,9,5,1,0,4,1
15180,8,33,8,0,25,8
15180,7,135,38,0,97,38
15180,6,288,74,0,214,74
15180,5,107,28,0,79,28
15180,4,54,16,0,38,16
15180,3,30,7,0,23,7
15180,2,13,5,0,8,5
113819,10,9,1,0,8,1
113819,8,32,6,0,26,6
113819,7,67,8,0,59,8
113819,6,162,26,0,136,26
113819,5,122,26,0,96,26
113819,4,104,25,0,79,25
113819,3,53,17,0,36,17
113819,2,56,20,0,36,20
113819,1,50,23,0,27,23
23540,10,58,20,0,38,20
23540,9,167,61,0,106,61
23540,8,303,102,0,201,102
23540,7,82,31,0,51,31
23540,6,36,9,0,27,9
23540,5,11,3,0,8,3
23540,4,5,4,0,1,4
7824,10,9,3,0,6,3
7824,9,13,5,0,8,5
7824,8,63,25,0,38,25
7824,7,135,53,0,82,53
7824,6,259,108,0,151,108
7824,5,108,38,0,70,38
7824,4,51,13,0,38,13
7824,3,19,9,0,10,9
7824,2,5,3,0,2,3
7824,1,2,1,0,1,1
884,10,2,2,0,0,2
884,9,12,7,0,5,7
884,8,75,31,0,44,31
884,7,174,61,0,113,61
884,6,242,76,0,166,76
884,5,92,35,0,57,35
884,4,41,17,0,24,17
884,3,21,8,0,13,8
884,2,6,2,0,4,2
34010,10,6,2,0,4,2
34010,9,13,3,0,10,3
34010,8,83,19,0,64,19
34010,7,180,48,0,132,48
34010,6,240,60,0,180,60
34010,5,79,17,0,62,17
34010,4,39,9,0,30,9
34010,3,19,7,0,12,7
34010,2,3,1,0,2,1
1206,10,11,1,0,10,1
1206,9,26,11,0,15,11
1206,8,94,32,0,62,32
1206,7,183,57,0,126,57
1206,6,234,76,0,158,76
1206,5,70,16,0,54,16
1206,4,35,14,0,21,14
1206,3,10,2,0,8,2
759,10,29,11,0,18,11
759,9,49,15,0,34,15
759,8,216,69,0,147,69
759,7,207,57,0,150,57
759,6,111,28,0,83,28
759,5,32,9,0,23,9
759,4,14,4,0,10,4
759,3,4,2,0,2,2
33643,10,23,4,0,19,4
33643,9,36,14,0,22,14
33643,8,163,38,0,125,38
33643,7,208,59,0,149,59
33643,6,143,28,0,115,28
33643,5,51,14,0,37,14
33643,4,22,5,0,17,5
33643,3,12,2,0,10,2
33643,2,4,1,0,3,1
33643,1,2,1,0,1,1
29613,9,7,1,0,6,1
29613,8,29,7,0,22,7
29613,7,57,6,0,51,6
29613,6,175,34,0,141,34
29613,5,168,28,0,140,28
29613,4,117,29,0,88,29
29613,3,52,21,0,31,21
29613,2,42,17,0,25,17
29613,1,13,6,0,7,6
20,10,57,15,0,42,15
20,9,94,25,0,69,25
20,8,194,48,0,146,48
20,7,177,28,0,149,28
20,6,84,21,0,63,21
20,5,28,4,0,24,4
20,4,15,4,0,11,4
20,3,8,1,0,7,1
238992,10,55,9,1,46,8
238992,9,110,30,0,80,30
238992,8,245,41,6,204,35
238992,7,134,19,1,115,18
238992,6,85,14,1,71,13
238992,5,20,4,0,16,4
238992,4,11,3,0,8,3
238992,3,10,5,0,5,5
238992,2,4,3,0,1,3
238992,1,3,1,0,2,1
2876,10,17,7,0,10,7
2876,9,53,16,0,37,16
2876,8,110,32,0,78,32
2876,7,181,54,0,127,54
2876,6,179,51,0,128,51
2876,5,67,19,0,48,19
2876,4,32,14,0,18,14
2876,3,18,8,0,10,8
2876,2,3,2,0,1,2
2876,1,2,1,0,1,1
111173,9,10,3,0,7,3
111173,8,59,11,0,48,11
111173,7,171,25,0,146,25
111173,6,270,57,0,213,57
111173,5,90,21,0,69,21
111173,4,36,14,0,22,14
111173,3,17,4,0,13,4
111173,2,4,1,0,3,1
111173,1,3,2,0,1,2
152757,10,4,3,0,1,3
152757,9,15,4,0,11,4
152757,8,159,28,0,131,28
152757,7,210,38,0,172,38
152757,6,212,47,0,165,47
152757,5,40,8,0,32,8
152757,4,16,4,0,12,4
422,10,26,5,0,21,5
422,9,57,11,0,46,11
422,8,181,33,0,148,33
422,7,172,51,0,121,51
422,6,139,36,0,103,36
422,5,49,13,0,36,13
422,4,22,13,0,9,13
422,3,6,5,0,1,5
422,2,7,3,0,4,3
18748,10,51,18,0,33,18
18748,9,103,44,0,59,44
18748,8,255,93,0,162,93
18748,7,144,34,0,110,34
18748,6,59,26,0,33,26
18748,5,25,12,0,13,12
18748,4,14,8,0,6,8
18748,3,5,2,0,3,2
18748,2,3,2,0,1,2
173018,10,23,8,0,15,8
173018,9,37,7,1,30,6
173018,8,138,29,1,109,28
173018,7,142,22,2,120,20
173018,6,180,33,0,147,33
173018,5,67,12,0,55,12
173018,4,41,16,1,25,15
173018,3,11,2,0,9,2
173018,2,16,9,0,7,9
173018,1,5,3,0,2,3
85,10,17,6,0,11,6
85,9,29,9,0,20,9
85,8,168,80,0,88,80
85,7,224,89,0,135,89
85,6,156,57,0,99,57
85,5,41,18,0,23,18
85,4,14,5,0,9,5
85,3,5,3,0,2,3
85,2,6,1,0,5,1
669,10,16,2,0,14,2
669,9,24,6,0,18,6
669,8,86,36,0,50,36
669,7,158,55,0,103,55
669,6,176,64,0,112,64
669,5,94,33,0,61,33
669,4,62,23,0,39,23
669,3,31,19,0,12,19
669,2,10,6,0,4,6
669,1,3,1,0,2,1
163976,10,14,3,0,11,3
163976,9,25,5,3,20,2
163976,8,134,20,5,114,15
163976,7,202,28,2,174,26
163976,6,179,26,4,153,22
163976,5,63,18,0,45,18
163976,4,26,9,0,17,9
163976,3,8,4,0,4,4
163976,2,6,1,0,5,1
163976,1,3,1,1,2,0
95386,10,9,3,0,6,3
95386,9,19,3,0,16,3
95386,8,74,15,0,59,15
95386,7,130,16,0,114,16
95386,6,251,33,0,218,33
95386,5,89,12,0,77,12
95386,4,47,10,0,37,10
95386,3,29,7,0,22,7
95386,2,7,2,0,5,2
95386,1,4,2,0,2,2
38364,10,2,1,0,1,1
38364,9,9,2,0,7,2
38364,8,53,20,0,33,20
38364,7,154,43,0,111,43
38364,6,258,79,0,179,79
38364,5,92,32,0,60,32
38364,4,63,30,0,33,30
38364,3,21,6,0,15,6
38364,2,5,3,0,2,3
239840,10,18,7,0,11,7
239840,9,24,7,0,17,7
239840,8,182,27,0,155,27
239840,7,223,17,0,206,17
239840,6,146,27,0,119,27
239840,5,45,8,0,37,8
239840,4,12,6,0,6,6
239840,3,6,1,0,5,1
239840,2,2,1,0,1,1
7538,9,4,1,0,3,1
7538,8,36,19,0,17,19
7538,7,104,39,0,65,39
7538,6,266,98,0,168,98
7538,5,147,61,0,86,61
7538,4,65,25,0,40,25
7538,3,25,14,0,11,14
7538,2,5,3,0,2,3
7538,1,3,2,0,1,2
42444,10,6,1,0,5,1
42444,9,12,1,0,11,1
42444,8,89,23,0,66,23
42444,7,188,49,0,139,49
42444,6,233,70,1,163,69
42444,5,83,31,0,52,31
42444,4,29,10,0,19,10
42444,3,14,6,0,8,6
142334,10,8,1,0,7,1
142334,9,14,1,0,13,1
142334,8,55,11,0,44,11
142334,7,114,8,0,106,8
142334,6,237,33,0,204,33
142334,5,123,24,0,99,24
142334,4,66,9,0,57,9
142334,3,24,6,0,18,6
142334,2,11,1,0,10,1
142334,1,6,2,0,4,2
124827,10,48,17,1,31,16
124827,9,75,20,2,55,18
124827,8,246,61,5,185,56
124827,7,146,28,2,118,26
124827,6,93,18,1,75,17
124827,5,30,8,0,22,8
124827,4,17,7,0,10,7
1323,10,26,9,0,17,9
1323,9,45,13,0,32,13
1323,8,117,30,0,87,30
1323,7,198,40,0,158,40
1323,6,172,42,0,130,42
1323,5,45,7,0,38,7
1323,4,17,6,0,11,6
1323,3,10,4,0,6,4
1323,2,4,1,0,3,1
202,10,9,1,0,8,1
202,9,17,1,0,16,1
202,8,85,9,0,76,9
202,7,203,31,0,172,31
202,6,199,31,0,168,31
202,5,82,13,0,69,13
202,4,37,14,0,23,14
202,3,16,3,0,13,3
202,2,8,4,0,4,4
29096,9,2,2,0,0,2
29096,8,28,11,0,17,11
29096,7,55,16,0,39,16
29096,6,168,37,0,131,37
29096,5,148,22,0,126,22
29096,4,110,26,0,84,26
29096,3,67,20,0,47,20
29096,2,53,17,0,36,17
29096,1,25,10,0,15,10
130827,10,9,1,0,8,1
130827,9,21,4,0,17,4
130827,8,83,16,1,67,15
130827,7,177,34,0,143,34
130827,6,226,28,0,198,28
130827,5,84,13,0,71,13
130827,4,36,4,0,32,4
130827,3,15,3,0,12,3
130827,2,5,1,0,4,1
223770,9,43,8,0,35,8
223770,8,164,29,0,135,29
223770,7,230,48,0,182,48
223770,6,156,23,0,133,23
223770,5,30,6,0,24,6
223770,4,15,4,0,11,4
223770,3,8,3,0,5,3
223770,2,1,1,0,0,1
227460,10,179,44,2,135,42
227460,9,193,23,3,170,20
227460,8,193,27,1,166,26
227460,7,51,13,0,38,13
227460,6,24,2,0,22,2
227460,5,8,1,0,7,1
227460,4,4,3,0,1,3
142271,10,27,8,0,19,8
142271,9,55,10,0,45,10
142271,8,191,29,0,162,29
142271,7,178,23,0,155,23
142271,6,144,25,0,119,25
142271,5,37,5,0,32,5
142271,4,12,2,0,10,2
142271,3,8,3,0,5,3
142271,2,5,3,0,2,3
20865,10,3,2,0,1,2
20865,9,29,18,0,11,18
20865,8,150,60,0,90,60
20865,7,172,52,0,120,52
20865,6,158,73,0,85,73
20865,5,84,36,0,48,36
20865,4,38,17,0,21,17
20865,3,11,5,0,6,5
20865,2,8,4,0,4,4
20865,1,2,1,0,1,1
142,10,6,2,0,4,2
142,9,18,8,0,10,8
142,8,105,44,0,61,44
142,7,201,50,0,151,50
142,6,207,60,0,147,60
142,5,69,19,0,50,19
142,4,36,17,0,19,17
142,3,6,1,0,5,1
142,2,4,2,0,2,2
142,1,3,1,0,2,1
33040,9,11,1,0,10,1
33040,8,67,17,0,50,17
33040,7,121,12,0,109,12
33040,6,205,34,0,171,34
33040,5,119,15,0,104,15
33040,4,69,16,0,53,16
33040,3,25,5,0,20,5
33040,2,25,7,0,18,7
33040,1,4,1,0,3,1
1417,10,4,2,0,2,2
1417,9,7,1,0,6,1
1417,8,43,9,0,34,9
1417,7,104,33,0,71,33
1417,6,184,54,0,130,54
1417,5,149,43,0,106,43
1417,4,76,23,0,53,23
1417,3,53,19,0,34,19
1417,2,34,13,0,21,13
1417,1,1,1,0,0,1
142262,10,22,8,0,14,8
142262,9,25,7,0,18,7
142262,8,117,28,8,89,20
142262,7,158,34,2,124,32
142262,6,192,35,4,157,31
142262,5,81,17,1,64,16
142262,4,36,8,0,28,8
142262,3,15,5,1,10,4
142262,2,6,3,0,3,3
142262,1,3,1,0,2,1
1099,9,3,1,0,2,1
1099,8,35,9,0,26,9
1099,7,85,19,0,66,19
1099,6,219,37,0,182,37
1099,5,164,33,0,131,33
1099,4,107,27,0,80,27
1099,3,25,7,0,18,7
1099,2,8,2,0,6,2
1099,1,4,2,0,2,2
203411,10,23,4,0,19,4
203411,9,53,9,0,44,9
203411,8,213,34,0,179,34
203411,7,153,23,0,130,23
203411,6,127,19,0,108,19
203411,5,51,12,0,39,12
203411,4,25,7,0,18,7
203411,3,6,2,0,4,2
203411,2,2,1,0,1,1
8817,10,27,12,0,15,12
8817,9,56,13,0,43,13
8817,8,153,48,0,105,48
8817,7,167,51,0,116,51
8817,6,151,43,0,108,43
8817,5,61,20,0,41,20
8817,4,19,2,0,17,2
8817,3,9,5,0,4,5
8817,2,3,1,0,2,1
8817,1,5,1,0,4,1
8130,10,1,1,0,0,1
8130,9,8,5,0,3,5
8130,8,86,31,0,55,31
8130,7,222,75,0,147,75
8130,6,244,89,0,155,89
8130,5,58,22,0,36,22
8130,4,21,8,0,13,8
8130,3,7,1,0,6,1
8130,2,4,1,0,3,1
182120,10,12,1,0,11,1
182120,9,18,1,0,17,1
182120,8,132,19,0,113,19
182120,7,208,30,0,178,30
182120,6,192,27,0,165,27
182120,5,54,12,0,42,12
182120,4,22,8,0,14,8
182120,3,9,4,0,5,4
182120,2,4,3,0,1,3
83734,10,51,21,0,30,21
83734,9,107,30,0,77,30
83734,8,243,66,0,177,66
83734,7,133,29,0,104,29
83734,6,81,23,0,58,23
83734,5,19,6,0,13,6
83734,4,8,1,0,7,1
83734,3,3,1,0,2,1
8730,10,39,11,0,28,11
8730,9,74,24,0,50,24
8730,8,234,75,0,159,75
8730,7,181,41,0,140,41
8730,6,75,21,0,54,21
8730,5,27,7,0,20,7
8730,4,8,5,0,3,5
8730,3,7,4,0,3,4
8730,2,3,2,0,1,2
147030,9,10,2,0,8,2
147030,8,73,16,0,57,16
147030,7,130,10,0,120,10
147030,6,241,37,0,204,37
147030,5,79,10,0,69,10
147030,4,57,14,0,43,14
147030,3,28,5,0,23,5
147030,2,14,4,0,10,4
147030,1,11,1,0,10,1
192343,10,10,4,0,6,4
192343,9,28,1,0,27,1
192343,8,113,13,0,100,13
192343,7,171,19,0,152,19
192343,6,197,29,0,168,29
192343,5,76,11,0,65,11
192343,4,32,7,0,25,7
192343,3,14,3,0,11,3
192343,2,8,3,0,5,3
192343,1,2,1,0,1,1
9962,10,7,3,0,4,3
9962,9,11,1,0,10,1
9962,8,71,16,0,55,16
9962,7,118,17,0,101,17
9962,6,248,44,0,204,44
9962,5,108,22,0,86,22
9962,4,54,9,0,45,9
9962,3,21,6,0,15,6
9962,2,9,1,0,8,1
9962,1,2,1,0,1,1
290,10,1,1,0,0,1
290,9,5,1,0,4,1
290,8,47,18,0,29,18
290,7,105,35,0,70,35
290,6,247,85,0,162,85
290,5,142,52,0,90,52
290,4,69,31,0,38,31
290,3,21,8,0,13,8
290,2,8,4,0,4,4
290,1,4,1,0,3,1
4556,10,17,6,0,11,6
4556,9,31,17,0,14,17
4556,8,125,38,0,87,38
4556,7,172,50,0,122,50
4556,6,188,50,0,138,50
4556,5,70,27,0,43,27
4556,4,31,13,0,18,13
4556,3,11,7,0,4,7
4556,2,3,2,0,1,2
40432,10,13,1,0,12,1
40432,9,12,2,0,10,2
40432,8,65,15,0,50,15
40432,7,139,24,0,115,24
40432,6,263,45,0,218,45
40432,5,115,23,0,92,23
40432,4,26,7,0,19,7
40432,3,10,2,0,8,2
40432,2,4,2,0,2,2
40432,1,1,1,0,0,1
61,9,4,3,0,1,3
61,8,20,9,0,11,9
61,7,102,29,0,73,29
61,6,219,62,0,157,62
61,5,162,52,0,110,52
61,4,80,27,0,53,27
61,3,37,15,0,22,15
61,2,20,9,0,11,9
61,1,3,2,0,1,2
105187,10,15,2,0,13,2
105187,9,43,10,0,33,10
105187,8,155,29,0,126,29
105187,7,167,25,0,142,25
105187,6,137,18,0,119,18
105187,5,60,11,0,49,11
105187,4,37,6,0,31,6
105187,3,26,12,0,14,12
105187,2,8,2,0,6,2
9792,10,6,3,0,3,3
9792,9,10,3,0,7,3
9792,8,61,18,0,43,18
9792,7,138,40,0,98,40
9792,6,205,58,0,147,58
9792,5,104,34,0,70,34
9792,4,68,33,0,35,33
9792,3,34,18,0,16,18
9792,2,18,6,0,12,6
9792,1,4,2,0,2,2
98347,10,13,3,1,10,2
98347,9,39,6,0,33,6
98347,8,159,39,1,120,38
98347,7,173,37,2,136,35
98347,6,157,40,2,117,38
98347,5,66,18,3,48,15
98347,4,24,10,1,14,9
98347,3,12,3,0,9,3
98347,2,3,1,0,2,1
267,10,5,2,0,3,2
267,9,26,10,0,16,10
267,8,157,52,0,105,52
267,7,212,58,0,154,58
267,6,181,46,0,135,46
267,5,43,17,0,26,17
267,4,17,4,0,13,4
267,2,2,2,0,0,2
31291,10,26,14,0,12,14
31291,9,68,24,0,44,24
31291,8,212,52,0,160,52
31291,7,195,52,0,143,52
31291,6,93,26,0,67,26
31291,5,27,5,0,22,5
31291,4,11,4,0,7,4
31291,3,6,1,0,5,1
8829,10,21,3,0,18,3
8829,9,55,2,0,53,2
8829,8,158,14,0,144,14
8829,7,175,19,0,156,19
8829,6,153,12,0,141,12
8829,5,41,1,0,40,1
8829,4,26,4,0,22,4
8829,3,11,3,0,8,3
67181,10,13,2,0,11,2
67181,9,28,3,0,25,3
67181,8,134,19,0,115,19
67181,7,181,26,0,155,26
67181,6,188,25,0,163,25
67181,5,52,14,0,38,14
67181,4,33,4,0,29,4
67181,3,14,3,0,11,3
32382,10,6,3,0,3,3
32382,9,16,7,0,9,7
32382,8,130,53,0,77,53
32382,7,207,55,0,152,55
32382,6,187,57,0,130,57
32382,5,54,23,0,31,23
32382,4,28,14,0,14,14
32382,3,13,7,0,6,7
32382,2,4,2,0,2,2
3518,10,32,12,0,20,12
3518,9,55,25,0,30,25
3518,8,113,35,0,78,35
3518,7,161,30,0,131,30
3518,6,135,49,0,86,49
3518,5,67,25,0,42,25
3518,4,48,21,0,27,21
3518,3,21,11,0,10,11
3518,2,10,6,0,4,6
3518,1,3,1,0,2,1
208024,10,88,22,3,66,19
208024,9,144,29,1,115,28
208024,8,233,30,3,203,27
208024,7,109,26,0,83,26
208024,6,48,8,0,40,8
208024,5,12,4,0,8,4
208024,4,6,2,1,4,1
208024,3,3,2,0,1,2
208024,1,3,1,1,2,0
1203,10,10,4,0,6,4
1203,9,24,7,0,17,7
1203,8,73,31,0,42,31
1203,7,162,40,0,122,40
1203,6,209,55,0,154,55
1203,5,103,20,0,83,20
1203,4,38,22,0,16,22
1203,3,15,6,0,9,6
1203,2,7,2,0,5,2
1203,1,3,1,0,2,1
14258,10,8,5,0,3,5
14258,9,20,11,0,9,11
14258,8,83,37,0,46,37
14258,7,155,54,0,101,54
14258,6,197,63,0,134,63
14258,5,86,37,1,49,36
14258,4,49,18,0,31,18
14258,3,29,17,0,12,17
14258,2,15,7,0,8,7
14258,1,2,1,0,1,1
133956,10,53,9,0,44,9
133956,9,73,14,0,59,14
133956,8,178,49,0,129,49
133956,7,150,33,0,117,33
133956,6,121,28,0,93,28
133956,5,33,7,0,26,7
133956,4,19,7,0,12,7
133956,3,4,3,0,1,3
133956,2,7,5,0,2,5
133956,1,6,4,0,2,4
2689,10,24,7,0,17,7
2689,9,35,8,0,27,8
2689,8,148,51,0,97,51
2689,7,209,58,0,151,58
2689,6,157,54,0,103,54
2689,5,37,9,0,28,9
2689,4,21,7,0,14,7
2689,3,6,3,0,3,3
2689,2,5,3,0,2,3
2689,1,2,2,0,0,2
77,10,82,52,0,30,52
77,9,102,46,0,56,46
77,8,201,65,0,136,65
77,7,131,32,0,99,32
77,6,78,23,0,55,23
77,5,20,6,0,14,6
77,4,11,5,0,6,5
77,3,8,4,0,4,4
77,2,4,3,0,1,3
124969,10,47,3,0,44,3
124969,9,59,9,0,50,9
124969,8,240,33,0,207,33
124969,7,165,17,0,148,17
124969,6,99,16,0,83,16
124969,5,22,4,0,18,4
124969,4,7,1,0,6,1
230342,10,8,2,0,6,2
230342,9,26,4,0,22,4
230342,8,190,17,0,173,17
230342,7,217,24,0,193,24
230342,6,149,14,0,135,14
230342,5,31,5,0,26,5
230342,4,13,5,0,8,5
230342,3,6,1,0,5,1
230342,2,4,1,0,3,1
13751,10,11,6,0,5,6
13751,9,21,7,0,14,7
13751,8,119,35,0,84,35
13751,7,196,52,0,144,52
13751,6,187,57,0,130,57
13751,5,64,17,0,47,17
13751,4,23,9,0,14,9
13751,3,11,3,0,8,3
13751,2,5,3,0,2,3
13751,1,6,2,0,4,2
24843,9,27,7,0,20,7
24843,8,155,36,0,119,36
24843,7,201,60,0,141,60
24843,6,165,48,0,117,48
24843,5,50,21,0,29,21
24843,4,27,9,0,18,9
24843,3,9,6,0,3,6
24843,2,4,1,0,3,1
11057,10,54,13,0,41,13
11057,9,114,30,0,84,30
11057,8,250,74,0,176,74
11057,7,129,34,0,95,34
11057,6,54,18,0,36,18
11057,5,21,7,0,14,7
11057,4,8,3,0,5,3
11057,3,6,2,0,4,2
1309,10,7,4,0,3,4
1309,9,11,3,0,8,3
1309,8,80,30,0,50,30
1309,7,172,41,0,131,41
1309,6,214,71,0,143,71
1309,5,95,29,0,66,29
1309,4,46,10,0,36,10
1309,3,15,8,0,7,8
1309,2,2,1,0,1,1
6714,10,28,18,0,10,18
6714,9,50,39,0,11,39
6714,8,97,62,0,35,62
6714,7,139,81,0,58,81
6714,6,172,77,0,95,77
6714,5,80,28,0,52,28
6714,4,39,17,0,22,17
6714,3,23,10,0,13,10
6714,2,11,7,0,4,7
6714,1,2,1,0,1,1
148532,10,21,5,0,16,5
148532,9,43,2,0,41,2
148532,8,155,24,0,131,24
148532,7,191,24,0,167,24
148532,6,172,21,0,151,21
148532,5,37,9,0,28,9
148532,4,15,7,0,8,7
148532,2,3,2,0,1,2
148532,1,2,1,0,1,1
5824,10,3,1,0,2,1
5824,9,9,4,0,5,4
5824,8,39,14,0,25,14
5824,7,89,31,0,58,31
5824,6,173,67,0,106,67
5824,5,135,49,0,86,49
5824,4,104,41,0,63,41
5824,3,54,22,0,32,22
5824,2,21,13,0,8,13
5824,1,14,9,0,5,9
15549,10,7,3,0,4,3
15549,8,13,4,0,9,4
15549,7,15,2,0,13,2
15549,6,67,9,0,58,9
15549,5,67,16,0,51,16
15549,4,114,19,0,95,19
15549,3,103,25,0,78,25
15549,2,121,27,0,94,27
15549,1,128,37,0,91,37
78733,10,27,5,1,22,4
78733,9,80,26,0,54,26
78733,8,255,58,0,197,58
78733,7,150,34,0,116,34
78733,6,84,23,0,61,23
78733,5,25,10,0,15,10
78733,4,11,4,0,7,4
78733,3,3,2,0,1,2
213492,10,8,2,0,6,2
213492,9,22,4,0,18,4
213492,8,161,34,0,127,34
213492,7,221,21,0,200,21
213492,6,163,25,0,138,25
213492,5,39,7,0,32,7
213492,4,13,2,0,11,2
213492,3,9,1,0,8,1
213492,2,3,1,0,2,1
41658,10,8,3,0,5,3
41658,9,8,2,0,6,2
41658,8,67,15,0,52,15
41658,7,150,28,0,122,28
41658,6,257,55,0,202,55
41658,5,98,14,0,84,14
41658,4,35,6,0,29,6
41658,3,12,4,0,8,4
65534,10,17,8,0,9,8
65534,9,41,19,0,22,19
65534,8,164,40,0,124,40
65534,7,140,35,0,105,35
65534,6,156,47,0,109,47
65534,5,63,19,0,44,19
65534,4,31,13,0,18,13
65534,3,16,5,0,11,5
65534,2,6,4,0,2,4
65534,1,4,2,0,2,2
264,10,13,4,0,9,4
264,9,21,8,0,13,8
264,8,76,26,0,50,26
264,7,150,53,0,97,53
264,6,231,70,0,161,70
264,5,76,21,0,55,21
264,4,40,19,0,21,19
264,3,21,7,0,14,7
264,2,7,2,0,5,2
264,1,3,2,0,1,2
97273,9,18,6,0,12,6
97273,8,121,25,0,96,25
97273,7,205,45,0,160,45
97273,6,181,37,0,144,37
97273,5,71,21,0,50,21
97273,4,25,8,0,17,8
97273,3,8,4,0,4,4
97273,2,6,3,0,3,3
192120,10,9,1,0,8,1
192120,9,31,10,0,21,10
192120,8,146,12,0,134,12
192120,7,192,23,0,169,23
192120,6,178,18,0,160,18
192120,5,46,6,0,40,6
192120,4,24,4,0,20,4
192120,3,9,1,0,8,1
195372,10,20,1,0,19,1
195372,9,77,8,0,69,8
195372,8,233,32,0,201,32
195372,7,186,18,0,168,18
195372,6,89,3,0,86,3
195372,5,21,2,0,19,2
195372,4,8,2,0,6,2
195372,3,4,2,0,2,2
7062,10,13,8,0,5,8
7062,9,30,11,0,19,11
7062,8,129,47,0,82,47
7062,7,181,76,0,105,76
7062,6,179,62,0,117,62
7062,5,51,19,0,32,19
7062,4,32,15,0,17,15
7062,3,12,5,0,7,5
7062,2,7,3,0,4,3
7062,1,3,1,0,2,1
174524,10,33,9,2,24,7
174524,9,55,12,1,43,11
174524,8,196,28,8,168,20
174524,7,179,23,5,156,18
174524,6,124,18,2,106,16
174524,5,29,10,0,19,10
174524,4,11,3,0,8,3
174524,3,8,3,0,5,3
174524,2,1,1,0,0,1
182,9,14,6,0,8,6
182,8,88,42,0,46,42
182,7,172,70,0,102,70
182,6,241,104,0,137,104
182,5,85,27,0,58,27
182,4,20,9,0,11,9
182,3,11,5,0,6,5
6931,10,18,2,0,16,2
6931,9,28,6,0,22,6
6931,8,68,8,0,60,8
6931,7,149,27,0,122,27
6931,6,239,31,0,208,31
6931,5,82,16,0,66,16
6931,4,29,5,0,24,5
6931,3,15,3,0,12,3
6931,2,4,1,0,3,1
6931,1,3,1,0,2,1
25729,10,35,16,0,19,16
25729,9,83,30,0,53,30
25729,8,233,80,0,153,80
25729,7,163,50,0,113,50
25729,6,84,32,0,52,32
25729,5,25,7,0,18,7
25729,4,3,3,0,0,3
25729,2,1,1,0,0,1
91034,10,26,1,0,25,1
91034,9,36,11,0,25,11
91034,8,120,14,0,106,14
91034,7,194,32,0,162,32
91034,6,165,27,0,138,27
91034,5,63,17,0,46,17
91034,4,23,7,0,16,7
91034,3,7,3,0,4,3
91034,2,3,2,0,1,2
54433,10,6,2,0,4,2
54433,8,103,29,0,74,29
54433,7,158,38,0,120,38
54433,6,206,56,0,150,56
54433,5,74,31,0,43,31
54433,4,37,13,0,24,13
54433,3,30,11,0,19,11
54433,2,9,3,0,6,3
20133,10,22,11,0,11,11
20133,9,87,33,0,54,33
20133,8,237,85,0,152,85
20133,7,156,45,0,111,45
20133,6,89,30,0,59,30
20133,5,23,6,0,17,6
20133,4,9,5,0,4,5
20133,3,5,1,0,4,1
20133,2,4,1,0,3,1
142197,9,14,2,0,12,2
142197,8,46,10,0,36,10
142197,7,141,21,0,120,21
142197,6,220,29,0,191,29
142197,5,124,15,0,109,15
142197,4,55,13,0,42,13
142197,3,25,4,0,21,4
142197,2,6,2,0,4,2
206175,10,6,1,0,5,1
206175,9,20,6,0,14,6
206175,8,83,7,0,76,7
206175,7,165,15,0,150,15
206175,6,229,32,0,197,32
206175,5,78,15,0,63,15
206175,4,40,8,0,32,8
206175,3,7,1,0,6,1
206175,2,6,1,0,5,1
163931,10,7,1,0,6,1
163931,9,15,3,0,12,3
163931,8,126,32,0,94,32
163931,7,195,28,0,167,28
163931,6,205,49,0,156,49
163931,5,57,20,0,37,20
163931,4,19,2,0,17,2
163931,3,7,3,0,4,3
163931,2,3,2,0,1,2
14038,10,15,4,0,11,4
14038,9,37,8,0,29,8
14038,8,83,31,0,52,31
14038,7,95,29,0,66,29
14038,6,179,63,0,116,63
14038,5,101,35,0,66,35
14038,4,58,24,0,34,24
14038,3,40,17,0,23,17
14038,2,19,9,0,10,9
14038,1,6,2,0,4,2
651,10,4,1,0,3,1
651,9,12,3,0,9,3
651,8,101,18,0,83,18
651,7,191,35,0,156,35
651,6,221,22,0,199,22
651,5,58,12,0,46,12
651,4,31,4,0,27,4
651,3,10,3,0,7,3
651,2,4,1,0,3,1
651,1,1,1,0,0,1
175495,9,10,1,0,9,1
175495,8,86,9,0,77,9
175495,7,168,23,0,145,23
175495,6,223,22,0,201,22
175495,5,80,10,0,70,10
175495,4,32,7,0,25,7
175495,3,18,2,0,16,2
175495,1,3,2,0,1,2
144036,9,10,1,0,9,1
144036,8,45,8,0,37,8
144036,7,84,22,0,62,22
144036,6,223,48,0,175,48
144036,5,146,31,0,115,31
144036,4,66,14,0,52,14
144036,3,37,12,0,25,12
144036,2,17,4,0,13,4
144036,1,2,1,0,1,1
1452,10,14,8,0,6,8
1452,9,34,13,0,21,13
1452,8,129,46,0,83,46
1452,7,175,45,0,130,45
1452,6,169,51,0,118,51
1452,5,63,17,0,46,17
1452,4,29,8,0,21,8
1452,3,16,7,0,9,7
1452,2,3,1,0,2,1
258444,10,6,1,0,5,1
258444,9,36,11,0,25,11
258444,8,198,25,0,173,25
258444,7,224,30,0,194,30
258444,6,129,23,0,106,23
258444,5,21,1,0,20,1
258444,4,15,4,0,11,4
258444,3,3,1,0,2,1
26472,9,3,1,0,2,1
26472,8,40,17,0,23,17
26472,7,118,47,0,71,47
26472,6,250,94,0,156,94
26472,5,131,49,0,82,49
26472,4,56,25,0,31,25
26472,3,22,7,0,15,7
26472,2,9,6,0,3,6
26472,1,2,1,0,1,1
61487,10,133,38,0,95,38
61487,9,192,44,0,148,44
61487,8,197,50,0,147,50
61487,7,70,13,0,57,13
61487,6,25,10,0,15,10
61487,4,5,1,0,4,1
61487,3,3,3,0,0,3
61487,2,2,2,0,0,2
61487,1,4,2,0,2,2
142402,10,67,5,0,62,5
142402,9,65,4,0,61,4
142402,8,164,14,1,150,13
142402,7,168,18,2,150,16
142402,6,106,5,1,101,4
142402,5,32,2,0,30,2
142402,4,12,2,0,10,2
142402,2,4,2,0,2,2
85105,9,4,2,0,2,2
85105,8,53,12,0,41,12
85105,7,161,38,0,123,38
85105,6,265,58,0,207,58
85105,5,82,24,0,58,24
85105,4,38,14,0,24,14
85105,3,16,5,0,11,5
85105,2,6,1,0,5,1
85105,1,1,1,0,0,1
156442,10,23,11,1,12,10
156442,9,57,13,1,44,12
156442,8,195,41,6,154,35
156442,7,159,32,5,127,27
156442,6,134,35,4,99,31
156442,5,33,12,1,21,11
156442,4,14,5,0,9,5
156442,3,8,3,0,5,3
156442,2,3,3,0,0,3
156442,1,4,3,1,1,2
124968,10,42,5,0,37,5
124968,9,56,6,0,50,6
124968,8,214,33,0,181,33
124968,7,171,21,0,150,21
124968,6,107,20,0,87,20
124968,5,26,3,0,23,3
124968,4,12,4,0,8,4
217083,10,49,10,0,39,10
217083,9,76,17,0,59,17
217083,8,256,63,0,193,63
217083,7,149,22,0,127,22
217083,6,70,9,0,61,9
217083,5,21,6,0,15,6
217083,4,6,3,0,3,3
217083,3,3,1,0,2,1
125050,10,13,2,1,11,1
125050,9,35,8,2,27,6
125050,8,158,38,6,120,32
125050,7,172,31,5,141,26
125050,6,169,33,1,136,32
125050,5,46,19,0,27,19
125050,4,23,10,0,13,10
125050,3,11,5,3,6,2
125050,2,2,1,0,1,1
125050,1,1,1,0,0,1
1144,10,8,1,0,7,1
1144,9,13,6,0,7,6
1144,8,52,16,0,36,16
1144,7,115,27,0,88,27
1144,6,218,67,0,151,67
1144,5,120,39,0,81,39
1144,4,64,27,0,37,27
1144,3,27,12,0,15,12
1144,2,7,3,0,4,3
1144,1,4,2,0,2,2
5451,10,24,4,0,20,4
5451,9,43,8,0,35,8
5451,8,129,24,0,105,24
5451,7,166,33,0,133,33
5451,6,162,36,0,126,36
5451,5,58,11,0,47,11
5451,4,20,4,0,16,4
5451,3,15,7,0,8,7
5451,2,8,2,0,6,2
5451,1,3,1,0,2,1
31545,10,10,2,0,8,2
31545,9,24,8,0,16,8
31545,8,127,43,0,84,43
31545,7,180,46,0,134,46
31545,6,196,44,0,152,44
31545,5,54,15,0,39,15
31545,4,25,7,0,18,7
31545,3,7,2,0,5,2
31545,2,4,2,0,2,2
38797,10,4,1,0,3,1
38797,9,18,7,0,11,7
38797,8,161,50,0,111,50
38797,7,191,55,0,136,55
38797,6,179,53,0,126,53
38797,5,45,13,0,32,13
38797,4,18,2,0,16,2
38797,3,7,3,0,4,3
38797,2,5,2,0,3,2
154479,10,13,5,0,8,5
154479,9,14,3,0,11,3
154479,8,67,12,0,55,12
154479,7,134,30,0,104,30
154479,6,201,35,0,166,35
154479,5,109,17,0,92,17
154479,4,61,10,0,51,10
154479,3,19,8,0,11,8
154479,2,8,2,0,6,2
3041,10,42,20,0,22,20
3041,9,61,31,0,30,31
3041,8,188,74,0,114,74
3041,7,190,71,0,119,71
3041,6,88,29,0,59,29
3041,5,34,15,0,19,15
3041,4,14,4,0,10,4
3041,3,5,1,0,4,1
231819,10,11,3,0,8,3
231819,9,30,8,0,22,8
231819,8,159,13,0,146,13
231819,7,229,31,0,198,31
231819,6,127,12,0,115,12
231819,5,43,7,0,36,7
231819,4,17,6,0,11,6
231819,3,9,3,0,6,3
201054,9,13,2,0,11,2
201054,8,47,9,0,38,9
201054,7,116,26,0,90,26
201054,6,254,35,0,219,35
201054,5,109,23,0,86,23
201054,4,61,10,0,51,10
201054,3,17,7,0,10,7
154173,10,14,2,0,12,2
154173,9,37,10,0,27,10
154173,8,189,34,0,155,34
154173,7,198,38,0,160,38
154173,6,140,28,0,112,28
154173,5,34,4,0,30,4
154173,4,11,1,0,10,1
154173,3,2,1,0,1,1
1037,10,60,22,0,38,22
1037,9,69,21,0,48,21
1037,8,174,57,0,117,57
1037,7,139,38,0,101,38
1037,6,101,27,0,74,27
1037,5,51,20,0,31,20
1037,4,21,10,0,11,10
1037,3,9,5,0,4,5
1037,1,3,1,0,2,1
41302,10,21,8,0,13,8
41302,9,40,14,0,26,14
41302,8,120,39,0,81,39
41302,7,192,50,0,142,50
41302,6,158,37,0,121,37
41302,5,57,15,0,42,15
41302,4,26,6,0,20,6
41302,3,5,1,0,4,1
41302,2,5,1,0,4,1
41302,1,2,1,0,1,1
38749,9,38,11,0,27,11
38749,8,161,44,0,117,44
38749,7,180,43,0,137,43
38749,6,167,35,0,132,35
38749,5,40,8,0,32,8
38749,4,17,3,0,14,3
38749,3,7,2,0,5,2
38749,2,1,1,0,0,1
9606,10,3,1,0,2,1
9606,9,11,7,0,4,7
9606,8,80,39,0,41,39
9606,7,183,78,0,105,78
9606,6,222,91,0,131,91
9606,5,77,36,0,41,36
9606,4,36,16,0,20,16
9606,3,7,2,0,5,2
9606,2,5,1,0,4,1
23890,9,18,6,0,12,6
23890,8,117,45,0,72,45
23890,7,203,49,0,154,49
23890,6,189,52,0,137,52
23890,5,55,22,0,33,22
23890,4,21,10,0,11,10
23890,3,13,2,0,11,2
23890,2,2,1,0,1,1
71973,9,11,2,0,9,2
71973,8,95,17,0,78,17
71973,7,187,43,0,144,43
71973,6,211,59,0,152,59
71973,5,73,22,0,51,22
71973,4,33,8,0,25,8
71973,3,10,2,0,8,2
248,10,17,11,0,6,11
248,9,35,14,0,21,14
248,8,109,26,0,83,26
248,7,168,53,0,115,53
248,6,165,53,0,112,53
248,5,59,18,0,41,18
248,4,47,20,0,27,20
248,3,10,3,0,7,3
248,2,8,4,0,4,4
248,1,3,1,0,2,1
135654,10,13,4,0,9,4
135654,9,31,10,1,21,9
135654,8,195,27,3,168,24
135654,7,166,33,1,133,32
135654,6,142,34,2,108,32
135654,5,48,10,2,38,8
135654,4,23,6,0,17,6
16373,9,7,2,0,5,2
16373,8,80,35,0,45,35
16373,7,152,54,0,98,54
16373,6,231,84,0,147,84
16373,5,89,39,0,50,39
16373,4,42,15,0,27,15
16373,3,15,5,0,10,5
16373,2,4,1,0,3,1
1149,10,16,5,0,11,5
1149,9,23,11,0,12,11
1149,8,86,30,0,56,30
1149,7,100,29,0,71,29
1149,6,219,56,0,163,56
1149,5,110,35,0,75,35
1149,4,40,8,0,32,8
1149,3,20,9,0,11,9
1149,2,4,3,0,1,3
1149,1,3,2,0,1,2
229791,10,11,1,0,10,1
229791,9,43,12,0,31,12
229791,8,143,35,8,108,27
229791,7,171,30,4,141,26
229791,6,149,27,3,122,24
229791,5,60,21,1,39,20
229791,4,25,7,0,18,7
229791,3,13,5,1,8,4
229791,2,5,3,0,2,3
229791,1,1,1,0,0,1
163354,10,4,1,0,3,1
163354,9,5,1,0,4,1
163354,8,49,9,0,40,9
163354,7,136,28,0,108,28
163354,6,243,50,0,193,50
163354,5,112,19,0,93,19
163354,4,49,12,0,37,12
163354,3,17,2,0,15,2
163354,2,4,1,0,3,1
38821,10,30,3,0,27,3
38821,9,46,3,0,43,3
38821,8,130,16,0,114,16
38821,7,149,24,0,125,24
38821,6,151,19,0,132,19
38821,5,69,8,0,61,8
38821,4,29,4,0,25,4
38821,2,4,1,0,3,1
38821,1,5,1,0,4,1
161578,10,20,3,0,17,3
161578,9,21,5,0,16,5
161578,8,110,23,2,87,21
161578,7,141,27,3,114,24
161578,6,168,22,1,146,21
161578,5,66,13,2,53,11
161578,4,46,14,1,32,13
161578,3,30,5,0,25,5
161578,2,10,3,0,7,3
161578,1,8,4,1,4,3
156976,9,10,1,0,9,1
156976,8,63,15,0,48,15
156976,7,135,30,0,105,30
156976,6,228,43,0,185,43
156976,5,96,18,0,78,18
156976,4,51,14,0,37,14
156976,3,25,4,0,21,4
156976,2,7,4,0,3,4
6657,10,6,3,0,3,3
6657,9,24,6,0,18,6
6657,8,78,17,0,61,17
6657,7,137,28,0,109,28
6657,6,207,33,0,174,33
6657,5,83,18,0,65,18
6657,4,48,12,0,36,12
6657,3,22,9,0,13,9
6657,2,12,6,0,6,6
6657,1,3,2,0,1,2
139326,9,14,2,0,12,2
139326,8,133,22,0,111,22
139326,7,205,28,0,177,28
139326,6,180,34,0,146,34
139326,5,51,6,0,45,6
139326,4,21,11,0,10,11
139326,2,1,1,0,0,1
139326,1,1,1,0,0,1
246297,10,13,3,0,10,3
246297,9,32,3,0,29,3
246297,8,163,19,0,144,19
246297,7,193,24,0,169,24
246297,6,134,11,0,123,11
246297,5,44,6,0,38,6
246297,4,25,4,0,21,4
246297,3,8,4,0,4,4
155119,10,6,1,0,5,1
155119,9,8,1,0,7,1
155119,8,66,14,0,52,14
155119,7,143,26,0,117,26
155119,6,206,32,0,174,32
155119,5,85,14,0,71,14
155119,4,56,16,0,40,16
155119,3,28,5,0,23,5
155119,2,17,5,0,12,5
155119,1,4,2,0,2,2
43578,10,7,2,0,5,2
43578,9,19,3,0,16,3
43578,8,83,24,0,59,24
43578,7,158,37,0,121,37
43578,6,238,46,0,192,46
43578,5,70,15,0,55,15
43578,4,30,6,0,24,6
43578,3,11,3,0,8,3
197097,10,76,25,0,51,25
197097,9,115,28,0,87,28
197097,8,191,33,0,158,33
197097,7,110,21,0,89,21
197097,6,79,17,0,62,17
197097,5,23,4,0,19,4
197097,4,13,3,0,10,3
197097,3,3,3,0,0,3
197097,2,4,2,0,2,2
197097,1,5,1,0,4,1
33911,9,9,4,0,5,4
33911,8,64,17,0,47,17
33911,7,129,40,0,89,40
33911,6,235,65,0,170,65
33911,5,101,22,0,79,22
33911,4,43,20,0,23,20
33911,3,24,13,0,11,13
33911,2,7,4,0,3,4
33911,1,2,2,0,0,2
102435,10,62,25,0,37,25
102435,9,144,42,0,102,42
102435,8,243,70,0,173,70
102435,7,85,21,0,64,21
102435,6,54,20,0,34,20
102435,5,19,6,0,13,6
102435,4,7,3,0,4,3
102435,3,1,1,0,0,1
29259,10,22,2,0,20,2
29259,9,31,8,0,23,8
29259,8,158,48,0,110,48
29259,7,187,47,0,140,47
29259,6,148,28,0,120,28
29259,5,37,6,0,31,6
29259,4,17,8,0,9,8
29259,3,8,4,0,4,4
29259,2,6,2,0,4,2
29259,1,3,2,0,1,2
17393,10,56,26,0,30,26
17393,9,70,17,0,53,17
17393,8,189,39,0,150,39
17393,7,142,38,0,104,38
17393,6,97,31,0,66,31
17393,5,35,12,0,23,12
17393,4,16,9,0,7,9
17393,3,9,3,0,6,3
17393,2,1,1,0,0,1
17393,1,2,1,0,1,1
5620,10,62,27,0,35,27
5620,9,97,30,0,67,30
5620,8,153,42,0,111,42
5620,7,149,28,0,121,28
5620,6,85,29,0,56,29
5620,5,45,14,0,31,14
5620,4,17,8,0,9,8
3218,10,15,4,0,11,4
3218,9,18,4,0,14,4
3218,8,94,38,0,56,38
3218,7,151,48,0,103,48
3218,6,184,67,0,117,67
3218,5,104,35,0,69,35
3218,4,33,17,0,16,17
3218,3,11,2,0,9,2
3218,2,5,2,0,3,2
3218,1,1,1,0,0,1
2819,9,7,2,0,5,2
2819,8,46,10,0,36,10
2819,7,92,13,0,79,13
2819,6,163,23,0,140,23
2819,5,168,28,0,140,28
2819,4,77,20,0,57,20
2819,3,33,12,0,21,12
2819,2,18,6,0,12,6
2819,1,5,3,0,2,3
136356,9,12,4,0,8,4
136356,8,98,17,0,81,17
136356,7,181,22,0,159,22
136356,6,204,44,0,160,44
136356,5,75,12,0,63,12
136356,4,27,8,0,19,8
136356,3,13,4,0,9,4
136356,2,4,3,0,1,3
1717,10,26,7,0,19,7
1717,9,41,14,0,27,14
1717,8,132,38,0,94,38
1717,7,137,37,0,100,37
1717,6,156,37,0,119,37
1717,5,68,23,0,45,23
1717,4,33,10,0,23,10
1717,3,17,5,0,12,5
1717,2,3,1,0,2,1
2748,10,24,6,0,18,6
2748,9,52,18,0,34,18
2748,8,149,44,0,105,44
2748,7,159,43,0,116,43
2748,6,128,34,0,94,34
2748,5,44,16,0,28,16
2748,4,30,14,0,16,14
2748,3,18,11,0,7,11
2748,2,5,3,0,2,3
2748,1,5,4,0,1,4
114667,10,16,6,3,10,3
114667,9,26,11,1,15,10
114667,8,131,30,4,101,26
114667,7,145,28,3,117,25
114667,6,165,42,3,123,39
114667,5,69,21,0,48,21
114667,4,38,21,1,17,20
114667,3,13,6,0,7,6
114667,2,8,5,1,3,4
114667,1,4,4,0,0,4
121958,10,14,4,0,10,4
121958,9,25,4,0,21,4
121958,8,90,12,0,78,12
121958,7,137,20,0,117,20
121958,6,166,23,0,143,23
121958,5,91,21,0,70,21
121958,4,41,13,0,28,13
121958,3,27,8,0,19,8
121958,2,17,7,0,10,7
121958,1,5,2,0,3,2
329,10,44,21,0,23,21
329,9,56,20,0,36,20
329,8,159,54,0,105,54
329,7,179,45,0,134,45
329,6,107,28,0,79,28
329,5,35,9,0,26,9
329,4,21,5,0,16,5
329,3,6,3,0,3,3
329,2,3,1,0,2,1
299,10,55,28,0,27,28
299,9,68,20,0,48,20
299,8,147,45,0,102,45
299,7,170,41,0,129,41
299,6,96,29,0,67,29
299,5,39,16,0,23,16
299,4,19,7,0,12,7
299,3,11,6,0,5,6
299,2,5,2,0,3,2
253618,10,15,4,0,11,4
253618,9,39,4,0,35,4
253618,8,206,27,0,179,27
253618,7,205,29,0,176,29
253618,6,115,20,0,95,20
253618,5,28,2,0,26,2
253618,4,7,3,0,4,3
253618,3,3,2,0,1,2
191925,10,14,1,0,13,1
191925,9,17,2,0,15,2
191925,8,86,17,0,69,17
191925,7,185,22,0,163,22
191925,6,216,31,0,185,31
191925,5,62,6,0,56,6
191925,4,28,6,0,22,6
191925,3,5,1,0,4,1
1645,10,16,5,0,11,5
1645,9,32,18,0,14,18
1645,8,177,72,0,105,72
1645,7,201,65,0,136,65
1645,6,122,49,0,73,49
1645,5,39,17,0,22,17
1645,4,16,10,0,6,10
1645,3,6,2,0,4,2
232520,10,6,2,0,4,2
232520,9,34,9,2,25,7
232520,8,186,34,6,152,28
232520,7,234,32,2,202,30
232520,6,109,11,0,98,11
232520,5,29,6,0,23,6
232520,4,11,4,0,7,4
232520,2,1,1,0,0,1
172540,10,58,23,2,35,21
172540,9,58,13,2,45,11
172540,8,175,35,1,140,34
172540,7,135,17,1,118,16
172540,6,100,20,1,80,19
172540,5,36,10,0,26,10
172540,4,16,2,0,14,2
172540,3,19,4,0,15,4
172540,2,12,2,0,10,2
172540,1,2,1,0,1,1
207753,10,10,3,0,7,3
207753,9,13,3,0,10,3
207753,8,141,26,0,115,26
207753,7,176,26,0,150,26
207753,6,159,19,0,140,19
207753,5,74,11,0,63,11
207753,4,25,9,0,16,9
130592,8,55,5,0,50,5
130592,7,113,10,0,103,10
130592,6,236,16,0,220,16
130592,5,108,12,0,96,12
130592,4,55,7,0,48,7
130592,2,12,1,0,11,1
3464,10,76,21,1,55,20
3464,9,72,29,0,43,29
3464,8,116,41,1,75,40
3464,7,156,52,1,104,51
3464,6,111,32,1,79,31
3464,5,49,12,0,37,12
3464,4,22,9,0,13,9
3464,3,4,2,0,2,2
3464,2,5,1,0,4,1
144492,9,10,4,0,6,4
144492,8,84,21,0,63,21
144492,7,148,30,0,118,30
144492,6,213,34,0,179,34
144492,5,93,20,0,73,20
144492,4,45,10,0,35,10
144492,3,13,4,0,9,4
144492,2,4,1,0,3,1
194100,9,9,3,0,6,3
194100,8,90,21,0,69,21
194100,7,159,24,0,135,24
194100,6,206,33,0,173,33
194100,5,86,12,0,74,12
194100,4,29,7,0,22,7
194100,3,17,3,0,14,3
194100,2,9,4,0,5,4
1824,10,43,23,0,20,23
1824,9,8,6,0,2,6
1824,8,22,13,0,9,13
1824,7,51,21,0,30,21
1824,6,95,33,0,62,33
1824,5,95,32,0,63,32
1824,4,59,18,0,41,18
1824,3,36,9,0,27,9
1824,2,35,15,0,20,15
1824,1,166,51,0,115,51
66085,10,11,5,0,6,5
66085,9,28,10,0,18,10
66085,8,172,47,0,125,47
66085,7,195,36,0,159,36
66085,6,144,22,0,122,22
66085,5,40,10,0,30,10
66085,4,14,2,0,12,2
18460,10,44,22,0,22,22
18460,9,90,31,0,59,31
18460,8,193,63,0,130,63
18460,7,133,38,0,95,38
18460,6,92,33,0,59,33
18460,5,29,12,0,17,12
18460,4,13,5,0,8,5
18460,3,8,5,0,3,5
18460,2,3,2,0,1,2
18460,1,5,1,0,4,1
40761,10,9,2,0,7,2
40761,9,10,2,0,8,2
40761,8,73,14,0,59,14
40761,7,153,35,0,118,35
40761,6,232,53,0,179,53
40761,5,83,28,0,55,28
40761,4,32,8,0,24,8
40761,3,10,4,0,6,4
40761,2,6,3,0,3,3
1931,10,3,2,0,1,2
1931,8,7,2,0,5,2
1931,7,17,5,0,12,5
1931,6,57,11,0,46,11
1931,5,90,13,0,77,13
1931,4,140,30,0,110,30
1931,3,126,31,0,95,31
1931,2,95,28,0,67,28
1931,1,72,19,0,53,19
11265,10,11,4,0,7,4
11265,9,37,13,0,24,13
11265,8,184,79,0,105,79
11265,7,186,48,0,138,48
11265,6,115,41,0,74,41
11265,5,37,13,0,24,13
11265,4,20,11,0,9,11
11265,3,10,7,0,3,7
11265,2,6,1,0,5,1
677,10,4,2,0,2,2
677,8,13,6,0,7,6
677,7,40,9,0,31,9
677,6,99,23,0,76,23
677,5,142,33,0,109,33
677,4,137,35,0,102,35
677,3,74,25,0,49,25
677,2,66,26,0,40,26
677,1,33,16,0,17,16
2363,10,18,7,0,11,7
2363,9,34,9,0,25,9
2363,8,115,26,0,89,26
2363,7,163,34,0,129,34
2363,6,163,37,0,126,37
2363,5,72,17,0,55,17
2363,4,30,8,0,22,8
2363,3,9,1,0,8,1
2363,2,2,2,0,0,2
2363,1,2,1,0,1,1
3394,9,6,1,0,5,1
3394,8,29,7,0,22,7
3394,7,74,11,0,63,11
3394,6,141,22,0,119,22
3394,5,148,29,0,119,29
3394,4,106,25,0,81,25
3394,3,46,14,0,32,14
3394,2,33,7,0,26,7
3394,1,12,3,0,9,3
23010,10,23,5,0,18,5
23010,9,28,9,0,19,9
23010,8,82,18,0,64,18
23010,7,131,19,0,112,19
23010,6,189,49,0,140,49
23010,5,89,23,0,66,23
23010,4,44,9,0,35,9
23010,3,12,6,0,6,6
23010,2,7,2,0,5,2
23010,1,3,1,0,2,1
37296,10,3,1,0,2,1
37296,9,7,1,0,6,1
37296,8,89,27,0,62,27
37296,7,145,47,0,98,47
37296,6,243,80,0,163,80
37296,5,74,14,0,60,14
37296,4,30,12,0,18,12
37296,3,9,3,0,6,3
37296,2,6,2,0,4,2
8593,10,2,1,0,1,1
8593,9,4,3,0,1,3
8593,8,37,20,0,17,20
8593,7,85,28,0,57,28
8593,6,228,72,0,156,72
8593,5,122,40,0,82,40
8593,4,66,25,0,41,25
8593,3,35,10,0,25,10
8593,2,21,10,0,11,10
8593,1,7,4,0,3,4
246200,10,13,2,0,11,2
246200,9,37,10,0,27,10
246200,8,249,36,0,213,36
246200,7,188,30,0,158,30
246200,6,85,11,0,74,11
246200,5,25,10,0,15,10
246200,4,6,1,0,5,1
246200,3,4,3,0,1,3
359,10,2,2,0,0,2
359,9,10,3,0,7,3
359,8,55,24,0,31,24
359,7,135,50,0,85,50
359,6,239,69,0,170,69
359,5,91,21,0,70,21
359,4,45,16,0,29,16
359,3,21,8,0,13,8
359,1,4,2,0,2,2
4286,10,36,17,0,19,17
4286,9,42,8,0,34,8
4286,8,146,46,0,100,46
4286,7,153,43,0,110,43
4286,6,128,35,0,93,35
4286,5,54,13,0,41,13
4286,4,20,7,0,13,7
4286,3,12,6,0,6,6
4286,2,6,4,0,2,4
4286,1,7,1,0,6,1
65990,10,5,1,0,4,1
65990,9,17,6,0,11,6
65990,8,72,20,0,52,20
65990,7,127,34,0,93,34
65990,6,230,53,0,177,53
65990,5,68,27,0,41,27
65990,4,51,17,0,34,17
65990,3,16,5,0,11,5
65990,2,12,9,0,3,9
65990,1,6,5,0,1,5
4616,10,75,40,0,35,40
4616,9,55,22,0,33,22
4616,8,142,35,0,107,35
4616,7,142,46,0,96,46
4616,6,114,39,0,75,39
4616,5,52,19,0,33,19
4616,4,13,8,0,5,8
4616,3,6,3,0,3,3
147299,9,18,3,0,15,3
147299,8,105,18,2,87,16
147299,7,147,27,1,120,26
147299,6,184,40,2,144,38
147299,5,85,19,1,66,18
147299,4,34,12,0,22,12
147299,3,17,7,1,10,6
147299,2,6,2,0,4,2
147299,1,2,1,0,1,1
128565,10,8,1,0,7,1
128565,8,30,5,0,25,5
128565,7,74,7,0,67,7
128565,6,210,40,1,170,39
128565,5,112,24,0,88,24
128565,4,62,19,0,43,19
128565,3,52,16,1,36,15
128565,2,36,16,2,20,14
128565,1,10,1,0,9,1
27117,9,6,2,0,4,2
27117,8,83,21,0,62,21
27117,7,150,43,0,107,43
27117,6,236,78,0,158,78
27117,5,69,24,0,45,24
27117,4,42,22,0,20,22
27117,3,6,3,0,3,3
27117,2,8,2,0,6,2
124390,9,14,4,1,10,3
124390,8,63,13,1,50,12
124390,7,142,28,1,114,27
124390,6,237,54,3,183,51
124390,5,95,26,2,69,24
124390,4,28,8,0,20,8
124390,3,15,5,0,10,5
124390,2,7,4,0,3,4
167763,10,41,3,0,38,3
167763,9,66,8,0,58,8
167763,8,158,19,0,139,19
167763,7,176,20,0,156,20
167763,6,99,8,0,91,8
167763,5,38,12,0,26,12
167763,4,14,4,0,10,4
167763,1,1,1,0,0,1
232361,10,24,8,0,16,8
232361,9,60,12,0,48,12
232361,8,212,41,0,171,41
232361,7,148,16,1,132,15
232361,6,107,15,0,92,15
232361,5,32,4,0,28,4
232361,4,12,2,0,10,2
232361,2,5,1,0,4,1
96704,10,12,4,0,8,4
96704,9,26,8,0,18,8
96704,8,142,48,1,94,47
96704,7,175,51,1,124,50
96704,6,158,41,1,117,40
96704,5,57,13,1,44,12
96704,4,25,6,0,19,6
96704,3,5,3,0,2,3
144568,10,54,26,0,28,26
144568,9,124,37,1,87,36
144568,8,235,50,0,185,50
144568,7,110,19,0,91,19
144568,6,60,19,0,41,19
144568,5,12,4,0,8,4
144568,4,5,3,0,2,3
225,10,31,12,0,19,12
225,9,48,20,0,28,20
225,8,110,33,0,77,33
225,7,142,43,0,99,43
225,6,139,33,0,106,33
225,5,60,15,0,45,15
225,4,46,12,0,34,12
225,3,14,4,0,10,4
225,2,7,1,0,6,1
225,1,4,2,0,2,2
70519,10,39,14,0,25,14
70519,9,77,24,0,53,24
70519,8,240,70,0,170,70
70519,7,127,33,0,94,33
70519,6,74,20,0,54,20
70519,5,25,8,0,17,8
70519,4,14,6,0,8,6
70519,3,2,1,0,1,1
1814,10,7,2,0,5,2
1814,9,16,4,0,12,4
1814,8,69,22,0,47,22
1814,7,103,40,0,63,40
1814,6,219,59,0,160,59
1814,5,96,34,0,62,34
1814,4,54,20,0,34,20
1814,3,22,11,0,11,11
1814,2,12,5,0,7,5
1814,1,3,2,0,1,2
4112,10,57,27,0,30,27
4112,9,49,25,0,24,25
4112,8,102,35,0,67,35
4112,7,116,35,0,81,35
4112,6,141,49,0,92,49
4112,5,72,18,0,54,18
4112,4,43,11,0,32,11
4112,3,13,4,0,9,4
4112,2,5,1,0,4,1
4112,1,2,1,0,1,1
13456,10,11,1,0,10,1
13456,9,34,12,0,22,12
13456,8,103,34,0,69,34
13456,7,149,30,0,119,30
13456,6,171,33,0,138,33
13456,5,62,16,0,46,16
13456,4,36,14,0,22,14
13456,3,16,4,0,12,4
13456,2,13,7,0,6,7
13456,1,5,2,0,3,2
224904,10,11,6,0,5,6
224904,9,41,12,1,29,11
224904,8,182,28,0,154,28
224904,7,199,29,2,170,27
224904,6,126,30,0,96,30
224904,5,25,12,0,13,12
224904,4,14,5,0,9,5
224904,2,1,1,0,0,1
209001,10,48,11,2,37,9
209001,9,76,17,1,59,16
209001,8,219,31,5,188,26
209001,7,131,13,2,118,11
209001,6,74,16,2,58,14
209001,5,31,4,0,27,4
209001,4,11,8,0,3,8
209001,2,2,1,0,1,1
175095,10,92,31,1,61,30
175095,9,159,32,1,127,31
175095,8,220,47,3,173,44
175095,7,80,15,1,65,14
175095,6,36,7,0,29,7
175095,5,7,3,0,4,3
175095,4,1,1,0,0,1
175095,2,2,1,0,1,1
379,10,5,2,0,3,2
379,9,16,10,0,6,10
379,8,69,21,0,48,21
379,7,146,30,0,116,30
379,6,213,52,0,161,52
379,5,87,18,0,69,18
379,4,43,14,0,29,14
379,3,13,4,0,9,4
379,2,6,1,0,5,1
2922,9,6,2,0,4,2
2922,8,34,10,0,24,10
2922,7,98,18,0,80,18
2922,6,217,37,0,180,37
2922,5,121,28,0,93,28
2922,4,73,17,0,56,17
2922,3,34,10,0,24,10
2922,2,10,2,0,8,2
67593,9,10,3,0,7,3
67593,8,93,12,0,81,12
67593,7,138,19,0,119,19
67593,6,205,24,0,181,24
67593,5,79,13,0,66,13
67593,4,39,5,0,34,5
67593,3,20,6,0,14,6
67593,2,8,2,0,6,2
168839,10,16,5,0,11,5
168839,9,36,8,0,28,8
168839,8,101,23,0,78,23
168839,7,152,24,0,128,24
168839,6,176,36,0,140,36
168839,5,60,11,0,49,11
168839,4,32,8,0,24,8
168839,3,14,4,0,10,4
168839,1,4,1,0,3,1
42892,10,3,1,0,2,1
42892,9,2,1,0,1,1
42892,8,50,24,0,26,24
42892,7,97,24,0,73,24
42892,6,193,61,0,132,61
42892,5,100,32,0,68,32
42892,4,93,39,0,54,39
42892,3,39,15,0,24,15
42892,2,16,6,0,10,6
42892,1,5,1,0,4,1
158392,10,20,1,0,19,1
158392,9,18,3,0,15,3
158392,8,90,12,1,78,11
158392,7,142,5,0,137,5
158392,6,157,13,0,144,13
158392,5,76,6,1,70,5
158392,4,38,6,0,32,6
158392,3,29,5,0,24,5
158392,2,23,8,0,15,8
158392,1,3,1,0,2,1
129820,10,6,1,0,5,1
129820,9,19,3,0,16,3
129820,8,122,25,4,97,21
129820,7,163,35,3,128,32
129820,6,191,44,2,147,42
129820,5,59,15,2,44,13
129820,4,28,10,0,18,10
129820,3,7,2,0,5,2
872,10,4,3,0,1,3
872,9,13,5,0,8,5
872,8,98,35,0,63,35
872,7,175,49,0,126,49
872,6,199,56,0,143,56
872,5,53,19,0,34,19
872,4,38,13,0,25,13
872,3,12,3,0,9,3
872,2,4,1,0,3,1
872,1,1,1,0,0,1
2541,10,4,1,0,3,1
2541,9,10,7,0,3,7
2541,8,46,18,0,28,18
2541,7,100,33,0,67,33
2541,6,252,98,0,154,98
2541,5,109,44,0,65,44
2541,4,47,24,0,23,24
2541,3,19,12,0,7,12
2541,2,8,6,0,2,6
11104,10,6,3,0,3,3
11104,9,7,2,0,5,2
11104,8,68,22,0,46,22
11104,7,139,36,0,103,36
11104,6,218,56,0,162,56
11104,5,87,27,0,60,27
11104,4,42,14,0,28,14
11104,3,23,11,0,12,11
11104,2,5,2,0,3,2
230769,10,74,25,0,49,25
230769,9,104,24,2,80,22
230769,8,159,34,7,125,27
230769,7,104,18,1,86,17
230769,6,85,15,0,70,15
230769,5,31,7,0,24,7
230769,4,18,4,0,14,4
230769,3,10,1,0,9,1
230769,2,7,4,0,3,4
230769,1,6,2,1,4,1
16320,10,4,1,0,3,1
16320,9,5,1,0,4,1
16320,8,89,33,0,56,33
16320,7,157,45,0,112,45
16320,6,214,68,0,146,68
16320,5,77,29,0,48,29
16320,4,34,10,0,24,10
16320,3,13,6,0,7,6
175695,9,27,7,0,20,7
175695,8,200,45,4,155,41
175695,7,212,47,4,165,43
175695,6,110,23,1,87,22
175695,5,31,8,0,23,8
175695,4,7,3,0,4,3
175695,3,6,1,0,5,1
175695,2,2,2,0,0,2
175695,1,2,1,0,1,1
155,10,13,4,0,9,4
155,9,30,9,0,21,9
155,8,159,52,0,107,52
155,7,190,41,0,149,41
155,6,148,58,0,90,58
155,5,35,7,0,28,7
155,4,16,5,0,11,5
155,3,3,3,0,0,3
155,2,1,1,0,0,1
32032,10,11,1,0,10,1
32032,9,8,2,0,6,2
32032,8,30,2,0,28,2
32032,7,53,4,0,49,4
32032,6,131,15,0,116,15
32032,5,154,17,0,137,17
32032,4,93,18,0,75,18
32032,3,51,12,0,39,12
32032,2,42,10,0,32,10
32032,1,22,5,0,17,5
147790,9,6,2,0,4,2
147790,8,39,12,2,27,10
147790,7,112,27,0,85,27
147790,6,238,59,6,179,53
147790,5,108,20,2,88,18
147790,4,66,24,0,42,24
147790,3,15,4,0,11,4
147790,2,8,2,0,6,2
16498,10,3,2,0,1,2
16498,9,2,1,0,1,1
16498,8,24,6,0,18,6
16498,7,75,20,0,55,20
16498,6,222,63,0,159,63
16498,5,136,37,0,99,37
16498,4,67,16,0,51,16
16498,3,43,12,0,31,12
16498,2,20,5,0,15,5
3874,10,7,2,0,5,2
3874,9,18,6,0,12,6
3874,8,52,13,0,39,13
3874,7,109,31,0,78,31
3874,6,194,47,0,147,47
3874,5,120,31,0,89,31
3874,4,61,17,0,44,17
3874,3,21,7,0,14,7
3874,2,12,3,0,9,3
84465,10,28,14,0,14,14
84465,9,53,18,0,35,18
84465,8,215,68,0,147,68
84465,7,169,46,0,123,46
84465,6,88,29,0,59,29
84465,5,28,13,0,15,13
84465,4,5,2,0,3,2
84465,3,2,1,0,1,1
84465,2,4,2,0,2,2
21709,10,1,1,0,0,1
21709,8,49,11,0,38,11
21709,7,153,40,0,113,40
21709,6,244,71,0,173,71
21709,5,80,29,0,51,29
21709,4,40,10,0,30,10
21709,3,14,6,0,8,6
21709,2,4,3,0,1,3
130912,9,6,2,0,4,2
130912,8,61,14,0,47,14
130912,7,122,16,0,106,16
130912,6,165,34,0,131,34
130912,5,105,20,0,85,20
130912,4,66,13,0,53,13
130912,3,32,12,0,20,12
130912,2,21,5,0,16,5
130912,1,10,4,0,6,4
186701,10,17,2,0,15,2
186701,9,39,8,1,31,7
186701,8,146,29,6,117,23
186701,7,165,24,0,141,24
186701,6,171,31,4,140,27
186701,5,37,4,0,33,4
186701,3,2,2,0,0,2
245354,10,39,4,0,35,4
245354,9,100,13,0,87,13
245354,8,238,32,0,206,32
245354,7,112,11,0,101,11
245354,6,65,15,0,50,15
245354,5,22,3,0,19,3
245354,4,8,2,0,6,2
245354,3,8,1,0,7,1
2785,10,5,3,0,2,3
2785,9,3,3,0,0,3
2785,8,6,1,0,5,1
2785,7,18,4,0,14,4
2785,6,48,7,0,41,7
2785,5,74,7,0,67,7
2785,4,117,26,0,91,26
2785,3,98,27,0,71,27
2785,2,108,27,0,81,27
2785,1,113,45,0,68,45
4355,10,6,3,0,3,3
4355,9,12,3,0,9,3
4355,8,36,11,0,25,11
4355,7,81,12,0,69,12
4355,6,148,30,0,118,30
4355,5,138,16,0,122,16
4355,4,85,19,0,66,19
4355,3,54,10,0,44,10
4355,2,20,7,0,13,7
4355,1,12,3,0,9,3
142687,10,6,2,0,4,2
142687,9,17,6,1,11,5
142687,8,48,11,1,37,10
142687,7,120,22,4,98,18
142687,6,210,42,5,168,37
142687,5,108,24,3,84,21
142687,4,45,15,1,30,14
142687,3,27,7,0,20,7
5869,10,1,1,0,0,1
5869,9,6,2,0,4,2
5869,8,86,33,0,53,33
5869,7,160,62,0,98,62
5869,6,186,67,0,119,67
5869,5,82,31,0,51,31
5869,4,42,27,0,15,27
5869,3,18,11,0,7,11
5869,2,5,2,0,3,2
5869,1,4,2,0,2,2
56128,10,5,1,0,4,1
56128,9,11,1,0,10,1
56128,8,81,11,0,70,11
56128,7,146,14,0,132,14
56128,6,198,21,0,177,21
56128,5,82,9,0,73,9
56128,4,43,8,0,35,8
56128,3,11,1,0,10,1
56128,2,10,4,0,6,4
56128,1,3,1,0,2,1
4505,10,42,12,0,30,12
4505,9,54,13,0,41,13
4505,8,114,32,0,82,32
4505,7,132,25,0,107,25
4505,6,133,31,0,102,31
4505,5,51,15,0,36,15
4505,4,31,9,0,22,9
4505,3,12,6,0,6,6
4505,2,6,2,0,4,2
4505,1,15,2,0,13,2
3341,10,5,2,0,3,2
3341,9,9,4,0,5,4
3341,8,70,26,0,44,26
3341,7,126,26,0,100,26
3341,6,213,47,0,166,47
3341,5,90,18,0,72,18
3341,4,42,13,0,29,13
3341,3,20,7,0,13,7
3341,2,12,5,0,7,5
55705,10,8,1,0,7,1
55705,9,15,4,0,11,4
55705,8,72,18,0,54,18
55705,7,137,35,0,102,35
55705,6,201,52,0,149,52
55705,5,94,22,0,72,22
55705,4,43,12,0,31,12
55705,3,15,8,0,7,8
192351,10,5,1,0,4,1
192351,9,8,1,0,7,1
192351,8,79,14,1,65,13
192351,7,173,25,1,148,24
192351,6,219,39,1,180,38
192351,5,51,14,0,37,14
192351,4,27,8,0,19,8
192351,3,20,6,0,14,6
192351,2,6,1,0,5,1
192351,1,2,1,0,1,1
108665,10,16,5,0,11,5
108665,9,29,8,1,21,7
108665,8,88,17,3,71,14
108665,7,116,23,2,93,21
108665,6,154,31,2,123,29
108665,5,83,18,1,65,17
108665,4,44,13,0,31,13
108665,3,26,11,1,15,10
108665,2,22,4,1,18,3
108665,1,10,6,0,4,6
27298,9,8,3,0,5,3
27298,8,73,24,0,49,24
27298,7,156,48,0,108,48
27298,6,212,68,0,144,68
27298,5,76,32,0,44,32
27298,4,44,15,0,29,15
27298,3,7,3,0,4,3
27298,2,9,4,0,5,4
27298,1,2,1,0,1,1
165657,9,12,5,0,7,5
165657,8,65,16,0,49,16
165657,7,124,28,2,96,26
165657,6,189,36,3,153,33
165657,5,84,15,1,69,14
165657,4,55,12,0,43,12
165657,3,27,5,0,22,5
165657,2,16,3,1,13,2
225244,10,36,5,0,31,5
225244,9,94,19,0,75,19
225244,8,229,22,0,207,22
225244,7,161,17,0,144,17
225244,6,51,6,0,45,6
225244,5,11,1,0,10,1
225244,3,3,1,0,2,1
225244,2,2,1,0,1,1
3990,8,6,3,0,3,3
3990,7,25,6,0,19,6
3990,6,64,10,0,54,10
3990,5,108,21,0,87,21
3990,4,142,38,0,104,38
3990,3,99,29,0,70,29
3990,2,95,40,0,55,40
3990,1,47,22,0,25,22
238656,10,23,1,0,22,1
238656,9,57,9,1,48,8
238656,8,205,26,1,179,25
238656,7,189,29,2,160,27
238656,6,87,11,1,76,10
238656,5,19,5,1,14,4
238656,3,3,1,0,2,1
238656,1,1,1,1,0,0
38735,10,6,2,0,4,2
38735,9,12,5,0,7,5
38735,8,105,34,0,71,34
38735,7,157,40,0,117,40
38735,6,196,47,0,149,47
38735,5,63,17,0,46,17
38735,4,36,14,0,22,14
38735,3,6,3,0,3,3
38735,2,6,1,0,5,1
88016,9,19,4,0,15,4
88016,8,120,28,1,92,27
88016,7,139,29,1,110,28
88016,6,158,26,0,132,26
88016,5,81,20,0,61,20
88016,4,35,14,0,21,14
88016,3,20,9,0,11,9
88016,2,8,4,0,4,4
88016,1,2,1,0,1,1
156786,9,25,6,0,19,6
156786,8,80,13,0,67,13
156786,7,133,17,0,116,17
156786,6,173,18,0,155,18
156786,5,94,10,0,84,10
156786,4,35,8,0,27,8
156786,3,27,6,0,21,6
156786,2,11,4,0,7,4
156786,1,2,1,0,1,1
182116,10,4,2,0,2,2
182116,9,19,7,2,12,5
182116,8,93,20,3,73,17
182116,7,157,23,0,134,23
182116,6,216,43,4,173,39
182116,5,56,14,2,42,12
182116,4,30,14,0,16,14
182116,3,9,4,0,5,4
182116,2,2,1,0,1,1
2612,10,15,6,0,9,6
2612,9,66,24,0,42,24
2612,8,216,82,0,134,82
2612,7,152,66,0,86,66
2612,6,88,38,0,50,38
2612,5,22,12,0,10,12
2612,4,14,7,0,7,7
2612,3,5,3,0,2,3
2612,2,3,1,0,2,1
43249,9,7,5,0,2,5
43249,8,58,12,0,46,12
43249,7,143,44,0,99,44
43249,6,215,57,0,158,57
43249,5,77,26,0,51,26
43249,4,47,22,0,25,22
43249,3,20,9,0,11,9
43249,2,8,5,0,3,5
43249,1,3,1,0,2,1
27823,10,2,2,0,0,2
27823,9,11,6,0,5,6
27823,8,69,24,0,45,24
27823,7,124,43,0,81,43
27823,6,193,68,0,125,68
27823,5,99,37,0,62,37
27823,4,42,16,0,26,16
27823,3,26,12,0,14,12
27823,2,14,5,0,9,5
27823,1,4,2,0,2,2
179245,10,30,11,0,19,11
179245,9,43,13,3,30,10
179245,8,163,31,3,132,28
179245,7,173,21,0,152,21
179245,6,103,9,0,94,9
179245,5,39,9,2,30,7
179245,4,14,4,0,10,4
179245,3,11,2,0,9,2
179245,2,8,3,0,5,3
140795,10,9,2,0,7,2
140795,9,19,7,0,12,7
140795,8,89,21,0,68,21
140795,7,161,29,0,132,29
140795,6,183,39,0,144,39
140795,5,72,12,0,60,12
140795,4,33,7,0,26,7
140795,3,13,4,0,9,4
140795,2,4,2,0,2,2
101013,10,12,4,0,8,4
101013,9,36,9,0,27,9
101013,8,93,24,0,69,24
101013,7,159,44,0,115,44
101013,6,168,34,0,134,34
101013,5,59,11,0,48,11
101013,4,32,11,0,21,11
101013,3,16,5,0,11,5
101013,2,8,4,0,4,4
251412,10,16,7,0,9,7
251412,9,60,20,1,40,19
251412,8,224,45,3,179,42
251412,7,157,32,4,125,28
251412,6,99,28,3,71,25
251412,5,26,9,0,17,9
251412,4,5,1,0,4,1
3377,9,13,3,0,10,3
3377,8,50,14,0,36,14
3377,7,87,16,0,71,16
3377,6,192,36,0,156,36
3377,5,106,25,0,81,25
3377,4,66,17,0,49,17
3377,3,42,6,0,36,6
3377,2,18,5,0,13,5
3377,1,5,2,0,3,2
68606,10,23,4,0,19,4
68606,9,16,3,0,13,3
68606,8,52,10,1,42,9
68606,7,94,19,3,75,16
68606,6,180,40,2,140,38
68606,5,93,23,3,70,20
68606,4,55,12,1,43,11
68606,3,41,11,0,30,11
68606,2,18,5,1,13,4
68606,1,12,5,2,7,3
3071,8,58,15,0,43,15
3071,7,120,19,0,101,19
3071,6,183,41,0,142,41
3071,5,104,16,0,88,16
3071,4,50,15,0,35,15
3071,3,25,9,0,16,9
3071,2,9,3,0,6,3
3071,1,8,2,0,6,2
25114,10,7,3,0,4,3
25114,9,16,5,0,11,5
25114,8,102,38,0,64,38
25114,7,197,56,0,141,56
25114,6,171,48,0,123,48
25114,5,57,15,0,42,15
25114,4,27,8,0,19,8
25114,2,2,1,0,1,1
226610,10,8,4,0,4,4
226610,9,10,1,0,9,1
226610,8,33,5,0,28,5
226610,7,76,10,0,66,10
226610,6,156,20,0,136,20
226610,5,116,17,0,99,17
226610,4,65,14,0,51,14
226610,3,56,10,0,46,10
226610,2,42,12,0,30,12
226610,1,23,11,0,12,11
11415,9,2,2,0,0,2
11415,8,20,9,0,11,9
11415,7,51,17,0,34,17
11415,6,163,46,0,117,46
11415,5,148,45,0,103,45
11415,4,97,28,0,69,28
11415,3,49,16,0,33,16
11415,2,36,17,0,19,17
11415,1,14,5,0,9,5
151151,10,16,3,0,13,3
151151,9,20,2,0,18,2
151151,8,121,19,1,102,18
151151,7,147,15,3,132,12
151151,6,169,31,2,138,29
151151,5,67,15,2,52,13
151151,4,26,10,1,16,9
151151,3,12,3,0,9,3
151151,2,3,1,0,2,1
9735,10,2,1,0,1,1
9735,9,20,11,0,9,11
9735,8,83,38,0,45,38
9735,7,169,72,0,97,72
9735,6,193,73,0,120,73
9735,5,62,27,0,35,27
9735,4,33,17,0,16,17
9735,3,10,2,0,8,2
9735,2,9,7,0,2,7
136440,10,12,6,2,6,4
136440,9,32,8,2,24,6
136440,8,180,34,5,146,29
136440,7,174,30,4,144,26
136440,6,123,33,0,90,33
136440,5,35,15,2,20,13
136440,4,18,3,0,15,3
136440,3,6,1,0,5,1
136440,2,2,2,0,0,2
10908,9,9,4,0,5,4
10908,8,56,21,0,35,21
10908,7,129,35,0,94,35
10908,6,220,59,0,161,59
10908,5,86,33,0,53,33
10908,4,43,16,0,27,16
10908,3,24,9,0,15,9
10908,2,7,4,0,3,4
10908,1,6,3,0,3,3
22938,10,11,2,0,9,2
22938,8,47,17,0,30,17
22938,7,114,25,0,89,25
22938,6,206,49,0,157,49
22938,5,105,38,0,67,38
22938,4,59,19,0,40,19
22938,3,22,11,0,11,11
22938,2,8,4,0,4,4
22938,1,6,2,0,4,2
24920,10,10,5,0,5,5
24920,9,40,21,0,19,21
24920,8,209,72,0,137,72
24920,7,191,71,0,120,71
24920,6,80,28,0,52,28
24920,5,21,8,0,13,8
24920,4,15,5,0,10,5
24920,3,8,3,0,5,3
24920,2,4,2,0,2,2
95613,10,6,2,0,4,2
95613,9,17,3,0,14,3
95613,8,90,23,0,67,23
95613,7,155,31,1,124,30
95613,6,181,33,0,148,33
95613,5,74,13,0,61,13
95613,4,27,8,0,19,8
95613,3,17,2,0,15,2
95613,2,10,2,0,8,2
95613,1,4,1,0,3,1
218129,10,18,6,0,12,6
218129,9,27,5,0,22,5
218129,8,116,20,0,96,20
218129,7,197,22,0,175,22
218129,6,151,18,0,133,18
218129,5,44,10,0,34,10
218129,4,21,4,0,17,4
218129,3,6,1,0,5,1
218129,2,1,1,0,0,1
31971,9,5,3,0,2,3
31971,8,44,11,2,33,9
31971,7,104,21,1,83,20
31971,6,216,43,6,173,37
31971,5,117,36,3,81,33
31971,4,55,12,1,43,11
31971,3,22,9,1,13,8
31971,2,9,1,1,8,0
31971,1,6,2,0,4,2
2247,10,14,7,0,7,7
2247,9,34,9,0,25,9
2247,8,152,44,0,108,44
2247,7,203,70,0,133,70
2247,6,108,39,0,69,39
2247,5,39,14,0,25,14
2247,4,20,9,0,11,9
2247,3,8,2,0,6,2
2247,2,1,1,0,0,1
123609,10,95,24,0,71,24
123609,9,94,15,1,79,14
123609,8,194,31,0,163,31
123609,7,111,28,1,83,27
123609,6,56,10,0,46,10
123609,5,12,2,0,10,2
123609,4,9,1,0,8,1
123609,2,3,1,0,2,1
497,9,6,1,0,5,1
497,8,40,13,0,27,13
497,7,129,49,0,80,49
497,6,219,67,0,152,67
497,5,117,34,0,83,34
497,4,46,14,0,32,14
497,3,15,8,0,7,8
497,2,4,1,0,3,1
497,1,3,2,0,1,2
162388,10,110,18,0,92,18
162388,9,130,27,1,103,26
162388,8,174,19,1,155,18
162388,7,99,12,1,87,11
162388,6,42,8,0,34,8
162388,5,14,1,1,13,0
718,10,5,1,0,4,1
718,9,12,7,0,5,7
718,8,76,30,0,46,30
718,7,172,41,0,131,41
718,6,167,60,0,107,60
718,5,88,35,0,53,35
718,4,36,19,0,17,19
718,3,18,10,0,8,10
718,2,3,1,0,2,1
718,1,2,1,0,1,1
253684,10,11,3,0,8,3
253684,9,42,5,0,37,5
253684,8,210,34,0,176,34
253684,7,184,30,0,154,30
253684,6,95,14,0,81,14
253684,5,19,4,0,15,4
253684,4,15,2,0,13,2
253684,3,4,1,0,3,1
224316,9,40,3,0,37,3
224316,8,158,22,0,136,22
224316,7,205,37,0,168,37
224316,6,123,17,0,106,17
224316,5,21,7,0,14,7
224316,4,10,1,0,9,1
224316,3,6,3,0,3,3
224316,2,4,1,0,3,1
211940,9,13,5,0,8,5
211940,8,111,20,0,91,20
211940,7,189,26,0,163,26
211940,6,175,32,0,143,32
211940,5,52,17,0,35,17
211940,4,15,3,0,12,3
211940,3,11,1,0,10,1
211940,2,2,1,0,1,1
211940,1,2,2,0,0,2
193212,10,6,2,0,4,2
193212,9,14,2,0,12,2
193212,8,55,9,0,46,9
193212,7,130,26,0,104,26
193212,6,214,23,0,191,23
193212,5,78,19,0,59,19
193212,4,49,13,0,36,13
193212,3,19,6,0,13,6
193212,2,11,3,0,8,3
193212,1,3,3,0,0,3
233868,10,216,89,3,127,86
233868,9,91,24,1,67,23
233868,8,107,19,2,88,17
233868,7,37,6,0,31,6
233868,6,19,7,1,12,6
233868,5,14,3,1,11,2
233868,4,9,3,0,6,3
233868,3,10,3,0,7,3
233868,2,14,4,0,10,4
233868,1,65,19,0,46,19
21551,10,73,27,0,46,27
21551,9,123,25,0,98,25
21551,8,210,45,0,165,45
21551,7,106,29,0,77,29
21551,6,35,5,0,30,5
21551,5,11,1,0,10,1
21551,4,9,2,0,7,2
21551,3,3,1,0,2,1
21551,2,3,1,0,2,1
21551,1,5,1,0,4,1
102181,9,20,4,0,16,4
102181,8,81,13,0,68,13
102181,7,157,37,0,120,37
102181,6,196,37,0,159,37
102181,5,66,12,0,54,12
102181,4,34,6,0,28,6
102181,3,13,6,0,7,6
254386,10,30,7,0,23,7
254386,9,66,18,1,48,17
254386,8,234,25,4,209,21
254386,7,126,19,2,107,17
254386,6,80,20,1,60,19
254386,5,25,6,1,19,5
254386,4,13,3,0,10,3
254386,3,3,2,0,1,2
8069,10,14,2,0,12,2
8069,9,21,8,0,13,8
8069,8,84,24,0,60,24
8069,7,124,32,0,92,32
8069,6,158,49,0,109,49
8069,5,103,36,0,67,36
8069,4,51,11,0,40,11
8069,3,15,7,0,8,7
8069,1,1,1,0,0,1
213370,10,12,4,0,8,4
213370,9,15,3,0,12,3
213370,8,111,20,0,91,20
213370,7,165,25,0,140,25
213370,6,160,26,0,134,26
213370,5,71,16,0,55,16
213370,4,29,5,0,24,5
213370,3,13,3,0,10,3
8935,10,4,1,0,3,1
8935,9,16,9,0,7,9
8935,8,78,32,0,46,32
8935,7,135,49,0,86,49
8935,6,202,71,0,131,71
8935,5,77,24,0,53,24
8935,4,38,6,0,32,6
8935,3,17,3,0,14,3
8935,2,7,2,0,5,2
8935,1,3,1,0,2,1
216403,10,36,10,0,26,10
216403,9,62,20,0,42,20
216403,8,196,26,0,170,26
216403,7,153,22,0,131,22
216403,6,94,15,0,79,15
216403,5,24,4,0,20,4
216403,4,8,4,0,4,4
216403,3,3,3,0,0,3
216403,2,1,1,0,0,1
251293,10,7,1,0,6,1
251293,9,32,9,0,23,9
251293,8,143,26,0,117,26
251293,7,210,30,0,180,30
251293,6,127,25,0,102,25
251293,5,39,11,0,28,11
251293,4,18,5,0,13,5
251293,3,5,3,0,2,3
3269,10,4,1,0,3,1
3269,9,8,2,0,6,2
3269,8,40,11,0,29,11
3269,7,92,28,0,64,28
3269,6,231,69,0,162,69
3269,5,125,33,0,92,33
3269,4,52,14,0,38,14
3269,3,17,3,0,14,3
3269,2,7,1,0,6,1
8690,8,38,11,0,27,11
8690,7,95,23,0,72,23
8690,6,195,40,0,155,40
8690,5,132,21,0,111,21
8690,4,77,20,0,57,20
8690,3,23,3,0,20,3
8690,2,3,1,0,2,1
252328,10,170,33,0,137,33
252328,9,180,24,0,156,24
252328,8,148,18,0,130,18
252328,7,37,9,0,28,9
252328,6,24,3,0,21,3
252328,5,6,1,0,5,1
252328,3,2,1,0,1,1
252328,2,3,1,0,2,1
252328,1,9,5,0,4,5
1338,9,26,17,0,9,17
1338,8,172,58,0,114,58
1338,7,179,57,0,122,57
1338,6,134,50,0,84,50
1338,5,34,11,0,23,11
1338,4,16,6,0,10,6
1338,3,9,5,0,4,5
1338,2,2,2,0,0,2
1338,1,2,1,0,1,1
55834,10,6,1,0,5,1
55834,9,9,2,0,7,2
55834,8,102,28,0,74,28
55834,7,184,55,0,129,55
55834,6,202,45,0,157,45
55834,5,49,19,0,30,19
55834,4,18,4,0,14,4
55834,3,4,1,0,3,1
11081,10,4,1,0,3,1
11081,9,12,3,0,9,3
11081,8,89,39,0,50,39
11081,7,148,55,0,93,55
11081,6,199,64,0,135,64
11081,5,65,22,0,43,22
11081,4,46,22,0,24,22
11081,3,10,2,0,8,2
11081,2,2,2,0,0,2
12283,10,5,1,0,4,1
12283,9,36,17,0,19,17
12283,8,114,46,0,68,46
12283,7,169,50,0,119,50
12283,6,134,56,0,78,56
12283,5,40,24,0,16,24
12283,4,47,15,0,32,15
12283,3,17,11,0,6,11
12283,2,8,6,0,2,6
12283,1,5,2,0,3,2
8126,9,8,4,0,4,4
8126,8,76,20,0,56,20
8126,7,174,45,0,129,45
8126,6,212,62,0,150,62
8126,5,69,22,0,47,22
8126,4,23,12,0,11,12
8126,3,9,4,0,5,4
8126,2,5,3,0,2,3
91189,10,13,4,0,9,4
91189,9,30,10,0,20,10
91189,8,147,29,0,118,29
91189,7,175,26,0,149,26
91189,6,148,22,0,126,22
91189,5,40,8,0,32,8
91189,4,16,2,0,14,2
91189,3,2,1,0,1,1
91189,2,3,1,0,2,1
147431,10,6,3,1,3,2
147431,9,23,5,0,18,5
147431,8,162,33,4,129,29
147431,7,168,30,1,138,29
147431,6,151,31,0,120,31
147431,5,41,11,0,30,11
147431,4,15,2,0,13,2
147431,3,7,1,0,6,1
90190,9,5,2,0,3,2
90190,8,74,12,1,62,11
90190,7,144,24,0,120,24
90190,6,200,34,0,166,34
90190,5,87,21,0,66,21
90190,4,45,9,0,36,9
90190,3,7,1,0,6,1
90190,2,6,1,0,5,1
38778,10,5,3,0,2,3
38778,9,16,6,0,10,6
38778,8,98,41,0,57,41
38778,7,131,41,0,90,41
38778,6,159,43,0,116,43
38778,5,71,22,0,49,22
38778,4,51,16,0,35,16
38778,3,24,11,0,13,11
38778,2,15,11,0,4,11
38778,1,4,2,0,2,2
104573,9,9,1,0,8,1
104573,8,87,32,0,55,32
104573,7,187,47,0,140,47
104573,6,189,44,0,145,44
104573,5,65,16,0,49,16
104573,4,24,7,0,17,7
104573,3,7,1,0,6,1
21239,9,3,1,0,2,1
21239,8,21,5,0,16,5
21239,7,76,22,0,54,22
21239,6,169,65,0,104,65
21239,5,114,45,0,69,45
21239,4,87,24,0,63,24
21239,3,50,18,0,32,18
21239,2,37,24,0,13,24
21239,1,15,9,0,6,9
170604,10,67,19,1,48,18
170604,9,122,23,0,99,23
170604,8,230,56,3,174,53
170604,7,80,13,0,67,13
170604,6,49,13,2,36,11
170604,5,16,1,0,15,1
170604,4,5,1,1,4,0
170604,3,1,1,0,0,1
43307,10,21,12,0,9,12
43307,9,57,22,0,35,22
43307,8,209,65,0,144,65
43307,7,141,39,0,102,39
43307,6,93,41,0,52,41
43307,5,18,10,0,8,10
43307,4,17,12,0,5,12
43307,3,9,5,0,4,5
43307,2,4,1,0,3,1
17136,10,2,1,0,1,1
17136,9,7,2,0,5,2
17136,8,50,18,0,32,18
17136,7,76,25,0,51,25
17136,6,190,58,0,132,58
17136,5,110,35,0,75,35
17136,4,85,31,0,54,31
17136,3,35,11,0,24,11
17136,2,16,8,0,8,8
17136,1,2,1,0,1,1
171479,10,40,10,2,30,8
171479,9,54,22,0,32,22
171479,8,207,53,1,154,52
171479,7,151,31,1,120,30
171479,6,83,18,0,65,18
171479,5,20,3,0,17,3
171479,4,9,3,0,6,3
1430,10,26,9,0,17,9
1430,9,50,26,0,24,26
1430,8,148,64,0,84,64
1430,7,172,50,0,122,50
1430,6,111,36,0,75,36
1430,5,34,15,0,19,15
1430,4,22,4,0,18,4
1430,3,6,3,0,3,3
100734,10,6,4,1,2,3
100734,9,15,4,0,11,4
100734,8,88,20,2,68,18
100734,7,165,25,0,140,25
100734,6,212,48,0,164,48
100734,5,59,7,0,52,7
100734,4,16,5,0,11,5
100734,3,4,1,0,3,1
100734,2,5,1,0,4,1
4229,10,22,9,0,13,9
4229,9,28,7,0,21,7
4229,8,52,18,0,34,18
4229,7,47,13,0,34,13
4229,6,89,22,0,67,22
4229,5,90,18,0,72,18
4229,4,100,36,0,64,36
4229,3,59,24,0,35,24
4229,2,59,32,0,27,32
4229,1,24,15,0,9,15
1982,10,4,2,0,2,2
1982,9,13,7,0,6,7
1982,8,92,28,0,64,28
1982,7,133,31,0,102,31
1982,6,194,50,0,144,50
1982,5,87,28,0,59,28
1982,4,29,11,0,18,11
1982,3,8,1,0,7,1
1982,2,7,3,0,4,3
17484,10,41,22,0,19,22
17484,9,84,35,0,49,35
17484,8,173,58,0,115,58
17484,7,127,50,0,77,50
17484,6,87,27,0,60,27
17484,5,28,11,0,17,11
17484,4,13,7,0,6,7
17484,3,8,5,0,3,5
17484,2,3,2,0,1,2
17484,1,5,1,0,4,1
38931,10,9,6,0,3,6
38931,9,15,3,0,12,3
38931,8,112,26,0,86,26
38931,7,157,35,0,122,35
38931,6,185,40,0,145,40
38931,5,71,16,0,55,16
38931,4,15,5,0,10,5
38931,3,2,1,0,1,1
38931,2,2,1,0,1,1
173319,10,10,4,0,6,4
173319,9,22,2,0,20,2
173319,8,131,26,0,105,26
173319,7,193,36,0,157,36
173319,6,149,18,0,131,18
173319,5,47,8,0,39,8
173319,4,14,2,0,12,2
173319,2,2,1,0,1,1
1333,10,5,1,0,4,1
1333,8,37,17,0,20,17
1333,7,62,20,0,42,20
1333,6,164,50,0,114,50
1333,5,137,37,0,100,37
1333,4,92,30,0,62,30
1333,3,44,17,0,27,17
1333,2,15,6,0,9,6
1333,1,10,2,0,8,2
231733,10,77,29,1,48,28
231733,9,154,43,4,111,39
231733,8,203,50,4,153,46
231733,7,73,20,1,53,19
231733,6,38,10,0,28,10
231733,5,12,3,0,9,3
231733,4,9,5,0,4,5
231733,2,2,2,0,0,2
123160,10,39,20,1,19,19
123160,9,50,16,1,34,15
123160,8,145,40,3,105,37
123160,7,154,34,4,120,30
123160,6,125,31,3,94,28
123160,5,26,10,1,16,9
123160,4,15,6,0,9,6
123160,3,9,4,0,5,4
123160,2,3,1,0,2,1
123160,1,2,1,0,1,1
2940,10,3,1,0,2,1
2940,9,11,4,0,7,4
2940,8,29,10,0,19,10
2940,7,93,32,0,61,32
2940,6,183,59,0,124,59
2940,5,115,36,0,79,36
2940,4,84,31,0,53,31
2940,3,29,13,0,16,13
2940,2,15,12,0,3,12
2940,1,6,4,0,2,4
21930,10,8,2,0,6,2
21930,9,22,3,0,19,3
21930,8,104,17,0,87,17
21930,7,121,19,0,102,19
21930,6,182,27,0,155,27
21930,5,58,8,0,50,8
21930,4,48,7,0,41,7
21930,3,17,4,0,13,4
21930,2,8,5,0,3,5
5697,10,2,1,0,1,1
5697,9,7,5,0,2,5
5697,8,36,22,0,14,22
5697,7,95,37,0,58,37
5697,6,225,96,0,129,96
5697,5,127,47,0,80,47
5697,4,53,14,0,39,14
5697,3,19,9,0,10,9
5697,2,4,2,0,2,2
163641,9,16,4,0,12,4
163641,8,109,25,3,84,22
163641,7,160,29,2,131,27
163641,6,173,35,0,138,35
163641,5,72,14,1,58,13
163641,4,26,6,1,20,5
163641,2,5,2,0,3,2
163641,1,2,1,0,1,1
9364,10,66,17,0,49,17
9364,9,86,16,0,70,16
9364,8,156,33,0,123,33
9364,7,117,17,0,100,17
9364,6,78,16,0,62,16
9364,5,28,5,0,23,5
9364,4,22,3,0,19,3
9364,3,8,1,0,7,1
9364,2,5,3,0,2,3
65814,10,4,2,0,2,2
65814,9,9,4,0,5,4
65814,8,50,18,0,32,18
65814,7,120,37,0,83,37
65814,6,204,49,0,155,49
65814,5,107,25,0,82,25
65814,4,41,11,0,30,11
65814,3,23,5,0,18,5
65814,2,7,3,0,4,3
65814,1,2,1,0,1,1
174744,9,16,4,0,12,4
174744,8,157,39,0,118,39
174744,7,189,35,0,154,35
174744,6,142,26,0,116,26
174744,5,35,7,0,28,7
174744,4,15,4,0,11,4
174744,3,8,3,0,5,3
126750,10,5,1,0,4,1
126750,9,18,2,0,16,2
126750,8,79,19,0,60,19
126750,7,169,24,0,145,24
126750,6,188,33,0,155,33
126750,5,68,8,0,60,8
126750,4,22,5,0,17,5
126750,3,10,1,0,9,1
126750,2,5,3,0,2,3
126750,1,3,2,0,1,2
3202,10,34,21,0,13,21
3202,9,71,26,0,45,26
3202,8,165,70,0,95,70
3202,7,166,43,0,123,43
3202,6,88,24,0,64,24
3202,5,25,11,0,14,11
3202,4,6,3,0,3,3
3202,3,5,2,0,3,2
172881,10,14,2,0,12,2
172881,9,32,6,0,26,6
172881,8,159,25,0,134,25
172881,7,171,22,0,149,22
172881,6,121,15,0,106,15
172881,5,36,7,0,29,7
172881,4,19,9,0,10,9
172881,3,11,3,0,8,3
172881,2,3,1,0,2,1
233571,10,104,19,0,85,19
233571,9,155,11,0,144,11
233571,8,172,17,0,155,17
233571,7,65,9,0,56,9
233571,6,39,6,0,33,6
233571,4,5,2,0,3,2
233571,3,6,4,0,2,4
233571,2,2,1,0,1,1
233571,1,12,8,0,4,8
704,10,3,1,0,2,1
704,9,8,3,0,5,3
704,8,46,15,0,31,15
704,7,111,39,0,72,39
704,6,198,57,0,141,57
704,5,110,38,0,72,38
704,4,60,25,0,35,25
704,3,17,11,0,6,11
704,2,11,5,0,6,5
704,1,2,2,0,0,2
75223,10,14,5,0,9,5
75223,9,38,13,0,25,13
75223,8,127,41,0,86,41
75223,7,143,46,0,97,46
75223,6,185,52,0,133,52
75223,5,37,14,0,23,14
75223,4,15,6,0,9,6
75223,3,5,4,0,1,4
75223,2,1,1,0,0,1
87821,10,7,2,0,5,2
87821,9,24,8,0,16,8
87821,8,155,41,1,114,40
87821,7,184,53,1,131,52
87821,6,147,36,1,111,35
87821,5,41,15,0,26,15
87821,4,5,3,0,2,3
169649,10,5,3,0,2,3
169649,9,17,4,0,13,4
169649,8,123,13,0,110,13
169649,7,169,21,0,148,21
169649,6,162,32,0,130,32
169649,5,52,7,0,45,7
169649,4,21,6,0,15,6
169649,3,10,3,0,7,3
169649,2,4,1,0,3,1
192735,10,7,1,0,6,1
192735,8,79,16,0,63,16
192735,7,135,24,0,111,24
192735,6,194,43,0,151,43
192735,5,78,14,0,64,14
192735,4,31,12,0,19,12
192735,3,15,6,0,9,6
192735,2,10,3,0,7,3
90,10,3,1,0,2,1
90,9,8,2,0,6,2
90,8,76,28,0,48,28
90,7,162,61,0,101,61
90,6,191,68,0,123,68
90,5,74,21,0,53,21
90,4,25,12,0,13,12
90,3,17,5,0,12,5
90,2,6,2,0,4,2
1590,10,5,2,0,3,2
1590,9,14,4,0,10,4
1590,8,33,12,0,21,12
1590,7,86,17,0,69,17
1590,6,184,47,0,137,47
1590,5,126,42,0,84,42
1590,4,67,25,0,42,25
1590,3,30,14,0,16,14
1590,2,14,11,0,3,11
1590,1,5,3,0,2,3
146725,10,47,14,1,33,13
146725,9,56,10,0,46,10
146725,8,95,13,1,82,12
146725,7,122,25,1,97,24
146725,6,122,28,2,94,26
146725,5,52,10,0,42,10
146725,4,27,6,0,21,6
146725,3,18,6,0,12,6
146725,2,9,3,0,6,3
146725,1,15,9,0,6,9
209324,10,88,21,0,67,21
209324,9,135,28,4,107,24
209324,8,191,32,6,159,26
209324,7,78,8,0,70,8
209324,6,39,5,1,34,4
209324,5,11,1,0,10,1
209324,4,8,1,0,7,1
209324,3,3,1,0,2,1
209324,2,6,5,1,1,4
209324,1,3,1,1,2,0
35289,9,14,5,0,9,5
35289,8,86,28,0,58,28
35289,7,182,43,0,139,43
35289,6,170,32,0,138,32
35289,5,72,19,0,53,19
35289,4,18,8,0,10,8
35289,3,10,4,0,6,4
35289,2,6,3,0,3,3
200934,10,30,9,0,21,9
200934,9,63,13,2,50,11
200934,8,215,41,1,174,40
200934,7,135,18,1,117,17
200934,6,78,18,0,60,18
200934,5,26,3,0,23,3
200934,4,10,3,0,7,3
200934,3,4,2,0,2,2
200934,2,2,2,1,0,1
160784,10,2,1,0,1,1
160784,9,8,3,0,5,3
160784,8,85,16,3,69,13
160784,7,163,34,5,129,29
160784,6,183,35,4,148,31
160784,5,75,20,0,55,20
160784,4,28,12,1,16,11
160784,3,14,3,1,11,2
19646,9,6,3,0,3,3
19646,8,35,18,0,17,18
19646,7,121,35,0,86,35
19646,6,233,75,0,158,75
19646,5,87,27,0,60,27
19646,4,45,11,0,34,11
19646,3,20,8,0,12,8
19646,2,10,5,0,5,5
19646,1,3,2,0,1,2
3711,10,10,3,0,7,3
3711,9,28,4,0,24,4
3711,8,63,26,0,37,26
3711,7,133,33,0,100,33
3711,6,163,42,0,121,42
3711,5,86,23,0,63,23
3711,4,43,15,0,28,15
3711,3,18,8,0,10,8
3711,2,16,7,0,9,7
3711,1,1,1,0,0,1
13347,10,5,3,0,2,3
13347,9,20,15,0,5,15
13347,8,76,41,0,35,41
13347,7,140,63,0,77,63
13347,6,160,73,0,87,73
13347,5,74,32,0,42,32
13347,4,51,32,0,19,32
13347,3,29,15,0,14,15
13347,2,6,5,0,1,5
1506,10,8,3,0,5,3
1506,9,28,7,0,21,7
1506,8,86,22,0,64,22
1506,7,147,47,0,100,47
1506,6,186,52,0,134,52
1506,5,63,14,0,49,14
1506,4,24,5,0,19,5
1506,3,13,7,0,6,7
1506,2,3,2,0,1,2
1506,1,3,1,0,2,1
4173,10,19,11,0,8,11
4173,9,33,18,0,15,18
4173,8,101,40,0,61,40
4173,7,163,51,0,112,51
4173,6,154,45,0,109,45
4173,5,56,14,0,42,14
4173,4,24,4,0,20,4
4173,3,8,1,0,7,1
36400,10,81,37,1,44,36
36400,9,119,31,0,88,31
36400,8,173,46,1,127,45
36400,7,81,24,1,57,23
36400,6,61,18,0,43,18
36400,5,26,10,0,16,10
36400,4,7,2,0,5,2
36400,3,8,2,0,6,2
36400,2,2,1,0,1,1
36400,1,1,1,0,0,1
684,9,11,4,0,7,4
684,8,27,7,0,20,7
684,7,88,29,0,59,29
684,6,189,46,0,143,46
684,5,110,22,0,88,22
684,4,71,19,0,52,19
684,3,34,11,0,23,11
684,2,17,5,0,12,5
684,1,6,1,0,5,1
8017,9,3,2,0,1,2
8017,8,54,18,0,36,18
8017,7,147,45,0,102,45
8017,6,231,69,0,162,69
8017,5,81,24,0,57,24
8017,4,29,11,0,18,11
8017,3,11,8,0,3,8
8017,2,2,1,0,1,1
197320,10,17,6,0,11,6
197320,9,78,15,0,63,15
197320,8,191,34,0,157,34
197320,7,128,25,0,103,25
197320,6,105,28,0,77,28
197320,5,30,4,0,26,4
197320,4,8,2,0,6,2
197320,3,3,1,0,2,1
67453,9,10,1,0,9,1
67453,8,86,19,0,67,19
67453,7,146,30,0,116,30
67453,6,192,45,0,147,45
67453,5,75,23,0,52,23
67453,4,28,8,0,20,8
67453,3,11,3,0,8,3
2399,10,10,5,0,5,5
2399,9,16,2,0,14,2
2399,8,51,18,0,33,18
2399,7,108,38,0,70,38
2399,6,179,48,0,131,48
2399,5,101,27,0,74,27
2399,4,54,19,0,35,19
2399,3,24,13,0,11,13
2399,2,12,6,0,6,6
2399,1,4,1,0,3,1
5316,10,23,7,0,16,7
5316,9,43,9,0,34,9
5316,8,104,20,0,84,20
5316,7,140,32,0,108,32
5316,6,132,31,0,101,31
5316,5,53,11,0,42,11
5316,4,28,8,0,20,8
5316,3,15,3,0,12,3
5316,2,8,2,0,6,2
5316,1,13,1,0,12,1
43320,10,16,3,0,13,3
43320,9,35,9,0,26,9
43320,8,121,32,0,89,32
43320,7,150,30,0,120,30
43320,6,127,35,0,92,35
43320,5,51,14,0,37,14
43320,4,22,7,0,15,7
43320,3,15,5,0,10,5
43320,2,16,5,0,11,5
43320,1,5,5,0,0,5
231197,10,7,1,0,6,1
231197,9,22,2,0,20,2
231197,8,165,23,0,142,23
231197,7,177,22,0,155,22
231197,6,114,12,0,102,12
231197,5,46,8,0,38,8
231197,4,17,3,0,14,3
231197,3,4,1,0,3,1
19184,10,12,5,0,7,5
19184,9,36,13,0,23,13
19184,8,150,56,0,94,56
19184,7,156,52,0,104,52
19184,6,119,46,0,73,46
19184,5,52,15,0,37,15
19184,4,19,2,0,17,2
19184,3,9,6,0,3,6
159868,10,5,1,0,4,1
159868,9,24,6,0,18,6
159868,8,109,27,0,82,27
159868,7,154,22,0,132,22
159868,6,177,25,0,152,25
159868,5,60,13,0,47,13
159868,4,17,2,0,15,2
159868,3,8,1,0,7,1
159868,1,2,1,0,1,1
1070,10,7,4,0,3,4
1070,9,13,6,0,7,6
1070,8,70,24,0,46,24
1070,7,132,39,0,93,39
1070,6,190,68,0,122,68
1070,5,84,24,0,60,24
1070,4,39,17,0,22,17
1070,3,15,3,0,12,3
1070,2,8,3,0,5,3
31621,9,8,2,0,6,2
31621,8,70,17,0,53,17
31621,7,151,39,0,112,39
31621,6,193,40,0,153,40
31621,5,73,24,0,49,24
31621,4,41,12,0,29,12
31621,3,16,5,0,11,5
31621,2,6,2,0,4,2
193483,10,33,10,1,23,9
193483,9,45,12,1,33,11
193483,8,100,19,2,81,17
193483,7,150,27,3,123,24
193483,6,135,16,1,119,15
193483,5,50,11,0,39,11
193483,4,24,6,0,18,6
193483,2,10,3,0,7,3
168770,10,17,7,1,10,6
168770,9,34,11,1,23,10
168770,8,107,24,5,83,19
168770,7,134,18,3,116,15
168770,6,154,19,0,135,19
168770,5,63,10,0,53,10
168770,4,31,6,1,25,5
168770,3,14,4,0,10,4
168770,2,4,2,0,2,2
28037,8,46,12,0,34,12
28037,7,126,33,0,93,33
28037,6,231,40,0,191,40
28037,5,86,19,0,67,19
28037,4,46,12,0,34,12
28037,3,12,3,0,9,3
28037,2,6,2,0,4,2
1830,10,14,1,0,13,1
1830,9,33,3,0,30,3
1830,8,129,42,0,87,42
1830,7,172,51,0,121,51
1830,6,131,38,0,93,38
1830,5,49,13,0,36,13
1830,4,21,7,0,14,7
1830,2,3,2,0,1,2
1830,1,1,1,0,0,1
3383,9,15,3,0,12,3
3383,8,68,13,0,55,13
3383,7,163,37,0,126,37
3383,6,189,28,0,161,28
3383,5,71,19,0,52,19
3383,4,32,8,0,24,8
3383,3,14,6,0,8,6
121615,10,5,2,0,3,2
121615,9,9,2,0,7,2
121615,8,88,22,3,66,19
121615,7,108,23,1,85,22
121615,6,168,30,2,138,28
121615,5,84,20,1,64,19
121615,4,62,24,1,38,23
121615,3,16,4,0,12,4
121615,2,10,4,0,6,4
121615,1,7,1,1,6,0
182094,10,19,5,0,14,5
182094,9,20,3,0,17,3
182094,8,95,9,0,86,9
182094,7,154,13,0,141,13
182094,6,165,14,0,151,14
182094,5,57,9,0,48,9
182094,4,24,7,0,17,7
182094,3,15,2,0,13,2
182094,2,5,2,0,3,2
182094,1,2,1,0,1,1
128698,9,31,2,0,29,2
128698,8,149,40,0,109,40
128698,7,162,35,0,127,35
128698,6,128,31,0,97,31
128698,5,37,10,0,27,10
128698,4,27,5,0,22,5
128698,3,13,2,0,11,2
192334,10,5,1,0,4,1
192334,8,81,18,0,63,18
192334,7,124,15,0,109,15
192334,6,191,22,0,169,22
192334,5,79,12,0,67,12
192334,4,35,7,0,28,7
192334,3,20,6,0,14,6
192334,2,8,3,0,5,3
99079,10,10,2,0,8,2
99079,9,14,5,0,9,5
99079,8,37,9,0,28,9
99079,7,51,5,0,46,5
99079,6,120,25,0,95,25
99079,5,120,18,0,102,18
99079,4,84,20,0,64,20
99079,3,60,14,0,46,14
99079,2,46,10,0,36,10
99079,1,12,4,0,8,4
761,9,3,1,0,2,1
761,8,23,4,0,19,4
761,7,90,25,0,65,25
761,6,199,45,0,154,45
761,5,121,30,0,91,30
761,4,71,19,0,52,19
761,3,25,15,0,10,15
761,2,13,8,0,5,8
761,1,5,2,0,3,2
167298,10,6,2,0,4,2
167298,9,17,2,0,15,2
167298,8,107,18,0,89,18
167298,7,195,41,0,154,41
167298,6,153,30,0,123,30
167298,5,51,12,0,39,12
167298,4,15,5,0,10,5
167298,3,8,1,0,7,1
697,10,6,5,0,1,5
697,9,18,6,0,12,6
697,8,87,40,0,47,40
697,7,124,39,0,85,39
697,6,180,61,0,119,61
697,5,82,16,0,66,16
697,4,34,12,0,22,12
697,3,13,6,0,7,6
697,2,9,4,0,5,4
200726,10,8,4,1,4,3
200726,9,21,3,0,18,3
200726,8,125,24,2,101,22
200726,7,186,38,3,148,35
200726,6,155,34,3,121,31
200726,5,35,10,0,25,10
200726,4,12,4,0,8,4
200726,3,5,1,0,4,1
200726,2,6,2,0,4,2
245045,10,12,1,0,11,1
245045,9,32,3,0,29,3
245045,8,162,19,0,143,19
245045,7,197,25,0,172,25
245045,6,102,10,0,92,10
245045,5,30,5,0,25,5
245045,4,8,2,0,6,2
245045,3,7,1,0,6,1
245045,2,3,1,0,2,1
1253,10,2,1,0,1,1
1253,9,10,3,0,7,3
1253,8,43,7,0,36,7
1253,7,119,27,0,92,27
1253,6,226,39,0,187,39
1253,5,84,24,0,60,24
1253,4,41,12,0,29,12
1253,3,19,8,0,11,8
1253,2,4,2,0,2,2
1253,1,4,1,0,3,1
126912,10,7,1,0,6,1
126912,9,4,1,0,3,1
126912,8,96,18,0,78,18
126912,7,150,21,0,129,21
126912,6,173,31,0,142,31
126912,5,75,11,0,64,11
126912,4,29,4,0,25,4
126912,3,16,4,0,12,4
4401,10,4,1,0,3,1
4401,9,12,7,0,5,7
4401,8,91,34,0,57,34
4401,7,151,44,0,107,44
4401,6,192,58,0,134,58
4401,5,63,22,0,41,22
4401,4,23,12,0,11,12
4401,3,13,8,0,5,8
208773,10,39,16,0,23,16
208773,9,101,25,2,76,23
208773,8,215,52,3,163,49
208773,7,105,18,1,87,17
208773,6,53,11,0,42,11
208773,5,21,4,0,17,4
208773,4,13,4,0,9,4
208773,3,3,1,0,2,1
208773,1,1,1,0,0,1
183284,10,31,10,1,21,9
183284,9,63,16,1,47,15
183284,8,178,31,4,147,27
183284,7,147,33,1,114,32
183284,6,92,16,0,76,16
183284,5,22,6,0,16,6
183284,4,14,5,0,9,5
183284,3,4,1,0,3,1
183284,2,1,1,0,0,1
12538,8,22,10,0,12,10
12538,7,90,47,0,43,47
12538,6,239,100,0,139,100
12538,5,116,52,0,64,52
12538,4,50,28,0,22,28
12538,3,18,9,0,9,9
12538,2,8,3,0,5,3
9615,10,3,1,0,2,1
9615,9,5,1,0,4,1
9615,8,53,19,0,34,19
9615,7,133,43,0,90,43
9615,6,235,69,0,166,69
9615,5,75,32,0,43,32
9615,4,29,12,0,17,12
9615,3,13,9,0,4,9
9615,2,4,2,0,2,2
47046,9,24,8,0,16,8
47046,8,135,34,0,101,34
47046,7,162,33,0,129,33
47046,6,145,27,0,118,27
47046,5,49,10,0,39,10
47046,4,21,4,0,17,4
47046,3,7,1,0,6,1
47046,2,2,1,0,1,1
47046,1,2,1,0,1,1
234621,10,5,3,0,2,3
234621,9,14,2,0,12,2
234621,8,172,31,0,141,31
234621,7,198,31,0,167,31
234621,6,121,19,0,102,19
234621,5,30,7,0,23,7
234621,4,8,3,0,5,3
234621,3,3,1,0,2,1
234621,2,3,1,0,2,1
234621,1,1,1,0,0,1
21985,10,10,2,0,8,2
21985,9,19,10,0,9,10
21985,8,110,56,0,54,56
21985,7,165,53,0,112,53
21985,6,175,66,0,109,66
21985,5,47,18,0,29,18
21985,4,15,4,0,11,4
21985,3,7,1,0,6,1
21985,2,2,1,0,1,1
21985,1,1,1,0,0,1
245352,9,52,4,0,48,4
245352,8,176,22,0,154,22
245352,7,185,20,0,165,20
245352,6,88,14,0,74,14
245352,5,21,1,0,20,1
245352,4,8,5,0,3,5
245352,3,5,2,0,3,2
210290,10,40,12,0,28,12
210290,9,96,15,0,81,15
210290,8,215,31,0,184,31
210290,7,120,14,0,106,14
210290,6,60,10,0,50,10
210290,5,11,2,0,9,2
210290,4,5,1,0,4,1
1708,10,9,5,0,4,5
1708,9,25,8,0,17,8
1708,8,79,20,0,59,20
1708,7,129,30,0,99,30
1708,6,192,55,0,137,55
1708,5,71,23,0,48,23
1708,4,23,7,0,16,7
1708,3,18,8,0,10,8
1708,2,3,2,0,1,2
3656,10,11,2,0,9,2
3656,9,20,5,0,15,5
3656,8,43,14,0,29,14
3656,7,95,34,0,61,34
3656,6,186,57,0,129,57
3656,5,115,33,0,82,33
3656,4,50,16,0,34,16
3656,3,19,4,0,15,4
3656,2,9,1,0,8,1
220632,10,87,19,3,68,16
220632,9,78,11,2,67,9
220632,8,190,26,4,164,22
220632,7,98,11,2,87,9
220632,6,57,16,1,41,15
220632,5,24,4,0,20,4
220632,4,9,4,1,5,3
220632,3,6,4,0,2,4
220632,2,6,4,0,2,4
205498,10,12,3,0,9,3
205498,9,34,8,0,26,8
205498,8,214,31,1,183,30
205498,7,168,28,0,140,28
205498,6,89,16,0,73,16
205498,5,26,9,0,17,9
205498,4,6,1,0,5,1
205498,2,2,2,0,0,2
161926,10,8,5,1,3,4
161926,9,14,4,0,10,4
161926,8,80,24,2,56,22
161926,7,160,35,5,125,30
161926,6,195,37,5,158,32
161926,5,47,9,0,38,9
161926,4,28,5,0,23,5
161926,3,10,2,0,8,2
161926,2,6,2,0,4,2
29355,10,6,2,0,4,2
29355,9,15,7,0,8,7
29355,8,97,24,0,73,24
29355,7,150,27,0,123,27
29355,6,185,48,0,137,48
29355,5,57,16,0,41,16
29355,4,25,7,0,18,7
29355,2,4,1,0,3,1
4562,9,18,6,0,12,6
4562,8,98,37,0,61,37
4562,7,152,60,0,92,60
4562,6,135,35,0,100,35
4562,5,47,19,0,28,19
4562,4,34,13,0,21,13
4562,3,13,6,0,7,6
4562,2,2,1,0,1,1
10819,10,46,29,0,17,29
10819,9,60,27,0,33,27
10819,8,161,73,0,88,73
10819,7,115,42,0,73,42
10819,6,102,26,0,76,26
10819,5,31,7,0,24,7
10819,4,10,4,0,6,4
10819,3,12,5,0,7,5
10819,2,7,1,0,6,1
10819,1,5,1,0,4,1
4358,10,14,8,0,6,8
4358,9,22,8,0,14,8
4358,8,53,15,0,38,15
4358,7,104,33,0,71,33
4358,6,135,42,0,93,42
4358,5,95,34,0,61,34
4358,4,72,28,0,44,28
4358,3,29,9,0,20,9
4358,2,18,12,0,6,12
4358,1,6,6,0,0,6
180199,10,40,10,0,30,10
180199,9,119,19,0,100,19
180199,8,243,50,0,193,50
180199,7,94,27,0,67,27
180199,6,36,10,0,26,10
180199,4,5,2,0,3,2
180199,3,1,1,0,0,1
180199,2,2,2,0,0,2
180199,1,3,1,0,2,1
1577,10,11,3,0,8,3
1577,9,21,10,0,11,10
1577,8,122,39,0,83,39
1577,7,125,32,0,93,32
1577,6,142,39,0,103,39
1577,5,67,28,0,39,28
1577,4,38,16,0,22,16
1577,3,18,5,0,13,5
1577,2,3,1,0,2,1
1577,1,1,1,0,0,1
54643,9,8,1,0,7,1
54643,8,87,33,0,54,33
54643,7,154,33,0,121,33
54643,6,181,39,0,142,39
54643,5,71,18,0,53,18
54643,4,30,7,0,23,7
54643,3,5,1,0,4,1
54643,2,5,1,0,4,1
54643,1,3,2,0,1,2
156,10,14,4,0,10,4
156,9,38,8,0,30,8
156,8,97,39,0,58,39
156,7,187,53,0,134,53
156,6,154,49,0,105,49
156,5,38,14,0,24,14
156,4,7,4,0,3,4
156,3,7,4,0,3,4
156,2,3,2,0,1,2
156,1,2,1,0,1,1
126008,10,47,3,0,44,3
126008,9,56,8,0,48,8
126008,8,203,32,0,171,32
126008,7,132,13,0,119,13
126008,6,86,19,0,67,19
126008,5,15,1,0,14,1
126008,4,7,2,0,5,2
145014,10,3,1,0,2,1
145014,9,10,2,0,8,2
145014,8,83,13,0,70,13
145014,7,170,22,0,148,22
145014,6,188,28,0,160,28
145014,5,61,13,0,48,13
145014,4,24,5,0,19,5
145014,2,5,2,0,3,2
37615,8,29,17,0,12,17
37615,7,112,28,0,84,28
37615,6,232,68,0,164,68
37615,5,115,28,0,87,28
37615,4,30,10,0,20,10
37615,3,20,6,0,14,6
37615,2,6,2,0,4,2
40276,10,12,4,0,8,4
40276,9,26,9,0,17,9
40276,8,133,40,0,93,40
40276,7,148,38,0,110,38
40276,6,132,41,0,91,41
40276,5,50,15,0,35,15
40276,4,23,10,0,13,10
40276,3,14,8,0,6,8
40276,2,8,4,0,4,4
40276,1,1,1,0,0,1
136192,10,49,16,3,33,13
136192,9,54,21,2,33,19
136192,8,109,37,4,72,33
136192,7,119,18,1,101,17
136192,6,118,27,9,91,18
136192,5,47,9,1,38,8
136192,4,23,5,1,18,4
136192,3,15,5,3,10,2
136192,2,7,3,0,4,3
245353,10,10,1,0,9,1
245353,9,35,3,0,32,3
245353,8,141,24,0,117,24
245353,7,166,18,0,148,18
245353,6,119,15,0,104,15
245353,5,43,6,0,37,6
245353,4,18,4,0,14,4
245353,3,6,2,0,4,2
180901,10,10,5,0,5,5
180901,9,37,3,0,34,3
180901,8,183,47,0,136,47
180901,7,162,34,0,128,34
180901,6,112,26,0,86,26
180901,5,26,8,0,18,8
180901,4,9,5,0,4,5
180901,3,6,4,0,2,4
180901,2,1,1,0,0,1
11949,10,25,10,0,15,10
11949,9,76,36,0,40,36
11949,8,186,74,0,112,74
11949,7,127,41,0,86,41
11949,6,75,31,0,44,31
11949,5,29,13,0,16,13
11949,4,12,8,0,4,8
11949,2,5,2,0,3,2
11949,1,7,2,0,5,2
1496,10,23,11,0,12,11
1496,9,31,13,0,18,13
1496,8,93,25,0,68,25
1496,7,138,33,0,105,33
1496,6,158,39,0,119,39
1496,5,47,18,0,29,18
1496,4,33,15,0,18,15
1496,3,13,9,0,4,9
1496,2,9,6,0,3,6
1496,1,2,1,0,1,1
138104,10,11,4,0,7,4
138104,9,18,3,0,15,3
138104,8,93,22,0,71,22
138104,7,128,19,0,109,19
138104,6,135,20,0,115,20
138104,5,71,14,0,57,14
138104,4,55,12,0,43,12
138104,3,21,5,0,16,5
138104,2,4,1,0,3,1
138104,1,10,2,0,8,2
3586,10,4,3,0,1,3
3586,9,7,3,0,4,3
3586,8,62,28,0,34,28
3586,7,140,51,0,89,51
3586,6,218,74,0,144,74
3586,5,74,33,0,41,33
3586,4,32,18,0,14,18
3586,3,4,3,0,1,3
3586,2,3,1,0,2,1
24416,9,15,3,0,12,3
24416,8,78,16,0,62,16
24416,7,149,29,0,120,29
24416,6,183,35,0,148,35
24416,5,65,15,0,50,15
24416,4,31,8,0,23,8
24416,3,9,4,0,5,4
24416,2,9,6,0,3,6
79282,10,7,3,0,4,3
79282,9,8,1,0,7,1
79282,8,88,19,0,69,19
79282,7,121,19,0,102,19
79282,6,156,33,0,123,33
79282,5,73,18,0,55,18
79282,4,57,17,0,40,17
79282,3,19,11,0,8,11
79282,2,10,5,0,5,5
79282,1,4,1,0,3,1
1143,10,16,9,0,7,9
1143,9,21,8,0,13,8
1143,8,60,20,0,40,20
1143,7,99,22,0,77,22
1143,6,106,34,0,72,34
1143,5,42,10,0,32,10
1143,4,19,5,0,14,5
1143,3,8,5,0,3,5
1143,2,3,2,0,1,2
172737,10,166,52,3,114,49
172737,9,136,31,4,105,27
172737,8,137,28,2,109,26
172737,7,44,7,1,37,6
172737,6,35,8,0,27,8
172737,5,10,2,0,8,2
172737,4,7,3,0,4,3
172737,2,6,2,0,4,2
172737,1,2,1,1,1,0
256877,10,15,2,0,13,2
256877,9,33,9,0,24,9
256877,8,146,25,0,121,25
256877,7,161,19,0,142,19
256877,6,124,21,0,103,21
256877,5,37,10,0,27,10
256877,4,19,6,0,13,6
256877,3,7,2,0,5,2
164840,10,14,3,0,11,3
164840,9,17,2,0,15,2
164840,8,72,9,0,63,9
164840,7,139,11,0,128,11
164840,6,186,28,0,158,28
164840,5,65,4,0,61,4
164840,4,33,9,0,24,9
164840,3,10,2,0,8,2
56758,9,12,6,0,6,6
56758,8,98,31,0,67,31
56758,7,165,57,0,108,57
56758,6,184,51,0,133,51
56758,5,46,17,0,29,17
56758,4,21,9,0,12,9
56758,3,12,4,0,8,4
56758,2,4,1,0,3,1
37461,10,7,2,0,5,2
37461,9,29,10,0,19,10
37461,8,104,27,0,77,27
37461,7,148,37,0,111,37
37461,6,134,47,0,87,47
37461,5,62,19,0,43,19
37461,4,28,14,0,14,14
37461,3,17,10,0,7,10
37461,2,12,5,0,7,5
37461,1,1,1,0,0,1
224272,10,18,6,0,12,6
224272,9,35,6,0,29,6
224272,8,126,20,0,106,20
224272,7,135,18,0,117,18
224272,6,137,14,0,123,14
224272,5,48,3,0,45,3
224272,4,21,6,0,15,6
224272,3,15,4,0,11,4
224272,2,6,1,0,5,1
8127,9,3,1,0,2,1
8127,8,15,4,0,11,4
8127,7,72,21,0,51,21
8127,6,197,50,0,147,50
8127,5,112,30,0,82,30
8127,4,77,23,0,54,23
8127,3,46,14,0,32,14
8127,2,13,6,0,7,6
8127,1,5,2,0,3,2
5050,7,15,3,0,12,3
5050,6,34,3,0,31,3
5050,5,63,14,0,49,14
5050,4,112,26,0,86,26
5050,3,102,31,0,71,31
5050,2,101,45,0,56,45
5050,1,104,55,0,49,55
6420,10,2,2,0,0,2
6420,9,8,4,0,4,4
6420,8,25,10,0,15,10
6420,7,65,25,0,40,25
6420,6,150,46,0,104,46
6420,5,147,36,0,111,36
6420,4,83,26,0,57,26
6420,3,43,16,0,27,16
6420,2,9,3,0,6,3
6420,1,10,4,0,6,4
23953,10,54,26,0,28,26
23953,9,36,19,0,17,19
23953,8,130,66,1,64,65
23953,7,106,47,0,59,47
23953,6,101,49,0,52,49
23953,5,26,12,0,14,12
20195,10,12,1,0,11,1
20195,9,9,4,0,5,4
20195,8,72,19,0,53,19
20195,7,131,35,0,96,35
20195,6,194,69,0,125,69
20195,5,70,17,0,53,17
20195,4,40,10,0,30,10
20195,3,8,4,0,4,4
20195,1,2,1,0,1,1
16144,10,2,1,0,1,1
16144,8,30,11,0,19,11
16144,7,99,37,0,62,37
16144,6,226,83,0,143,83
16144,5,101,43,0,58,43
16144,4,53,18,0,35,18
16144,3,19,10,0,9,10
16144,2,6,3,0,3,3
16144,1,1,1,0,0,1
179071,10,13,5,1,8,4
179071,9,36,12,1,24,11
179071,8,175,36,3,139,33
179071,7,175,16,2,159,14
179071,6,106,17,3,89,14
179071,5,24,7,0,17,7
179071,4,6,1,0,5,1
179071,3,4,1,0,3,1
200058,10,27,4,0,23,4
200058,9,34,5,0,29,5
200058,8,209,48,0,161,48
200058,7,134,30,0,104,30
200058,6,99,20,0,79,20
200058,5,28,4,0,24,4
200058,3,4,2,0,2,2
200058,2,2,1,0,1,1
19854,10,36,16,0,20,16
19854,9,70,26,0,44,26
19854,8,177,53,0,124,53
19854,7,140,41,0,99,41
19854,6,69,22,0,47,22
19854,5,24,7,0,17,7
19854,4,11,7,0,4,7
19854,3,5,3,0,2,3
19854,2,4,3,0,1,3
19854,1,3,1,0,2,1
182074,9,10,2,0,8,2
182074,8,86,18,0,68,18
182074,7,141,25,0,116,25
182074,6,189,36,0,153,36
182074,5,64,14,0,50,14
182074,4,27,7,0,20,7
182074,3,9,5,0,4,5
182074,2,8,3,0,5,3
182074,1,2,1,0,1,1
6117,9,10,5,0,5,5
6117,8,55,19,0,36,19
6117,7,130,50,0,80,50
6117,6,200,69,0,131,69
6117,5,88,30,0,58,30
6117,4,39,16,0,23,16
6117,3,10,5,0,5,5
6117,2,5,4,0,1,4
6117,1,1,1,0,0,1
534,10,15,1,0,14,1
534,9,10,2,0,8,2
534,8,67,13,0,54,13
534,7,152,43,0,109,43
534,6,191,33,0,158,33
534,5,74,11,0,63,11
534,4,19,5,0,14,5
534,3,11,6,0,5,6
91773,10,27,3,0,24,3
91773,9,40,3,0,37,3
91773,8,115,10,0,105,10
91773,7,158,21,0,137,21
91773,6,127,21,0,106,21
91773,5,39,7,0,32,7
91773,4,18,4,0,14,4
91773,3,5,1,0,4,1
91773,2,4,1,0,3,1
91773,1,6,2,0,4,2
2133,10,17,6,0,11,6
2133,9,26,9,0,17,9
2133,8,48,11,0,37,11
2133,7,82,21,0,61,21
2133,6,157,47,0,110,47
2133,5,89,18,0,71,18
2133,4,40,13,0,27,13
2133,3,24,8,0,16,8
2133,2,6,3,0,3,3
2133,1,1,1,0,0,1
18946,9,16,3,0,13,3
18946,8,54,13,0,41,13
18946,7,125,23,0,102,23
18946,6,199,24,0,175,24
18946,5,85,16,0,69,16
18946,4,27,5,0,22,5
18946,3,16,5,0,11,5
18946,2,10,1,0,9,1
120447,10,6,1,1,5,0
120447,9,8,2,1,6,1
120447,8,65,13,1,52,12
120447,7,134,19,1,115,18
120447,6,158,15,0,143,15
120447,5,79,13,0,66,13
120447,4,50,11,0,39,11
120447,3,28,6,1,22,5
120447,2,10,1,0,9,1
120447,1,1,1,0,0,1
195867,9,37,12,1,25,11
195867,8,145,21,0,124,21
195867,7,181,27,0,154,27
195867,6,124,24,0,100,24
195867,5,31,5,0,26,5
195867,4,11,2,0,9,2
195867,2,1,1,0,0,1
139897,9,8,3,0,5,3
139897,8,63,13,2,50,11
139897,7,113,22,1,91,21
139897,6,219,26,1,193,25
139897,5,78,19,1,59,18
139897,4,34,15,1,19,14
139897,3,20,8,0,12,8
139897,2,3,1,0,2,1
96,10,11,5,0,6,5
96,9,19,6,0,13,6
96,8,77,29,0,48,29
96,7,101,25,0,76,25
96,6,170,63,0,107,63
96,5,89,33,0,56,33
96,4,39,21,0,18,21
96,3,22,11,0,11,11
96,2,8,3,0,5,3
5622,10,65,19,0,46,19
5622,9,94,36,0,58,36
5622,8,154,47,0,107,47
5622,7,113,19,0,94,19
5622,6,61,11,0,50,11
5622,5,27,5,0,22,5
5622,4,12,3,0,9,3
5622,3,4,1,0,3,1
5622,1,6,2,0,4,2
3801,10,6,3,0,3,3
3801,9,11,5,0,6,5
3801,8,43,16,0,27,16
3801,7,96,24,0,72,24
3801,6,142,38,0,104,38
3801,5,116,42,0,74,42
3801,4,53,25,0,28,25
3801,3,41,15,0,26,15
3801,2,22,11,0,11,11
3801,1,7,5,0,2,5
22143,10,86,39,0,47,39
22143,9,150,56,0,94,56
22143,8,168,50,0,118,50
22143,7,63,12,0,51,12
22143,6,35,10,0,25,10
22143,5,15,2,0,13,2
22143,2,4,4,0,0,4
36986,10,6,3,0,3,3
36986,9,21,7,0,14,7
36986,8,89,24,0,65,24
36986,7,126,33,0,93,33
36986,6,149,40,0,109,40
36986,5,68,24,0,44,24
36986,4,37,17,0,20,17
36986,3,20,10,0,10,10
36986,2,15,7,0,8,7
36986,1,6,4,0,2,4
122690,9,35,6,0,29,6
122690,8,127,28,0,99,28
122690,7,139,27,0,112,27
122690,6,118,20,0,98,20
122690,5,52,10,0,42,10
122690,4,21,2,0,19,2
122690,3,14,3,0,11,3
122690,2,7,3,0,4,3
122690,1,6,1,0,5,1
215371,10,26,9,0,17,9
215371,9,51,10,0,41,10
215371,8,155,26,1,129,25
215371,7,147,23,0,124,23
215371,6,98,24,0,74,24
215371,5,32,6,0,26,6
215371,4,14,2,0,12,2
215371,3,9,3,0,6,3
215371,2,4,1,0,3,1
215371,1,1,1,0,0,1
24878,10,26,9,0,17,9
24878,9,57,17,0,40,17
24878,8,131,40,0,91,40
24878,7,124,25,0,99,25
24878,6,109,34,0,75,34
24878,5,49,16,0,33,16
24878,4,21,8,0,13,8
24878,3,10,1,0,9,1
24878,2,7,1,0,6,1
24878,1,2,1,0,1,1
30328,10,21,5,0,16,5
30328,9,30,10,0,20,10
30328,8,83,39,0,44,39
30328,7,112,43,0,69,43
30328,6,181,64,0,117,64
30328,5,74,28,0,46,28
30328,4,29,11,0,18,11
30328,3,4,1,0,3,1
30328,2,1,1,0,0,1
137238,9,14,2,0,12,2
137238,8,93,18,0,75,18
137238,7,143,27,0,116,27
137238,6,149,24,0,125,24
137238,5,67,14,0,53,14
137238,4,41,7,0,34,7
137238,3,11,1,0,10,1
137238,2,11,2,0,9,2
139562,10,16,2,0,14,2
139562,9,30,5,0,25,5
139562,8,191,42,4,149,38
139562,7,171,21,1,150,20
139562,6,83,14,1,69,13
139562,5,26,4,0,22,4
139562,4,10,1,1,9,0
257518,10,81,10,0,71,10
257518,9,184,32,1,152,31
257518,8,198,37,5,161,32
257518,7,46,10,1,36,9
257518,6,20,3,0,17,3
257518,5,5,1,0,4,1
257518,4,1,1,0,0,1
257518,3,2,1,0,1,1
84869,9,13,2,0,11,2
84869,8,96,17,0,79,17
84869,7,172,45,0,127,45
84869,6,156,38,0,118,38
84869,5,49,11,0,38,11
84869,4,26,7,0,19,7
84869,3,10,1,0,9,1
84869,2,6,1,0,5,1
84869,1,2,1,0,1,1
188314,10,20,3,0,17,3
188314,9,48,7,0,41,7
188314,8,197,29,1,168,28
188314,7,155,18,0,137,18
188314,6,84,6,0,78,6
188314,5,23,3,0,20,3
5259,9,5,2,0,3,2
5259,8,30,11,0,19,11
5259,7,67,21,0,46,21
5259,6,152,46,0,106,46
5259,5,120,34,0,86,34
5259,4,100,43,0,57,43
5259,3,43,17,0,26,17
5259,2,13,4,0,9,4
5259,1,2,2,0,0,2
129614,10,7,2,0,5,2
129614,9,19,7,0,12,7
129614,8,82,20,0,62,20
129614,7,173,19,0,154,19
129614,6,167,34,0,133,34
129614,5,49,11,0,38,11
129614,4,26,3,0,23,3
129614,3,7,1,0,6,1
13230,10,10,3,0,7,3
13230,9,13,3,0,10,3
13230,8,56,14,0,42,14
13230,7,117,18,0,99,18
13230,6,209,60,0,149,60
13230,5,76,20,0,56,20
13230,4,35,9,0,26,9
13230,3,9,5,0,4,5
13230,2,6,3,0,3,3
13230,1,2,1,0,1,1
63091,10,48,7,0,41,7
63091,9,68,18,0,50,18
63091,8,168,33,0,135,33
63091,7,118,8,0,110,8
63091,6,97,14,0,83,14
63091,5,18,2,0,16,2
63091,4,8,1,0,7,1
63091,1,5,1,0,4,1
157322,10,15,7,0,8,7
157322,9,24,4,0,20,4
157322,8,63,13,0,50,13
157322,7,125,27,0,98,27
157322,6,154,29,1,125,28
157322,5,76,20,0,56,20
157322,4,45,4,0,41,4
157322,3,20,7,0,13,7
157322,2,7,3,0,4,3
157322,1,4,2,0,2,2
233961,10,9,3,0,6,3
233961,9,18,5,0,13,5
233961,8,157,33,0,124,33
233961,7,190,28,0,162,28
233961,6,111,21,0,90,21
233961,5,33,9,0,24,9
233961,4,16,5,0,11,5
233961,2,1,1,0,0,1
226520,10,30,2,0,28,2
226520,9,78,14,0,64,14
226520,8,231,29,0,202,29
226520,7,113,6,0,107,6
226520,6,50,6,0,44,6
226520,5,18,3,0,15,3
226520,3,2,1,0,1,1
226520,1,5,1,0,4,1
2339,10,1,1,0,0,1
2339,9,3,2,0,1,2
2339,8,46,18,0,28,18
2339,7,112,42,0,70,42
2339,6,203,52,0,151,52
2339,5,91,36,0,55,36
2339,4,47,19,0,28,19
2339,3,19,7,0,12,7
2339,2,8,4,0,4,4
182218,9,10,3,0,7,3
182218,8,68,10,0,58,10
182218,7,126,19,0,107,19
182218,6,172,24,0,148,24
182218,5,74,8,0,66,8
182218,4,47,6,0,41,6
182218,3,23,2,0,21,2
182218,1,3,1,0,2,1
156373,10,15,4,0,11,4
156373,9,46,15,0,31,15
156373,8,147,34,0,113,34
156373,7,169,39,0,130,39
156373,6,109,22,0,87,22
156373,5,20,6,0,14,6
156373,4,12,2,0,10,2
156373,3,10,2,0,8,2
156373,2,2,1,0,1,1
13883,10,10,2,0,8,2
13883,9,45,12,0,33,12
13883,8,170,53,0,117,53
13883,7,163,43,0,120,43
13883,6,103,35,0,68,35
13883,5,28,10,0,18,10
13883,4,5,3,0,2,3
13883,2,5,1,0,4,1
88513,10,12,4,0,8,4
88513,9,43,10,0,33,10
88513,8,117,34,2,83,32
88513,7,133,32,1,101,31
88513,6,133,36,2,97,34
88513,5,52,13,1,39,12
88513,4,23,6,0,17,6
88513,3,13,3,0,10,3
88513,2,4,2,0,2,2
6521,10,2,2,0,0,2
6521,9,4,1,0,3,1
6521,8,14,6,0,8,6
6521,7,60,21,0,39,21
6521,6,175,60,0,115,60
6521,5,140,29,0,111,29
6521,4,73,30,0,43,30
6521,3,36,17,0,19,17
6521,2,24,7,0,17,7
152899,10,23,6,0,17,6
152899,9,52,8,0,44,8
152899,8,152,19,0,133,19
152899,7,151,16,0,135,16
152899,6,109,17,0,92,17
152899,5,29,4,0,25,4
152899,4,4,1,0,3,1
152899,3,4,2,0,2,2
152899,2,5,1,0,4,1
152899,1,2,2,0,0,2
2114,10,3,1,0,2,1
2114,9,14,6,0,8,6
2114,8,63,35,0,28,35
2114,7,124,51,0,73,51
2114,6,197,57,0,140,57
2114,5,78,18,0,60,18
2114,4,35,10,0,25,10
2114,3,13,3,0,10,3
2114,2,4,1,0,3,1
153422,9,16,4,0,12,4
153422,8,106,10,0,96,10
153422,7,149,23,0,126,23
153422,6,178,20,0,158,20
153422,5,56,10,0,46,10
153422,4,15,4,0,11,4
153422,3,3,1,0,2,1
17534,9,8,4,0,4,4
17534,8,31,7,0,24,7
17534,7,108,25,0,83,25
17534,6,194,40,0,154,40
17534,5,90,21,0,69,21
17534,4,62,22,0,40,22
17534,3,22,5,0,17,5
17534,2,10,6,0,4,6
193651,9,10,5,0,5,5
193651,8,79,13,0,66,13
193651,7,153,15,0,138,15
193651,6,181,37,0,144,37
193651,5,65,12,0,53,12
193651,4,24,7,0,17,7
193651,3,10,3,0,7,3
193651,2,3,1,0,2,1
193651,1,1,1,0,0,1
270,10,12,1,0,11,1
270,9,23,5,0,18,5
270,8,87,26,0,61,26
270,7,107,21,0,86,21
270,6,172,30,0,142,30
270,5,81,18,0,63,18
270,4,28,12,0,16,12
270,3,13,4,0,9,4
270,2,5,4,0,1,4
270,1,3,1,0,2,1
143096,10,49,14,1,35,13
143096,9,76,24,0,52,24
143096,8,154,48,4,106,44
143096,7,120,20,0,100,20
143096,6,68,15,1,53,14
143096,5,30,6,0,24,6
143096,4,14,2,0,12,2
143096,3,8,2,1,6,1
143096,2,8,3,0,5,3
143096,1,2,1,0,1,1
130605,10,12,2,0,10,2
130605,9,35,12,1,23,11
130605,8,136,38,3,98,35
130605,7,147,35,2,112,33
130605,6,125,26,1,99,25
130605,5,41,11,1,30,10
130605,4,19,7,0,12,7
130605,3,6,1,0,5,1
130605,2,4,3,1,1,2
5298,10,10,3,0,7,3
5298,9,17,6,0,11,6
5298,8,52,18,0,34,18
5298,7,78,20,0,58,20
5298,6,182,52,0,130,52
5298,5,81,22,0,59,22
5298,4,49,12,0,37,12
5298,3,25,11,0,14,11
5298,2,20,12,0,8,12
5298,1,13,6,0,7,6
11182,10,19,6,0,13,6
11182,9,30,12,0,18,12
11182,8,69,18,0,51,18
11182,7,123,26,0,97,26
11182,6,151,34,0,117,34
11182,5,70,18,0,52,18
11182,4,40,20,0,20,20
11182,3,17,6,0,11,6
11182,2,7,3,0,4,3
159059,10,24,11,0,13,11
159059,9,38,8,2,30,6
159059,8,163,39,13,124,26
159059,7,141,30,1,111,29
159059,6,97,26,6,71,20
159059,5,30,12,2,18,10
159059,4,23,9,0,14,9
159059,3,5,2,1,3,1
159059,2,2,1,1,1,0
159059,1,4,1,0,3,1
229414,10,13,3,0,10,3
229414,9,47,11,0,36,11
229414,8,170,28,0,142,28
229414,7,156,31,0,125,31
229414,6,90,14,0,76,14
229414,5,24,3,0,21,3
229414,4,16,3,0,13,3
229414,3,10,5,0,5,5
229414,2,1,1,0,0,1
38359,10,1,1,0,0,1
38359,9,9,1,0,8,1
38359,8,43,10,0,33,10
38359,7,88,28,0,60,28
38359,6,169,43,0,126,43
38359,5,83,25,0,58,25
38359,4,60,23,0,37,23
38359,3,34,13,0,21,13
38359,2,27,12,0,15,12
38359,1,14,6,0,8,6
11159,8,63,17,0,46,17
11159,7,135,24,0,111,24
11159,6,198,33,0,165,33
11159,5,72,14,0,58,14
11159,4,30,6,0,24,6
11159,3,9,2,0,7,2
11159,2,2,1,0,1,1
34227,9,9,1,0,8,1
34227,8,101,30,0,71,30
34227,7,170,45,0,125,45
34227,6,155,29,0,126,29
34227,5,48,11,0,37,11
34227,4,23,5,0,18,5
34227,3,11,3,0,8,3
228133,10,31,7,0,24,7
228133,9,54,11,0,43,11
228133,8,172,21,0,151,21
228133,7,132,21,0,111,21
228133,6,88,13,0,75,13
228133,5,37,9,0,28,9
228133,4,5,2,0,3,2
228133,3,4,2,0,2,2
1535,10,13,6,0,7,6
1535,9,29,18,0,11,18
1535,8,101,38,0,63,38
1535,7,131,45,0,86,45
1535,6,166,48,0,118,48
1535,5,50,13,0,37,13
1535,4,27,10,0,17,10
1535,3,6,3,0,3,3
1535,2,2,1,0,1,1
122599,10,22,12,1,10,11
122599,9,21,5,0,16,5
122599,8,75,18,0,57,18
122599,7,92,12,0,80,12
122599,6,121,18,0,103,18
122599,5,78,14,0,64,14
122599,4,53,11,0,42,11
122599,3,32,3,0,29,3
122599,2,15,2,0,13,2
122599,1,16,4,0,12,4
41429,10,62,25,0,37,25
41429,9,102,34,1,68,33
41429,8,180,52,3,128,49
41429,7,91,31,0,60,31
41429,6,61,29,1,32,28
41429,5,21,9,0,12,9
41429,4,4,2,0,2,2
41429,2,1,1,0,0,1
4792,10,3,1,0,2,1
4792,9,2,1,0,1,1
4792,7,15,3,0,12,3
4792,6,55,21,0,34,21
4792,5,96,31,0,65,31
4792,4,137,37,0,100,37
4792,3,109,32,0,77,32
4792,2,73,21,0,52,21
4792,1,33,12,0,21,12
145888,10,21,4,0,17,4
145888,9,24,6,0,18,6
145888,8,103,15,0,88,15
145888,7,150,29,0,121,29
145888,6,137,30,0,107,30
145888,5,44,9,0,35,9
145888,4,21,5,0,16,5
145888,3,17,4,0,13,4
145888,2,6,2,0,4,2
25738,10,7,2,0,5,2
25738,9,17,2,0,15,2
25738,8,76,16,0,60,16
25738,7,141,18,0,123,18
25738,6,167,23,0,144,23
25738,5,62,3,0,59,3
25738,4,31,5,0,26,5
25738,3,18,3,0,15,3
25738,2,3,1,0,2,1
25738,1,3,1,0,2,1
123228,9,24,5,1,19,4
123228,8,107,27,2,80,25
123228,7,125,16,1,109,15
123228,6,176,41,3,135,38
123228,5,48,13,0,35,13
123228,4,27,12,0,15,12
123228,3,9,3,0,6,3
92666,10,14,2,0,12,2
92666,9,40,14,0,26,14
92666,8,138,42,2,96,40
92666,7,137,30,2,107,28
92666,6,116,29,0,87,29
92666,5,43,11,0,32,11
92666,4,27,5,0,22,5
92666,3,6,2,0,4,2
175755,10,6,1,0,5,1
175755,9,10,2,0,8,2
175755,8,45,9,0,36,9
175755,7,123,20,0,103,20
175755,6,205,28,0,177,28
175755,5,72,10,0,62,10
175755,4,35,9,0,26,9
175755,3,22,3,0,19,3
175755,2,6,3,0,3,3
6627,10,1,1,0,0,1
6627,8,34,11,0,23,11
6627,7,134,56,0,78,56
6627,6,213,81,0,132,81
6627,5,85,34,0,51,34
6627,4,32,12,0,20,12
6627,3,15,6,0,9,6
6627,2,3,2,0,1,2
6627,1,3,1,0,2,1
192240,10,21,8,1,13,7
192240,9,34,9,0,25,9
192240,8,109,31,7,78,24
192240,7,119,19,4,100,15
192240,6,150,27,4,123,23
192240,5,46,4,0,42,4
192240,4,26,6,0,20,6
192240,3,15,3,1,12,2
192240,2,3,1,0,2,1
4090,10,23,5,0,18,5
4090,9,54,15,0,39,15
4090,8,165,58,0,107,58
4090,7,147,39,0,108,39
4090,6,93,21,0,72,21
4090,5,16,3,0,13,3
4090,4,18,7,0,11,7
4090,3,6,3,0,3,3
4090,1,1,1,0,0,1
2,10,19,7,0,12,7
2,9,29,9,0,20,9
2,8,83,35,0,48,35
2,7,138,43,0,95,43
2,6,159,62,0,97,62
2,5,66,20,0,46,20
2,4,17,10,0,7,10
2,3,7,2,0,5,2
2,2,3,2,0,1,2
237211,10,106,27,1,79,26
237211,9,78,13,0,65,13
237211,8,117,15,0,102,15
237211,7,87,8,1,79,7
237211,6,65,5,0,60,5
237211,5,28,6,0,22,6
237211,4,17,1,0,16,1
237211,3,10,1,0,9,1
237211,2,6,1,0,5,1
237211,1,10,5,0,5,5
2001,10,3,1,0,2,1
2001,9,6,1,0,5,1
2001,8,26,2,0,24,2
2001,7,74,3,0,71,3
2001,6,175,19,0,156,19
2001,5,122,17,0,105,17
2001,4,68,16,0,52,16
2001,3,25,8,0,17,8
2001,2,19,7,0,12,7
172155,10,44,9,0,35,9
172155,9,64,14,0,50,14
172155,8,159,26,0,133,26
172155,7,132,13,0,119,13
172155,6,84,14,0,70,14
172155,5,21,6,0,15,6
172155,4,11,5,0,6,5
172155,3,5,1,0,4,1
172155,2,4,1,0,3,1
210296,10,36,13,2,23,11
210296,9,112,26,6,86,20
210296,8,214,34,2,180,32
210296,7,80,11,0,69,11
210296,6,48,15,0,33,15
210296,5,17,6,0,11,6
210296,4,8,2,0,6,2
210296,3,7,2,0,5,2
210296,2,3,2,0,1,2
1710,10,23,11,0,12,11
1710,9,49,15,0,34,15
1710,8,135,41,0,94,41
1710,7,149,35,0,114,35
1710,6,106,20,0,86,20
1710,5,37,10,0,27,10
1710,4,11,3,0,8,3
1710,3,5,2,0,3,2
1710,2,5,1,0,4,1
1710,1,2,1,0,1,1
23,10,38,16,0,22,16
23,9,45,16,0,29,16
23,8,122,42,0,80,42
23,7,135,47,0,88,47
23,6,107,40,0,67,40
23,5,42,17,0,25,17
23,4,23,10,0,13,10
23,3,5,2,0,3,2
23,2,4,1,0,3,1
20847,9,3,1,0,2,1
20847,8,39,13,0,26,13
20847,7,120,43,0,77,43
20847,6,188,62,0,126,62
20847,5,105,47,0,58,47
20847,4,39,18,0,21,18
20847,3,18,11,0,7,11
20847,2,8,7,0,1,7
147305,10,8,1,0,7,1
147305,9,14,1,0,13,1
147305,8,73,16,0,57,16
147305,7,124,18,0,106,18
147305,6,181,28,0,153,28
147305,5,79,17,0,62,17
147305,4,27,7,0,20,7
147305,3,10,1,0,9,1
147305,2,4,1,0,3,1
220780,10,8,2,0,6,2
220780,9,25,8,0,17,8
220780,8,68,5,0,63,5
220780,7,138,24,0,114,24
220780,6,174,36,0,138,36
220780,5,64,8,0,56,8
220780,4,24,3,0,21,3
220780,3,13,3,0,10,3
220780,2,8,5,0,3,5
134,10,1,1,0,0,1
134,9,3,1,0,2,1
134,8,36,9,0,27,9
134,7,123,45,0,78,45
134,6,224,61,0,163,61
134,5,86,26,0,60,26
134,4,35,12,0,23,12
134,3,12,3,0,9,3
184700,10,10,2,0,8,2
184700,9,14,5,1,9,4
184700,8,128,21,3,107,18
184700,7,161,27,2,134,25
184700,6,142,21,1,121,20
184700,5,34,5,0,29,5
184700,4,22,5,2,17,3
252446,10,22,3,0,19,3
252446,9,49,12,0,37,12
252446,8,239,55,2,184,53
252446,7,127,24,1,103,23
252446,6,62,19,0,43,19
252446,5,14,5,0,9,5
252446,4,6,3,0,3,3
252446,1,1,1,0,0,1
353,9,5,2,0,3,2
353,8,27,8,0,19,8
353,7,80,13,0,67,13
353,6,162,41,0,121,41
353,5,113,33,0,80,33
353,4,80,27,0,53,27
353,3,29,12,0,17,12
353,2,16,8,0,8,8
353,1,7,1,0,6,1
108344,10,20,7,0,13,7
108344,9,21,5,0,16,5
108344,8,122,18,0,104,18
108344,7,135,20,0,115,20
108344,6,125,19,0,106,19
108344,5,46,11,0,35,11
108344,4,36,5,0,31,5
108344,3,11,2,0,9,2
158534,10,7,2,0,5,2
158534,9,13,5,0,8,5
158534,8,83,11,0,72,11
158534,7,150,25,0,125,25
158534,6,153,33,0,120,33
158534,5,67,19,1,48,18
158534,4,29,6,0,23,6
158534,3,12,3,0,9,3
158534,1,2,1,0,1,1
8964,10,3,1,0,2,1
8964,9,7,4,0,3,4
8964,8,25,16,0,9,16
8964,7,86,27,0,59,27
8964,6,146,32,0,114,32
8964,5,123,27,0,96,27
8964,4,85,24,0,61,24
8964,3,28,4,0,24,4
8964,2,12,5,0,7,5
8964,1,5,3,0,2,3
870,10,8,3,0,5,3
870,9,22,6,0,16,6
870,8,106,48,0,58,48
870,7,149,46,0,103,46
870,6,155,62,0,93,62
870,5,42,16,0,26,16
870,4,20,9,0,11,9
870,3,15,5,0,10,5
870,1,1,1,0,0,1
182875,9,2,1,0,1,1
182875,8,17,4,0,13,4
182875,7,52,12,0,40,12
182875,6,125,20,0,105,20
182875,5,105,14,0,91,14
182875,4,84,16,0,68,16
182875,3,63,18,0,45,18
182875,2,43,11,0,32,11
182875,1,17,3,0,14,3
10164,10,7,1,0,6,1
10164,9,2,2,0,0,2
10164,8,48,4,0,44,4
10164,7,106,21,0,85,21
10164,6,210,19,0,191,19
10164,5,87,12,0,75,12
10164,4,35,5,0,30,5
10164,3,18,3,0,15,3
766,10,14,6,0,8,6
766,9,15,3,0,12,3
766,8,58,22,0,36,22
766,7,135,44,0,91,44
766,6,187,52,0,135,52
766,5,56,17,0,39,17
766,4,33,13,0,20,13
766,3,12,3,0,9,3
766,2,6,6,0,0,6
28044,10,9,2,0,7,2
28044,9,30,14,0,16,14
28044,8,117,53,0,64,53
28044,7,129,51,0,78,51
28044,6,151,65,0,86,65
28044,5,37,10,0,27,10
28044,4,29,9,0,20,9
28044,3,6,3,0,3,3
28044,2,9,6,0,3,6
246663,10,26,11,0,15,11
246663,9,51,12,0,39,12
246663,8,208,33,0,175,33
246663,7,132,29,0,103,29
246663,6,71,13,0,58,13
246663,5,23,7,0,16,7
246663,4,5,2,0,3,2
246663,3,1,1,0,0,1
259,10,22,9,0,13,9
259,9,26,8,0,18,8
259,8,108,41,0,67,41
259,7,112,30,0,82,30
259,6,126,39,0,87,39
259,5,62,22,0,40,22
259,4,30,15,0,15,15
259,3,20,8,0,12,8
259,2,7,4,0,3,4
259,1,4,2,0,2,2
12750,10,55,27,0,28,27
12750,9,129,48,0,81,48
12750,8,190,60,0,130,60
12750,7,88,22,0,66,22
12750,6,30,14,0,16,14
12750,5,13,10,0,3,10
12750,4,5,3,0,2,3
124047,9,13,4,0,9,4
124047,8,69,14,1,55,13
124047,7,122,37,2,85,35
124047,6,179,40,4,139,36
124047,5,68,19,1,49,18
124047,4,41,14,0,27,14
124047,3,12,5,0,7,5
124047,2,6,3,0,3,3
2455,10,23,6,0,17,6
2455,9,32,7,0,25,7
2455,8,142,40,0,102,40
2455,7,167,50,0,117,50
2455,6,101,28,0,73,28
2455,5,27,12,0,15,12
2455,4,13,5,0,8,5
2455,3,5,2,0,3,2
2455,2,4,3,0,1,3
111502,10,20,1,0,19,1
111502,9,36,6,0,30,6
111502,8,122,20,0,102,20
111502,7,130,16,0,114,16
111502,6,123,23,0,100,23
111502,5,38,7,0,31,7
111502,4,21,9,0,12,9
111502,3,14,1,0,13,1
111502,1,4,1,0,3,1
71272,10,10,4,0,6,4
71272,9,11,7,0,4,7
71272,8,65,20,0,45,20
71272,7,116,32,0,84,32
71272,6,183,48,0,135,48
71272,5,82,21,0,61,21
71272,4,34,7,0,27,7
71272,3,11,6,0,5,6
71272,2,4,1,0,3,1
200924,10,8,1,0,7,1
200924,9,16,3,0,13,3
200924,8,152,19,0,133,19
200924,7,180,34,0,146,34
200924,6,125,25,0,100,25
200924,5,22,4,0,18,4
200924,4,13,4,0,9,4
40629,8,19,5,0,14,5
40629,7,77,28,0,49,28
40629,6,208,61,0,147,61
40629,5,109,28,0,81,28
40629,4,64,18,0,46,18
40629,3,23,5,0,18,5
40629,2,12,5,0,7,5
40629,1,2,1,0,1,1
80642,10,8,3,0,5,3
80642,9,23,4,0,19,4
80642,8,151,45,0,106,45
80642,7,163,37,0,126,37
80642,6,122,38,0,84,38
80642,5,32,8,0,24,8
80642,4,12,5,0,7,5
80642,3,4,1,0,3,1
352,10,7,2,0,5,2
352,9,13,2,0,11,2
352,8,74,16,0,58,16
352,7,112,38,0,74,38
352,6,162,42,0,120,42
352,5,76,28,0,48,28
352,4,44,12,0,32,12
352,3,17,6,0,11,6
352,2,11,5,0,6,5
11106,10,31,7,0,24,7
11106,9,34,7,0,27,7
11106,8,104,29,0,75,29
11106,7,142,21,0,121,21
11106,6,115,28,0,87,28
11106,5,51,13,0,38,13
11106,4,14,3,0,11,3
11106,3,12,5,0,7,5
11106,2,8,3,0,5,3
3706,10,6,1,0,5,1
3706,9,9,2,0,7,2
3706,8,41,16,0,25,16
3706,7,92,33,0,59,33
3706,6,208,71,0,137,71
3706,5,101,27,0,74,27
3706,4,36,10,0,26,10
3706,3,18,4,0,14,4
3706,2,3,2,0,1,2
2168,10,11,5,0,6,5
2168,9,23,8,0,15,8
2168,8,61,20,0,41,20
2168,7,131,43,0,88,43
2168,6,152,44,0,108,44
2168,5,80,16,0,64,16
2168,4,34,11,0,23,11
2168,3,11,2,0,9,2
2168,2,8,5,0,3,5
2168,1,4,1,0,3,1
177939,10,45,9,0,36,9
177939,9,62,6,0,56,6
177939,8,173,16,0,157,16
177939,7,124,12,0,112,12
177939,6,82,10,0,72,10
177939,5,20,4,0,16,4
177939,3,2,2,0,0,2
177939,2,2,1,0,1,1
177939,1,2,1,0,1,1
14683,10,7,4,0,3,4
14683,9,31,11,0,20,11
14683,8,135,55,0,80,55
14683,7,162,51,0,111,51
14683,6,114,38,0,76,38
14683,5,33,19,0,14,19
14683,4,19,9,0,10,9
14683,3,9,7,0,2,7
14683,2,4,3,0,1,3
14683,1,1,1,0,0,1
3661,10,21,6,0,15,6
3661,9,23,7,0,16,7
3661,8,108,43,0,65,43
3661,7,162,46,0,116,46
3661,6,129,38,0,91,38
3661,5,55,6,0,49,6
3661,4,13,3,0,10,3
64956,10,9,2,0,7,2
64956,9,12,3,0,9,3
64956,8,80,25,0,55,25
64956,7,186,55,0,131,55
64956,6,170,29,0,141,29
64956,5,33,10,0,23,10
64956,4,16,3,0,13,3
64956,3,5,1,0,4,1
171226,10,20,7,0,13,7
171226,9,33,3,0,30,3
171226,8,123,27,0,96,27
171226,7,155,21,0,134,21
171226,6,122,26,0,96,26
171226,5,40,9,0,31,9
171226,4,11,2,0,9,2
171226,3,9,1,0,8,1
12627,9,8,4,0,4,4
12627,8,48,15,0,33,15
12627,7,92,25,0,67,25
12627,6,191,67,0,124,67
12627,5,83,33,0,50,33
12627,4,54,19,0,35,19
12627,3,25,11,0,14,11
12627,2,6,1,0,5,1
28185,10,13,4,0,9,4
28185,9,25,7,0,18,7
28185,8,81,25,0,56,25
28185,7,149,45,0,104,45
28185,6,136,47,0,89,47
28185,5,53,23,0,30,23
28185,4,34,13,0,21,13
28185,3,15,10,0,5,10
28185,2,3,2,0,1,2
28185,1,4,3,0,1,3
169464,10,34,12,0,22,12
169464,9,75,16,2,59,14
169464,8,194,44,6,150,38
169464,7,120,25,1,95,24
169464,6,56,20,0,36,20
169464,5,16,2,0,14,2
169464,4,9,5,0,4,5
169464,3,5,2,0,3,2
169464,2,2,1,0,1,1
229218,10,29,5,0,24,5
229218,9,45,11,0,34,11
229218,8,137,15,0,122,15
229218,7,175,20,0,155,20
229218,6,82,11,0,71,11
229218,5,25,5,0,20,5
229218,4,10,2,0,8,2
229218,3,4,3,0,1,3
229218,1,8,5,0,3,5
2079,10,18,10,0,8,10
2079,9,27,8,0,19,8
2079,8,85,26,0,59,26
2079,7,144,46,0,98,46
2079,6,146,41,0,105,41
2079,5,61,15,0,46,15
2079,4,17,6,0,11,6
2079,3,5,1,0,4,1
2079,2,5,4,0,1,4
2079,1,3,2,0,1,2
5455,10,18,9,0,9,9
5455,9,22,7,0,15,7
5455,8,71,29,0,42,29
5455,7,129,44,0,85,44
5455,6,150,46,0,104,46
5455,5,77,30,0,47,30
5455,4,28,8,0,20,8
5455,3,8,4,0,4,4
5455,2,8,4,0,4,4
166317,10,38,8,0,30,8
166317,9,74,13,0,61,13
166317,8,219,40,0,179,40
166317,7,101,11,0,90,11
166317,6,54,12,0,42,12
166317,5,13,4,0,9,4
166317,4,6,1,0,5,1
166317,1,4,1,0,3,1
7858,10,60,34,0,26,34
7858,9,126,40,0,86,40
7858,8,183,52,0,131,52
7858,7,98,25,0,73,25
7858,6,19,6,0,13,6
7858,5,10,3,0,7,3
7858,4,8,3,0,5,3
7858,3,3,2,0,1,2
7858,1,6,1,0,5,1
142854,10,7,4,0,3,4
142854,9,44,14,0,30,14
142854,8,219,54,0,165,54
142854,7,132,33,0,99,33
142854,6,87,23,0,64,23
142854,5,14,2,0,12,2
142854,4,6,2,0,4,2
142854,3,2,1,0,1,1
142555,9,30,5,0,25,5
142555,8,119,19,0,100,19
142555,7,161,25,0,136,25
142555,6,124,17,0,107,17
142555,5,37,2,0,35,2
142555,4,17,5,0,12,5
142555,3,5,1,0,4,1
142555,1,2,1,0,1,1
82402,10,7,1,0,6,1
82402,9,19,1,0,18,1
82402,8,66,6,0,60,6
82402,7,138,14,0,124,14
82402,6,162,14,0,148,14
82402,5,58,9,0,49,9
82402,4,46,5,0,41,5
82402,3,8,2,0,6,2
82402,2,5,1,0,4,1
82402,1,1,1,0,0,1
131904,10,51,13,0,38,13
131904,9,93,25,2,68,23
131904,8,175,32,2,143,30
131904,7,83,8,0,75,8
131904,6,76,15,1,61,14
131904,5,24,8,1,16,7
131904,4,7,2,0,5,2
131904,2,1,1,0,0,1
166107,10,5,3,0,2,3
166107,9,14,1,0,13,1
166107,8,78,16,0,62,16
166107,7,146,33,1,113,32
166107,6,174,39,0,135,39
166107,5,57,11,0,46,11
166107,4,23,7,1,16,6
166107,3,10,6,0,4,6
166107,2,4,1,0,3,1
175961,10,12,1,0,11,1
175961,9,19,2,0,17,2
175961,8,62,12,0,50,12
175961,7,135,19,0,116,19
175961,6,173,25,0,148,25
175961,5,62,9,0,53,9
175961,4,27,4,0,23,4
175961,3,12,2,0,10,2
175961,2,7,1,0,6,1
4050,10,14,8,0,6,8
4050,9,26,12,0,14,12
4050,8,74,28,0,46,28
4050,7,153,46,0,107,46
4050,6,160,56,0,104,56
4050,5,52,15,0,37,15
4050,4,22,8,0,14,8
4050,3,7,3,0,4,3
4050,2,2,1,0,1,1
147747,10,13,3,0,10,3
147747,9,31,6,0,25,6
147747,8,136,29,0,107,29
147747,7,143,25,0,118,25
147747,6,125,22,0,103,22
147747,5,33,5,0,28,5
147747,4,16,3,0,13,3
147747,3,6,2,0,4,2
147747,2,5,1,0,4,1
147747,1,2,1,0,1,1
3337,10,4,1,0,3,1
3337,9,5,1,0,4,1
3337,8,29,4,0,25,4
3337,7,100,14,0,86,14
3337,6,175,26,0,149,26
3337,5,84,10,0,74,10
3337,4,66,15,0,51,15
3337,3,25,7,0,18,7
3337,2,16,5,0,11,5
3337,1,5,3,0,2,3
215308,10,12,1,0,11,1
215308,9,21,3,0,18,3
215308,8,146,19,0,127,19
215308,7,151,22,0,129,22
215308,6,119,22,0,97,22
215308,5,38,11,0,27,11
215308,4,17,5,0,12,5
215308,3,5,1,0,4,1
215308,2,2,1,0,1,1
142432,8,51,9,0,42,9
142432,7,108,14,0,94,14
142432,6,201,31,0,170,31
142432,5,84,18,0,66,18
142432,4,33,11,0,22,11
142432,3,15,4,0,11,4
142432,2,4,2,0,2,2
142432,1,3,1,0,2,1
123045,10,9,3,0,6,3
123045,9,18,7,0,11,7
123045,8,112,32,0,80,32
123045,7,147,28,0,119,28
123045,6,130,29,0,101,29
123045,5,43,8,0,35,8
123045,4,26,8,0,18,8
123045,3,16,5,0,11,5
123045,2,6,2,0,4,2
123045,1,2,1,0,1,1
41372,10,4,2,0,2,2
41372,9,10,2,0,8,2
41372,8,40,12,0,28,12
41372,7,74,24,0,50,24
41372,6,140,29,0,111,29
41372,5,83,24,0,59,24
41372,4,43,12,0,31,12
41372,3,18,8,0,10,8
41372,2,11,3,0,8,3
41372,1,5,3,0,2,3
2316,10,9,2,0,7,2
2316,9,16,10,0,6,10
2316,8,78,30,0,48,30
2316,7,132,42,0,90,42
2316,6,168,60,0,108,60
2316,5,51,18,0,33,18
2316,4,30,9,0,21,9
2316,3,15,5,0,10,5
2316,2,7,3,0,4,3
35342,10,24,11,0,13,11
35342,9,67,30,1,37,29
35342,8,154,59,0,95,59
35342,7,149,42,0,107,42
35342,6,70,21,0,49,21
35342,5,23,10,0,13,10
35342,4,11,4,0,7,4
35342,3,8,3,0,5,3
35342,2,2,1,0,1,1
160409,9,13,5,0,8,5
160409,8,72,14,2,58,12
160409,7,130,35,0,95,35
160409,6,200,49,0,151,49
160409,5,59,4,0,55,4
160409,4,22,7,0,15,7
245197,10,15,5,0,10,5
245197,9,35,7,0,28,7
245197,8,125,19,3,106,16
245197,7,157,19,2,138,17
245197,6,117,21,2,96,19
245197,5,34,5,1,29,4
245197,4,18,4,0,14,4
245197,2,4,1,0,3,1
139952,10,44,14,1,30,13
139952,9,88,17,0,71,17
139952,8,190,43,0,147,43
139952,7,86,16,0,70,16
139952,6,64,17,0,47,17
139952,5,22,9,0,13,9
139952,4,9,5,1,4,4
139952,2,1,1,0,0,1
139952,1,1,1,0,0,1
2956,10,4,1,0,3,1
2956,9,1,1,0,0,1
2956,7,20,3,0,17,3
2956,6,65,13,0,52,13
2956,5,94,15,0,79,15
2956,4,121,25,0,96,25
2956,3,94,29,0,65,29
2956,2,69,25,0,44,25
2956,1,31,15,0,16,15
12248,10,3,1,0,2,1
12248,9,9,4,0,5,4
12248,8,55,12,0,43,12
12248,7,114,27,0,87,27
12248,6,193,57,0,136,57
12248,5,74,23,0,51,23
12248,4,34,12,0,22,12
12248,3,16,8,0,8,8
12248,2,8,5,0,3,5
1448,9,12,7,0,5,7
1448,8,74,31,0,43,31
1448,7,163,48,0,115,48
1448,6,157,50,0,107,50
1448,5,63,20,0,43,20
1448,4,25,9,0,16,9
1448,3,7,3,0,4,3
1448,2,1,1,0,0,1
1448,1,2,1,0,1,1
191301,10,72,25,2,47,23
191301,9,106,21,3,85,18
191301,8,175,24,2,151,22
191301,7,81,10,0,71,10
191301,6,43,4,0,39,4
191301,5,16,4,0,12,4
191301,4,6,1,0,5,1
191301,3,2,2,0,0,2
191301,1,6,1,0,5,1
177727,9,16,4,0,12,4
177727,8,114,24,0,90,24
177727,7,169,13,0,156,13
177727,6,137,15,0,122,15
177727,5,44,5,0,39,5
177727,4,11,2,0,9,2
177727,3,7,2,0,5,2
177727,1,1,1,0,0,1
140796,10,5,1,0,4,1
140796,9,12,3,0,9,3
140796,8,48,9,0,39,9
140796,7,93,12,0,81,12
140796,6,154,25,0,129,25
140796,5,88,17,0,71,17
140796,4,52,15,0,37,15
140796,3,26,6,0,20,6
140796,2,18,4,0,14,4
140796,1,11,4,0,7,4
3125,10,24,9,0,15,9
3125,9,31,9,0,22,9
3125,8,99,31,0,68,31
3125,7,125,47,0,78,47
3125,6,129,39,0,90,39
3125,5,59,16,0,43,16
3125,4,21,9,0,12,9
3125,3,14,7,0,7,7
3125,2,2,1,0,1,1
3125,1,2,1,0,1,1
10756,10,3,2,0,1,2
10756,9,4,2,0,2,2
10756,8,29,14,0,15,14
10756,7,85,34,0,51,34
10756,6,203,83,0,120,83
10756,5,97,34,0,63,34
10756,4,53,24,0,29,24
10756,3,25,14,0,11,14
10756,2,6,2,0,4,2
18963,10,6,2,0,4,2
18963,9,11,2,0,9,2
18963,8,36,14,0,22,14
18963,7,84,27,0,57,27
18963,6,181,46,0,135,46
18963,5,103,32,0,71,32
18963,4,57,20,0,37,20
18963,3,19,9,0,10,9
18963,2,8,5,0,3,5
18963,1,1,1,0,0,1
72809,10,27,11,0,16,11
72809,9,39,17,0,22,17
72809,8,124,27,0,97,27
72809,7,131,22,0,109,22
72809,6,91,20,0,71,20
72809,5,30,7,0,23,7
72809,4,19,6,1,13,5
72809,3,4,2,0,2,2
72809,2,7,4,0,3,4
72809,1,13,9,0,4,9
7967,9,5,2,0,3,2
7967,8,29,10,0,19,10
7967,7,83,23,0,60,23
7967,6,206,58,0,148,58
7967,5,96,30,0,66,30
7967,4,52,14,0,38,14
7967,3,25,10,0,15,10
7967,2,8,4,0,4,4
118776,10,4,2,0,2,2
118776,9,8,2,0,6,2
118776,8,61,18,1,43,17
118776,7,155,30,1,125,29
118776,6,186,42,1,144,41
118776,5,58,14,0,44,14
118776,4,27,10,1,17,9
118776,2,3,2,0,1,2
183797,8,61,8,0,53,8
183797,7,112,6,0,106,6
183797,6,194,21,0,173,21
183797,5,75,10,0,65,10
183797,4,28,7,0,21,7
183797,3,13,1,0,12,1
183797,2,5,2,0,3,2
180761,10,11,2,0,9,2
180761,9,25,6,1,19,5
180761,8,97,20,2,77,18
180761,7,139,20,2,119,18
180761,6,155,37,2,118,35
180761,5,46,10,0,36,10
180761,4,23,4,0,19,4
180761,3,5,1,0,4,1
180761,2,4,1,0,3,1
30483,10,5,3,0,2,3
30483,9,6,1,0,5,1
30483,8,51,20,0,31,20
30483,7,129,47,0,82,47
30483,6,194,71,0,123,71
30483,5,73,21,0,52,21
30483,4,31,13,0,18,13
30483,3,9,5,0,4,5
30483,2,6,4,0,2,4
30483,1,1,1,0,0,1
4550,10,23,9,0,14,9
4550,9,38,13,0,25,13
4550,8,98,42,0,56,42
4550,7,127,57,0,70,57
4550,6,133,59,0,74,59
4550,5,44,16,0,28,16
4550,4,19,9,0,10,9
4550,3,5,3,0,2,3
4550,2,8,5,0,3,5
4550,1,11,4,0,7,4
257527,10,12,1,0,11,1
257527,9,42,8,0,34,8
257527,8,165,28,0,137,28
257527,7,164,16,0,148,16
257527,6,89,19,0,70,19
257527,5,19,3,0,16,3
257527,4,11,2,0,9,2
257527,3,5,2,0,3,2
177354,10,79,21,0,58,21
177354,9,117,22,0,95,22
177354,8,176,28,0,148,28
177354,7,76,8,0,68,8
177354,6,36,6,0,30,6
177354,5,11,1,0,10,1
177354,4,5,2,0,3,2
177354,2,1,1,0,0,1
177354,1,3,1,0,2,1
155689,10,41,11,0,30,11
155689,9,59,8,0,51,8
155689,8,143,27,0,116,27
155689,7,116,21,0,95,21
155689,6,90,13,0,77,13
155689,5,33,6,0,27,6
155689,4,15,4,0,11,4
155689,1,2,1,0,1,1
244114,10,62,16,0,46,16
244114,9,125,33,0,92,33
244114,8,186,47,0,139,47
244114,7,81,14,0,67,14
244114,6,37,10,0,27,10
244114,5,9,2,0,7,2
244114,3,1,1,0,0,1
145976,10,36,10,0,26,10
145976,9,104,35,0,69,35
145976,8,187,43,0,144,43
145976,7,91,17,0,74,17
145976,6,52,20,0,32,20
145976,5,21,4,0,17,4
145976,4,7,3,0,4,3
145976,3,3,1,0,2,1
26055,10,16,1,0,15,1
26055,9,37,10,0,27,10
26055,8,134,34,0,100,34
26055,7,144,20,0,124,20
26055,6,96,22,0,74,22
26055,5,44,7,0,37,7
26055,4,19,5,0,14,5
26055,3,7,2,0,5,2
26055,2,5,1,0,4,1
130486,10,26,6,0,20,6
130486,9,66,15,0,51,15
130486,8,221,46,1,175,45
130486,7,101,23,0,78,23
130486,6,56,12,0,44,12
130486,5,20,5,0,15,5
130486,4,6,2,0,4,2
130486,3,7,3,0,4,3
2767,10,5,3,0,2,3
2767,9,8,3,0,5,3
2767,8,35,22,0,13,22
2767,7,74,40,0,34,40
2767,6,115,54,0,61,54
2767,5,112,51,0,61,51
2767,4,73,31,0,42,31
2767,3,34,13,0,21,13
2767,2,29,9,0,20,9
2767,1,19,10,0,9,10
748,10,15,6,0,9,6
748,9,15,8,0,7,8
748,8,82,30,0,52,30
748,7,137,41,0,96,41
748,6,150,38,0,112,38
748,5,68,19,0,49,19
748,4,26,7,0,19,7
748,3,8,5,0,3,5
748,2,1,1,0,0,1
16443,10,8,1,0,7,1
16443,9,14,1,0,13,1
16443,8,66,15,0,51,15
16443,7,132,22,0,110,22
16443,6,164,30,0,134,30
16443,5,71,13,0,58,13
16443,4,31,4,0,27,4
16443,3,10,3,0,7,3
16443,2,6,2,0,4,2
16443,1,1,1,0,0,1
121041,10,13,1,0,12,1
121041,9,17,1,0,16,1
121041,8,119,15,0,104,15
121041,7,129,16,0,113,16
121041,6,152,25,0,127,25
121041,5,38,4,0,34,4
121041,4,18,7,0,11,7
121041,3,10,2,0,8,2
121041,2,4,1,0,3,1
121041,1,3,1,0,2,1
840,9,7,4,0,3,4
840,8,43,13,0,30,13
840,7,139,42,0,97,42
840,6,171,49,0,122,49
840,5,90,28,0,62,28
840,4,30,14,0,16,14
840,3,14,4,0,10,4
840,2,6,3,0,3,3
15156,8,35,8,0,27,8
15156,7,113,29,0,84,29
15156,6,166,27,0,139,27
15156,5,94,23,0,71,23
15156,4,54,14,0,40,14
15156,3,26,11,0,15,11
15156,2,8,2,0,6,2
29256,10,21,14,0,7,14
29256,9,51,21,0,30,21
29256,8,137,45,0,92,45
29256,7,99,26,0,73,26
29256,6,93,34,0,59,34
29256,5,38,15,0,23,15
29256,4,29,13,0,16,13
29256,3,20,12,0,8,12
29256,2,11,3,0,8,3
621,10,11,4,0,7,4
621,9,22,11,0,11,11
621,8,89,31,0,58,31
621,7,148,59,0,89,59
621,6,135,49,0,86,49
621,5,56,21,0,35,21
621,4,33,10,0,23,10
621,3,4,3,0,1,3
621,2,3,3,0,0,3
8096,9,10,4,0,6,4
8096,8,62,28,0,34,28
8096,7,128,54,0,74,54
8096,6,172,71,0,101,71
8096,5,77,31,0,46,31
8096,4,26,10,0,16,10
8096,3,9,3,0,6,3
8096,2,8,4,0,4,4
8096,1,4,2,0,2,2
1379,10,2,1,0,1,1
1379,9,18,5,0,13,5
1379,8,87,25,0,62,25
1379,7,144,42,0,102,42
1379,6,168,39,0,129,39
1379,5,50,18,0,32,18
1379,4,20,6,0,14,6
1379,3,9,5,0,4,5
1379,2,3,1,0,2,1
29030,9,2,1,0,1,1
29030,8,39,9,0,30,9
29030,7,105,19,0,86,19
29030,6,209,49,0,160,49
29030,5,79,17,0,62,17
29030,4,40,20,0,20,20
29030,3,19,7,0,12,7
29030,2,5,3,0,2,3
12171,10,14,5,0,9,5
12171,9,27,12,0,15,12
12171,8,110,38,0,72,38
12171,7,124,31,0,93,31
12171,6,145,42,0,103,42
12171,5,58,17,0,41,17
12171,4,13,5,0,8,5
12171,3,8,3,0,5,3
12171,2,2,1,0,1,1
194196,10,14,2,0,12,2
194196,9,19,7,1,12,6
194196,8,89,10,2,79,8
194196,7,130,19,1,111,18
194196,6,139,19,4,120,15
194196,5,54,11,1,43,10
194196,4,30,6,0,24,6
194196,3,16,3,0,13,3
194196,2,4,2,0,2,2
194196,1,8,5,0,3,5
6663,10,14,3,0,11,3
6663,9,25,8,0,17,8
6663,8,136,43,0,93,43
6663,7,145,34,0,111,34
6663,6,113,31,0,82,31
6663,5,41,11,0,30,11
6663,4,17,10,0,7,10
6663,3,5,3,0,2,3
6663,2,4,4,0,0,4
8192,9,11,2,0,9,2
8192,8,76,33,0,43,33
8192,7,122,31,0,91,31
8192,6,162,55,0,107,55
8192,5,59,22,0,37,22
8192,4,34,16,0,18,16
8192,3,24,9,0,15,9
8192,2,5,5,0,0,5
8192,1,3,1,0,2,1
1943,10,11,4,0,7,4
1943,9,13,4,0,9,4
1943,8,47,23,0,24,23
1943,7,80,31,0,49,31
1943,6,136,46,0,90,46
1943,5,114,40,0,74,40
1943,4,61,23,0,38,23
1943,3,21,11,0,10,11
1943,2,12,5,0,7,5
1943,1,6,3,0,3,3
15064,10,4,2,0,2,2
15064,9,10,4,0,6,4
15064,8,25,5,0,20,5
15064,7,59,14,0,45,14
15064,6,142,29,0,113,29
15064,5,106,24,0,82,24
15064,4,70,25,0,45,25
15064,3,38,14,0,24,14
15064,2,28,16,0,12,16
15064,1,17,10,0,7,10
793,10,4,3,0,1,3
793,9,15,7,0,8,7
793,8,46,16,0,30,16
793,7,107,35,0,72,35
793,6,183,62,0,121,62
793,5,87,22,0,65,22
793,4,37,16,0,21,16
793,3,15,8,0,7,8
793,2,5,2,0,3,2
793,1,1,1,0,0,1
1372,10,19,8,0,11,8
1372,9,49,17,0,32,17
1372,8,121,30,0,91,30
1372,7,153,33,0,120,33
1372,6,102,35,0,67,35
1372,5,33,9,0,24,9
1372,4,13,9,0,4,9
1372,3,4,1,0,3,1
1372,2,4,2,0,2,2
9201,8,20,5,0,15,5
9201,7,84,24,0,60,24
9201,6,193,70,0,123,70
9201,5,108,41,0,67,41
9201,4,51,21,0,30,21
9201,3,19,10,0,9,10
9201,2,19,8,0,11,8
9201,1,6,3,0,3,3
141090,10,21,5,0,16,5
141090,9,52,6,0,46,6
141090,8,221,43,0,178,43
141090,7,113,19,0,94,19
141090,6,63,18,0,45,18
141090,5,16,7,0,9,7
141090,4,5,2,0,3,2
141090,3,7,2,0,5,2
1576,10,14,7,0,7,7
1576,9,14,6,0,8,6
1576,8,84,33,0,51,33
1576,7,152,56,0,96,56
1576,6,155,53,0,102,53
1576,5,53,17,0,36,17
1576,4,20,5,0,15,5
1576,3,6,3,0,3,3
1576,2,1,1,0,0,1
200171,10,20,3,0,17,3
200171,9,40,4,0,36,4
200171,8,134,14,0,120,14
200171,7,164,18,0,146,18
200171,6,91,15,0,76,15
200171,5,30,9,0,21,9
200171,4,9,5,0,4,5
200171,3,6,2,0,4,2
200171,1,3,3,0,0,3
212765,10,7,3,0,4,3
212765,9,31,5,0,26,5
212765,8,149,34,2,115,32
212765,7,156,30,1,126,29
212765,6,123,20,1,103,19
212765,5,20,5,0,15,5
212765,4,7,2,0,5,2
212765,3,5,3,0,2,3
212765,2,2,1,0,1,1
173441,10,17,9,0,8,9
173441,9,34,4,0,30,4
173441,8,128,23,1,105,22
173441,7,153,28,0,125,28
173441,6,120,20,0,100,20
173441,5,31,4,0,27,4
173441,4,13,4,0,9,4
2968,10,1,1,0,0,1
2968,9,7,1,0,6,1
2968,8,78,36,0,42,36
2968,7,150,51,0,99,51
2968,6,175,62,0,113,62
2968,5,58,21,0,37,21
2968,4,16,4,0,12,4
2968,3,9,2,0,7,2
2968,2,3,1,0,2,1
2968,1,1,1,0,0,1
1218,10,6,3,0,3,3
1218,8,34,12,0,22,12
1218,7,72,23,0,49,23
1218,6,176,57,0,119,57
1218,5,125,38,0,87,38
1218,4,61,18,0,43,18
1218,3,21,7,0,14,7
172584,10,7,2,0,5,2
172584,9,16,3,0,13,3
172584,8,127,19,2,108,17
172584,7,173,26,0,147,26
172584,6,110,24,0,86,24
172584,5,40,12,0,28,12
172584,4,10,2,0,8,2
172584,3,11,4,0,7,4
172584,2,3,2,0,1,2
6552,10,14,6,0,8,6
6552,9,20,3,0,17,3
6552,8,47,14,0,33,14
6552,7,52,13,0,39,13
6552,6,99,24,0,75,24
6552,5,77,16,0,61,16
6552,4,66,18,0,48,18
6552,3,47,16,0,31,16
6552,2,38,22,0,16,22
6552,1,38,18,0,20,18
173634,10,81,9,0,72,9
173634,9,70,11,0,59,11
173634,8,134,19,2,115,17
173634,7,109,8,1,101,7
173634,6,70,5,0,65,5
173634,5,14,1,0,13,1
173634,4,7,1,0,6,1
173634,3,5,1,0,4,1
173634,2,3,1,0,2,1
55165,10,7,3,0,4,3
55165,9,25,13,0,12,13
55165,8,92,29,0,63,29
55165,7,147,46,0,101,46
55165,6,147,52,0,95,52
55165,5,49,24,0,25,24
55165,4,19,7,0,12,7
55165,3,8,3,0,5,3
55165,2,4,1,0,3,1
397,10,13,4,0,9,4
397,9,12,3,0,9,3
397,8,50,17,0,33,17
397,7,84,26,0,58,26
397,6,161,52,0,109,52
397,5,86,20,0,66,20
397,4,51,19,0,32,19
397,3,26,7,0,19,7
397,2,11,3,0,8,3
397,1,4,1,0,3,1
1412,9,10,7,0,3,7
1412,8,53,28,0,25,28
1412,7,129,43,0,86,43
1412,6,194,66,0,128,66
1412,5,68,26,0,42,26
1412,4,32,12,0,20,12
1412,3,9,7,0,2,7
1412,2,2,1,0,1,1
6778,10,14,4,0,10,4
6778,9,39,15,0,24,15
6778,8,121,42,0,79,42
6778,7,143,36,0,107,36
6778,6,121,44,0,77,44
6778,5,35,11,0,24,11
6778,4,12,3,0,9,3
6778,2,1,1,0,0,1
6778,1,7,1,0,6,1
5393,10,3,2,0,1,2
5393,9,9,2,0,7,2
5393,8,71,31,0,40,31
5393,7,116,44,0,72,44
5393,6,175,51,0,124,51
5393,5,64,24,0,40,24
5393,4,36,12,0,24,12
5393,3,13,5,0,8,5
5393,2,8,6,0,2,6
15167,9,3,2,0,1,2
15167,8,45,18,0,27,18
15167,7,121,30,0,91,30
15167,6,204,55,0,149,55
15167,5,88,29,0,59,29
15167,4,24,4,0,20,4
15167,3,4,2,0,2,2
15167,2,5,3,0,2,3
73664,10,21,4,0,17,4
73664,9,37,9,0,28,9
73664,8,133,18,0,115,18
73664,7,126,28,0,98,28
73664,6,108,21,0,87,21
73664,5,34,8,0,26,8
73664,4,23,11,0,12,11
73664,3,8,5,0,3,5
73664,2,7,3,0,4,3
155025,10,12,3,0,9,3
155025,9,31,2,0,29,2
155025,8,113,15,0,98,15
155025,7,141,19,0,122,19
155025,6,119,15,0,104,15
155025,5,52,6,0,46,6
155025,4,13,7,0,6,7
155025,3,8,3,0,5,3
155025,2,7,2,0,5,2
192297,10,5,1,0,4,1
192297,9,20,5,0,15,5
192297,8,122,25,0,97,25
192297,7,177,33,0,144,33
192297,6,123,24,0,99,24
192297,5,30,14,0,16,14
192297,4,12,1,0,11,1
192297,3,6,2,0,4,2
180241,10,73,14,0,59,14
180241,9,56,11,0,45,11
180241,8,124,25,0,99,25
180241,7,73,10,0,63,10
180241,6,42,8,0,34,8
180241,5,22,5,0,17,5
180241,4,15,3,0,12,3
180241,3,19,4,0,15,4
180241,2,15,6,0,9,6
180241,1,57,29,0,28,29
30057,9,5,2,0,3,2
30057,8,49,19,0,30,19
30057,7,118,25,0,93,25
30057,6,184,56,0,128,56
30057,5,76,24,0,52,24
30057,4,40,12,0,28,12
30057,3,15,5,0,10,5
30057,2,6,1,0,5,1
65262,8,14,2,0,12,2
65262,7,47,4,0,43,4
65262,6,127,21,0,106,21
65262,5,162,26,0,136,26
65262,4,94,19,0,75,19
65262,3,33,6,0,27,6
65262,2,8,1,0,7,1
65262,1,7,1,0,6,1
218050,10,15,8,0,7,8
218050,9,36,10,0,26,10
218050,8,150,25,0,125,25
218050,7,165,21,0,144,21
218050,6,93,21,0,72,21
218050,5,24,7,0,17,7
218050,4,6,2,0,4,2
218050,3,3,2,0,1,2
218050,2,3,1,0,2,1
206754,10,25,8,0,17,8
206754,9,38,12,0,26,12
206754,8,85,21,0,64,21
206754,7,119,17,0,102,17
206754,6,141,31,0,110,31
206754,5,46,13,0,33,13
206754,4,28,9,0,19,9
206754,3,8,5,0,3,5
13729,8,36,11,0,25,11
13729,7,125,37,0,88,37
13729,6,178,48,0,130,48
13729,5,81,27,0,54,27
13729,4,44,10,0,34,10
13729,3,14,6,0,8,6
13729,2,8,3,0,5,3
13729,1,2,1,0,1,1
199493,10,20,3,0,17,3
199493,9,29,9,0,20,9
199493,8,144,20,0,124,20
199493,7,145,25,0,120,25
199493,6,112,24,0,88,24
199493,5,28,5,0,23,5
199493,4,13,4,0,9,4
199493,2,2,1,0,1,1
17465,10,7,4,0,3,4
17465,9,14,6,0,8,6
17465,8,70,30,0,40,30
17465,7,109,41,0,68,41
17465,6,164,69,0,95,69
17465,5,73,37,0,36,37
17465,4,31,14,0,17,14
17465,3,19,11,0,8,11
17465,2,9,6,0,3,6
54507,9,4,1,0,3,1
54507,8,67,15,0,52,15
54507,7,127,33,0,94,33
54507,6,200,47,0,153,47
54507,5,70,20,0,50,20
54507,4,20,8,0,12,8
156266,10,50,14,2,36,12
156266,9,67,18,1,49,17
156266,8,135,32,3,103,29
156266,7,110,19,3,91,16
156266,6,74,18,1,56,17
156266,5,20,6,1,14,5
156266,4,23,8,0,15,8
156266,3,9,3,1,6,2
156266,2,4,2,0,2,2
156266,1,5,4,2,1,2
23964,10,1,1,0,0,1
23964,8,21,2,0,19,2
23964,7,31,9,0,22,9
23964,6,78,14,0,64,14
23964,5,111,21,0,90,21
23964,4,116,28,0,88,28
23964,3,60,21,0,39,21
23964,2,45,9,0,36,9
23964,1,29,11,0,18,11
63196,10,12,2,0,10,2
63196,9,19,6,0,13,6
63196,8,98,15,0,83,15
63196,7,141,21,0,120,21
63196,6,151,18,0,133,18
63196,5,43,8,0,35,8
63196,4,20,4,0,16,4
63196,3,10,3,0,7,3
34,10,13,7,0,6,7
34,9,6,1,0,5,1
34,8,37,16,0,21,16
34,7,43,11,0,32,11
34,6,33,3,0,30,3
34,5,18,4,0,14,4
34,4,8,2,0,6,2
34,3,5,2,0,3,2
34,2,3,1,0,2,1
34,1,1,1,0,0,1
2669,10,1,1,0,0,1
2669,9,6,2,0,4,2
2669,8,32,15,0,17,15
2669,7,78,22,0,56,22
2669,6,147,47,0,100,47
2669,5,124,47,0,77,47
2669,4,63,26,0,37,26
2669,3,26,9,0,17,9
2669,2,14,3,0,11,3
2669,1,3,1,0,2,1
2821,9,9,3,0,6,3
2821,8,29,9,0,20,9
2821,7,60,9,0,51,9
2821,6,150,32,0,118,32
2821,5,122,25,0,97,25
2821,4,72,19,0,53,19
2821,3,32,12,0,20,12
2821,2,14,5,0,9,5
2821,1,4,1,0,3,1
2234,10,4,2,0,2,2
2234,8,27,5,0,22,5
2234,7,50,14,0,36,14
2234,6,136,37,0,99,37
2234,5,120,23,0,97,23
2234,4,86,31,0,55,31
2234,3,35,14,0,21,14
2234,2,21,5,0,16,5
2234,1,5,2,0,3,2
1783,10,7,5,0,2,5
1783,9,15,9,0,6,9
1783,8,72,33,0,39,33
1783,7,124,36,0,88,36
1783,6,162,63,0,99,63
1783,5,75,19,0,56,19
1783,4,24,6,0,18,6
1783,3,9,2,0,7,2
1783,2,2,1,0,1,1
1783,1,3,1,0,2,1
3347,9,10,1,0,9,1
3347,8,32,4,0,28,4
3347,7,65,10,0,55,10
3347,6,136,18,0,118,18
3347,5,101,11,0,90,11
3347,4,66,12,0,54,12
3347,3,35,6,0,29,6
3347,2,18,4,0,14,4
3347,1,17,3,0,14,3
2872,10,11,4,0,7,4
2872,9,21,5,0,16,5
2872,8,71,19,0,52,19
2872,7,123,44,0,79,44
2872,6,146,42,0,104,42
2872,5,73,18,0,55,18
2872,4,31,12,0,19,12
2872,3,13,5,0,8,5
2872,2,4,2,0,2,2
6352,9,2,1,0,1,1
6352,8,26,11,0,15,11
6352,7,42,11,0,31,11
6352,6,78,25,0,53,25
6352,5,34,11,0,23,11
6352,4,18,8,0,10,8
6352,3,10,3,0,7,3
2573,9,4,1,0,3,1
2573,8,20,7,0,13,7
2573,7,56,15,0,41,15
2573,6,119,44,0,75,44
2573,5,120,50,0,70,50
2573,4,92,28,0,64,28
2573,3,46,19,0,27,19
2573,2,24,13,0,11,13
2573,1,7,5,0,2,5
220774,9,15,1,0,14,1
220774,8,82,8,0,74,8
220774,7,139,17,0,122,17
220774,6,142,26,0,116,26
220774,5,63,17,0,46,17
220774,4,29,9,0,20,9
220774,3,15,4,0,11,4
220774,2,4,2,0,2,2
165477,10,5,2,0,3,2
165477,8,85,16,0,69,16
165477,7,156,26,2,130,24
165477,6,144,24,0,120,24
165477,5,56,12,0,44,12
165477,4,23,3,0,20,3
165477,3,7,1,0,6,1
165477,2,4,1,0,3,1
165477,1,4,2,0,2,2
31722,10,16,5,0,11,5
31722,9,53,17,0,36,17
31722,8,201,54,0,147,54
31722,7,122,34,0,88,34
31722,6,64,22,0,42,22
31722,5,20,11,0,9,11
31722,4,11,4,0,7,4
31722,3,2,1,0,1,1
31722,2,2,1,0,1,1
3986,10,17,6,0,11,6
3986,9,41,19,0,22,19
3986,8,125,62,0,63,62
3986,7,172,69,0,103,69
3986,6,98,47,0,51,47
3986,5,26,12,0,14,12
3986,4,9,5,0,4,5
231567,10,5,1,0,4,1
231567,9,35,4,0,31,4
231567,8,182,30,2,152,28
231567,7,131,11,2,120,9
231567,6,103,25,2,78,23
231567,5,19,2,0,17,2
231567,4,9,1,0,8,1
231567,3,8,4,0,4,4
191177,10,19,3,0,16,3
191177,9,40,12,4,28,8
191177,8,119,25,4,94,21
191177,7,161,17,2,144,15
191177,6,108,29,5,79,24
191177,5,25,6,0,19,6
191177,4,10,1,1,9,0
191177,3,6,1,0,5,1
191177,2,4,3,0,1,3
167292,9,9,1,0,8,1
167292,8,45,6,0,39,6
167292,7,107,13,0,94,13
167292,6,198,31,0,167,31
167292,5,74,8,0,66,8
167292,4,34,8,0,26,8
167292,3,19,3,0,16,3
167292,2,3,2,0,1,2
101930,10,2,1,0,1,1
101930,8,49,16,3,33,13
101930,7,85,21,5,64,16
101930,6,178,46,4,132,42
101930,5,88,24,3,64,21
101930,4,43,14,3,29,11
101930,3,23,6,1,17,5
101930,2,16,8,0,8,8
101930,1,3,2,0,1,2
63975,10,4,1,0,3,1
63975,9,13,2,0,11,2
63975,8,64,24,0,40,24
63975,7,122,29,0,93,29
63975,6,192,44,0,148,44
63975,5,53,13,0,40,13
63975,4,31,6,0,25,6
63975,3,9,4,0,5,4
24947,10,59,20,0,39,20
24947,9,48,23,0,25,23
24947,8,101,26,0,75,26
24947,7,98,27,0,71,27
24947,6,84,21,0,63,21
24947,5,46,15,0,31,15
24947,4,24,6,0,18,6
24947,3,11,3,0,8,3
24947,2,12,5,0,7,5
24947,1,8,3,0,5,3
235512,9,18,3,0,15,3
235512,8,99,12,0,87,12
235512,7,154,15,0,139,15
235512,6,130,12,0,118,12
235512,5,47,7,0,40,7
235512,4,20,2,0,18,2
235512,3,12,3,0,9,3
235512,1,2,1,0,1,1
117995,10,5,2,0,3,2
117995,9,11,2,0,9,2
117995,8,68,14,0,54,14
117995,7,128,26,0,102,26
117995,6,173,29,0,144,29
117995,5,69,11,0,58,11
117995,4,25,5,0,20,5
117995,3,6,1,0,5,1
22465,10,8,4,0,4,4
22465,8,60,16,0,44,16
22465,7,111,23,0,88,23
22465,6,189,41,0,148,41
22465,5,62,16,0,46,16
22465,4,34,7,0,27,7
22465,3,11,2,0,9,2
173105,10,40,11,1,29,10
173105,9,94,25,3,69,22
173105,8,208,49,3,159,46
173105,7,81,16,1,65,15
173105,6,45,17,1,28,16
173105,5,10,5,0,5,5
173105,4,8,4,0,4,4
173105,3,2,2,0,0,2
173105,2,1,1,0,0,1
173105,1,2,1,0,1,1
208775,10,9,2,0,7,2
208775,9,32,9,0,23,9
208775,8,156,23,0,133,23
208775,7,181,14,0,167,14
208775,6,91,22,0,69,22
208775,5,12,3,0,9,3
208775,4,5,1,0,4,1
208775,3,5,1,0,4,1
6644,10,6,3,0,3,3
6644,9,6,3,0,3,3
6644,8,41,9,0,32,9
6644,7,89,29,0,60,29
6644,6,181,57,0,124,57
6644,5,90,25,0,65,25
6644,4,50,19,0,31,19
6644,3,20,9,0,11,9
6644,2,4,2,0,2,2
6644,1,2,2,0,0,2
12296,9,5,2,0,3,2
12296,8,25,9,0,16,9
12296,7,81,25,0,56,25
12296,6,154,46,0,108,46
12296,5,99,21,0,78,21
12296,4,78,39,0,39,39
12296,3,35,15,0,20,15
12296,2,11,5,0,6,5
173092,9,6,1,0,5,1
173092,8,92,14,0,78,14
173092,7,187,31,0,156,31
173092,6,151,27,0,124,27
173092,5,35,8,0,27,8
173092,4,12,1,0,11,1
173092,3,2,1,0,1,1
173092,1,1,1,0,0,1
137237,10,8,3,0,5,3
137237,8,117,23,0,94,23
137237,7,137,24,0,113,24
137237,6,123,29,0,94,29
137237,5,42,7,0,35,7
137237,4,31,10,0,21,10
137237,3,8,6,0,2,6
137237,2,9,6,0,3,6
137237,1,1,1,0,0,1
163937,10,7,2,0,5,2
163937,9,15,2,0,13,2
163937,8,108,15,0,93,15
163937,7,146,19,1,127,18
163937,6,133,21,0,112,21
163937,5,35,8,0,27,8
163937,4,15,4,0,11,4
163937,3,16,6,1,10,5
163937,2,10,3,0,7,3
163937,1,3,1,0,2,1
72132,10,8,4,0,4,4
72132,9,14,2,0,12,2
72132,8,91,27,0,64,27
72132,7,126,37,0,89,37
72132,6,153,35,0,118,35
72132,5,57,15,0,42,15
72132,4,20,4,0,16,4
72132,3,14,4,0,10,4
72132,2,4,1,0,3,1
72132,1,1,1,0,0,1
8671,9,7,2,0,5,2
8671,8,37,15,0,22,15
8671,7,87,31,0,56,31
8671,6,166,56,0,110,56
8671,5,76,17,0,59,17
8671,4,44,17,0,27,17
8671,3,21,11,0,10,11
8671,2,7,2,0,5,2
8671,1,7,3,0,4,3
131568,10,9,2,0,7,2
131568,9,8,2,0,6,2
131568,8,58,10,0,48,10
131568,7,145,17,0,128,17
131568,6,165,34,0,131,34
131568,5,59,13,0,46,13
131568,4,23,5,0,18,5
131568,3,14,4,0,10,4
131568,2,4,2,0,2,2
458,10,14,6,0,8,6
458,9,14,7,0,7,7
458,8,68,16,0,52,16
458,7,105,20,0,85,20
458,6,163,41,0,122,41
458,5,67,11,0,56,11
458,4,35,10,0,25,10
458,3,9,3,0,6,3
458,2,12,8,0,4,8
22111,9,7,2,0,5,2
22111,8,25,14,0,11,14
22111,7,75,30,0,45,30
22111,6,201,78,0,123,78
22111,5,98,36,0,62,36
22111,4,48,21,0,27,21
22111,3,22,15,0,7,15
22111,2,11,7,0,4,7
1254,10,9,3,0,6,3
1254,9,16,4,0,12,4
1254,8,50,16,0,34,16
1254,7,87,25,0,62,25
1254,6,142,39,0,103,39
1254,5,91,28,0,63,28
1254,4,60,20,0,40,20
1254,3,19,5,0,14,5
1254,2,7,2,0,5,2
1254,1,6,3,0,3,3
222145,10,16,5,0,11,5
222145,9,30,8,1,22,7
222145,8,98,18,1,80,17
222145,7,114,20,1,94,19
222145,6,121,22,1,99,21
222145,5,56,15,0,41,15
222145,4,25,7,1,18,6
222145,3,15,4,0,11,4
222145,2,11,5,1,6,4
222145,1,2,1,0,1,1
869,10,7,4,0,3,4
869,9,16,2,0,14,2
869,8,54,13,0,41,13
869,7,105,26,0,79,26
869,6,173,41,0,132,41
869,5,61,22,0,39,22
869,4,40,13,0,27,13
869,3,16,5,0,11,5
869,2,13,5,0,8,5
869,1,3,2,0,1,2
159632,10,11,2,0,9,2
159632,9,20,7,3,13,4
159632,8,120,27,2,93,25
159632,7,147,29,1,118,28
159632,6,130,26,3,104,23
159632,5,40,7,0,33,7
159632,4,13,2,0,11,2
159632,3,3,2,0,1,2
196526,10,27,9,0,18,9
196526,9,100,27,0,73,27
196526,8,204,50,0,154,50
196526,7,98,16,0,82,16
196526,6,42,10,0,32,10
196526,5,7,1,0,6,1
196526,4,4,1,0,3,1
196526,3,2,2,0,0,2
16035,10,5,1,0,4,1
16035,9,10,2,0,8,2
16035,8,50,16,0,34,16
16035,7,85,28,0,57,28
16035,6,178,53,0,125,53
16035,5,96,26,0,70,26
16035,4,39,9,0,30,9
16035,3,16,5,0,11,5
16035,2,4,3,0,1,3
16035,1,3,2,0,1,2
52,10,21,3,0,18,3
52,9,21,3,0,18,3
52,8,51,15,0,36,15
52,7,107,31,0,76,31
52,6,133,34,0,99,34
52,5,77,27,0,50,27
52,4,39,15,0,24,15
52,3,18,10,0,8,10
52,2,13,9,0,4,9
52,1,6,1,0,5,1
119637,10,39,6,0,33,6
119637,9,48,2,0,46,2
119637,8,202,33,0,169,33
119637,7,136,18,0,118,18
119637,6,44,4,0,40,4
119637,5,13,1,0,12,1
935,10,15,3,0,12,3
935,9,37,9,0,28,9
935,8,119,40,0,79,40
935,7,142,37,0,105,37
935,6,109,40,0,69,40
935,5,39,13,0,26,13
935,4,16,12,0,4,12
935,3,3,1,0,2,1
935,2,5,3,0,2,3
2629,10,4,3,0,1,3
2629,8,26,8,0,18,8
2629,7,82,8,0,74,8
2629,6,199,38,0,161,38
2629,5,97,17,0,80,17
2629,4,57,13,0,44,13
2629,3,11,3,0,8,3
2629,2,5,3,0,2,3
3048,9,7,1,0,6,1
3048,8,21,4,0,17,4
3048,7,74,13,0,61,13
3048,6,140,19,0,121,19
3048,5,115,22,0,93,22
3048,4,65,20,0,45,20
3048,3,33,15,0,18,15
3048,2,24,11,0,13,11
3048,1,5,2,0,3,2
38553,10,5,1,0,4,1
38553,9,20,5,0,15,5
38553,8,103,38,0,65,38
38553,7,123,36,0,87,36
38553,6,124,44,0,80,44
38553,5,58,17,0,41,17
38553,4,20,8,0,12,8
38553,3,16,7,0,9,7
38553,2,12,8,0,4,8
38553,1,4,4,0,0,4
140997,8,46,14,0,32,14
140997,7,107,23,0,84,23
140997,6,175,30,0,145,30
140997,5,82,15,0,67,15
140997,4,37,4,0,33,4
140997,3,13,2,1,11,1
140997,2,8,1,0,7,1
140997,1,1,1,0,0,1
31075,10,3,1,0,2,1
31075,9,6,1,0,5,1
31075,8,50,14,0,36,14
31075,7,104,28,0,76,28
31075,6,165,47,0,118,47
31075,5,83,28,0,55,28
31075,4,39,16,0,23,16
31075,3,20,6,0,14,6
31075,2,8,5,0,3,5
31075,1,7,1,0,6,1
23817,10,31,7,0,24,7
23817,9,83,21,0,62,21
23817,8,183,51,0,132,51
23817,7,103,36,0,67,36
23817,6,50,20,0,30,20
23817,5,12,8,0,4,8
23817,4,14,7,0,7,7
23817,3,3,1,0,2,1
5029,10,7,2,0,5,2
5029,9,11,3,0,8,3
5029,8,29,5,0,24,5
5029,7,48,9,0,39,9
5029,6,121,30,0,91,30
5029,5,115,22,0,93,22
5029,4,78,25,0,53,25
5029,3,39,13,0,26,13
5029,2,27,8,0,19,8
5029,1,10,2,0,8,2
193728,10,63,18,0,45,18
193728,9,138,25,0,113,25
193728,8,149,26,0,123,26
193728,7,61,8,0,53,8
193728,6,41,18,0,23,18
193728,5,18,5,0,13,5
193728,4,7,4,0,3,4
193728,3,4,3,0,1,3
193728,2,1,1,0,0,1
193728,1,2,1,0,1,1
11929,10,10,4,0,6,4
11929,9,24,10,0,14,10
11929,8,57,16,0,41,16
11929,7,73,21,0,52,21
11929,6,145,44,0,101,44
11929,5,80,18,0,62,18
11929,4,59,22,0,37,22
11929,3,23,8,0,15,8
11929,2,9,3,0,6,3
11929,1,4,2,0,2,2
2536,10,4,1,0,3,1
2536,9,15,2,0,13,2
2536,8,59,20,0,39,20
2536,7,114,32,0,82,32
2536,6,173,36,0,137,36
2536,5,59,17,0,42,17
2536,4,39,15,0,24,15
2536,3,17,8,0,9,8
2536,2,4,1,0,3,1
14535,10,9,3,0,6,3
14535,8,35,7,0,28,7
14535,7,68,10,0,58,10
14535,6,128,35,0,93,35
14535,5,95,20,0,75,20
14535,4,65,18,0,47,18
14535,3,51,13,0,38,13
14535,2,17,5,0,12,5
14535,1,11,4,0,7,4
217894,10,13,3,0,10,3
217894,9,18,4,1,14,3
217894,8,113,19,5,94,14
217894,7,144,24,2,120,22
217894,6,117,20,4,97,16
217894,5,46,11,1,35,10
217894,4,19,10,1,9,9
217894,2,4,3,0,1,3
217894,1,3,1,0,2,1
65568,10,4,1,0,3,1
65568,9,19,4,0,15,4
65568,8,96,25,0,71,25
65568,7,162,41,0,121,41
65568,6,142,32,0,110,32
65568,5,34,6,0,28,6
65568,4,22,7,0,15,7
165876,9,23,6,0,17,6
165876,8,121,24,0,97,24
165876,7,145,29,0,116,29
165876,6,116,28,0,88,28
165876,5,43,16,0,27,16
165876,4,25,4,0,21,4
165876,3,4,2,0,2,2
165876,2,3,2,0,1,2
245476,10,13,1,0,12,1
245476,9,28,11,0,17,11
245476,8,162,16,0,146,16
245476,7,143,17,0,126,17
245476,6,104,11,0,93,11
245476,5,18,2,0,16,2
245476,4,12,1,0,11,1
245476,3,6,3,0,3,3
245476,2,1,1,0,0,1
228411,10,13,3,0,10,3
228411,9,45,12,0,33,12
228411,8,184,32,0,152,32
228411,7,142,19,0,123,19
228411,6,74,7,0,67,7
228411,5,13,2,0,11,2
228411,4,10,4,0,6,4
228411,3,2,1,0,1,1
163170,10,7,3,0,4,3
163170,9,11,3,0,8,3
163170,8,35,9,0,26,9
163170,7,83,15,0,68,15
163170,6,130,28,0,102,28
163170,5,95,19,0,76,19
163170,4,52,11,0,41,11
163170,3,35,9,0,26,9
163170,2,27,10,0,17,10
163170,1,7,3,0,4,3
982,10,8,3,0,5,3
982,9,12,2,0,10,2
982,8,40,18,0,22,18
982,7,109,36,0,73,36
982,6,166,50,0,116,50
982,5,86,31,0,55,31
982,4,35,19,0,16,19
982,3,16,4,0,12,4
982,2,7,6,0,1,6
1188,10,12,7,0,5,7
1188,9,14,4,0,10,4
1188,8,37,11,0,26,11
1188,7,97,27,0,70,27
1188,6,161,51,0,110,51
1188,5,80,26,0,54,26
1188,4,51,17,0,34,17
1188,3,17,3,0,14,3
1188,2,10,4,0,6,4
1188,1,3,1,0,2,1
177702,9,5,1,0,4,1
177702,8,64,10,0,54,10
177702,7,134,23,0,111,23
177702,6,171,21,0,150,21
177702,5,61,11,0,50,11
177702,4,23,5,0,18,5
177702,3,12,3,0,9,3
177702,1,2,2,0,0,2
217949,10,6,1,0,5,1
217949,9,13,1,0,12,1
217949,8,106,15,0,91,15
217949,7,148,19,0,129,19
217949,6,125,11,0,114,11
217949,5,48,7,0,41,7
217949,4,21,4,0,17,4
217949,3,9,1,0,8,1
217949,2,6,2,0,4,2
218995,9,18,1,0,17,1
218995,8,83,15,0,68,15
218995,7,162,16,0,146,16
218995,6,151,25,0,126,25
218995,5,43,5,0,38,5
218995,4,12,3,0,9,3
218995,3,2,1,0,1,1
161757,9,20,3,3,17,0
161757,8,87,13,0,74,13
161757,7,128,25,0,103,25
161757,6,141,26,0,115,26
161757,5,57,10,0,47,10
161757,4,27,5,0,22,5
161757,3,13,5,0,8,5
161757,2,5,3,0,2,3
161757,1,2,1,0,1,1
121193,10,14,3,0,11,3
121193,9,20,3,0,17,3
121193,8,68,13,0,55,13
121193,7,95,15,0,80,15
121193,6,156,24,0,132,24
121193,5,54,3,0,51,3
121193,4,43,8,0,35,8
121193,3,21,5,0,16,5
121193,2,7,2,0,5,2
121193,1,3,1,0,2,1
3593,10,19,6,0,13,6
3593,9,28,9,0,19,9
3593,8,114,33,0,81,33
3593,7,153,38,0,115,38
3593,6,104,32,0,72,32
3593,5,31,3,0,28,3
3593,4,22,5,0,17,5
3593,3,5,1,0,4,1
3593,2,3,2,0,1,2
142451,10,8,4,0,4,4
142451,9,23,11,2,12,9
142451,8,72,22,2,50,20
142451,7,93,15,3,78,12
142451,6,124,27,0,97,27
142451,5,62,13,0,49,13
142451,4,35,11,2,24,9
142451,3,34,14,0,20,14
142451,2,25,13,2,12,11
142451,1,5,4,0,1,4
244330,9,15,1,0,14,1
244330,8,93,13,0,80,13
244330,7,171,23,0,148,23
244330,6,141,20,0,121,20
244330,5,42,7,0,35,7
244330,4,15,3,0,12,3
124590,10,6,1,0,5,1
124590,9,16,7,0,9,7
124590,8,88,12,0,76,12
124590,7,142,17,0,125,17
124590,6,155,32,0,123,32
124590,5,48,17,0,31,17
124590,4,18,6,0,12,6
124590,3,3,1,0,2,1
124590,2,2,1,0,1,1
185709,10,31,6,1,25,5
185709,9,37,8,0,29,8
185709,8,145,29,0,116,29
185709,7,132,30,0,102,30
185709,6,88,12,0,76,12
185709,5,17,3,0,14,3
185709,4,17,3,0,14,3
185709,3,7,1,0,6,1
185709,2,2,1,0,1,1
185709,1,7,4,1,3,3
114438,10,14,5,0,9,5
114438,9,26,6,0,20,6
114438,8,131,38,1,93,37
114438,7,111,32,0,79,32
114438,6,123,36,0,87,36
114438,5,45,11,0,34,11
114438,4,19,6,0,13,6
114438,3,6,5,0,1,5
19074,10,4,4,0,0,4
19074,9,1,1,0,0,1
19074,8,36,10,0,26,10
19074,7,95,29,0,66,29
19074,6,180,34,0,146,34
19074,5,92,27,0,65,27
19074,4,50,22,0,28,22
19074,3,18,8,0,10,8
19074,2,3,1,0,2,1
71593,10,2,1,0,1,1
71593,9,10,4,0,6,4
71593,8,66,13,0,53,13
71593,7,131,39,0,92,39
71593,6,174,43,0,131,43
71593,5,54,16,0,38,16
71593,4,32,12,0,20,12
71593,3,10,1,0,9,1
14083,10,31,13,0,18,13
14083,9,87,40,0,47,40
14083,8,163,62,0,101,62
14083,7,101,35,0,66,35
14083,6,52,20,0,32,20
14083,5,24,10,0,14,10
14083,4,10,5,0,5,5
14083,3,5,2,0,3,2
14083,2,2,1,0,1,1
99219,10,5,1,0,4,1
99219,9,9,1,0,8,1
99219,8,47,6,0,41,6
99219,7,110,15,0,95,15
99219,6,188,33,0,155,33
99219,5,71,13,0,58,13
99219,4,40,7,0,33,7
99219,3,6,3,0,3,3
99219,2,4,1,0,3,1
219100,10,114,19,1,95,18
219100,9,125,21,2,104,19
219100,8,129,13,0,116,13
219100,7,49,9,3,40,6
219100,6,27,1,0,26,1
219100,5,13,3,0,10,3
219100,4,10,5,0,5,5
219100,2,4,1,0,3,1
219100,1,8,2,0,6,2
1152,10,11,5,0,6,5
1152,9,17,6,0,11,6
1152,8,74,28,0,46,28
1152,7,117,39,0,78,39
1152,6,168,59,0,109,59
1152,5,59,18,0,41,18
1152,4,29,6,1,23,5
72448,9,8,2,0,6,2
72448,8,50,8,0,42,8
72448,7,104,12,0,92,12
72448,6,165,18,0,147,18
72448,5,78,11,0,67,11
72448,4,40,15,0,25,15
72448,3,17,4,0,13,4
72448,2,13,3,0,10,3
72448,1,1,1,0,0,1
181617,9,26,4,0,22,4
181617,8,144,16,0,128,16
181617,7,168,18,0,150,18
181617,6,104,20,0,84,20
181617,5,21,6,0,15,6
181617,4,5,2,0,3,2
181617,1,1,1,0,0,1
2640,10,35,13,0,22,13
2640,9,48,17,0,31,17
2640,8,87,25,0,62,25
2640,7,107,34,0,73,34
2640,6,96,26,0,70,26
2640,5,52,17,0,35,17
2640,4,27,12,0,15,12
2640,3,17,4,0,13,4
2640,2,4,2,0,2,2
2640,1,5,4,0,1,4
173805,10,52,14,0,38,14
173805,9,71,13,2,58,11
173805,8,155,33,4,122,29
173805,7,85,13,1,72,12
173805,6,57,11,3,46,8
173805,5,27,6,0,21,6
173805,4,16,4,0,12,4
173805,3,6,3,0,3,3
173805,2,4,1,0,3,1
173805,1,5,4,1,1,3
180867,10,8,1,0,7,1
180867,9,11,2,0,9,2
180867,8,36,8,0,28,8
180867,7,74,8,0,66,8
180867,6,197,30,0,167,30
180867,5,84,18,0,66,18
180867,4,39,9,0,30,9
180867,3,16,5,0,11,5
180867,2,12,1,0,11,1
181329,10,11,2,0,9,2
181329,9,31,6,0,25,6
181329,8,112,23,0,89,23
181329,7,164,35,0,129,35
181329,6,110,23,0,87,23
181329,5,38,11,0,27,11
181329,3,3,1,0,2,1
164506,10,4,1,0,3,1
164506,9,26,8,1,18,7
164506,8,140,28,2,112,26
164506,7,145,30,1,115,29
164506,6,112,31,0,81,31
164506,5,23,8,1,15,7
164506,4,16,9,1,7,8
164506,3,7,2,0,5,2
164506,2,5,1,0,4,1
162093,9,9,5,0,4,5
162093,8,41,11,0,30,11
162093,7,60,17,1,43,16
162093,6,123,32,2,91,30
162093,5,89,21,1,68,20
162093,4,67,15,1,52,14
162093,3,42,14,2,28,12
162093,2,30,12,1,18,11
162093,1,15,4,1,11,3
506,10,3,1,0,2,1
506,9,10,6,0,4,6
506,8,38,13,0,25,13
506,7,97,30,0,67,30
506,6,160,34,0,126,34
506,5,112,32,0,80,32
506,4,37,9,0,28,9
506,3,12,4,0,8,4
506,2,7,3,0,4,3
506,1,2,2,0,0,2
193,10,6,1,0,5,1
193,9,7,2,0,5,2
193,8,44,11,0,33,11
193,7,89,19,0,70,19
193,6,150,31,0,119,31
193,5,86,23,0,63,23
193,4,51,14,0,37,14
193,3,26,9,0,17,9
193,2,11,3,0,8,3
193,1,6,3,0,3,3
178892,10,23,3,0,20,3
178892,9,48,7,0,41,7
178892,8,134,17,0,117,17
178892,7,108,19,0,89,19
178892,6,103,20,0,83,20
178892,5,26,7,0,19,7
178892,4,26,8,0,18,8
178892,2,1,1,0,0,1
18296,9,3,3,0,0,3
18296,8,38,15,0,23,15
18296,7,92,28,0,64,28
18296,6,188,66,0,122,66
18296,5,100,40,0,60,40
18296,4,37,18,0,19,18
18296,3,14,6,0,8,6
18296,2,1,1,0,0,1
18296,1,1,1,0,0,1
128921,9,14,5,1,9,4
128921,8,100,24,0,76,24
128921,7,132,24,0,108,24
128921,6,155,23,0,132,23
128921,5,41,7,0,34,7
128921,4,24,7,0,17,7
128921,3,4,1,0,3,1
128921,2,2,1,0,1,1
236217,9,43,9,0,34,9
236217,8,142,26,0,116,26
236217,7,144,12,0,132,12
236217,6,93,13,0,80,13
236217,5,27,3,0,24,3
236217,4,3,1,0,2,1
253398,10,4,1,0,3,1
253398,9,29,12,0,17,12
253398,8,139,36,0,103,36
253398,7,164,30,0,134,30
253398,6,98,22,0,76,22
253398,5,33,8,0,25,8
253398,4,8,8,0,0,8
136955,10,53,16,1,37,15
136955,9,99,26,4,73,22
136955,8,188,54,6,134,48
136955,7,80,18,0,62,18
136955,6,30,10,0,20,10
136955,5,9,6,0,3,6
136955,4,11,2,0,9,2
136955,3,3,1,0,2,1
136955,2,3,1,1,2,0
182082,10,21,5,0,16,5
182082,9,41,10,0,31,10
182082,8,170,32,0,138,32
182082,7,152,28,0,124,28
182082,6,69,11,0,58,11
182082,5,12,4,0,8,4
182082,4,5,3,0,2,3
182082,3,3,1,0,2,1
172062,9,23,6,0,17,6
172062,8,72,11,0,61,11
172062,7,128,17,0,111,17
172062,6,147,18,0,129,18
172062,5,57,11,0,46,11
172062,4,17,3,0,14,3
172062,3,11,2,0,9,2
172062,1,2,1,0,1,1
10788,10,21,10,0,11,10
10788,9,56,23,0,33,23
10788,8,197,65,0,132,65
10788,7,109,36,0,73,36
10788,6,59,20,0,39,20
10788,5,15,5,0,10,5
10788,4,8,2,0,6,2
10788,3,4,3,0,1,3
10788,2,2,1,0,1,1
10788,1,4,3,0,1,3
186995,10,23,6,0,17,6
186995,9,60,16,0,44,16
186995,8,137,29,0,108,29
186995,7,107,17,0,90,17
186995,6,101,25,0,76,25
186995,5,28,11,0,17,11
186995,4,10,4,0,6,4
186995,3,6,3,0,3,3
186995,2,3,1,0,2,1
186995,1,1,1,0,0,1
7240,10,3,3,0,0,3
7240,9,10,2,0,8,2
7240,8,55,28,0,27,28
7240,7,86,37,0,49,37
7240,6,160,62,0,98,62
7240,5,80,44,0,36,44
7240,4,40,22,0,18,22
7240,3,25,16,0,9,16
7240,2,14,9,0,5,9
7240,1,2,1,0,1,1
66120,10,5,2,0,3,2
66120,9,14,3,0,11,3
66120,8,116,29,0,87,29
66120,7,150,29,0,121,29
66120,6,147,25,0,122,25
66120,5,33,7,0,26,7
66120,4,3,2,0,1,2
66120,2,5,1,0,4,1
258308,10,6,2,0,4,2
258308,9,30,7,0,23,7
258308,8,135,17,0,118,17
258308,7,146,18,0,128,18
258308,6,111,15,0,96,15
258308,5,25,2,0,23,2
258308,4,19,1,0,18,1
258308,3,3,1,0,2,1
164698,9,17,7,0,10,7
164698,8,103,26,0,77,26
164698,7,131,22,0,109,22
164698,6,106,12,0,94,12
164698,5,25,6,0,19,6
164698,4,9,3,0,6,3
164698,3,6,3,0,3,3
164698,2,2,1,0,1,1
164698,1,1,1,0,0,1
11161,9,12,2,0,10,2
11161,8,61,14,0,47,14
11161,7,123,28,0,95,28
11161,6,170,20,0,150,20
11161,5,66,21,0,45,21
11161,4,25,7,0,18,7
6719,10,14,7,0,7,7
6719,9,35,12,0,23,12
6719,8,168,58,0,110,58
6719,7,147,52,0,95,52
6719,6,66,24,0,42,24
6719,5,19,10,0,9,10
6719,4,11,6,0,5,6
6719,3,8,3,0,5,3
6719,2,4,1,0,3,1
6719,1,2,1,0,1,1
3692,10,7,3,0,4,3
3692,9,7,3,0,4,3
3692,8,72,23,0,49,23
3692,7,97,21,0,76,21
3692,6,153,40,0,113,40
3692,5,81,21,0,60,21
3692,4,32,12,0,20,12
3692,3,17,7,0,10,7
3692,2,7,3,0,4,3
3692,1,1,1,0,0,1
66190,10,9,1,0,8,1
66190,9,9,2,0,7,2
66190,8,89,19,1,70,18
66190,7,150,28,0,122,28
66190,6,150,32,0,118,32
66190,5,50,17,0,33,17
66190,4,10,2,0,8,2
66190,2,1,1,0,0,1
66190,1,2,1,0,1,1
221769,10,46,14,0,32,14
221769,9,108,20,1,88,19
221769,8,168,33,0,135,33
221769,7,80,11,0,69,11
221769,6,42,12,0,30,12
221769,5,10,2,0,8,2
221769,4,8,4,0,4,4
221769,3,7,3,0,4,3
221769,1,2,1,0,1,1
20295,10,20,3,0,17,3
20295,9,40,12,0,28,12
20295,8,124,29,0,95,29
20295,7,115,28,1,87,27
20295,6,110,29,0,81,29
20295,5,38,8,0,30,8
20295,4,19,5,0,14,5
20295,3,4,2,0,2,2
20295,1,2,1,0,1,1
178302,10,10,2,0,8,2
178302,9,25,8,0,17,8
178302,8,169,30,0,139,30
178302,7,145,17,0,128,17
178302,6,70,10,0,60,10
178302,5,31,11,0,20,11
178302,4,13,8,0,5,8
178302,3,6,2,0,4,2
178302,2,4,2,0,2,2
142239,10,12,4,1,8,3
142239,9,34,11,1,23,10
142239,8,118,25,3,93,22
142239,7,119,20,4,99,16
142239,6,120,26,2,94,24
142239,5,40,9,0,31,9
142239,4,16,8,1,8,7
142239,3,8,1,0,7,1
142239,1,2,2,0,0,2
201509,10,24,3,0,21,3
201509,9,27,5,0,22,5
201509,8,122,23,2,99,21
201509,7,121,12,2,109,10
201509,6,109,14,0,95,14
201509,5,37,3,0,34,3
201509,4,19,6,0,13,6
201509,3,11,3,0,8,3
201509,2,2,1,0,1,1
66982,9,17,3,0,14,3
66982,8,71,9,0,62,9
66982,7,147,20,0,127,20
66982,6,148,15,0,133,15
66982,5,56,5,0,51,5
66982,4,16,2,0,14,2
66982,3,6,1,0,5,1
66982,2,6,1,0,5,1
118023,9,10,4,0,6,4
118023,8,69,18,0,51,18
118023,7,141,36,0,105,36
118023,6,178,34,0,144,34
118023,5,49,7,0,42,7
118023,4,18,7,0,11,7
118023,3,3,1,0,2,1
5478,10,2,1,0,1,1
5478,9,15,10,0,5,10
5478,8,57,9,0,48,9
5478,7,112,25,0,87,25
5478,6,184,41,0,143,41
5478,5,57,12,0,45,12
5478,4,25,10,0,15,10
5478,3,9,5,0,4,5
5478,2,9,4,0,5,4
147021,9,16,1,0,15,1
147021,8,96,22,3,74,19
147021,7,133,22,0,111,22
147021,6,135,24,2,111,22
147021,5,46,9,0,37,9
147021,4,28,4,0,24,4
147021,3,8,1,0,7,1
147021,2,5,2,0,3,2
216658,10,33,3,0,30,3
216658,9,57,3,0,54,3
216658,8,160,14,0,146,14
216658,7,147,7,0,140,7
216658,6,54,6,0,48,6
216658,5,11,2,0,9,2
216658,2,2,1,0,1,1
205057,10,18,6,2,12,4
205057,9,22,7,0,15,7
205057,8,164,36,4,128,32
205057,7,140,22,4,118,18
205057,6,96,20,3,76,17
205057,5,16,2,0,14,2
205057,4,10,5,0,5,5
205057,3,2,1,0,1,1
205057,2,2,1,0,1,1
1163,10,4,1,0,3,1
1163,9,12,6,0,6,6
1163,8,44,9,0,35,9
1163,7,89,12,0,77,12
1163,6,168,27,0,141,27
1163,5,84,22,0,62,22
1163,4,49,14,0,35,14
1163,3,13,3,0,10,3
1163,2,7,2,0,5,2
152758,10,2,1,0,1,1
152758,9,3,2,0,1,2
152758,8,16,5,0,11,5
152758,7,36,8,0,28,8
152758,6,118,30,0,88,30
152758,5,95,27,0,68,27
152758,4,77,28,0,49,28
152758,3,49,29,0,20,29
152758,2,51,25,0,26,25
152758,1,23,14,0,9,14
41762,10,10,5,0,5,5
41762,9,14,2,0,12,2
41762,8,74,14,0,60,14
41762,7,120,27,0,93,27
41762,6,161,45,0,116,45
41762,5,59,18,0,41,18
41762,4,24,9,0,15,9
3083,10,8,3,0,5,3
3083,9,22,8,0,14,8
3083,8,72,18,0,54,18
3083,7,116,26,0,90,26
3083,6,148,43,0,105,43
3083,5,75,21,0,54,21
3083,4,16,1,0,15,1
3083,3,8,2,0,6,2
3083,2,3,2,0,1,2
3083,1,1,1,0,0,1
434,8,41,5,0,36,5
434,7,81,19,0,62,19
434,6,177,35,0,142,35
434,5,86,18,0,68,18
434,4,44,13,0,31,13
434,3,27,12,0,15,12
434,2,5,3,0,2,3
163377,10,2,1,0,1,1
163377,9,3,1,0,2,1
163377,8,55,11,0,44,11
163377,7,142,29,0,113,29
163377,6,170,42,0,128,42
163377,5,62,16,0,46,16
163377,4,25,8,0,17,8
163377,3,7,3,0,4,3
2073,10,24,6,0,18,6
2073,9,28,7,0,21,7
2073,8,96,34,0,62,34
2073,7,154,33,0,121,33
2073,6,108,21,0,87,21
2073,5,37,6,0,31,6
2073,4,11,5,0,6,5
2073,3,5,2,0,3,2
2073,2,6,1,0,5,1
171261,10,14,3,0,11,3
171261,9,18,5,0,13,5
171261,8,99,37,1,62,36
171261,7,129,27,1,102,26
171261,6,125,23,3,102,20
171261,5,56,12,1,44,11
171261,4,20,9,0,11,9
171261,3,6,3,0,3,3
171261,2,2,1,0,1,1
3828,10,5,3,0,2,3
3828,9,19,8,0,11,8
3828,8,148,51,2,97,49
3828,7,134,40,1,94,39
3828,6,91,37,1,54,36
3828,5,35,13,0,22,13
3828,4,21,9,0,12,9
3828,3,12,6,0,6,6
3828,2,3,2,0,1,2
206150,10,39,14,0,25,14
206150,9,87,23,1,64,22
206150,8,215,58,2,157,56
206150,7,76,14,0,62,14
206150,6,39,11,0,28,11
206150,5,8,3,0,5,3
206150,4,4,2,0,2,2
114871,10,2,1,1,1,0
114871,9,5,2,0,3,2
114871,8,36,15,2,21,13
114871,7,85,26,4,59,22
114871,6,161,49,7,112,42
114871,5,102,34,3,68,31
114871,4,50,17,1,33,16
114871,3,18,9,0,9,9
114871,2,6,2,0,4,2
114871,1,3,1,0,2,1
56796,10,10,3,0,7,3
56796,9,24,7,0,17,7
56796,8,89,29,0,60,29
56796,7,131,21,0,110,21
56796,6,147,21,0,126,21
56796,5,41,10,0,31,10
56796,4,22,7,0,15,7
56796,3,4,1,0,3,1
218161,10,4,1,0,3,1
218161,9,14,1,0,13,1
218161,8,82,13,0,69,13
218161,7,145,31,0,114,31
218161,6,147,17,0,130,17
218161,5,46,6,0,40,6
218161,4,19,5,0,14,5
218161,3,8,3,0,5,3
1527,10,3,2,0,1,2
1527,9,1,1,0,0,1
1527,8,13,5,0,8,5
1527,7,33,15,0,18,15
1527,6,88,31,0,57,31
1527,5,113,35,0,78,35
1527,4,109,38,0,71,38
1527,3,51,22,0,29,22
1527,2,38,25,0,13,25
1527,1,19,13,0,6,13
4001,10,20,9,0,11,9
4001,9,36,12,0,24,12
4001,8,97,24,0,73,24
4001,7,117,29,0,88,29
4001,6,112,23,0,89,23
4001,5,50,13,0,37,13
4001,4,25,6,0,19,6
4001,3,6,3,0,3,3
4001,2,3,1,0,2,1
22485,10,7,4,0,3,4
22485,9,12,7,0,5,7
22485,8,73,26,0,47,26
22485,7,123,45,0,78,45
22485,6,150,51,0,99,51
22485,5,53,20,0,33,20
22485,4,32,16,0,16,16
22485,3,9,4,0,5,4
22485,2,6,2,0,4,2
22485,1,3,2,0,1,2
162009,10,105,31,0,74,31
162009,9,127,28,0,99,28
162009,8,133,30,0,103,30
162009,7,53,20,0,33,20
162009,6,27,11,0,16,11
162009,5,12,5,0,7,5
162009,4,8,3,0,5,3
162009,3,3,2,0,1,2
41259,7,40,8,0,32,8
41259,6,127,25,0,102,25
41259,5,150,32,0,118,32
41259,4,80,20,0,60,20
41259,3,38,15,0,23,15
41259,2,19,9,0,10,9
24473,9,2,1,0,1,1
24473,8,16,7,0,9,7
24473,7,58,14,0,44,14
24473,6,189,47,0,142,47
24473,5,105,33,0,72,33
24473,4,54,13,0,41,13
24473,3,31,7,0,24,7
24473,2,10,7,0,3,7
24473,1,2,1,0,1,1
185123,10,39,6,0,33,6
185123,9,66,9,0,57,9
185123,8,180,19,0,161,19
185123,7,116,20,0,96,20
185123,6,39,10,0,29,10
185123,5,19,4,0,15,4
185123,4,7,2,0,5,2
185123,3,2,1,0,1,1
173115,10,11,2,0,9,2
173115,9,38,6,0,32,6
173115,8,103,12,0,91,12
173115,7,134,18,0,116,18
173115,6,108,21,0,87,21
173115,5,41,8,0,33,8
173115,4,23,7,0,16,7
173115,3,8,4,0,4,4
103091,10,7,3,0,4,3
103091,9,27,4,0,23,4
103091,8,94,10,0,84,10
103091,7,151,16,0,135,16
103091,6,129,17,0,112,17
103091,5,41,5,0,36,5
103091,4,9,2,0,7,2
103091,2,1,1,0,0,1
30662,10,22,6,0,16,6
30662,9,43,12,0,31,12
30662,8,132,32,0,100,32
30662,7,141,32,0,109,32
30662,6,98,16,0,82,16
30662,5,21,2,0,19,2
30662,3,4,2,0,2,2
30662,1,2,1,0,1,1
131449,10,16,4,0,12,4
131449,9,36,9,0,27,9
131449,8,156,34,1,122,33
131449,7,121,27,1,94,26
131449,6,97,24,0,73,24
131449,5,25,3,0,22,3
131449,4,9,4,0,5,4
7204,9,3,2,0,1,2
7204,8,34,18,0,16,18
7204,7,97,38,0,59,38
7204,6,187,60,0,127,60
7204,5,79,27,0,52,27
7204,4,40,10,0,30,10
7204,3,19,6,0,13,6
7204,2,7,2,0,5,2
7204,1,1,1,0,0,1
86128,8,47,13,0,34,13
86128,7,99,22,0,77,22
86128,6,179,57,0,122,57
86128,5,69,31,0,38,31
86128,4,45,19,0,26,19
86128,3,17,8,0,9,8
86128,2,4,1,0,3,1
746,10,5,2,0,3,2
746,9,11,4,0,7,4
746,8,35,11,0,24,11
746,7,86,30,0,56,30
746,6,145,49,0,96,49
746,5,105,35,0,70,35
746,4,42,16,0,26,16
746,3,27,11,0,16,11
746,2,9,4,0,5,4
67436,10,6,2,0,4,2
67436,9,8,2,0,6,2
67436,8,48,14,0,34,14
67436,7,81,25,0,56,25
67436,6,190,40,0,150,40
67436,5,76,23,0,53,23
67436,4,35,14,0,21,14
67436,3,15,3,0,12,3
67436,2,4,2,0,2,2
322,10,3,1,0,2,1
322,9,9,6,0,3,6
322,8,71,35,0,36,35
322,7,141,46,0,95,46
322,6,161,44,0,117,44
322,5,52,21,0,31,21
322,4,20,5,0,15,5
181523,10,9,3,1,6,2
181523,9,26,4,0,22,4
181523,8,112,26,2,86,24
181523,7,158,25,2,133,23
181523,6,109,26,4,83,22
181523,5,30,7,0,23,7
181523,4,13,2,0,11,2
181523,3,7,3,0,4,3
181523,2,1,1,0,0,1
53317,7,35,4,0,31,4
53317,6,142,20,0,122,20
53317,5,121,27,0,94,27
53317,4,86,12,0,74,12
53317,3,43,13,0,30,13
53317,2,17,6,0,11,6
53317,1,8,3,0,5,3
204286,10,62,19,0,43,19
204286,9,98,22,0,76,22
204286,8,154,33,1,121,32
204286,7,78,18,0,60,18
204286,6,43,9,0,34,9
204286,5,18,5,0,13,5
204286,4,7,2,0,5,2
204286,3,4,3,0,1,3
204286,2,2,2,0,0,2
204286,1,2,2,0,0,2
222407,10,29,6,0,23,6
222407,9,98,17,0,81,17
222407,8,210,30,0,180,30
222407,7,77,14,0,63,14
222407,6,40,7,0,33,7
222407,5,7,1,0,6,1
222407,4,6,2,0,4,2
191543,10,11,3,0,8,3
191543,9,11,3,0,8,3
191543,8,70,14,0,56,14
191543,7,136,18,0,118,18
191543,6,133,14,0,119,14
191543,5,58,9,0,49,9
191543,4,31,7,0,24,7
191543,3,5,1,0,4,1
191543,2,7,3,0,4,3
191543,1,2,1,0,1,1
2960,10,6,4,0,2,4
2960,9,8,4,0,4,4
2960,8,58,30,0,28,30
2960,7,115,57,0,58,57
2960,6,179,64,1,115,63
2960,5,61,20,0,41,20
2960,4,25,13,0,12,13
2960,3,9,4,0,5,4
2960,2,1,1,0,0,1
2960,1,2,1,0,1,1
179820,10,30,12,0,18,12
179820,9,49,15,0,34,15
179820,8,136,16,0,120,16
179820,7,113,12,0,101,12
179820,6,88,14,0,74,14
179820,5,27,3,0,24,3
179820,4,13,3,0,10,3
179820,3,6,2,0,4,2
3548,10,17,7,0,10,7
3548,9,28,12,0,16,12
3548,8,120,52,0,68,52
3548,7,143,44,0,99,44
3548,6,106,31,0,75,31
3548,5,34,9,0,25,9
3548,4,7,4,0,3,4
3548,3,5,2,0,3,2
3548,2,3,1,0,2,1
41490,10,25,11,0,14,11
41490,9,49,18,0,31,18
41490,8,187,60,0,127,60
41490,7,119,41,0,78,41
41490,6,53,19,0,34,19
41490,5,16,3,0,13,3
41490,4,11,2,0,9,2
68,10,20,8,0,12,8
68,9,49,14,0,35,14
68,8,115,34,0,81,34
68,7,127,27,0,100,27
68,6,95,27,0,68,27
68,5,28,9,0,19,9
68,4,20,7,0,13,7
68,3,5,3,0,2,3
212281,10,56,12,2,44,10
212281,9,97,15,0,82,15
212281,8,159,29,2,130,27
212281,7,80,8,0,72,8
212281,6,42,9,0,33,9
212281,5,11,1,0,10,1
212281,4,11,2,0,9,2
212281,3,5,1,0,4,1
212281,2,2,2,0,0,2
212281,1,1,1,0,0,1
9439,9,3,2,0,1,2
9439,8,24,8,0,16,8
9439,7,99,28,0,71,28
9439,6,179,35,0,144,35
9439,5,94,23,0,71,23
9439,4,37,14,0,23,14
9439,3,19,8,0,11,8
9439,2,7,3,0,4,3
6137,10,6,2,0,4,2
6137,9,8,2,0,6,2
6137,8,77,30,0,47,30
6137,7,138,70,0,68,70
6137,6,155,66,0,89,66
6137,5,55,18,0,37,18
6137,4,16,9,0,7,9
6137,3,4,1,0,3,1
6137,2,3,2,0,1,2
225729,10,10,1,0,9,1
225729,9,22,7,0,15,7
225729,8,127,12,0,115,12
225729,7,172,14,0,158,14
225729,6,95,5,0,90,5
225729,5,24,5,0,19,5
225729,4,9,3,0,6,3
1098,10,11,6,0,5,6
1098,9,25,4,0,21,4
1098,8,55,18,0,37,18
1098,7,102,28,0,74,28
1098,6,145,42,0,103,42
1098,5,56,10,0,46,10
1098,4,41,17,0,24,17
1098,3,20,12,0,8,12
1098,2,4,2,0,2,2
1098,1,2,1,0,1,1
127589,10,9,1,0,8,1
127589,9,16,2,0,14,2
127589,8,41,4,0,37,4
127589,7,104,8,0,96,8
127589,6,136,13,0,123,13
127589,5,77,11,0,66,11
127589,4,48,10,0,38,10
127589,3,14,4,0,10,4
127589,2,11,4,0,7,4
127589,1,5,2,0,3,2
3137,10,4,1,0,3,1
3137,9,23,5,0,18,5
3137,8,101,9,0,92,9
3137,7,154,16,0,138,16
3137,6,136,14,0,122,14
3137,5,22,5,0,17,5
3137,4,15,3,0,12,3
171339,10,4,1,0,3,1
171339,9,10,1,0,9,1
171339,8,78,14,1,64,13
171339,7,110,21,2,89,19
171339,6,153,26,1,127,25
171339,5,52,8,1,44,7
171339,4,32,8,0,24,8
171339,3,14,4,0,10,4
171339,2,5,2,0,3,2
171339,1,3,1,0,2,1
194230,10,19,6,0,13,6
194230,9,42,7,0,35,7
194230,8,125,30,0,95,30
194230,7,122,23,0,99,23
194230,6,98,20,0,78,20
194230,5,30,5,0,25,5
194230,4,14,2,0,12,2
194230,3,6,2,0,4,2
194230,2,3,2,0,1,2
32146,10,14,7,0,7,7
32146,9,17,8,0,9,8
32146,8,49,14,0,35,14
32146,7,84,15,0,69,15
32146,6,165,37,0,128,37
32146,5,57,12,0,45,12
32146,4,30,5,0,25,5
32146,3,24,6,0,18,6
32146,2,16,5,0,11,5
32146,1,5,2,0,3,2
33088,10,8,2,0,6,2
33088,8,36,4,0,32,4
33088,7,105,10,0,95,10
33088,6,176,23,0,153,23
33088,5,81,6,0,75,6
33088,4,35,3,0,32,3
33088,2,4,1,0,3,1
143484,10,7,2,0,5,2
143484,9,23,4,0,19,4
143484,8,129,25,0,104,25
143484,7,148,22,0,126,22
143484,6,98,15,0,83,15
143484,5,31,11,0,20,11
143484,4,14,4,0,10,4
143484,3,8,1,0,7,1
143484,2,2,2,0,0,2
125368,10,6,1,0,5,1
125368,9,10,2,0,8,2
125368,8,26,7,0,19,7
125368,7,86,19,0,67,19
125368,6,180,45,0,135,45
125368,5,89,13,0,76,13
125368,4,34,9,0,25,9
125368,3,18,4,0,14,4
125368,2,10,4,0,6,4
125368,1,2,1,0,1,1
8450,8,24,6,0,18,6
8450,7,79,18,0,61,18
8450,6,158,36,0,122,36
8450,5,94,25,0,69,25
8450,4,53,17,0,36,17
8450,3,31,7,0,24,7
8450,2,19,6,0,13,6
37301,10,48,26,0,22,26
37301,9,55,24,0,31,24
37301,8,129,37,0,92,37
37301,7,126,38,0,88,38
37301,6,73,21,0,52,21
37301,5,21,6,0,15,6
37301,4,5,1,0,4,1
37301,3,1,1,0,0,1
37301,1,1,1,0,0,1
2301,10,11,2,0,9,2
2301,9,17,3,0,14,3
2301,8,39,9,0,30,9
2301,7,92,24,0,68,24
2301,6,163,53,0,110,53
2301,5,85,23,0,62,23
2301,4,40,17,0,23,17
2301,3,8,5,0,3,5
2301,2,5,1,0,4,1
179259,10,6,3,0,3,3
179259,9,13,2,0,11,2
179259,8,48,9,1,39,8
179259,7,99,21,2,78,19
179259,6,164,30,2,134,28
179259,5,73,19,2,54,17
179259,4,37,7,0,30,7
179259,3,12,4,0,8,4
179259,2,6,3,0,3,3
145722,10,4,2,0,2,2
145722,9,3,1,0,2,1
145722,8,49,11,0,38,11
145722,7,106,16,0,90,16
145722,6,177,32,0,145,32
145722,5,71,13,0,58,13
145722,4,27,8,0,19,8
145722,3,12,5,0,7,5
145722,2,6,2,0,4,2
145722,1,4,1,0,3,1
136117,10,3,1,0,2,1
136117,9,6,2,0,4,2
136117,8,30,8,0,22,8
136117,7,80,21,0,59,21
136117,6,134,30,0,104,30
136117,5,81,14,0,67,14
136117,4,65,10,0,55,10
136117,3,23,4,0,19,4
136117,2,19,5,0,14,5
136117,1,18,6,0,12,6
23935,10,3,1,0,2,1
23935,9,15,5,0,10,5
23935,8,47,14,0,33,14
23935,7,104,27,0,77,27
23935,6,168,49,0,119,49
23935,5,74,28,0,46,28
23935,4,33,10,0,23,10
23935,3,9,5,0,4,5
23935,2,5,3,0,2,3
23418,10,66,20,0,46,20
23418,9,95,32,0,63,32
23418,8,156,44,0,112,44
23418,7,79,13,0,66,13
23418,6,33,11,0,22,11
23418,5,8,3,0,5,3
23418,4,13,6,0,7,6
23418,3,3,2,0,1,2
23418,2,3,1,0,2,1
23418,1,4,1,0,3,1
24410,10,16,7,0,9,7
24410,9,17,4,0,13,4
24410,8,46,18,0,28,18
24410,7,91,26,0,65,26
24410,6,169,42,0,127,42
24410,5,59,21,0,38,21
24410,4,36,16,0,20,16
24410,3,16,6,1,10,5
24410,2,7,3,0,4,3
240465,10,11,4,0,7,4
240465,9,12,4,0,8,4
240465,8,65,13,0,52,13
240465,7,114,13,0,101,13
240465,6,150,20,0,130,20
240465,5,57,7,0,50,7
240465,4,32,6,0,26,6
240465,3,11,1,0,10,1
240465,2,6,1,0,5,1
140125,10,92,30,7,62,23
140125,9,77,20,3,57,17
140125,8,146,40,13,106,27
140125,7,61,15,4,46,11
140125,6,58,13,2,45,11
140125,5,15,4,0,11,4
140125,4,5,3,0,2,3
140125,3,2,1,0,1,1
140125,1,2,1,0,1,1
177490,9,7,1,0,6,1
177490,8,67,12,2,55,10
177490,7,139,33,2,106,31
177490,6,154,32,1,122,31
177490,5,51,10,0,41,10
177490,4,28,11,0,17,11
177490,3,8,3,0,5,3
1413,10,12,4,0,8,4
1413,9,22,12,0,10,12
1413,8,91,36,0,55,36
1413,7,120,40,0,80,40
1413,6,126,46,0,80,46
1413,5,50,12,0,38,12
1413,4,20,9,0,11,9
1413,3,10,3,0,7,3
129469,10,5,2,0,3,2
129469,8,38,6,0,32,6
129469,7,66,15,0,51,15
129469,6,132,18,0,114,18
129469,5,114,22,0,92,22
129469,4,51,5,0,46,5
129469,3,28,7,0,21,7
129469,2,17,2,0,15,2
129469,1,6,1,0,5,1
174155,10,11,2,0,9,2
174155,9,53,7,0,46,7
174155,8,175,30,0,145,30
174155,7,102,22,0,80,22
174155,6,85,19,0,66,19
174155,5,19,5,0,14,5
174155,4,9,4,0,5,4
174155,3,2,2,0,0,2
6569,10,1,1,0,0,1
6569,9,2,2,0,0,2
6569,8,32,11,0,21,11
6569,7,99,36,0,63,36
6569,6,201,69,0,132,69
6569,5,79,27,0,52,27
6569,4,29,18,0,11,18
6569,3,11,5,0,6,5
6569,2,2,1,0,1,1
6569,1,1,1,0,0,1
12826,10,7,3,0,4,3
12826,8,19,2,0,17,2
12826,7,45,11,0,34,11
12826,6,157,30,0,127,30
12826,5,105,24,0,81,24
12826,4,72,14,0,58,14
12826,3,33,7,0,26,7
12826,2,14,4,0,10,4
5258,10,13,3,0,10,3
5258,9,16,3,0,13,3
5258,8,25,8,0,17,8
5258,7,76,23,0,53,23
5258,6,130,29,0,101,29
5258,5,86,20,0,66,20
5258,4,62,23,0,39,23
5258,3,26,11,0,15,11
5258,2,17,8,0,9,8
5258,1,5,2,0,3,2
234931,10,26,5,0,21,5
234931,9,51,7,0,44,7
234931,8,154,21,0,133,21
234931,7,120,19,0,101,19
234931,6,67,4,0,63,4
234931,5,20,6,0,14,6
234931,3,8,1,0,7,1
97875,10,12,3,0,9,3
97875,9,14,5,0,9,5
97875,8,103,24,0,79,24
97875,7,116,22,0,94,22
97875,6,122,24,0,98,24
97875,5,55,15,1,40,14
97875,4,25,7,0,18,7
97875,3,6,1,0,5,1
19679,10,43,6,0,37,6
19679,9,82,22,0,60,22
19679,8,146,27,0,119,27
19679,7,85,10,0,75,10
19679,6,58,13,0,45,13
19679,5,21,6,0,15,6
19679,4,11,2,0,9,2
19679,3,7,2,0,5,2
208480,10,12,2,0,10,2
208480,9,27,6,0,21,6
208480,8,140,36,2,104,34
208480,7,154,30,1,124,29
208480,6,94,17,0,77,17
208480,5,25,10,0,15,10
146818,9,11,2,0,9,2
146818,8,56,5,0,51,5
146818,7,114,11,0,103,11
146818,6,174,21,0,153,21
146818,5,65,5,0,60,5
146818,4,24,5,0,19,5
146818,3,7,2,0,5,2
146818,2,1,1,0,0,1
198447,10,11,2,0,9,2
198447,9,16,4,0,12,4
198447,8,24,5,0,19,5
198447,7,56,9,0,47,9
198447,6,110,20,0,90,20
198447,5,89,16,0,73,16
198447,4,62,19,0,43,19
198447,3,41,11,0,30,11
198447,2,26,16,0,10,16
198447,1,19,5,0,14,5
197065,10,21,4,0,17,4
197065,9,51,10,0,41,10
197065,8,177,30,0,147,30
197065,7,134,18,0,116,18
197065,6,56,11,0,45,11
197065,5,10,2,0,8,2
197065,1,1,1,0,0,1
2043,10,5,1,0,4,1
2043,9,4,1,0,3,1
2043,8,24,3,0,21,3
2043,7,54,5,0,49,5
2043,6,111,16,0,95,16
2043,5,82,14,0,68,14
2043,4,44,12,0,32,12
2043,3,13,2,0,11,2
58099,10,8,2,0,6,2
58099,9,21,3,0,18,3
58099,8,123,34,0,89,34
58099,7,148,26,0,122,26
58099,6,112,25,0,87,25
58099,5,31,7,0,24,7
58099,4,6,3,0,3,3
16362,9,12,6,0,6,6
16362,8,47,21,0,26,21
16362,7,113,64,0,49,64
16362,6,172,65,0,107,65
16362,5,59,28,0,31,28
16362,4,30,13,0,17,13
16362,3,13,5,0,8,5
16362,2,5,3,0,2,3
140613,10,1,1,0,0,1
140613,9,4,2,1,2,1
140613,8,53,14,1,39,13
140613,7,96,23,5,73,18
140613,6,144,35,5,109,30
140613,5,69,16,0,53,16
140613,4,51,14,3,37,11
140613,3,21,3,0,18,3
140613,2,13,6,1,7,5
140613,1,2,2,0,0,2
140638,10,9,2,0,7,2
140638,9,12,5,0,7,5
140638,8,46,7,0,39,7
140638,7,104,16,0,88,16
140638,6,160,24,0,136,24
140638,5,65,13,0,52,13
140638,4,37,14,0,23,14
140638,3,10,2,0,8,2
140638,2,6,1,0,5,1
140638,1,5,1,0,4,1
217776,10,11,4,1,7,3
217776,9,57,16,2,41,14
217776,8,169,39,5,130,34
217776,7,103,18,2,85,16
217776,6,65,14,0,51,14
217776,5,27,12,0,15,12
217776,4,12,4,1,8,3
217776,3,9,4,0,5,4
217776,1,1,1,0,0,1
70916,8,44,6,0,38,6
70916,7,100,18,0,82,18
70916,6,181,27,0,154,27
70916,5,71,12,0,59,12
70916,4,29,3,0,26,3
70916,3,13,5,0,8,5
70916,2,5,3,0,2,3
20782,10,11,3,0,8,3
20782,9,36,7,0,29,7
20782,8,107,23,0,84,23
20782,7,142,28,0,114,28
20782,6,111,24,0,87,24
20782,5,32,10,0,22,10
20782,4,7,1,0,6,1
229741,10,14,3,1,11,2
229741,9,27,4,0,23,4
229741,8,138,10,0,128,10
229741,7,141,19,0,122,19
229741,6,98,16,0,82,16
229741,5,26,4,0,22,4
163027,9,18,7,2,11,5
163027,8,93,16,1,77,15
163027,7,122,17,2,105,15
163027,6,125,33,5,92,28
163027,5,55,9,0,46,9
163027,4,20,11,3,9,8
163027,3,10,3,1,7,2
163027,2,8,2,1,6,1
163027,1,2,2,0,0,2
139245,10,7,3,0,4,3
139245,9,48,11,0,37,11
139245,8,177,33,0,144,33
139245,7,104,23,0,81,23
139245,6,94,20,0,74,20
139245,5,17,1,0,16,1
139245,3,2,1,0,1,1
55833,10,7,1,0,6,1
55833,9,18,3,0,15,3
55833,8,48,7,0,41,7
55833,7,102,18,0,84,18
55833,6,144,22,0,122,22
55833,5,72,8,0,64,8
55833,4,31,5,0,26,5
55833,3,17,2,0,15,2
55833,2,8,2,0,6,2
55833,1,6,1,0,5,1
5758,10,18,2,0,16,2
5758,9,9,2,0,7,2
5758,8,24,9,0,15,9
5758,7,45,2,0,43,2
5758,6,113,21,0,92,21
5758,5,107,19,0,88,19
5758,4,77,17,0,60,17
5758,3,30,8,0,22,8
5758,2,20,3,0,17,3
5758,1,11,3,0,8,3
153709,10,6,3,0,3,3
153709,8,61,11,0,50,11
153709,7,129,28,0,101,28
153709,6,171,24,0,147,24
153709,5,55,12,0,43,12
153709,4,22,2,0,20,2
153709,3,3,1,0,2,1
153709,2,2,1,0,1,1
94733,10,8,1,0,7,1
94733,9,12,3,0,9,3
94733,8,49,5,0,44,5
94733,7,73,9,0,64,9
94733,6,166,21,0,145,21
94733,5,90,27,0,63,27
94733,4,38,10,0,28,10
94733,3,14,2,0,12,2
1444,10,28,6,0,22,6
1444,9,67,23,0,44,23
1444,8,145,32,0,113,32
1444,7,102,20,0,82,20
1444,6,66,21,0,45,21
1444,5,18,5,0,13,5
1444,4,10,7,0,3,7
1444,3,10,2,0,8,2
1444,1,6,2,0,4,2
3463,10,60,18,0,42,18
3463,9,38,17,0,21,17
3463,8,93,28,0,65,28
3463,7,84,24,0,60,24
3463,6,88,24,0,64,24
3463,5,21,8,0,13,8
3463,4,12,4,0,8,4
3044,10,7,1,0,6,1
3044,9,17,7,0,10,7
3044,8,52,15,0,37,15
3044,7,130,45,0,85,45
3044,6,138,56,0,82,56
3044,5,75,21,0,54,21
3044,4,22,11,0,11,11
3044,3,9,3,0,6,3
3044,2,1,1,0,0,1
138311,10,2,1,0,1,1
138311,9,12,3,0,9,3
138311,8,48,8,1,40,7
138311,7,69,15,2,54,13
138311,6,122,22,4,100,18
138311,5,71,8,1,63,7
138311,4,53,12,1,41,11
138311,3,40,12,2,28,10
138311,2,18,4,2,14,2
138311,1,16,6,1,10,5
248900,9,29,5,0,24,5
248900,8,149,16,0,133,16
248900,7,135,17,0,118,17
248900,6,93,13,0,80,13
248900,5,24,2,0,22,2
248900,4,12,3,0,9,3
205885,9,19,3,0,16,3
205885,8,102,17,0,85,17
205885,7,170,21,0,149,21
205885,6,103,18,0,85,18
205885,5,36,3,0,33,3
205885,4,11,3,0,8,3
205885,3,7,1,0,6,1
205885,2,1,1,0,0,1
191057,10,7,2,0,5,2
191057,9,13,1,0,12,1
191057,8,43,3,0,40,3
191057,7,100,6,0,94,6
191057,6,124,3,0,121,3
191057,5,80,7,0,73,7
191057,4,51,9,0,42,9
191057,3,20,4,0,16,4
191057,2,12,4,0,8,4
184824,10,82,24,0,58,24
184824,9,128,34,0,94,34
184824,8,152,29,0,123,29
184824,7,71,16,0,55,16
184824,6,10,3,0,7,3
184824,5,4,1,0,3,1
184824,4,3,1,0,2,1
201920,8,51,5,0,46,5
201920,7,112,13,0,99,13
201920,6,164,20,0,144,20
201920,5,66,11,0,55,11
201920,4,26,4,0,22,4
201920,3,11,4,0,7,4
201920,2,9,1,0,8,1
114912,10,6,1,0,5,1
114912,9,13,4,0,9,4
114912,8,97,31,0,66,31
114912,7,146,45,0,101,45
114912,6,125,39,0,86,39
114912,5,29,9,0,20,9
114912,4,23,8,0,15,8
114912,3,9,6,0,3,6
114912,2,1,1,0,0,1
114912,1,1,1,0,0,1
7514,10,17,5,0,12,5
7514,9,24,10,0,14,10
7514,8,87,31,0,56,31
7514,7,108,34,0,74,34
7514,6,145,51,0,94,51
7514,5,42,14,0,28,14
7514,4,11,6,0,5,6
7514,3,7,4,0,3,4
7514,2,7,3,0,4,3
194553,10,7,4,0,3,4
194553,9,8,1,0,7,1
194553,8,91,21,0,70,21
194553,7,134,27,0,107,27
194553,6,139,15,0,124,15
194553,5,38,5,0,33,5
194553,4,20,10,0,10,10
194553,3,7,1,0,6,1
178209,9,22,6,0,16,6
178209,8,76,8,0,68,8
178209,7,110,11,0,99,11
178209,6,122,18,0,104,18
178209,5,56,8,0,48,8
178209,4,22,4,0,18,4
178209,3,15,4,0,11,4
178209,2,10,6,0,4,6
33581,8,34,9,0,25,9
33581,7,89,25,0,64,25
33581,6,142,31,0,111,31
33581,5,98,29,0,69,29
33581,4,54,22,0,32,22
33581,3,23,11,0,12,11
33581,2,4,2,0,2,2
21613,8,19,3,0,16,3
21613,7,70,13,0,57,13
21613,6,161,39,0,122,39
21613,5,106,36,0,70,36
21613,4,62,26,0,36,26
21613,3,19,10,0,9,10
21613,2,8,5,0,3,5
202755,10,8,5,0,3,5
202755,9,25,4,0,21,4
202755,8,175,23,0,152,23
202755,7,138,11,0,127,11
202755,6,81,12,0,69,12
202755,5,12,4,0,8,4
202755,1,1,1,0,0,1
4606,10,7,5,0,2,5
4606,9,6,3,0,3,3
4606,8,35,9,0,26,9
4606,7,73,32,0,41,32
4606,6,147,57,0,90,57
4606,5,81,24,0,57,24
4606,4,40,18,0,22,18
4606,3,38,22,0,16,22
4606,2,13,10,0,3,10
4606,1,8,6,0,2,6
861,10,15,5,0,10,5
861,9,8,2,0,6,2
861,8,55,16,0,39,16
861,7,61,19,0,42,19
861,6,137,31,0,106,31
861,5,94,30,0,64,30
861,4,54,25,0,29,25
861,3,12,4,0,8,4
861,2,10,5,0,5,5
4604,9,5,1,0,4,1
4604,8,52,6,0,46,6
4604,7,102,20,0,82,20
4604,6,150,24,0,126,24
4604,5,75,16,0,59,16
4604,4,39,8,0,31,8
4604,3,11,3,0,8,3
4604,2,8,4,0,4,4
4604,1,4,2,0,2,2
248005,10,22,6,0,16,6
248005,9,55,12,0,43,12
248005,8,178,27,0,151,27
248005,7,105,10,0,95,10
248005,6,57,6,0,51,6
248005,5,22,4,0,18,4
248005,4,6,1,0,5,1
248005,3,4,1,0,3,1
18961,10,5,2,0,3,2
18961,9,12,1,0,11,1
18961,8,43,9,0,34,9
18961,7,110,31,0,79,31
18961,6,128,38,0,90,38
18961,5,76,28,0,48,28
18961,4,41,18,0,23,18
18961,3,20,5,0,15,5
18961,2,10,8,0,2,8
18961,1,2,1,0,1,1
189294,9,11,2,0,9,2
189294,8,50,12,0,38,12
189294,7,141,23,0,118,23
189294,6,158,22,0,136,22
189294,5,59,7,0,52,7
189294,4,17,3,0,14,3
189294,3,5,1,0,4,1
189294,2,4,1,0,3,1
23981,10,3,2,0,1,2
23981,9,9,5,0,4,5
23981,8,60,35,0,25,35
23981,7,142,63,0,79,63
23981,6,152,51,0,101,51
23981,5,51,19,0,32,19
23981,4,19,7,0,12,7
23981,3,9,4,0,5,4
23981,2,1,1,0,0,1
177659,10,18,4,1,14,3
177659,9,54,15,0,39,15
177659,8,192,23,3,169,20
177659,7,90,18,3,72,15
177659,6,63,4,0,59,4
177659,5,17,4,0,13,4
177659,3,10,3,0,7,3
177659,2,2,1,0,1,1
177659,1,1,1,0,0,1
1125,10,4,2,0,2,2
1125,9,15,4,0,11,4
1125,8,82,30,0,52,30
1125,7,129,28,0,101,28
1125,6,133,34,0,99,34
1125,5,51,13,0,38,13
1125,4,20,4,0,16,4
1125,3,9,1,0,8,1
1125,2,2,1,0,1,1
19027,10,15,4,0,11,4
19027,9,10,6,0,4,6
19027,8,31,9,0,22,9
19027,7,62,18,0,44,18
19027,6,119,32,0,87,32
19027,5,72,21,0,51,21
19027,4,55,14,0,41,14
19027,3,38,13,0,25,13
19027,2,26,12,0,14,12
19027,1,19,10,0,9,10
39188,10,59,25,0,34,25
39188,9,122,39,0,83,39
39188,8,154,44,0,110,44
39188,7,66,14,0,52,14
39188,6,26,8,0,18,8
39188,5,11,4,0,7,4
39188,4,4,1,0,3,1
7104,10,26,14,0,12,14
7104,9,44,16,0,28,16
7104,8,113,37,0,76,37
7104,7,138,45,0,93,45
7104,6,87,23,0,64,23
7104,5,31,12,0,19,12
7104,4,4,1,0,3,1
7104,3,1,1,0,0,1
38786,10,41,19,0,22,19
38786,9,112,31,0,81,31
38786,8,180,45,0,135,45
38786,7,68,14,0,54,14
38786,6,30,11,0,19,11
38786,5,6,1,0,5,1
38786,4,5,4,0,1,4
123370,9,7,4,0,3,4
123370,8,36,7,0,29,7
123370,7,92,8,0,84,8
123370,6,145,19,0,126,19
123370,5,80,12,0,68,12
123370,4,47,9,0,38,9
123370,3,24,9,0,15,9
123370,2,10,4,0,6,4
1002,10,13,7,0,6,7
1002,9,34,16,0,18,16
1002,8,119,50,0,69,50
1002,7,125,30,0,95,30
1002,6,89,40,0,49,40
1002,5,41,13,0,28,13
1002,4,12,6,0,6,6
1002,3,9,5,0,4,5
1002,2,4,2,0,2,2
1002,1,1,1,0,0,1
4388,10,4,1,0,3,1
4388,9,5,2,0,3,2
4388,8,52,21,0,31,21
4388,7,142,55,0,87,55
4388,6,150,70,0,80,70
4388,5,56,18,0,38,18
4388,4,25,9,0,16,9
4388,3,6,2,0,4,2
4388,2,6,3,0,3,3
8392,9,3,2,0,1,2
8392,8,8,2,0,6,2
8392,7,23,12,0,11,12
8392,6,73,31,0,42,31
8392,5,118,39,0,79,39
8392,4,106,27,0,79,27
8392,3,65,19,0,46,19
8392,2,36,13,0,23,13
8392,1,10,3,0,7,3
1631,10,14,7,0,7,7
1631,9,30,17,0,13,17
1631,8,71,36,0,35,36
1631,7,96,35,0,61,35
1631,6,140,53,0,87,53
1631,5,52,19,0,33,19
1631,4,26,11,0,15,11
1631,3,9,5,0,4,5
1631,2,7,5,0,2,5
207338,10,4,2,0,2,2
207338,9,13,3,0,10,3
207338,8,62,5,0,57,5
207338,7,120,18,0,102,18
207338,6,163,20,0,143,20
207338,5,55,7,0,48,7
207338,4,20,5,0,15,5
207338,3,7,1,0,6,1
66608,9,8,5,0,3,5
66608,8,53,19,0,34,19
66608,7,86,29,0,57,29
66608,6,171,45,0,126,45
66608,5,76,21,0,55,21
66608,4,33,5,0,28,5
66608,3,12,7,0,5,7
66608,2,4,1,0,3,1
1859,10,16,4,0,12,4
1859,9,11,2,0,9,2
1859,8,39,10,0,29,10
1859,7,56,8,0,48,8
1859,6,115,25,0,90,25
1859,5,95,29,0,66,29
1859,4,66,20,0,46,20
1859,3,21,7,0,14,7
1859,2,16,7,0,9,7
1859,1,9,5,0,4,5
159581,10,3,1,0,2,1
159581,9,20,4,0,16,4
159581,8,83,13,0,70,13
159581,7,132,26,0,106,26
159581,6,116,17,0,99,17
159581,5,45,7,0,38,7
159581,4,34,12,0,22,12
159581,3,9,2,0,7,2
159581,2,2,2,0,0,2
4816,10,7,1,0,6,1
4816,9,13,3,0,10,3
4816,8,27,6,0,21,6
4816,7,90,21,0,69,21
4816,6,136,44,0,92,44
4816,5,78,19,0,59,19
4816,4,56,17,0,39,17
4816,3,24,11,0,13,11
4816,2,9,3,0,6,3
4816,1,4,2,0,2,2
1881,10,14,3,0,11,3
1881,9,18,1,0,17,1
1881,8,44,10,0,34,10
1881,7,67,16,0,51,16
1881,6,136,31,0,105,31
1881,5,80,22,0,58,22
1881,4,46,13,0,33,13
1881,3,23,6,0,17,6
1881,2,12,4,0,8,4
1881,1,4,2,0,2,2
27961,8,18,4,0,14,4
27961,7,63,15,0,48,15
27961,6,136,31,0,105,31
27961,5,110,23,0,87,23
27961,4,66,17,0,49,17
27961,3,23,5,0,18,5
27961,2,17,3,0,14,3
27961,1,6,2,0,4,2
3052,9,3,1,0,2,1
3052,8,13,4,0,9,4
3052,7,33,8,0,25,8
3052,6,71,21,0,50,21
3052,5,84,22,0,62,22
3052,4,109,32,0,77,32
3052,3,56,20,0,36,20
3052,2,55,22,0,33,22
3052,1,20,9,0,11,9
25695,10,4,2,0,2,2
25695,9,15,6,0,9,6
25695,8,56,30,0,26,30
25695,7,108,32,0,76,32
25695,6,164,50,0,114,50
25695,5,43,9,0,34,9
25695,4,34,8,0,26,8
25695,3,10,5,0,5,5
25695,2,9,6,0,3,6
93185,10,8,3,0,5,3
93185,8,35,2,0,33,2
93185,7,91,17,0,74,17
93185,6,163,37,0,126,37
93185,5,84,18,0,66,18
93185,4,38,10,0,28,10
93185,3,15,3,0,12,3
93185,2,4,3,0,1,3
187289,10,10,3,0,7,3
187289,9,16,5,0,11,5
187289,8,56,16,0,40,16
187289,7,86,14,0,72,14
187289,6,163,30,0,133,30
187289,5,60,8,0,52,8
187289,4,38,7,0,31,7
187289,2,3,1,0,2,1
187289,1,1,1,0,0,1
146784,10,17,6,0,11,6
146784,9,32,7,0,25,7
146784,8,123,26,0,97,26
146784,7,112,21,0,91,21
146784,6,104,19,0,85,19
146784,5,30,8,0,22,8
146784,4,10,3,0,7,3
146784,3,13,3,0,10,3
181440,10,13,8,0,5,8
181440,9,21,4,0,17,4
181440,8,78,10,0,68,10
181440,7,119,12,0,107,12
181440,6,124,19,0,105,19
181440,5,55,7,0,48,7
181440,4,19,3,0,16,3
181440,3,13,2,0,11,2
514,10,9,2,0,7,2
514,9,7,2,0,5,2
514,8,58,17,0,41,17
514,7,97,39,0,58,39
514,6,130,34,0,96,34
514,5,73,18,0,55,18
514,4,35,9,0,26,9
514,3,21,5,0,16,5
514,2,8,3,0,5,3
19878,9,3,2,0,1,2
19878,8,41,10,0,31,10
19878,7,99,28,0,71,28
19878,6,167,50,0,117,50
19878,5,74,22,0,52,22
19878,4,39,15,0,24,15
19878,3,13,6,0,7,6
3573,10,16,6,0,10,6
3573,9,13,5,0,8,5
3573,8,71,31,0,40,31
3573,7,130,49,0,81,49
3573,6,143,61,0,82,61
3573,5,51,18,0,33,18
3573,4,9,4,0,5,4
3573,3,6,3,0,3,3
3573,1,2,1,0,1,1
261114,10,18,4,0,14,4
261114,9,53,6,0,47,6
261114,8,176,21,0,155,21
261114,7,108,22,0,86,22
261114,6,56,5,0,51,5
261114,5,16,4,0,12,4
261114,4,12,2,0,10,2
40107,10,13,11,0,2,11
40107,9,30,16,0,14,16
40107,8,131,53,0,78,53
40107,7,139,52,0,87,52
40107,6,87,35,0,52,35
40107,5,22,7,0,15,7
40107,4,11,6,0,5,6
40107,3,5,4,0,1,4
40107,2,3,1,0,2,1
40107,1,1,1,0,0,1
1308,8,16,2,0,14,2
1308,7,58,6,0,52,6
1308,6,142,25,0,117,25
1308,5,106,15,0,91,15
1308,4,60,6,0,54,6
1308,3,33,5,0,28,5
1308,2,16,6,0,10,6
1308,1,4,2,0,2,2
2318,10,2,1,0,1,1
2318,8,12,5,0,7,5
2318,7,31,13,0,18,13
2318,6,86,19,0,67,19
2318,5,123,22,0,101,22
2318,4,95,20,0,75,20
2318,3,45,18,0,27,18
2318,2,35,14,0,21,14
2318,1,11,1,0,10,1
58329,9,5,1,0,4,1
58329,8,48,6,0,42,6
58329,7,128,21,0,107,21
58329,6,166,40,0,126,40
58329,5,54,9,0,45,9
58329,4,22,7,0,15,7
58329,3,10,4,0,6,4
58329,2,3,1,0,2,1
58329,1,2,1,0,1,1
170199,10,16,3,0,13,3
170199,9,60,7,0,53,7
170199,8,168,24,0,144,24
170199,7,115,16,0,99,16
170199,6,52,8,0,44,8
170199,5,16,5,0,11,5
170199,4,7,1,0,6,1
170199,2,2,1,0,1,1
170199,1,3,3,0,0,3
103651,10,1,1,0,0,1
103651,9,8,5,0,3,5
103651,8,60,25,0,35,25
103651,7,142,43,0,99,43
103651,6,160,45,0,115,45
103651,5,48,11,0,37,11
103651,4,16,5,0,11,5
38402,9,13,2,0,11,2
38402,8,49,8,0,41,8
38402,7,90,15,0,75,15
38402,6,138,32,0,106,32
38402,5,68,18,0,50,18
38402,4,45,11,0,34,11
38402,3,15,4,0,11,4
38402,2,13,1,0,12,1
38402,1,8,2,0,6,2
155702,9,23,3,0,20,3
155702,8,119,13,0,106,13
155702,7,124,14,0,110,14
155702,6,92,17,0,75,17
155702,5,34,6,0,28,6
155702,4,18,2,0,16,2
155702,3,10,3,0,7,3
210052,10,10,1,0,9,1
210052,9,12,2,0,10,2
210052,8,81,19,0,62,19
210052,7,126,18,0,108,18
210052,6,122,18,1,104,17
210052,5,48,10,0,38,10
210052,3,13,4,0,9,4
210052,2,10,5,0,5,5
210052,1,2,1,0,1,1
1493,10,16,3,0,13,3
1493,9,43,15,0,28,15
1493,8,118,37,0,81,37
1493,7,107,24,0,83,24
1493,6,95,29,0,66,29
1493,5,33,9,0,24,9
1493,4,15,6,0,9,6
1493,3,7,3,0,4,3
1493,1,3,2,0,1,2
222514,10,164,27,2,137,25
222514,9,137,21,2,116,19
222514,8,105,11,1,94,10
222514,7,25,7,0,18,7
222514,6,12,3,0,9,3
222514,5,11,2,0,9,2
222514,4,5,1,0,4,1
222514,3,2,1,0,1,1
108161,10,21,6,0,15,6
108161,9,21,6,0,15,6
108161,8,77,10,0,67,10
108161,7,129,28,0,101,28
108161,6,130,26,0,104,26
108161,5,43,13,0,30,13
108161,4,12,4,0,8,4
108161,3,3,2,0,1,2
108161,2,5,3,0,2,3
13507,10,5,1,0,4,1
13507,9,15,9,0,6,9
13507,8,106,21,0,85,21
13507,7,119,25,0,94,25
13507,6,132,17,0,115,17
13507,5,34,7,0,27,7
13507,4,16,6,0,10,6
27970,10,10,4,0,6,4
27970,9,11,1,0,10,1
27970,8,41,15,0,26,15
27970,7,67,19,0,48,19
27970,6,131,31,0,100,31
27970,5,89,27,0,62,27
27970,4,57,20,0,37,20
27970,3,21,8,0,13,8
27970,2,8,5,0,3,5
27970,1,5,2,0,3,2
25677,9,4,2,0,2,2
25677,8,18,6,0,12,6
25677,7,87,20,0,67,20
25677,6,148,42,0,106,42
25677,5,80,22,0,58,22
25677,4,54,21,0,33,21
25677,3,31,13,0,18,13
25677,2,16,10,0,6,10
756,10,12,5,0,7,5
756,9,39,17,0,22,17
756,8,115,52,0,63,52
756,7,142,62,0,80,62
756,6,84,31,0,53,31
756,5,26,9,0,17,9
756,4,13,3,0,10,3
756,3,4,4,0,0,4
756,2,3,1,0,2,1
756,1,1,1,0,0,1
177499,10,9,3,0,6,3
177499,9,23,3,0,20,3
177499,8,90,18,0,72,18
177499,7,122,26,0,96,26
177499,6,119,20,0,99,20
177499,5,44,5,0,39,5
177499,4,22,7,0,15,7
177499,3,7,1,0,6,1
177499,2,3,1,0,2,1
206206,10,13,4,1,9,3
206206,9,37,7,0,30,7
206206,8,135,27,0,108,27
206206,7,123,27,0,96,27
206206,6,82,17,0,65,17
206206,5,27,5,0,22,5
206206,4,12,6,0,6,6
206206,3,6,1,0,5,1
206206,2,3,1,0,2,1
234948,10,19,3,0,16,3
234948,9,58,12,2,46,10
234948,8,183,22,5,161,17
234948,7,87,15,1,72,14
234948,6,58,13,1,45,12
234948,5,15,3,0,12,3
234948,4,12,3,0,9,3
234948,2,4,2,0,2,2
4984,10,21,9,0,12,9
4984,9,23,8,0,15,8
4984,8,66,22,0,44,22
4984,7,119,38,0,81,38
4984,6,122,28,0,94,28
4984,5,65,22,0,43,22
4984,4,13,4,0,9,4
4984,3,7,2,0,5,2
238546,10,39,6,0,33,6
238546,9,83,9,0,74,9
238546,8,163,16,0,147,16
238546,7,75,11,0,64,11
238546,6,38,6,0,32,6
238546,5,17,4,0,13,4
238546,4,10,4,0,6,4
238546,3,7,2,0,5,2
238546,2,4,4,0,0,4
238546,1,2,1,0,1,1
39088,9,18,6,0,12,6
39088,8,45,10,0,35,10
39088,7,110,22,0,88,22
39088,6,165,28,0,137,28
39088,5,57,9,0,48,9
39088,4,27,7,0,20,7
39088,3,8,3,0,5,3
39088,2,2,1,0,1,1
176262,10,5,2,0,3,2
176262,9,16,7,0,9,7
176262,8,126,22,5,104,17
176262,7,151,28,4,123,24
176262,6,98,24,2,74,22
176262,5,28,8,0,20,8
176262,4,9,1,0,8,1
43530,10,11,1,0,10,1
43530,9,26,2,0,24,2
43530,8,59,5,0,54,5
43530,7,81,9,0,72,9
43530,6,142,6,0,136,6
43530,5,61,4,0,57,4
43530,4,30,2,0,28,2
43530,3,13,3,0,10,3
43530,2,11,2,0,9,2
43530,1,2,1,0,1,1
110331,10,17,1,0,16,1
110331,9,21,4,0,17,4
110331,8,86,21,0,65,21
110331,7,118,26,0,92,26
110331,6,118,18,0,100,18
110331,5,43,11,0,32,11
110331,4,20,2,0,18,2
110331,3,9,4,0,5,4
110331,2,2,1,0,1,1
110331,1,2,1,0,1,1
29663,10,48,9,0,39,9
29663,9,62,13,0,49,13
29663,8,100,19,0,81,19
29663,7,107,22,0,85,22
29663,6,72,12,0,60,12
29663,5,24,6,0,18,6
29663,4,12,4,0,8,4
29663,3,6,1,0,5,1
29663,2,5,1,0,4,1
79068,10,6,1,0,5,1
79068,9,5,1,0,4,1
79068,8,65,19,2,46,17
79068,7,96,11,1,85,10
79068,6,152,27,2,125,25
79068,5,47,8,0,39,8
79068,4,38,11,0,27,11
79068,3,14,4,0,10,4
79068,2,13,5,0,8,5
17988,10,5,3,0,2,3
17988,9,17,11,0,6,11
17988,8,84,29,0,55,29
17988,7,131,47,0,84,47
17988,6,124,39,0,85,39
17988,5,44,12,0,32,12
17988,4,26,7,0,19,7
17988,2,1,1,0,0,1
11202,10,5,1,0,4,1
11202,9,11,6,0,5,6
11202,8,71,27,0,44,27
11202,7,108,41,0,67,41
11202,6,122,38,0,84,38
11202,5,47,20,0,27,20
11202,4,32,11,0,21,11
11202,3,24,9,0,15,9
11202,2,10,2,0,8,2
11202,1,6,3,0,3,3
172600,10,3,1,0,2,1
172600,8,35,12,0,23,12
172600,7,100,15,1,85,14
172600,6,155,34,2,121,32
172600,5,73,14,1,59,13
172600,4,38,7,0,31,7
172600,3,19,5,0,14,5
172600,2,7,3,0,4,3
89342,10,20,10,1,10,9
89342,9,16,1,0,15,1
89342,8,98,25,2,73,23
89342,7,95,21,0,74,21
89342,6,92,13,1,79,12
89342,5,40,8,0,32,8
89342,4,39,16,0,23,16
89342,3,14,5,0,9,5
89342,2,16,9,2,7,7
89342,1,5,2,0,3,2
1693,10,8,1,0,7,1
1693,9,23,11,0,12,11
1693,8,69,24,0,45,24
1693,7,101,23,0,78,23
1693,6,144,32,0,112,32
1693,5,64,21,0,43,21
1693,4,16,3,0,13,3
1693,3,9,5,0,4,5
1693,2,1,1,0,0,1
248117,9,25,7,0,18,7
248117,8,141,29,0,112,29
248117,7,137,28,0,109,28
248117,6,77,17,0,60,17
248117,5,30,9,0,21,9
248117,4,13,5,0,8,5
255664,10,52,11,0,41,11
255664,9,54,12,0,42,12
255664,8,101,14,2,87,12
255664,7,81,11,1,70,10
255664,6,72,10,1,62,9
255664,5,29,6,0,23,6
255664,4,18,4,2,14,2
255664,3,18,7,0,11,7
255664,2,10,8,1,2,7
255664,1,4,3,0,1,3
89,10,14,5,0,9,5
89,9,39,23,0,16,23
89,8,92,46,0,46,46
89,7,112,36,0,76,36
89,6,96,33,0,63,33
89,5,46,15,0,31,15
89,4,22,11,0,11,11
89,3,7,3,0,4,3
89,2,4,2,0,2,2
89,1,2,2,0,0,2
10502,10,9,4,0,5,4
10502,8,22,9,0,13,9
10502,7,34,5,0,29,5
10502,6,99,15,0,84,15
10502,5,108,24,0,84,24
10502,4,85,21,0,64,21
10502,3,37,18,0,19,18
10502,2,27,10,0,17,10
10502,1,11,3,0,8,3
160567,10,10,1,0,9,1
160567,9,18,1,0,17,1
160567,8,68,11,0,57,11
160567,7,111,14,0,97,14
160567,6,141,10,0,131,10
160567,5,45,3,0,42,3
160567,4,32,8,0,24,8
160567,2,4,1,0,3,1
15738,9,4,1,0,3,1
15738,8,28,14,0,14,14
15738,7,65,22,0,43,22
15738,6,147,47,0,100,47
15738,5,81,22,0,59,22
15738,4,55,15,0,40,15
15738,3,27,7,0,20,7
15738,2,18,11,0,7,11
213953,10,8,3,0,5,3
213953,9,11,4,0,7,4
213953,8,96,16,0,80,16
213953,7,143,25,0,118,25
213953,6,117,21,0,96,21
213953,5,35,9,0,26,9
213953,4,17,4,0,13,4
213953,3,3,1,0,2,1
213953,2,2,1,0,1,1
173294,10,35,7,0,28,7
173294,9,50,3,0,47,3
173294,8,130,12,0,118,12
173294,7,112,14,0,98,14
173294,6,77,12,0,65,12
173294,5,14,1,0,13,1
173294,2,2,1,0,1,1
173294,1,5,2,0,3,2
4122,10,3,2,0,1,2
4122,9,3,3,0,0,3
4122,8,17,4,0,13,4
4122,7,35,8,0,27,8
4122,6,72,18,0,54,18
4122,5,115,19,0,96,19
4122,4,93,27,0,66,27
4122,3,50,16,0,34,16
4122,2,31,12,0,19,12
4122,1,14,4,0,10,4
137811,9,18,6,0,12,6
137811,8,51,12,0,39,12
137811,7,68,12,0,56,12
137811,6,126,35,1,91,34
137811,5,73,14,0,59,14
137811,4,43,14,1,29,13
137811,3,26,10,0,16,10
137811,2,17,5,0,12,5
137811,1,8,4,0,4,4
207208,9,22,6,0,16,6
207208,8,96,24,0,72,24
207208,7,130,17,0,113,17
207208,6,109,30,0,79,30
207208,5,46,9,0,37,9
207208,4,18,3,0,15,3
207208,3,9,4,0,5,4
186721,10,10,1,0,9,1
186721,9,34,4,0,30,4
186721,8,175,37,0,138,37
186721,7,117,23,0,94,23
186721,6,70,10,0,60,10
186721,5,12,2,0,10,2
186721,4,10,4,0,6,4
186721,3,5,3,0,2,3
4052,10,8,1,0,7,1
4052,9,16,3,0,13,3
4052,8,50,14,0,36,14
4052,7,74,24,0,50,24
4052,6,116,38,0,78,38
4052,5,79,18,0,61,18
4052,4,37,11,0,26,11
4052,3,28,10,0,18,10
4052,2,15,7,0,8,7
4052,1,10,3,0,7,3
112598,10,6,2,0,4,2
112598,9,15,7,0,8,7
112598,8,70,22,0,48,22
112598,7,109,20,0,89,20
112598,6,130,35,0,95,35
112598,5,59,17,0,42,17
112598,4,31,4,0,27,4
112598,3,6,1,0,5,1
112598,2,4,2,0,2,2
3529,10,4,1,0,3,1
3529,9,4,1,0,3,1
3529,8,20,7,0,13,7
3529,7,30,12,0,18,12
3529,6,133,49,0,84,49
3529,5,110,41,0,69,41
3529,4,78,26,0,52,26
3529,3,33,16,0,17,16
3529,2,15,8,0,7,8
3529,1,5,3,0,2,3
2981,10,24,13,0,11,13
2981,9,49,21,0,28,21
2981,8,135,50,0,85,50
2981,7,135,51,0,84,51
2981,6,62,19,0,43,19
2981,5,12,6,0,6,6
2981,4,6,2,0,4,2
2981,3,3,2,0,1,2
2981,2,4,2,0,2,2
2981,1,2,1,0,1,1
170146,9,6,1,0,5,1
170146,8,72,14,0,58,14
170146,7,108,21,0,87,21
170146,6,135,31,0,104,31
170146,5,66,12,0,54,12
170146,4,28,5,0,23,5
170146,3,10,3,0,7,3
170146,2,4,4,0,0,4
179933,10,12,5,0,7,5
179933,9,37,12,1,25,11
179933,8,144,40,6,104,34
179933,7,125,21,0,104,21
179933,6,90,26,1,64,25
179933,5,15,3,0,12,3
179933,4,5,1,1,4,0
179933,3,3,2,0,1,2
64220,10,9,3,0,6,3
64220,9,11,4,0,7,4
64220,8,83,34,0,49,34
64220,7,116,41,0,75,41
64220,6,126,38,0,88,38
64220,5,58,14,0,44,14
64220,4,19,9,0,10,9
64220,3,6,1,0,5,1
177147,10,9,2,0,7,2
177147,9,24,3,0,21,3
177147,8,139,19,0,120,19
177147,7,130,19,0,111,19
177147,6,110,20,0,90,20
177147,5,17,7,0,10,7
177147,2,1,1,0,0,1
35706,10,3,1,0,2,1
35706,9,5,1,0,4,1
35706,8,39,14,0,25,14
35706,7,103,34,0,69,34
35706,6,153,45,0,108,45
35706,5,64,18,0,46,18
35706,4,42,13,0,29,13
35706,3,17,3,0,14,3
35706,2,5,1,0,4,1
186864,10,16,4,0,12,4
186864,9,38,3,0,35,3
186864,8,166,29,0,137,29
186864,7,102,15,0,87,15
186864,6,77,13,0,64,13
186864,5,15,3,0,12,3
186864,4,10,2,0,8,2
186864,3,4,1,0,3,1
68858,10,34,3,0,31,3
68858,9,69,13,1,56,12
68858,8,134,16,0,118,16
68858,7,108,11,0,97,11
68858,6,65,15,0,50,15
68858,5,11,1,0,10,1
68858,2,1,1,0,0,1
93541,9,14,1,0,13,1
93541,8,85,22,0,63,22
93541,7,112,22,0,90,22
93541,6,118,31,0,87,31
93541,5,61,21,0,40,21
93541,4,18,10,0,8,10
93541,3,8,1,0,7,1
93541,1,1,1,0,0,1
1421,10,6,3,0,3,3
1421,9,26,9,0,17,9
1421,8,64,29,0,35,29
1421,7,115,41,0,74,41
1421,6,130,49,0,81,49
196496,10,54,17,1,37,16
196496,9,87,11,0,76,11
196496,8,160,30,4,130,26
196496,7,64,12,1,52,11
196496,6,33,5,0,28,5
196496,5,18,9,0,9,9
196496,4,3,1,0,2,1
196496,3,5,1,0,4,1
99808,9,6,1,0,5,1
99808,8,57,20,1,37,19
99808,7,112,27,1,85,26
99808,6,140,36,0,104,36
99808,5,65,16,0,49,16
99808,4,29,8,1,21,7
99808,3,11,5,0,6,5
99808,2,6,2,0,4,2
101786,10,38,10,0,28,10
101786,9,52,7,0,45,7
101786,8,116,14,0,102,14
101786,7,121,19,0,102,19
101786,6,67,10,0,57,10
101786,5,18,3,0,15,3
101786,4,9,3,0,6,3
101786,3,6,1,0,5,1
154875,10,60,21,0,39,21
154875,9,97,21,0,76,21
154875,8,150,34,0,116,34
154875,7,78,20,0,58,20
154875,6,28,6,0,22,6
154875,5,9,4,0,5,4
154875,3,2,2,0,0,2
217475,10,6,1,0,5,1
217475,8,67,9,0,58,9
217475,7,118,16,0,102,16
217475,6,147,25,0,122,25
217475,5,48,7,0,41,7
217475,4,22,11,0,11,11
217475,2,2,1,0,1,1
1593,10,9,6,0,3,6
1593,9,8,3,0,5,3
1593,8,30,15,0,15,15
1593,7,87,22,0,65,22
1593,6,133,25,0,108,25
1593,5,82,24,0,58,24
1593,4,40,9,0,31,9
1593,3,26,7,0,19,7
1593,2,10,5,0,5,5
1593,1,4,3,0,1,3
88402,10,3,1,0,2,1
88402,9,10,5,0,5,5
88402,8,32,15,0,17,15
88402,7,71,22,0,49,22
88402,6,140,42,0,98,42
88402,5,83,31,0,52,31
88402,4,53,15,0,38,15
88402,3,19,8,0,11,8
88402,2,10,4,0,6,4
88402,1,8,3,0,5,3
1713,10,2,1,0,1,1
1713,8,66,13,0,53,13
1713,7,108,33,0,75,33
1713,6,134,31,0,103,31
1713,5,64,18,0,46,18
1713,4,33,15,0,18,15
1713,3,13,7,0,6,7
1713,2,6,3,0,3,3
4047,10,15,8,0,7,8
4047,9,32,12,0,20,12
4047,8,108,51,0,57,51
4047,7,128,47,0,81,47
4047,6,96,41,0,55,41
4047,5,30,12,0,18,12
4047,4,12,8,0,4,8
4047,3,6,1,0,5,1
4047,2,2,1,0,1,1
142503,10,9,1,0,8,1
142503,9,8,1,0,7,1
142503,8,73,18,0,55,18
142503,7,92,13,0,79,13
142503,6,132,19,0,113,19
142503,5,54,12,0,42,12
142503,4,33,8,0,25,8
142503,3,14,3,0,11,3
142503,2,10,5,0,5,5
142503,1,4,1,0,3,1
39332,10,6,1,0,5,1
39332,9,11,4,0,7,4
39332,8,54,9,0,45,9
39332,7,107,19,0,88,19
39332,6,155,32,0,123,32
39332,5,55,13,0,42,13
39332,4,32,5,0,27,5
39332,3,5,1,0,4,1
39332,2,3,1,0,2,1
145642,10,12,3,0,9,3
145642,9,27,8,0,19,8
145642,8,100,13,1,87,12
145642,7,137,32,0,105,32
145642,6,109,23,1,86,22
145642,5,25,6,0,19,6
145642,4,13,6,0,7,6
145642,3,3,1,1,2,0
145642,2,3,1,0,2,1
145642,1,3,1,1,2,0
165877,10,5,1,0,4,1
165877,9,25,6,0,19,6
165877,8,73,27,0,46,27
165877,7,129,21,0,108,21
165877,6,129,25,0,104,25
165877,5,38,6,0,32,6
165877,4,15,5,0,10,5
165877,3,10,3,0,7,3
244918,10,26,2,0,24,2
244918,9,42,10,0,32,10
244918,8,158,29,0,129,29
244918,7,112,14,0,98,14
244918,6,67,6,0,61,6
244918,5,13,1,0,12,1
244918,4,6,1,0,5,1
244918,2,3,1,0,2,1
302,10,6,3,0,3,3
302,9,18,5,0,13,5
302,8,110,21,0,89,21
302,7,133,28,0,105,28
302,6,101,21,0,80,21
302,5,41,18,0,23,18
302,4,11,7,0,4,7
302,3,5,1,0,4,1
302,2,3,2,0,1,2
302,1,1,1,0,0,1
149787,10,55,22,2,33,20
149787,9,94,20,2,74,18
149787,8,145,39,2,106,37
149787,7,61,7,0,54,7
149787,6,30,3,0,27,3
149787,5,15,4,0,11,4
149787,4,14,3,0,11,3
149787,3,7,4,0,3,4
149787,2,6,2,0,4,2
61458,10,1,1,0,0,1
61458,9,22,8,0,14,8
61458,8,141,42,0,99,42
61458,7,129,33,0,96,33
61458,6,93,26,0,67,26
61458,5,27,12,0,15,12
61458,4,11,5,0,6,5
61458,3,4,2,0,2,2
133285,10,9,3,0,6,3
133285,9,25,10,0,15,10
133285,8,156,33,0,123,33
133285,7,104,20,0,84,20
133285,6,88,19,0,69,19
133285,5,23,5,0,18,5
133285,4,14,4,0,10,4
133285,3,6,2,0,4,2
133285,1,1,1,0,0,1
3422,9,4,1,0,3,1
3422,8,20,4,0,16,4
3422,7,44,9,0,35,9
3422,6,110,28,0,82,28
3422,5,82,13,0,69,13
3422,4,69,11,0,58,11
3422,3,49,9,0,40,9
3422,2,27,10,0,17,10
3422,1,20,8,0,12,8
55863,10,13,6,0,7,6
55863,9,16,5,0,11,5
55863,8,82,24,0,58,24
55863,7,147,35,0,112,35
55863,6,124,33,0,91,33
55863,5,30,6,0,24,6
55863,4,8,3,0,5,3
55863,3,4,2,0,2,2
6551,10,4,1,0,3,1
6551,9,8,2,0,6,2
6551,8,47,22,0,25,22
6551,7,103,43,0,60,43
6551,6,134,41,0,93,41
6551,5,70,23,0,47,23
6551,4,38,19,0,19,19
6551,3,16,8,0,8,8
6551,2,5,2,0,3,2
6551,1,2,1,0,1,1
12318,10,5,3,0,2,3
12318,9,7,4,0,3,4
12318,8,56,18,0,38,18
12318,7,104,35,0,69,35
12318,6,155,66,0,89,66
12318,5,55,23,0,32,23
12318,4,24,9,0,15,9
12318,3,13,7,0,6,7
12318,2,4,3,0,1,3
12318,1,4,2,0,2,2
110870,10,6,1,0,5,1
110870,8,67,15,0,52,15
110870,7,120,20,0,100,20
110870,6,152,24,0,128,24
110870,5,38,10,0,28,10
110870,4,21,3,0,18,3
110870,3,9,3,0,6,3
110870,2,4,2,0,2,2
32901,10,14,2,0,12,2
32901,9,27,1,0,26,1
32901,8,66,11,0,55,11
32901,7,105,7,0,98,7
32901,6,135,18,0,117,18
32901,5,47,5,0,42,5
32901,1,6,1,0,5,1
256916,10,84,14,0,70,14
256916,9,112,16,0,96,16
256916,8,166,26,0,140,26
256916,7,44,8,0,36,8
256916,6,15,3,0,12,3
256916,4,4,3,0,1,3
256916,2,1,1,0,0,1
256916,1,1,1,0,0,1
3730,10,44,23,0,21,23
3730,9,34,10,0,24,10
3730,8,85,34,0,51,34
3730,7,112,44,0,68,44
3730,6,95,27,0,68,27
3730,5,33,13,0,20,13
3730,4,16,2,0,14,2
3730,3,3,2,0,1,2
3730,1,3,2,0,1,2
4985,10,28,14,0,14,14
4985,9,48,20,0,28,20
4985,8,106,38,0,68,38
4985,7,121,27,0,94,27
4985,6,77,24,0,53,24
4985,5,17,5,0,12,5
4985,4,14,6,0,8,6
4985,3,5,2,0,3,2
4985,2,3,1,0,2,1
1250,10,2,1,0,1,1
1250,9,7,2,0,5,2
1250,8,37,6,0,31,6
1250,7,92,16,0,76,16
1250,6,142,38,0,104,38
1250,5,80,19,0,61,19
1250,4,39,14,0,25,14
1250,3,17,5,0,12,5
1250,2,7,3,0,4,3
1250,1,2,2,0,0,2
5668,10,3,2,0,1,2
5668,8,26,5,0,21,5
5668,7,64,17,0,47,17
5668,6,143,19,0,124,19
5668,5,101,22,0,79,22
5668,4,53,9,0,44,9
5668,3,18,6,0,12,6
5668,2,8,2,0,6,2
43691,10,10,5,0,5,5
43691,9,16,5,0,11,5
43691,8,43,18,0,25,18
43691,7,125,53,0,72,53
43691,6,158,56,0,102,56
43691,5,51,21,0,30,21
43691,4,18,5,0,13,5
43691,3,3,2,0,1,2
203204,10,22,5,0,17,5
203204,9,36,5,0,31,5
203204,8,97,16,0,81,16
203204,7,131,18,0,113,18
203204,6,94,12,0,82,12
203204,5,28,4,0,24,4
203204,4,10,1,0,9,1
203204,3,6,1,0,5,1
3562,10,2,1,0,1,1
3562,8,40,23,0,17,23
3562,7,97,25,0,72,25
3562,6,150,50,0,100,50
3562,5,78,23,0,55,23
3562,4,29,18,0,11,18
3562,3,22,8,0,14,8
3562,2,5,5,0,0,5
64,10,6,1,0,5,1
64,9,22,8,0,14,8
64,8,58,12,0,46,12
64,7,108,26,0,82,26
64,6,133,27,0,106,27
64,5,44,19,0,25,19
64,4,29,12,0,17,12
64,3,10,2,0,8,2
64,2,10,3,0,7,3
64,1,5,2,0,3,2
144525,9,16,7,0,9,7
144525,8,71,13,0,58,13
144525,7,109,19,0,90,19
144525,6,123,21,0,102,21
144525,5,47,10,0,37,10
144525,4,25,6,0,19,6
144525,3,13,3,0,10,3
144525,2,8,2,0,6,2
144525,1,4,2,0,2,2
205907,10,74,15,0,59,15
205907,9,95,9,0,86,9
205907,8,119,20,0,99,20
205907,7,60,7,0,53,7
205907,6,38,4,0,34,4
205907,5,14,3,0,11,3
205907,4,8,1,0,7,1
205907,2,6,2,0,4,2
205907,1,8,5,0,3,5
245422,10,24,10,1,14,9
245422,9,64,12,3,52,9
245422,8,197,32,2,165,30
245422,7,87,12,1,75,11
245422,6,37,4,0,33,4
245422,5,11,3,0,8,3
245422,4,5,2,0,3,2
245422,1,2,1,0,1,1
186323,10,19,4,2,15,2
186323,9,29,12,0,17,12
186323,8,161,32,5,129,27
186323,7,120,21,3,99,18
186323,6,63,13,1,50,12
186323,5,16,2,0,14,2
186323,4,7,3,0,4,3
199904,10,69,22,0,47,22
199904,9,111,27,0,84,27
199904,8,137,24,0,113,24
199904,7,45,10,0,35,10
199904,6,36,9,0,27,9
199904,5,12,4,0,8,4
199904,4,5,3,0,2,3
199904,3,5,1,0,4,1
4651,10,17,11,0,6,11
4651,9,9,2,0,7,2
4651,8,46,23,0,23,23
4651,7,85,37,0,48,37
4651,6,114,32,0,82,32
4651,5,80,27,0,53,27
4651,4,44,20,0,24,20
4651,3,20,10,0,10,10
4651,2,6,4,0,2,4
4651,1,3,1,0,2,1
23950,10,15,9,0,6,9
23950,9,38,18,0,20,18
23950,8,103,45,0,58,45
23950,7,104,30,0,74,30
23950,6,106,46,0,60,46
23950,5,31,15,0,16,15
23950,4,21,9,0,12,9
23950,3,4,3,0,1,3
23950,2,1,1,0,0,1
23950,1,1,1,0,0,1
38275,10,4,2,0,2,2
38275,9,9,3,0,6,3
38275,8,44,13,0,31,13
38275,7,125,33,0,92,33
38275,6,148,35,0,113,35
38275,5,57,11,0,46,11
38275,4,22,4,0,18,4
38275,3,9,4,0,5,4
38275,2,5,1,0,4,1
13972,8,16,1,0,15,1
13972,7,72,8,0,64,8
13972,6,168,19,0,149,19
13972,5,77,9,0,68,9
13972,4,49,7,0,42,7
13972,3,28,4,0,24,4
13972,2,10,1,0,9,1
35634,9,10,3,0,7,3
35634,8,56,14,0,42,14
35634,7,129,28,0,101,28
35634,6,136,32,0,104,32
35634,5,46,13,0,33,13
35634,4,31,6,0,25,6
35634,3,9,5,0,4,5
35634,2,5,3,0,2,3
4928,10,15,3,0,12,3
4928,9,17,6,0,11,6
4928,8,44,9,0,35,9
4928,7,89,27,0,62,27
4928,6,139,33,0,106,33
4928,5,76,16,0,60,16
4928,4,32,6,0,26,6
4928,3,8,3,0,5,3
4928,2,2,1,0,1,1
4928,1,1,1,0,0,1
271,10,1,1,0,0,1
271,9,8,3,0,5,3
271,8,32,15,0,17,15
271,7,101,40,0,61,40
271,6,149,52,0,97,52
271,5,74,20,0,54,20
271,4,39,13,0,26,13
271,3,13,6,0,7,6
271,2,5,2,0,3,2
145501,10,4,1,0,3,1
145501,9,9,2,0,7,2
145501,8,42,5,0,37,5
145501,7,107,19,0,88,19
145501,6,165,18,0,147,18
145501,5,55,10,0,45,10
145501,4,31,9,0,22,9
145501,3,9,1,0,8,1
178147,10,25,2,0,23,2
178147,9,22,4,0,18,4
178147,8,55,6,0,49,6
178147,7,108,7,0,101,7
178147,6,118,20,0,98,20
178147,5,57,7,0,50,7
178147,4,22,2,0,20,2
178147,3,10,2,0,8,2
178147,2,4,2,0,2,2
178147,1,1,1,0,0,1
4532,10,10,4,0,6,4
4532,9,6,3,0,3,3
4532,8,61,18,0,43,18
4532,7,103,25,0,78,25
4532,6,144,35,0,109,35
4532,5,53,11,0,42,11
4532,4,21,11,0,10,11
4532,3,16,8,0,8,8
4532,2,3,1,0,2,1
4532,1,6,2,0,4,2
3921,10,4,1,0,3,1
3921,9,2,2,0,0,2
3921,8,30,11,0,19,11
3921,7,74,24,0,50,24
3921,6,153,58,0,95,58
3921,5,91,28,0,63,28
3921,4,40,10,0,30,10
3921,3,19,8,0,11,8
3921,2,10,3,0,7,3
2998,10,23,9,0,14,9
2998,9,39,16,0,23,16
2998,8,128,27,0,101,27
2998,7,127,27,0,100,27
2998,6,69,21,0,48,21
2998,5,23,12,0,11,12
2998,4,11,3,0,8,3
2998,3,4,3,0,1,3
179350,10,8,2,0,6,2
179350,9,19,5,0,14,5
179350,8,101,19,0,82,19
179350,7,118,22,0,96,22
179350,6,114,20,0,94,20
179350,5,40,7,0,33,7
179350,4,11,3,0,8,3
179350,3,9,2,0,7,2
2150,10,12,3,0,9,3
2150,9,25,12,0,13,12
2150,8,100,45,0,55,45
2150,7,137,42,0,95,42
2150,6,100,29,0,71,29
2150,5,29,11,0,18,11
2150,4,8,2,0,6,2
2150,3,7,4,0,3,4
2150,1,1,1,0,0,1
230059,10,10,3,0,7,3
230059,9,15,1,0,14,1
230059,8,93,12,0,81,12
230059,7,131,21,0,110,21
230059,6,108,19,0,89,19
230059,5,34,6,0,28,6
230059,4,24,1,0,23,1
230059,3,5,1,0,4,1
230059,2,3,1,0,2,1
230059,1,2,1,0,1,1
22019,10,3,1,0,2,1
22019,9,7,2,0,5,2
22019,8,37,19,0,18,19
22019,7,55,16,0,39,16
22019,6,120,36,0,84,36
22019,5,81,20,0,61,20
22019,4,48,19,0,29,19
22019,3,31,14,0,17,14
22019,2,23,12,0,11,12
22019,1,17,4,0,13,4
159692,10,58,19,0,39,19
159692,9,91,24,0,67,24
159692,8,171,41,0,130,41
159692,7,54,15,0,39,15
159692,6,28,7,0,21,7
159692,5,12,5,0,7,5
159692,4,6,2,0,4,2
159692,2,2,1,0,1,1
73313,10,9,5,0,4,5
73313,9,23,9,0,14,9
73313,8,97,29,0,68,29
73313,7,129,36,0,93,36
73313,6,122,34,0,88,34
73313,5,25,3,0,22,3
73313,4,12,2,0,10,2
73313,3,4,2,0,2,2
149896,10,36,7,0,29,7
149896,9,52,13,1,39,12
149896,8,98,18,0,80,18
149896,7,84,11,1,73,10
149896,6,77,11,0,66,11
149896,5,34,10,0,24,10
149896,4,16,4,0,12,4
149896,3,12,6,0,6,6
149896,2,3,2,0,1,2
149896,1,9,6,2,3,4
37739,10,4,1,0,3,1
37739,9,4,1,0,3,1
37739,8,51,9,0,42,9
37739,7,116,28,0,88,28
37739,6,147,38,0,109,38
37739,5,53,14,0,39,14
37739,4,19,6,0,13,6
37739,3,14,4,0,10,4
37739,2,11,6,0,5,6
159143,9,6,3,0,3,3
159143,8,48,11,0,37,11
159143,7,136,23,1,113,22
159143,6,166,20,0,146,20
159143,5,41,4,0,37,4
159143,4,15,3,0,12,3
140271,9,4,1,0,3,1
140271,8,27,8,0,19,8
140271,7,60,12,0,48,12
140271,6,155,41,0,114,41
140271,5,85,14,0,71,14
140271,4,51,11,0,40,11
140271,3,25,8,0,17,8
140271,1,7,3,0,4,3
988,9,14,4,0,10,4
988,8,43,9,0,34,9
988,7,95,27,0,68,27
988,6,149,29,0,120,29
988,5,73,17,0,56,17
988,4,29,8,0,21,8
988,3,11,6,0,5,6
3893,10,19,4,0,15,4
3893,9,51,15,0,36,15
3893,8,119,30,0,89,30
3893,7,121,32,0,89,32
3893,6,75,20,0,55,20
3893,5,21,5,0,16,5
3893,4,7,4,0,3,4
3893,3,4,1,0,3,1
3893,2,2,2,0,0,2
2127,10,20,3,0,17,3
2127,9,7,3,0,4,3
2127,8,35,10,0,25,10
2127,7,52,13,0,39,13
2127,6,105,31,0,74,31
2127,5,87,23,0,64,23
2127,4,64,18,0,46,18
2127,3,28,9,0,19,9
2127,2,18,9,0,9,9
2127,1,4,2,0,2,2
121764,10,9,2,0,7,2
121764,9,13,6,1,7,5
121764,8,73,28,0,45,28
121764,7,118,33,1,85,32
121764,6,125,27,1,98,26
121764,5,44,11,0,33,11
121764,4,18,8,0,10,8
121764,3,15,3,0,12,3
121764,2,5,4,0,1,4
94734,10,8,1,0,7,1
94734,9,9,3,0,6,3
94734,8,48,5,0,43,5
94734,7,70,9,0,61,9
94734,6,148,23,0,125,23
94734,5,89,20,0,69,20
94734,4,28,6,0,22,6
94734,3,18,6,0,12,6
94734,2,1,1,0,0,1
159209,9,15,4,0,11,4
159209,8,57,13,0,44,13
159209,7,114,26,0,88,26
159209,6,124,25,0,99,25
159209,5,55,14,0,41,14
159209,4,35,7,0,28,7
159209,3,16,6,0,10,6
159209,2,3,1,0,2,1
130390,10,12,3,0,9,3
130390,9,41,8,0,33,8
130390,8,152,29,1,123,28
130390,7,119,25,0,94,25
130390,6,69,21,0,48,21
130390,5,14,5,0,9,5
130390,4,7,2,0,5,2
130390,3,4,1,0,3,1
1439,10,4,1,0,3,1
1439,9,4,3,0,1,3
1439,8,19,8,0,11,8
1439,7,38,15,0,23,15
1439,6,128,41,0,87,41
1439,5,105,32,0,73,32
1439,4,74,26,0,48,26
1439,3,35,6,0,29,6
1439,2,12,6,0,6,6
148271,9,28,2,0,26,2
148271,8,147,23,0,124,23
148271,7,124,15,0,109,15
148271,6,79,10,0,69,10
148271,5,24,4,0,20,4
148271,4,5,1,0,4,1
154428,10,22,5,0,17,5
154428,9,35,6,0,29,6
154428,8,116,27,1,89,26
154428,7,124,21,2,103,19
154428,6,80,19,2,61,17
154428,5,26,4,0,22,4
154428,4,11,4,0,7,4
154428,3,4,2,0,2,2
154428,1,1,1,0,0,1
162152,9,9,3,0,6,3
162152,8,49,12,0,37,12
162152,7,108,20,0,88,20
162152,6,144,30,0,114,30
162152,5,62,14,0,48,14
162152,4,25,5,0,20,5
162152,2,5,3,0,2,3
152847,10,7,2,0,5,2
152847,9,13,4,0,9,4
152847,8,66,10,0,56,10
152847,7,106,17,0,89,17
152847,6,144,22,0,122,22
152847,5,52,5,0,47,5
152847,4,19,1,0,18,1
152847,3,8,4,0,4,4
152847,2,4,1,0,3,1
72766,8,32,8,0,24,8
72766,7,69,13,0,56,13
72766,6,151,29,0,122,29
72766,5,73,18,0,55,18
72766,4,51,11,0,40,11
72766,3,16,4,0,12,4
72766,2,17,4,0,13,4
72766,1,7,1,0,6,1
24224,8,8,3,0,5,3
24224,7,34,9,0,25,9
24224,6,127,32,0,95,32
24224,5,110,27,0,83,27
24224,4,63,20,0,43,20
24224,3,52,17,0,35,17
24224,2,18,8,0,10,8
24224,1,6,1,0,5,1
6508,9,8,1,0,7,1
6508,8,57,23,0,34,23
6508,7,119,26,0,93,26
6508,6,141,38,0,103,38
6508,5,65,18,0,47,18
6508,4,16,6,0,10,6
6508,3,6,4,0,2,4
6508,2,3,2,0,1,2
2608,10,4,3,0,1,3
2608,9,10,6,0,4,6
2608,8,52,19,0,33,19
2608,7,68,28,0,40,28
2608,6,145,45,0,100,45
2608,5,85,34,0,51,34
2608,4,41,20,0,21,20
2608,3,12,5,0,7,5
86156,10,8,1,0,7,1
86156,9,33,9,0,24,9
86156,8,86,22,0,64,22
86156,7,118,25,0,93,25
86156,6,102,23,0,79,23
86156,5,44,7,0,37,7
86156,4,16,2,0,14,2
86156,3,8,3,0,5,3
86156,2,3,1,0,2,1
1692,10,5,3,0,2,3
1692,9,6,2,0,4,2
1692,8,25,10,0,15,10
1692,7,46,13,0,33,13
1692,6,112,39,0,73,39
1692,5,86,31,0,55,31
1692,4,86,35,0,51,35
1692,3,30,9,0,21,9
1692,2,15,4,0,11,4
1692,1,7,1,0,6,1
686,10,11,2,0,9,2
686,9,21,9,0,12,9
686,8,101,36,0,65,36
686,7,115,35,0,80,35
686,6,111,25,0,86,25
686,5,33,16,0,17,16
686,4,16,5,0,11,5
686,3,4,1,0,3,1
686,2,5,3,0,2,3
686,1,1,1,0,0,1
217362,9,6,2,0,4,2
217362,8,92,15,0,77,15
217362,7,140,26,0,114,26
217362,6,118,19,0,99,19
217362,5,36,6,0,30,6
217362,4,14,2,0,12,2
217362,3,6,1,0,5,1
217362,2,1,1,0,0,1
217362,1,1,1,0,0,1
1678,10,12,4,0,8,4
1678,9,32,11,0,21,11
1678,8,86,29,0,57,29
1678,7,104,28,0,76,28
1678,6,115,25,0,90,25
1678,5,39,9,0,30,9
1678,4,18,6,0,12,6
1678,2,3,3,0,0,3
719,10,5,3,0,2,3
719,9,12,5,0,7,5
719,8,66,16,0,50,16
719,7,134,37,0,97,37
719,6,115,37,0,78,37
719,5,58,16,0,42,16
719,4,22,11,0,11,11
719,3,4,2,0,2,2
218208,10,11,4,0,7,4
218208,9,32,7,0,25,7
218208,8,106,14,0,92,14
218208,7,152,19,0,133,19
218208,6,87,13,0,74,13
218208,5,19,3,0,16,3
218208,4,10,1,0,9,1
218208,2,1,1,0,0,1
166202,9,7,2,0,5,2
166202,8,64,17,0,47,17
166202,7,127,22,1,105,21
166202,6,150,24,1,126,23
166202,5,37,7,1,30,6
166202,4,18,5,0,13,5
166202,3,5,1,0,4,1
12875,10,8,3,0,5,3
12875,9,13,2,0,11,2
12875,8,38,8,0,30,8
12875,7,88,14,0,74,14
12875,6,153,35,0,118,35
12875,5,60,19,0,41,19
12875,4,37,9,0,28,9
12875,3,8,3,0,5,3
12875,2,10,1,0,9,1
24771,8,34,9,0,25,9
24771,7,112,31,0,81,31
24771,6,162,36,0,126,36
24771,5,60,15,0,45,15
24771,4,31,10,0,21,10
24771,3,15,5,0,10,5
195237,10,8,2,1,6,1
195237,9,22,4,0,18,4
195237,8,85,13,2,72,11
195237,7,123,17,0,106,17
195237,6,105,20,3,85,17
195237,5,34,9,1,25,8
195237,4,22,4,1,18,3
195237,3,10,4,0,6,4
195237,2,6,2,0,4,2
13123,10,28,11,0,17,11
13123,9,29,11,0,18,11
13123,8,107,43,0,64,43
13123,7,82,34,0,48,34
13123,6,96,38,0,58,38
13123,5,43,12,0,31,12
13123,4,20,6,0,14,6
13123,2,5,1,0,4,1
139629,9,7,1,0,6,1
139629,8,51,15,0,36,15
139629,7,90,17,0,73,17
139629,6,151,36,0,115,36
139629,5,59,15,0,44,15
139629,4,27,5,0,22,5
139629,3,15,4,0,11,4
139629,2,13,4,0,9,4
139629,1,4,3,0,1,3
1498,10,35,20,0,15,20
1498,9,38,22,0,16,22
1498,8,64,27,0,37,27
1498,7,100,34,0,66,34
1498,6,104,27,0,77,27
1498,5,50,18,0,32,18
1498,4,13,8,0,5,8
1498,3,7,2,0,5,2
1498,2,4,1,0,3,1
19187,10,6,2,0,4,2
19187,9,12,1,0,11,1
19187,8,60,13,0,47,13
19187,7,117,15,0,102,15
19187,6,125,17,0,108,17
19187,5,61,6,0,55,6
19187,4,19,4,0,15,4
19187,3,12,5,0,7,5
19187,2,2,2,0,0,2
25242,10,4,1,0,3,1
25242,9,5,2,0,3,2
25242,8,34,8,0,26,8
25242,7,89,19,0,70,19
25242,6,162,38,0,124,38
25242,5,70,20,0,50,20
25242,4,30,11,0,19,11
25242,3,16,8,0,8,8
25242,2,4,3,0,1,3
30641,10,2,1,0,1,1
30641,9,6,2,0,4,2
30641,8,56,7,0,49,7
30641,7,128,36,0,92,36
30641,6,155,33,0,122,33
30641,5,45,6,0,39,6
30641,4,15,2,0,13,2
30641,3,4,1,0,3,1
30641,2,1,1,0,0,1
30641,1,2,1,0,1,1
950,10,3,3,0,0,3
950,9,23,12,0,11,12
950,8,77,38,0,39,38
950,7,113,38,0,75,38
950,6,133,50,0,83,50
950,5,34,11,0,23,11
950,4,20,9,0,11,9
950,3,10,6,0,4,6
950,2,1,1,0,0,1
950,1,1,1,0,0,1
105199,8,39,11,0,28,11
105199,7,96,16,0,80,16
105199,6,161,34,0,127,34
105199,5,68,15,0,53,15
105199,4,30,8,0,22,8
105199,3,12,4,0,8,4
30379,9,6,3,0,3,3
30379,8,18,7,0,11,7
30379,7,57,19,0,38,19
30379,6,137,27,0,110,27
30379,5,87,25,0,62,25
30379,4,55,13,0,42,13
30379,3,38,20,0,18,20
30379,2,11,5,0,6,5
30379,1,5,2,0,3,2
25213,10,5,2,0,3,2
25213,9,16,4,0,12,4
25213,8,101,17,0,84,17
25213,7,123,19,0,104,19
25213,6,105,18,0,87,18
25213,5,38,4,0,34,4
25213,4,17,4,0,13,4
25213,3,5,1,0,4,1
25213,2,5,1,0,4,1
25213,1,1,1,0,0,1
145601,10,7,4,0,3,4
145601,9,22,4,0,18,4
145601,8,138,17,0,121,17
145601,7,101,15,0,86,15
145601,6,97,26,0,71,26
145601,5,30,4,0,26,4
145601,4,13,5,0,8,5
145601,3,6,3,0,3,3
1602,10,10,1,0,9,1
1602,9,9,4,0,5,4
1602,8,21,6,0,15,6
1602,7,60,18,0,42,18
1602,6,138,35,0,103,35
1602,5,91,23,0,68,23
1602,4,51,11,0,40,11
1602,3,18,6,0,12,6
1602,2,12,5,0,7,5
1602,1,4,3,0,1,3
34871,9,17,5,0,12,5
34871,8,86,10,0,76,10
34871,7,101,11,0,90,11
34871,6,105,18,0,87,18
34871,5,54,9,0,45,9
34871,4,29,5,0,24,5
34871,3,9,1,0,8,1
34871,2,3,1,0,2,1
644,9,5,2,0,3,2
644,8,21,5,0,16,5
644,7,77,19,0,58,19
644,6,162,57,0,105,57
644,5,81,24,0,57,24
644,4,36,12,0,24,12
644,3,19,10,0,9,10
644,2,9,4,0,5,4
644,1,4,2,0,2,2
175360,10,27,12,0,15,12
175360,9,61,23,0,38,23
175360,8,145,46,0,99,46
175360,7,99,27,0,72,27
175360,6,50,27,0,23,27
175360,5,20,8,0,12,8
175360,4,6,4,0,2,4
175360,3,5,2,0,3,2
119866,10,72,23,0,49,23
119866,9,74,22,0,52,22
119866,8,130,22,0,108,22
119866,7,87,17,0,70,17
119866,6,38,6,0,32,6
119866,5,8,1,0,7,1
119866,4,3,1,0,2,1
210040,10,52,15,3,37,12
210040,9,61,19,3,42,16
210040,8,119,18,1,101,17
210040,7,80,13,0,67,13
210040,6,63,15,0,48,15
210040,5,14,3,0,11,3
210040,4,11,3,0,8,3
210040,3,4,3,0,1,3
210040,2,5,2,0,3,2
210040,1,5,1,0,4,1
4845,9,5,3,0,2,3
4845,8,18,3,0,15,3
4845,7,34,10,0,24,10
4845,6,63,22,0,41,22
4845,5,107,32,0,75,32
4845,4,98,34,0,64,34
4845,3,51,21,0,30,21
4845,2,25,8,0,17,8
4845,1,10,3,0,7,3
90474,9,8,1,0,7,1
90474,8,78,21,0,57,21
90474,7,96,19,0,77,19
90474,6,159,42,0,117,42
90474,5,42,8,0,34,8
90474,4,20,2,0,18,2
90474,3,5,1,0,4,1
90474,1,1,1,0,0,1
3320,10,2,1,0,1,1
3320,9,6,1,0,5,1
3320,8,23,3,0,20,3
3320,7,43,11,0,32,11
3320,6,137,35,0,102,35
3320,5,84,26,0,58,26
3320,4,63,23,0,40,23
3320,3,31,9,0,22,9
3320,2,21,8,0,13,8
3320,1,3,2,0,1,2
172662,10,4,1,0,3,1
172662,9,12,3,0,9,3
172662,8,62,9,2,53,7
172662,7,108,27,2,81,25
172662,6,134,18,0,116,18
172662,5,56,13,0,43,13
172662,4,22,2,0,20,2
172662,3,12,3,1,9,2
118337,8,62,14,2,48,12
118337,7,108,19,2,89,17
118337,6,142,24,4,118,20
118337,5,52,13,0,39,13
118337,4,22,8,0,14,8
118337,3,12,1,1,11,0
118337,2,7,4,0,3,4
180591,9,13,5,0,8,5
180591,8,64,12,0,52,12
180591,7,140,17,0,123,17
180591,6,138,28,0,110,28
180591,5,42,8,0,34,8
180591,3,5,1,0,4,1
180591,1,1,1,0,0,1
35438,10,16,6,0,10,6
35438,9,9,5,0,4,5
35438,8,68,17,0,51,17
35438,7,99,32,0,67,32
35438,6,121,27,0,94,27
35438,5,41,11,0,30,11
35438,4,35,10,0,25,10
35438,3,11,3,0,8,3
35438,2,11,4,0,7,4
35438,1,2,2,0,0,2
119193,9,3,1,0,2,1
119193,8,20,7,0,13,7
119193,7,56,9,0,47,9
119193,6,175,37,0,138,37
119193,5,89,15,0,74,15
119193,4,47,19,0,28,19
119193,3,14,5,0,9,5
119193,2,7,3,0,4,3
119193,1,2,1,0,1,1
201186,10,47,21,1,26,20
201186,9,55,17,1,38,16
201186,8,116,20,2,96,18
201186,7,99,14,0,85,14
201186,6,48,5,0,43,5
201186,5,16,4,0,12,4
201186,4,15,4,0,11,4
201186,3,11,3,0,8,3
201186,2,5,2,0,3,2
40234,9,4,1,0,3,1
40234,8,42,12,0,30,12
40234,7,125,32,0,93,32
40234,6,165,35,0,130,35
40234,5,49,13,0,36,13
40234,4,17,6,0,11,6
40234,3,7,2,0,5,2
156719,10,3,1,0,2,1
156719,9,6,2,0,4,2
156719,8,45,12,0,33,12
156719,7,88,11,0,77,11
156719,6,174,18,0,156,18
156719,5,51,7,0,44,7
156719,4,35,6,0,29,6
156719,3,9,4,0,5,4
8633,10,3,1,0,2,1
8633,9,9,1,0,8,1
8633,8,17,3,0,14,3
8633,7,51,6,0,45,6
8633,6,99,23,0,76,23
8633,5,96,13,0,83,13
8633,4,68,15,0,53,15
8633,3,43,11,0,32,11
8633,2,21,5,0,16,5
8633,1,5,1,0,4,1
169274,10,32,6,0,26,6
169274,9,57,15,3,42,12
169274,8,129,17,1,112,16
169274,7,107,21,1,86,20
169274,6,57,12,0,45,12
169274,5,18,3,0,15,3
169274,4,8,1,0,7,1
169274,3,2,1,0,1,1
169274,1,1,1,0,0,1
145219,10,17,4,0,13,4
145219,9,33,2,0,31,2
145219,8,102,19,0,83,19
145219,7,70,13,0,57,13
145219,6,88,22,0,66,22
145219,5,54,15,0,39,15
145219,4,30,10,0,20,10
145219,3,11,2,0,9,2
145219,2,6,2,0,4,2
145219,1,2,1,0,1,1
3605,10,56,31,0,25,31
3605,9,70,20,0,50,20
3605,8,128,36,0,92,36
3605,7,85,21,0,64,21
3605,6,50,8,0,42,8
3605,5,13,2,0,11,2
3605,2,1,1,0,0,1
3605,1,5,1,0,4,1
1720,10,26,13,0,13,13
1720,9,31,10,0,21,10
1720,8,74,21,0,53,21
1720,7,113,36,0,77,36
1720,6,97,26,0,71,26
1720,5,39,11,0,28,11
1720,4,23,4,0,19,4
1720,3,6,3,0,3,3
1720,2,2,1,0,1,1
1720,1,1,1,0,0,1
154892,10,8,4,0,4,4
154892,9,19,3,0,16,3
154892,8,65,8,0,57,8
154892,7,96,10,0,86,10
154892,6,136,20,0,116,20
154892,5,42,7,0,35,7
154892,4,22,5,0,17,5
154892,3,19,6,0,13,6
154892,2,4,1,0,3,1
135888,10,6,2,0,4,2
135888,9,9,1,0,8,1
135888,8,57,13,0,44,13
135888,7,97,10,0,87,10
135888,6,139,23,0,116,23
135888,5,56,11,0,45,11
135888,4,33,8,0,25,8
135888,3,8,1,0,7,1
135888,2,6,3,0,3,3
27766,10,4,1,0,3,1
27766,9,11,2,0,9,2
27766,8,61,16,0,45,16
27766,7,113,18,0,95,18
27766,6,142,17,0,125,17
27766,5,45,10,0,35,10
27766,4,25,3,0,22,3
27766,3,5,1,0,4,1
82955,8,63,13,0,50,13
82955,7,125,36,0,89,36
82955,6,144,30,0,114,30
82955,5,33,8,0,25,8
82955,4,17,9,0,8,9
82955,3,6,2,0,4,2
82955,2,5,4,0,1,4
82955,1,1,1,0,0,1
2087,9,9,1,0,8,1
2087,8,38,6,0,32,6
2087,7,75,15,0,60,15
2087,6,138,28,0,110,28
2087,5,81,12,0,69,12
2087,4,41,8,0,33,8
2087,3,19,3,0,16,3
2087,2,7,3,0,4,3
169341,10,7,3,0,4,3
169341,9,15,7,0,8,7
169341,8,94,28,1,66,27
169341,7,123,26,2,97,24
169341,6,122,26,0,96,26
169341,5,36,10,0,26,10
169341,4,10,2,0,8,2
169341,3,4,1,0,3,1
181404,9,14,3,0,11,3
181404,8,56,7,0,49,7
181404,7,118,11,0,107,11
181404,6,118,16,0,102,16
181404,5,59,4,0,55,4
181404,4,23,7,0,16,7
181404,3,12,2,0,10,2
181404,2,5,2,0,3,2
181404,1,3,2,0,1,2
2781,9,5,1,0,4,1
2781,8,22,11,0,11,11
2781,7,70,28,0,42,28
2781,6,157,56,0,101,56
2781,5,97,41,0,56,41
2781,4,35,13,0,22,13
2781,3,15,6,0,9,6
2781,2,7,4,0,3,4
2781,1,2,1,0,1,1
8039,10,3,2,0,1,2
8039,8,22,4,0,18,4
8039,7,45,10,0,35,10
8039,6,102,20,0,82,20
8039,5,100,20,0,80,20
8039,4,58,16,0,42,16
8039,3,34,12,0,22,12
8039,2,32,12,0,20,12
8039,1,12,4,0,8,4
160814,10,10,1,0,9,1
160814,9,6,1,0,5,1
160814,8,38,5,0,33,5
160814,7,72,7,0,65,7
160814,6,141,23,0,118,23
160814,5,75,7,0,68,7
160814,4,47,6,0,41,6
160814,2,10,3,0,7,3
150484,10,52,20,2,32,18
150484,9,52,11,2,41,9
150484,8,117,28,4,89,24
150484,7,73,12,1,61,11
150484,6,62,14,3,48,11
150484,5,23,3,0,20,3
150484,4,16,11,1,5,10
150484,3,9,5,0,4,5
150484,2,6,5,0,1,5
3475,10,50,22,0,28,22
3475,9,33,10,0,23,10
3475,8,96,35,0,61,35
3475,7,85,25,0,60,25
3475,6,81,19,0,62,19
3475,5,28,11,0,17,11
3475,4,26,7,0,19,7
3475,3,7,2,0,5,2
3475,1,4,2,0,2,2
83040,10,41,14,0,27,14
83040,9,65,8,0,57,8
83040,8,147,36,0,111,36
83040,7,86,18,0,68,18
83040,6,54,10,0,44,10
83040,5,10,2,0,8,2
83040,4,2,1,0,1,1
83040,3,2,2,0,0,2
83040,1,2,1,0,1,1
9297,9,2,1,0,1,1
9297,8,34,10,0,24,10
9297,7,71,19,0,52,19
9297,6,178,52,0,126,52
9297,5,72,17,0,55,17
9297,4,32,9,0,23,9
9297,3,14,5,0,9,5
9297,2,7,4,0,3,4
208766,9,30,6,0,24,6
208766,8,92,7,0,85,7
208766,7,130,13,0,117,13
208766,6,113,16,0,97,16
208766,5,27,3,0,24,3
208766,3,5,3,0,2,3
208766,2,3,2,0,1,2
208766,1,1,1,0,0,1
131682,10,10,3,0,7,3
131682,9,31,10,1,21,9
131682,8,132,27,4,105,23
131682,7,95,8,0,87,8
131682,6,92,22,5,70,17
131682,5,25,5,0,20,5
131682,4,12,4,0,8,4
131682,3,9,4,1,5,3
131682,2,4,2,0,2,2
209660,10,42,7,0,35,7
209660,9,76,17,2,59,15
209660,8,152,35,3,117,32
209660,7,63,8,0,55,8
209660,6,46,15,1,31,14
209660,5,19,10,0,9,10
209660,4,7,1,0,6,1
209660,2,3,1,0,2,1
209660,1,1,1,0,0,1
147451,9,21,6,0,15,6
147451,8,85,30,0,55,30
147451,7,119,27,0,92,27
147451,6,120,29,0,91,29
147451,5,36,10,0,26,10
147451,4,16,2,0,14,2
147451,3,6,1,0,5,1
147451,2,2,2,0,0,2
103184,10,5,2,0,3,2
103184,9,9,3,0,6,3
103184,8,78,18,0,60,18
103184,7,115,21,0,94,21
103184,6,135,24,0,111,24
103184,5,45,15,0,30,15
103184,4,14,6,0,8,6
103184,3,4,2,0,2,2
103184,2,3,1,0,2,1
87,10,7,3,0,4,3
87,9,18,11,0,7,11
87,8,62,24,0,38,24
87,7,105,32,1,73,31
87,6,126,40,0,86,40
87,5,41,18,0,23,18
87,4,30,18,0,12,18
87,3,10,7,0,3,7
87,2,6,3,0,3,3
87,1,3,1,0,2,1
24627,10,2,2,0,0,2
24627,9,16,4,0,12,4
24627,8,32,9,0,23,9
24627,7,63,19,0,44,19
24627,6,104,34,0,70,34
24627,5,75,20,0,55,20
24627,4,62,23,0,39,23
24627,3,34,15,0,19,15
24627,2,10,5,0,5,5
24627,1,10,5,0,5,5
3567,10,2,1,0,1,1
3567,9,8,4,0,4,4
3567,8,39,13,0,26,13
3567,7,92,34,0,58,34
3567,6,161,60,0,101,60
3567,5,62,16,0,46,16
3567,4,32,12,0,20,12
3567,3,8,5,0,3,5
3567,2,3,1,0,2,1
193668,10,34,7,0,27,7
193668,9,47,9,0,38,9
193668,8,123,26,5,97,21
193668,7,92,17,2,75,15
193668,6,60,8,0,52,8
193668,5,17,9,0,8,9
193668,4,12,5,0,7,5
193668,3,11,5,1,6,4
193668,2,9,2,0,7,2
127493,10,59,12,0,47,12
127493,9,71,9,0,62,9
127493,8,131,23,0,108,23
127493,7,81,17,0,64,17
127493,6,32,6,0,26,6
127493,5,15,3,0,12,3
127493,4,10,4,0,6,4
127493,3,6,2,0,4,2
27658,10,18,5,0,13,5
27658,9,29,7,0,22,7
27658,8,96,21,0,75,21
27658,7,96,13,0,83,13
27658,6,105,15,0,90,15
27658,5,23,7,0,16,7
27658,4,16,6,0,10,6
27658,3,7,3,0,4,3
27658,1,11,2,0,9,2
9617,10,15,3,0,12,3
9617,9,14,2,0,12,2
9617,8,100,32,0,68,32
9617,7,131,32,0,99,32
9617,6,106,38,0,68,38
9617,5,26,10,0,16,10
9617,4,9,5,0,4,5
9617,3,1,1,0,0,1
9617,2,3,1,0,2,1
9617,1,1,1,0,0,1
210,10,3,2,0,1,2
210,9,10,6,0,4,6
210,8,41,8,0,33,8
210,7,95,20,0,75,20
210,6,155,37,0,118,37
210,5,76,11,0,65,11
210,4,20,6,0,14,6
210,3,5,1,0,4,1
1416,9,3,1,0,2,1
1416,8,41,12,0,29,12
1416,7,95,31,0,64,31
1416,6,153,41,0,112,41
1416,5,66,24,0,42,24
1416,4,35,14,0,21,14
1416,3,8,3,0,5,3
1416,2,3,2,0,1,2
223376,10,113,33,3,80,30
223376,9,117,24,3,93,21
223376,8,91,9,1,82,8
223376,7,41,7,0,34,7
223376,6,21,3,0,18,3
223376,5,10,2,0,8,2
223376,4,7,2,0,5,2
223376,3,4,2,0,2,2
223376,2,1,1,0,0,1
223376,1,5,1,1,4,0
143994,10,5,3,0,2,3
143994,9,15,4,0,11,4
143994,8,109,26,2,83,24
143994,7,115,31,2,84,29
143994,6,114,34,0,80,34
143994,5,33,10,0,23,10
143994,4,12,8,0,4,8
139508,10,9,2,0,7,2
139508,9,36,11,0,25,11
139508,8,97,20,0,77,20
139508,7,105,15,0,90,15
139508,6,95,14,0,81,14
139508,5,37,7,0,30,7
139508,4,17,7,0,10,7
139508,3,7,2,0,5,2
139508,2,2,1,0,1,1
139508,1,1,1,0,0,1
230889,10,102,30,0,72,30
230889,9,122,24,0,98,24
230889,8,110,15,0,95,15
230889,7,43,7,0,36,7
230889,6,23,2,0,21,2
230889,5,2,1,0,1,1
6554,9,8,5,0,3,5
6554,8,43,11,0,32,11
6554,7,94,35,0,59,35
6554,6,137,37,0,100,37
6554,5,75,27,0,48,27
6554,4,29,13,0,16,13
6554,3,12,5,0,7,5
6554,2,4,3,0,1,3
1669,10,7,3,0,4,3
1669,9,23,5,0,18,5
1669,8,74,38,0,36,38
1669,7,117,45,0,72,45
1669,6,113,28,0,85,28
1669,5,37,9,0,28,9
1669,4,18,4,0,14,4
1669,3,11,3,0,8,3
1669,2,4,2,0,2,2
18901,10,7,1,0,6,1
18901,9,7,3,0,4,3
18901,8,18,4,0,14,4
18901,7,36,7,0,29,7
18901,6,74,12,0,62,12
18901,5,101,18,0,83,18
18901,4,73,14,0,59,14
18901,3,48,10,0,38,10
18901,2,33,7,0,26,7
18901,1,8,2,0,6,2
216199,10,34,1,0,33,1
216199,9,56,3,0,53,3
216199,8,136,14,0,122,14
216199,7,108,13,0,95,13
216199,6,48,5,0,43,5
216199,5,12,2,0,10,2
216199,4,5,1,0,4,1
216199,2,2,1,0,1,1
181161,10,8,2,0,6,2
181161,9,22,4,0,18,4
181161,8,96,13,0,83,13
181161,7,108,11,0,97,11
181161,6,112,20,0,92,20
181161,5,37,2,0,35,2
181161,4,12,6,0,6,6
181161,2,1,1,0,0,1
181161,1,2,1,0,1,1
706,10,10,5,0,5,5
706,9,23,13,0,10,13
706,8,101,48,0,53,48
706,7,119,40,0,79,40
706,6,97,32,0,65,32
706,5,40,14,0,26,14
706,4,13,4,0,9,4
706,3,1,1,0,0,1
20609,10,27,8,0,19,8
20609,9,77,28,0,49,28
20609,8,131,39,0,92,39
20609,7,95,24,0,71,24
20609,6,46,7,0,39,7
20609,5,11,2,0,9,2
20609,4,10,4,0,6,4
20609,3,3,2,0,1,2
20609,2,2,1,0,1,1
1509,10,14,9,0,5,9
1509,9,10,4,0,6,4
1509,8,46,30,0,16,30
1509,7,90,30,0,60,30
1509,6,152,62,0,90,62
1509,5,52,17,0,35,17
1509,4,29,13,0,16,13
1509,3,8,3,0,5,3
1509,2,3,2,0,1,2
145186,10,3,1,0,2,1
145186,8,68,12,0,56,12
145186,7,106,14,0,92,14
145186,6,156,23,0,133,23
145186,5,37,6,0,31,6
145186,4,21,3,0,18,3
145186,3,5,1,0,4,1
3727,10,7,1,0,6,1
3727,9,15,6,0,9,6
3727,8,45,17,0,28,17
3727,7,46,14,0,32,14
3727,6,135,36,0,99,36
3727,5,74,23,0,51,23
3727,4,48,12,0,36,12
3727,3,18,3,0,15,3
3727,2,14,6,0,8,6
3727,1,3,2,0,1,2
911,10,28,10,0,18,10
911,9,47,15,0,32,15
911,8,105,31,0,74,31
911,7,97,29,0,68,29
911,6,73,29,0,44,29
911,5,32,9,0,23,9
911,4,14,9,0,5,9
911,3,4,2,0,2,2
911,2,3,1,0,2,1
911,1,2,1,0,1,1
2197,10,4,1,0,3,1
2197,8,13,3,0,10,3
2197,7,60,19,0,41,19
2197,6,117,37,0,80,37
2197,5,91,30,0,61,30
2197,4,63,22,0,41,22
2197,3,36,17,0,19,17
2197,2,11,7,0,4,7
2197,1,4,2,0,2,2
1533,10,3,1,0,2,1
1533,9,6,1,0,5,1
1533,8,41,18,0,23,18
1533,7,109,28,0,81,28
1533,6,158,49,0,109,49
1533,5,54,19,0,35,19
1533,4,25,9,0,16,9
1533,3,8,2,0,6,2
146158,9,7,2,0,5,2
146158,8,74,13,0,61,13
146158,7,123,33,0,90,33
146158,6,134,32,0,102,32
146158,5,45,11,0,34,11
146158,4,12,5,0,7,5
146158,3,4,2,0,2,2
146158,2,2,2,0,0,2
150298,10,7,1,0,6,1
150298,9,15,4,1,11,3
150298,8,69,19,1,50,18
150298,7,118,25,4,93,21
150298,6,143,28,0,115,28
150298,5,29,2,0,27,2
150298,4,12,2,0,10,2
150298,3,7,2,0,5,2
15410,10,2,1,0,1,1
15410,9,9,6,0,3,6
15410,8,33,14,0,19,14
15410,7,118,52,0,66,52
15410,6,153,51,0,102,51
15410,5,50,20,0,30,20
15410,4,29,14,0,15,14
15410,3,8,3,0,5,3
15410,2,1,1,0,0,1
52328,10,39,7,0,32,7
52328,9,60,13,0,47,13
52328,8,120,28,0,92,28
52328,7,102,18,0,84,18
52328,6,54,10,0,44,10
52328,5,17,3,0,14,3
52328,4,3,2,0,1,2
52328,3,4,1,0,3,1
6613,10,56,24,0,32,24
6613,9,84,35,0,49,35
6613,8,123,45,0,78,45
6613,7,77,22,0,55,22
6613,6,43,15,0,28,15
6613,5,12,5,0,7,5
6613,4,3,1,0,2,1
6613,3,3,1,0,2,1
6613,2,2,1,0,1,1
72482,9,6,2,0,4,2
72482,8,30,9,0,21,9
72482,7,80,20,0,60,20
72482,6,114,37,0,77,37
72482,5,70,20,0,50,20
72482,4,49,16,0,33,16
72482,3,27,10,0,17,10
72482,2,16,8,0,8,8
72482,1,8,3,0,5,3
161530,9,18,2,0,16,2
161530,8,114,14,0,100,14
161530,7,141,10,0,131,10
161530,6,79,18,0,61,18
161530,5,34,4,0,30,4
161530,4,7,3,0,4,3
161530,3,5,2,0,3,2
1520,10,7,1,0,6,1
1520,9,18,4,0,14,4
1520,8,57,18,1,39,17
1520,7,101,22,0,79,22
1520,6,124,35,0,89,35
1520,5,53,15,0,38,15
1520,4,20,8,0,12,8
1520,3,14,3,0,11,3
1520,2,7,2,0,5,2
56835,10,12,6,0,6,6
56835,9,9,2,0,7,2
56835,8,64,22,0,42,22
56835,7,74,26,1,48,25
56835,6,105,35,0,70,35
56835,5,61,21,0,40,21
56835,4,44,17,0,27,17
56835,3,21,5,0,16,5
56835,2,11,6,0,5,6
189062,9,23,2,0,21,2
189062,8,64,4,0,60,4
189062,7,76,7,0,69,7
189062,6,117,21,0,96,21
189062,5,53,8,0,45,8
189062,4,27,7,0,20,7
189062,3,24,7,0,17,7
189062,2,8,1,0,7,1
3040,10,18,4,0,14,4
3040,9,33,9,0,24,9
3040,8,63,22,0,41,22
3040,7,111,30,0,81,30
3040,6,107,30,0,77,30
3040,5,39,5,0,34,5
3040,4,17,7,0,10,7
3040,3,11,6,0,5,6
3040,2,3,2,0,1,2
1668,10,7,2,0,5,2
1668,9,14,2,0,12,2
1668,8,64,21,0,43,21
1668,7,101,32,0,69,32
1668,6,143,41,0,102,41
1668,5,38,13,0,25,13
1668,4,21,7,0,14,7
1668,3,11,4,0,7,4
14379,10,5,1,0,4,1
14379,8,26,5,0,21,5
14379,7,47,10,0,37,10
14379,6,125,31,0,94,31
14379,5,109,30,0,79,30
14379,4,59,20,0,39,20
14379,3,20,6,0,14,6
14379,2,7,1,0,6,1
14379,1,3,1,0,2,1
4907,10,1,1,0,0,1
4907,8,14,4,0,10,4
4907,7,31,11,0,20,11
4907,6,89,27,0,62,27
4907,5,105,28,0,77,28
4907,4,78,17,0,61,17
4907,3,44,16,0,28,16
4907,2,33,13,0,20,13
4907,1,6,1,0,5,1
173536,10,50,12,1,38,11
173536,9,63,16,0,47,16
173536,8,134,39,1,95,38
173536,7,73,14,0,59,14
173536,6,60,9,0,51,9
173536,5,15,2,1,13,1
173536,3,1,1,0,0,1
173536,1,3,1,0,2,1
138166,10,19,2,0,17,2
138166,9,36,5,0,31,5
138166,8,104,15,0,89,15
138166,7,107,9,0,98,9
138166,6,84,12,0,72,12
138166,5,21,4,0,17,4
138166,4,19,2,0,17,2
138166,3,4,1,0,3,1
138166,1,8,4,0,4,4
6866,10,98,24,0,74,24
6866,9,67,12,0,55,12
6866,8,103,20,0,83,20
6866,7,50,9,0,41,9
6866,6,47,17,0,30,17
6866,5,19,4,0,15,4
6866,4,10,2,0,8,2
6866,2,3,1,0,2,1
5122,10,8,4,0,4,4
5122,9,5,1,0,4,1
5122,8,31,10,0,21,10
5122,7,39,13,0,26,13
5122,6,84,27,0,57,27
5122,5,75,18,0,57,18
5122,4,74,25,0,49,25
5122,3,36,12,0,24,12
5122,2,34,12,0,22,12
5122,1,16,4,0,12,4
171492,9,8,2,0,6,2
171492,8,77,14,0,63,14
171492,7,117,18,0,99,18
171492,6,132,15,0,117,15
171492,5,39,8,0,31,8
171492,4,12,3,0,9,3
171492,3,9,2,0,7,2
171492,2,4,1,0,3,1
28609,10,7,2,0,5,2
28609,8,39,8,0,31,8
28609,7,63,10,0,53,10
28609,6,139,28,0,111,28
28609,5,74,11,0,63,11
28609,4,36,8,0,28,8
28609,3,20,5,0,15,5
28609,2,13,6,0,7,6
28609,1,7,4,0,3,4
162580,10,10,4,0,6,4
162580,9,14,4,0,10,4
162580,8,44,4,0,40,4
162580,7,92,18,0,74,18
162580,6,128,13,0,115,13
162580,5,50,8,0,42,8
162580,4,32,2,0,30,2
162580,3,22,2,0,20,2
181501,10,7,2,0,5,2
181501,9,23,10,0,13,10
181501,8,101,24,0,77,24
181501,7,127,26,0,101,26
181501,6,93,18,0,75,18
181501,5,21,3,0,18,3
181501,4,20,6,0,14,6
181501,3,4,2,0,2,2
181501,2,6,4,0,2,4
63,10,4,3,0,1,3
63,9,13,5,0,8,5
63,8,42,10,0,32,10
63,7,82,20,0,62,20
63,6,99,18,0,81,18
63,5,28,12,0,16,12
63,4,9,3,0,6,3
63,3,3,3,0,0,3
566,10,3,1,0,2,1
566,9,9,4,0,5,4
566,8,78,33,0,45,33
566,7,103,30,0,73,30
566,6,111,41,0,70,41
566,5,54,18,0,36,18
566,4,26,10,0,16,10
566,3,13,9,0,4,9
566,2,5,1,0,4,1
22861,9,5,4,0,1,4
22861,8,19,10,0,9,10
22861,7,32,11,0,21,11
22861,6,78,23,0,55,23
22861,5,107,35,0,72,35
22861,4,77,31,0,46,31
22861,3,46,21,0,25,21
22861,2,20,12,0,8,12
22861,1,12,9,0,3,9
330,10,9,6,0,3,6
330,9,6,2,0,4,2
330,8,65,27,0,38,27
330,7,120,37,0,83,37
330,6,127,37,0,90,37
330,5,43,10,0,33,10
330,4,14,6,0,8,6
330,3,8,4,0,4,4
330,2,6,3,0,3,3
13166,9,4,1,0,3,1
13166,8,8,2,0,6,2
13166,7,18,6,0,12,6
13166,6,66,23,0,43,23
13166,5,93,18,0,75,18
13166,4,102,35,0,67,35
13166,3,63,19,0,44,19
13166,2,30,7,0,23,7
13166,1,16,5,0,11,5
5306,10,7,6,0,1,6
5306,9,12,4,0,8,4
5306,8,62,32,0,30,32
5306,7,88,42,0,46,42
5306,6,143,58,0,85,58
5306,5,51,19,0,32,19
5306,4,26,11,0,15,11
5306,3,7,5,0,2,5
11096,10,7,3,0,4,3
11096,9,39,18,0,21,18
11096,8,137,76,0,61,76
11096,7,117,47,0,70,47
11096,6,66,23,0,43,23
11096,5,15,8,0,7,8
11096,4,11,5,0,6,5
11096,3,8,3,0,5,3
4688,10,41,13,0,28,13
4688,9,99,49,0,50,49
4688,8,145,55,0,90,55
4688,7,76,24,0,52,24
4688,6,29,9,0,20,9
4688,5,5,1,0,4,1
4688,4,5,1,0,4,1
12140,10,15,5,0,10,5
12140,9,46,16,0,30,16
12140,8,126,41,0,85,41
12140,7,126,26,0,100,26
12140,6,59,13,0,46,13
12140,5,17,8,0,9,8
12140,4,8,4,0,4,4
12140,3,2,1,0,1,1
12140,2,3,1,0,2,1
145842,9,7,1,0,6,1
145842,8,36,9,0,27,9
145842,7,63,9,0,54,9
145842,6,110,19,0,91,19
145842,5,84,14,0,70,14
145842,4,54,12,0,42,12
145842,3,27,9,0,18,9
145842,2,10,5,0,5,5
145842,1,6,2,0,4,2
9616,10,3,2,0,1,2
9616,8,29,10,0,19,10
9616,7,72,16,0,56,16
9616,6,171,34,0,137,34
9616,5,72,21,0,51,21
9616,4,28,2,0,26,2
9616,3,15,3,0,12,3
9616,2,2,1,0,1,1
9616,1,3,1,0,2,1
204505,10,36,4,1,32,3
204505,9,59,16,2,43,14
204505,8,152,29,10,123,19
204505,7,65,10,0,55,10
204505,6,55,12,1,43,11
204505,5,25,9,0,16,9
204505,4,12,6,1,6,5
204505,3,4,1,0,3,1
204505,2,2,1,0,1,1
99459,9,17,1,0,16,1
99459,8,66,6,0,60,6
99459,7,77,9,0,68,9
99459,6,140,25,0,115,25
99459,5,55,8,0,47,8
99459,4,21,5,0,16,5
99459,2,4,1,0,3,1
146579,10,2,2,0,0,2
146579,8,66,19,0,47,19
146579,7,128,34,0,94,34
146579,6,142,26,0,116,26
146579,5,30,9,0,21,9
146579,4,19,5,0,14,5
146579,3,4,1,0,3,1
146579,2,3,1,0,2,1
18064,10,5,3,0,2,3
18064,9,7,2,0,5,2
18064,8,37,12,0,25,12
18064,7,59,16,0,43,16
18064,6,128,36,0,92,36
18064,5,64,20,0,44,20
18064,4,33,17,0,16,17
18064,3,30,14,0,16,14
18064,2,26,12,0,14,12
18064,1,10,6,0,4,6
724,9,12,3,0,9,3
724,8,36,14,0,22,14
724,7,91,33,0,58,33
724,6,145,49,0,96,49
724,5,71,20,0,51,20
724,4,20,3,0,17,3
724,3,11,2,0,9,2
724,2,9,6,0,3,6
16162,10,2,2,0,0,2
16162,9,4,1,0,3,1
16162,8,67,30,0,37,30
16162,7,124,55,0,69,55
16162,6,149,65,0,84,65
16162,5,33,15,0,18,15
16162,4,15,10,0,5,10
16162,3,3,1,0,2,1
16162,2,1,1,0,0,1
16162,1,1,1,0,0,1
251890,10,10,3,0,7,3
251890,9,22,3,0,19,3
251890,8,148,20,0,128,20
251890,7,115,23,0,92,23
251890,6,78,15,0,63,15
251890,5,21,7,0,14,7
251890,4,6,1,0,5,1
251890,3,2,1,0,1,1
3404,9,4,1,0,3,1
3404,8,25,14,0,11,14
3404,7,74,35,0,39,35
3404,6,149,61,0,88,61
3404,5,81,34,0,47,34
3404,4,36,20,0,16,20
3404,3,18,8,0,10,8
3404,2,7,4,0,3,4
3404,1,1,1,0,0,1
227893,10,9,4,0,5,4
227893,9,11,5,0,6,5
227893,8,78,15,0,63,15
227893,7,134,20,0,114,20
227893,6,108,23,0,85,23
227893,5,42,9,0,33,9
227893,4,13,3,0,10,3
227893,2,4,1,0,3,1
33003,10,20,6,0,14,6
33003,9,60,25,0,35,25
33003,8,167,63,0,104,63
33003,7,98,23,0,75,23
33003,6,40,17,0,23,17
33003,5,11,8,0,3,8
33003,4,1,1,0,0,1
92776,10,16,8,0,8,8
92776,9,10,5,0,5,5
92776,8,40,10,0,30,10
92776,7,55,14,0,41,14
92776,6,101,14,0,87,14
92776,5,72,19,0,53,19
92776,4,34,14,0,20,14
92776,3,38,14,0,24,14
92776,2,25,10,0,15,10
92776,1,8,3,0,5,3
172032,8,14,3,1,11,2
172032,7,45,6,0,39,6
172032,6,143,31,0,112,31
172032,5,89,17,0,72,17
172032,4,61,13,2,48,11
172032,3,28,8,1,20,7
172032,2,10,2,0,8,2
172032,1,8,4,0,4,4
84838,10,77,30,2,47,28
84838,9,65,15,1,50,14
84838,8,99,25,2,74,23
84838,7,76,20,0,56,20
84838,6,47,6,0,41,6
84838,5,19,1,0,18,1
84838,4,7,2,0,5,2
84838,3,3,1,0,2,1
194286,10,16,3,0,13,3
194286,9,30,5,0,25,5
194286,8,111,22,4,89,18
194286,7,129,21,4,108,17
194286,6,71,18,2,53,16
194286,5,23,3,0,20,3
194286,4,13,5,0,8,5
194286,3,3,1,0,2,1
194286,2,4,2,0,2,2
178591,10,9,4,1,5,3
178591,9,30,14,2,16,12
178591,8,167,29,5,138,24
178591,7,107,27,0,80,27
178591,6,64,15,0,49,15
178591,5,17,4,0,13,4
178591,4,2,1,0,1,1
178591,3,2,1,0,1,1
178591,2,1,1,0,0,1
1408,10,2,1,0,1,1
1408,9,13,7,0,6,7
1408,8,35,16,0,19,16
1408,7,74,20,0,54,20
1408,6,124,39,0,85,39
1408,5,80,20,0,60,20
1408,4,44,20,0,24,20
1408,3,18,8,0,10,8
1408,2,5,3,0,2,3
58886,9,5,3,0,2,3
58886,8,51,9,0,42,9
58886,7,103,21,0,82,21
58886,6,133,29,0,104,29
58886,5,54,19,0,35,19
58886,4,32,10,0,22,10
58886,3,16,4,0,12,4
5546,9,4,2,0,2,2
5546,8,18,9,0,9,9
5546,7,31,14,0,17,14
5546,6,71,21,0,50,21
5546,5,87,30,0,57,30
5546,4,78,23,0,55,23
5546,3,64,21,0,43,21
5546,2,35,13,0,22,13
2047,9,5,1,0,4,1
2047,8,30,8,0,22,8
2047,7,56,11,0,45,11
2047,6,172,48,0,124,48
2047,5,70,19,0,51,19
2047,4,32,9,0,23,9
2047,3,15,8,0,7,8
2047,2,15,5,0,10,5
2047,1,3,2,0,1,2
84464,10,18,3,0,15,3
84464,9,15,2,0,13,2
84464,8,114,33,0,81,33
84464,7,119,19,0,100,19
84464,6,104,32,0,72,32
84464,5,15,7,0,8,7
84464,4,10,1,0,9,1
197178,10,4,1,0,3,1
197178,9,8,2,1,6,1
197178,8,52,13,0,39,13
197178,7,128,23,1,105,22
197178,6,145,25,1,120,24
197178,5,39,6,1,33,5
197178,4,16,6,1,10,5
197178,3,3,1,0,2,1
4493,10,7,3,0,4,3
4493,9,13,2,0,11,2
4493,8,72,16,0,56,16
4493,7,101,21,0,80,21
4493,6,118,24,0,94,24
4493,5,53,12,0,41,12
4493,4,24,8,0,16,8
4493,3,7,4,0,3,4
4493,2,3,1,0,2,1
178044,10,30,7,0,23,7
178044,9,36,9,0,27,9
178044,8,113,30,6,83,24
178044,7,110,15,0,95,15
178044,6,81,13,1,68,12
178044,5,16,1,0,15,1
178044,4,3,1,0,2,1
178044,3,4,2,0,2,2
178044,1,4,3,0,1,3
256606,10,14,4,0,10,4
256606,9,46,10,0,36,10
256606,8,147,23,0,124,23
256606,7,137,24,0,113,24
256606,6,44,8,0,36,8
256606,5,10,5,0,5,5
256606,4,4,2,0,2,2
166109,10,3,1,0,2,1
166109,9,11,2,0,9,2
166109,8,62,4,1,58,3
166109,7,88,15,1,73,14
166109,6,125,19,1,106,18
166109,5,60,6,0,54,6
166109,4,29,4,0,25,4
166109,3,15,1,0,14,1
166109,2,2,1,0,1,1
24070,10,19,9,0,10,9
24070,9,59,19,0,40,19
24070,8,148,44,0,104,44
24070,7,106,34,0,72,34
24070,6,43,17,0,26,17
24070,5,11,4,0,7,4
24070,4,5,2,0,3,2
24070,3,3,1,0,2,1
24070,2,2,1,0,1,1
562,10,4,2,0,2,2
562,9,7,2,0,5,2
562,8,68,19,0,49,19
562,7,115,23,0,92,23
562,6,125,36,0,89,36
562,5,52,8,0,44,8
562,4,18,9,0,9,9
562,3,7,1,0,6,1
562,1,1,1,0,0,1
5651,10,34,14,0,20,14
5651,9,45,15,0,30,15
5651,8,99,38,0,61,38
5651,7,87,34,0,53,34
5651,6,84,26,0,58,26
5651,5,28,9,0,19,9
5651,4,11,5,0,6,5
5651,3,2,1,0,1,1
5651,2,4,3,0,1,3
5651,1,3,1,0,2,1
130999,9,5,1,0,4,1
130999,8,37,7,0,30,7
130999,7,91,15,0,76,15
130999,6,158,20,0,138,20
130999,5,62,6,0,56,6
130999,4,31,6,0,25,6
130999,3,4,2,0,2,2
130999,2,3,1,0,2,1
130999,1,4,1,0,3,1
129395,9,6,2,0,4,2
129395,8,37,2,0,35,2
129395,7,83,14,0,69,14
129395,6,141,22,0,119,22
129395,5,66,8,0,58,8
129395,4,30,7,0,23,7
129395,3,16,4,0,12,4
129395,2,8,3,0,5,3
129395,1,7,2,0,5,2
137651,10,5,1,0,4,1
137651,9,22,6,0,16,6
137651,8,99,17,1,82,16
137651,7,107,21,2,86,19
137651,6,101,21,1,80,20
137651,5,34,11,1,23,10
137651,4,17,6,0,11,6
137651,3,6,2,0,4,2
137651,2,4,1,0,3,1
8232,9,6,1,0,5,1
8232,8,35,8,0,27,8
8232,7,100,25,0,75,25
8232,6,156,31,0,125,31
8232,5,58,12,0,46,12
8232,4,29,6,0,23,6
8232,3,9,2,0,7,2
8232,1,1,1,0,0,1
200834,9,21,4,0,17,4
200834,8,80,12,0,68,12
200834,7,110,14,0,96,14
200834,6,114,25,0,89,25
200834,5,35,11,0,24,11
200834,4,18,3,0,15,3
200834,3,12,5,0,7,5
33196,9,4,3,0,1,3
33196,8,44,14,0,30,14
33196,7,76,21,0,55,21
33196,6,139,58,0,81,58
33196,5,63,20,0,43,20
33196,4,34,10,0,24,10
33196,3,21,12,0,9,12
33196,2,11,2,0,9,2
250621,10,7,2,0,5,2
250621,9,62,8,0,54,8
250621,8,173,40,2,133,38
250621,7,100,26,1,74,25
250621,6,35,10,1,25,9
250621,5,10,3,1,7,2
250621,4,10,5,0,5,5
250621,3,2,2,0,0,2
250621,2,1,1,0,0,1
192185,10,8,2,0,6,2
192185,9,20,4,0,16,4
192185,8,94,15,0,79,15
192185,7,94,14,1,80,13
192185,6,133,20,0,113,20
192185,5,23,5,1,18,4
192185,4,15,1,0,14,1
192185,3,5,2,0,3,2
192185,2,4,1,0,3,1
192185,1,2,2,0,0,2
149130,9,8,2,0,6,2
149130,8,42,4,0,38,4
149130,7,98,14,0,84,14
149130,6,128,19,0,109,19
149130,5,66,9,0,57,9
149130,4,27,4,0,23,4
149130,3,11,5,0,6,5
149130,2,7,3,0,4,3
149130,1,2,1,0,1,1
256320,10,11,4,0,7,4
256320,9,20,4,0,16,4
256320,8,143,20,0,123,20
256320,7,139,10,0,129,10
256320,6,59,6,0,53,6
256320,5,14,4,0,10,4
256320,4,6,3,0,3,3
256320,3,3,2,0,1,2
6653,10,3,2,0,1,2
6653,9,13,3,0,10,3
6653,8,44,18,0,26,18
6653,7,66,23,0,43,23
6653,6,117,40,0,77,40
6653,5,65,22,0,43,22
6653,4,55,16,0,39,16
6653,3,16,6,0,10,6
6653,2,12,6,0,6,6
6653,1,5,1,0,4,1
182619,10,10,6,0,4,6
182619,9,26,8,0,18,8
182619,8,80,16,0,64,16
182619,7,103,28,0,75,28
182619,6,104,32,0,72,32
182619,5,38,8,0,30,8
182619,4,23,8,0,15,8
182619,3,7,4,0,3,4
182619,2,4,2,0,2,2
2975,10,8,5,0,3,5
2975,9,11,5,0,6,5
2975,8,43,15,0,28,15
2975,7,80,26,0,54,26
2975,6,116,39,0,77,39
2975,5,70,23,0,47,23
2975,4,32,12,0,20,12
2975,3,18,8,0,10,8
2975,2,10,8,0,2,8
2975,1,7,5,0,2,5
37738,9,10,3,0,7,3
37738,8,45,8,0,37,8
37738,7,92,30,0,62,30
37738,6,136,28,0,108,28
37738,5,56,15,0,41,15
37738,4,36,19,0,17,19
37738,3,13,3,0,10,3
37738,2,4,1,0,3,1
201455,10,19,2,0,17,2
201455,9,23,5,0,18,5
201455,8,103,22,0,81,22
201455,7,101,22,0,79,22
201455,6,96,22,0,74,22
201455,5,28,6,0,22,6
201455,4,15,5,0,10,5
201455,3,7,2,0,5,2
94732,10,8,1,0,7,1
94732,9,7,3,0,4,3
94732,8,34,3,0,31,3
94732,7,65,8,0,57,8
94732,6,152,16,0,136,16
94732,5,77,18,0,59,18
94732,4,34,14,0,20,14
94732,3,14,2,0,12,2
94732,2,3,1,0,2,1
15830,10,3,1,0,2,1
15830,9,8,1,0,7,1
15830,8,26,4,0,22,4
15830,7,52,9,0,43,9
15830,6,112,26,0,86,26
15830,5,91,16,0,75,16
15830,4,69,16,0,53,16
15830,3,23,8,0,15,8
15830,2,8,2,0,6,2
15830,1,2,1,0,1,1
25294,10,11,4,0,7,4
25294,9,23,12,0,11,12
25294,8,90,31,0,59,31
25294,7,112,29,0,83,29
25294,6,110,43,0,67,43
25294,5,33,9,0,24,9
25294,4,11,6,0,5,6
25294,3,5,2,0,3,2
28739,9,11,5,0,6,5
28739,8,74,25,0,49,25
28739,7,132,37,0,95,37
28739,6,106,42,0,64,42
28739,5,34,12,0,22,12
28739,4,17,5,0,12,5
28739,3,10,5,0,5,5
28739,2,2,1,0,1,1
2387,9,11,5,0,6,5
2387,8,20,6,0,14,6
2387,7,42,9,0,33,9
2387,6,107,33,0,74,33
2387,5,83,26,0,57,26
2387,4,62,17,0,45,17
2387,3,33,14,0,19,14
2387,2,26,14,0,12,14
2387,1,7,3,0,4,3
42050,10,7,1,0,6,1
42050,8,21,2,0,19,2
42050,7,21,1,0,20,1
42050,6,67,5,0,62,5
42050,5,85,5,0,80,5
42050,4,85,8,0,77,8
42050,3,51,4,0,47,4
42050,2,33,4,0,29,4
2816,10,3,2,0,1,2
2816,9,8,1,0,7,1
2816,8,21,10,0,11,10
2816,7,44,14,0,30,14
2816,6,113,32,0,81,32
2816,5,94,25,0,69,25
2816,4,49,17,0,32,17
2816,3,31,11,0,20,11
2816,2,15,5,0,10,5
2816,1,7,1,0,6,1
3093,10,12,4,0,8,4
3093,9,24,4,0,20,4
3093,8,55,11,0,44,11
3093,7,110,18,0,92,18
3093,6,115,23,0,92,23
3093,5,56,11,0,45,11
3093,2,2,1,0,1,1
1695,10,2,2,0,0,2
1695,9,20,10,0,10,10
1695,8,50,23,0,27,23
1695,7,96,38,0,58,38
1695,6,116,39,0,77,39
1695,5,60,12,0,48,12
1695,4,35,8,0,27,8
1695,3,8,1,0,7,1
10559,10,11,5,0,6,5
10559,9,12,4,0,8,4
10559,8,58,26,0,32,26
10559,7,79,41,0,38,41
10559,6,121,42,0,79,42
10559,5,53,22,0,31,22
10559,4,26,7,0,19,7
10559,3,16,9,0,7,9
10559,2,13,7,0,6,7
10559,1,4,3,0,1,3
9787,10,6,2,0,4,2
9787,9,9,4,0,5,4
9787,8,40,9,0,31,9
9787,7,63,11,0,52,11
9787,6,133,28,0,105,28
9787,5,66,20,0,46,20
9787,4,42,9,0,33,9
9787,3,17,8,0,9,8
9787,2,9,3,0,6,3
9787,1,7,2,0,5,2
128475,9,8,2,0,6,2
128475,8,41,6,0,35,6
128475,7,86,12,0,74,12
128475,6,141,26,0,115,26
128475,5,66,13,0,53,13
128475,4,30,5,0,25,5
128475,3,8,1,0,7,1
128475,2,5,1,0,4,1
128475,1,1,1,0,0,1
89962,10,3,2,0,1,2
89962,8,10,4,0,6,4
89962,7,24,5,0,19,5
89962,6,92,26,0,66,26
89962,5,73,17,0,56,17
89962,4,94,25,0,69,25
89962,3,46,19,0,27,19
89962,2,32,15,0,17,15
89962,1,17,10,0,7,10
2166,8,24,8,0,16,8
2166,7,54,18,0,36,18
2166,6,92,27,0,65,27
2166,5,79,15,0,64,15
2166,4,69,27,0,42,27
2166,3,36,10,0,26,10
2166,2,18,6,0,12,6
2166,1,9,2,0,7,2
93194,10,5,1,0,4,1
93194,9,19,5,0,14,5
93194,8,57,15,0,42,15
93194,7,85,15,0,70,15
93194,6,109,17,0,92,17
93194,5,57,12,0,45,12
93194,4,38,14,0,24,14
93194,3,10,4,0,6,4
93194,2,8,2,0,6,2
93194,1,4,2,0,2,2
125943,10,34,12,0,22,12
125943,9,36,11,0,25,11
125943,8,116,34,1,82,33
125943,7,96,14,1,82,13
125943,6,74,16,0,58,16
125943,5,21,2,0,19,2
125943,4,10,2,1,8,1
125943,3,3,1,1,2,0
125943,2,2,1,0,1,1
1518,9,11,3,0,8,3
1518,8,45,15,0,30,15
1518,7,96,34,0,62,34
1518,6,105,32,0,73,32
1518,5,79,26,0,53,26
1518,4,30,12,0,18,12
1518,3,15,5,0,10,5
1518,2,3,2,0,1,2
1518,1,4,2,0,2,2
5296,10,5,2,0,3,2
5296,9,10,6,0,4,6
5296,8,30,9,0,21,9
5296,7,66,26,0,40,26
5296,6,123,37,0,86,37
5296,5,93,25,0,68,25
5296,4,38,15,0,23,15
5296,3,20,6,0,14,6
5296,2,6,3,0,3,3
5296,1,1,1,0,0,1
72478,10,2,2,0,0,2
72478,9,13,5,0,8,5
72478,8,87,26,0,61,26
72478,7,118,41,0,77,41
72478,6,117,25,0,92,25
72478,5,40,7,0,33,7
72478,4,10,5,0,5,5
72478,3,2,1,0,1,1
72478,2,2,1,0,1,1
190400,10,25,5,0,20,5
190400,9,68,13,0,55,13
190400,8,143,17,0,126,17
190400,7,84,11,0,73,11
190400,6,51,6,1,45,5
190400,5,14,2,0,12,2
190400,4,4,1,0,3,1
190400,2,4,3,0,1,3
181254,10,14,4,0,10,4
181254,9,20,4,0,16,4
181254,8,87,14,0,73,14
181254,7,125,15,0,110,15
181254,6,98,18,0,80,18
181254,5,28,5,0,23,5
181254,4,13,1,0,12,1
181254,3,3,1,0,2,1
661,10,3,1,0,2,1
661,9,8,3,0,5,3
661,8,47,16,0,31,16
661,7,104,34,0,70,34
661,6,133,46,0,87,46
661,5,54,15,0,39,15
661,4,28,10,0,18,10
661,3,10,5,0,5,5
661,2,4,2,0,2,2
951,10,19,7,0,12,7
951,9,23,13,0,10,13
951,8,46,21,0,25,21
951,7,77,36,0,41,36
951,6,130,34,0,96,34
951,5,57,21,0,36,21
951,4,27,11,0,16,11
951,3,8,6,0,2,6
951,2,3,1,0,2,1
951,1,1,1,0,0,1
67178,10,4,1,0,3,1
67178,9,12,4,0,8,4
67178,8,71,15,0,56,15
67178,7,111,30,0,81,30
67178,6,141,35,0,106,35
67178,5,35,7,0,28,7
67178,4,13,4,0,9,4
67178,1,1,1,0,0,1
23263,10,8,1,0,7,1
23263,9,17,2,0,15,2
23263,8,63,18,0,45,18
23263,7,77,15,0,62,15
23263,6,116,34,0,82,34
23263,5,70,16,0,54,16
23263,4,26,7,0,19,7
23263,3,8,1,0,7,1
23263,2,4,3,0,1,3
23263,1,2,1,0,1,1
170202,9,6,3,0,3,3
170202,8,52,11,2,41,9
170202,7,107,25,5,82,20
170202,6,146,36,4,110,32
170202,5,36,7,1,29,6
170202,4,24,7,0,17,7
170202,3,12,3,0,9,3
170202,2,4,2,0,2,2
66437,10,7,1,0,6,1
66437,9,8,2,0,6,2
66437,8,66,13,0,53,13
66437,7,109,27,0,82,27
66437,6,125,21,0,104,21
66437,5,52,10,0,42,10
66437,4,14,1,0,13,1
66437,2,4,2,0,2,2
144632,10,3,1,0,2,1
144632,9,13,3,0,10,3
144632,8,56,14,2,42,12
144632,7,101,20,0,81,20
144632,6,116,29,1,87,28
144632,5,48,12,1,36,11
144632,4,31,10,0,21,10
144632,3,11,3,0,8,3
144632,2,4,1,0,3,1
144632,1,7,6,1,1,5
366,10,3,1,0,2,1
366,9,4,1,0,3,1
366,8,65,20,0,45,20
366,7,119,44,0,75,44
366,6,128,46,0,82,46
366,5,38,12,0,26,12
366,4,17,5,0,12,5
366,3,11,4,0,7,4
366,2,4,1,0,3,1
121409,10,7,3,0,4,3
121409,8,68,16,1,52,15
121409,7,108,14,0,94,14
121409,6,108,15,0,93,15
121409,5,43,11,0,32,11
121409,4,23,10,0,13,10
121409,3,18,4,0,14,4
121409,2,2,1,0,1,1
121409,1,1,1,0,0,1
2598,10,2,1,0,1,1
2598,8,16,7,0,9,7
2598,7,49,17,0,32,17
2598,6,120,39,0,81,39
2598,5,110,32,0,78,32
2598,4,54,22,0,32,22
2598,3,24,9,0,15,9
2598,2,10,6,0,4,6
2598,1,4,1,0,3,1
184919,10,8,2,0,6,2
184919,8,49,5,0,44,5
184919,7,120,22,0,98,22
184919,6,120,17,0,103,17
184919,5,40,7,0,33,7
184919,4,30,8,0,22,8
184919,3,7,1,0,6,1
114991,10,26,7,0,19,7
114991,9,28,3,0,25,3
114991,8,69,10,0,59,10
114991,7,94,11,0,83,11
114991,6,105,18,1,87,17
114991,5,35,4,0,31,4
114991,4,21,6,0,15,6
114991,3,5,2,0,3,2
114991,2,7,1,0,6,1
24491,10,3,1,0,2,1
24491,9,8,4,0,4,4
24491,8,56,21,0,35,21
24491,7,81,29,0,52,29
24491,6,137,44,0,93,44
24491,5,47,13,0,34,13
24491,4,34,11,0,23,11
24491,3,17,7,0,10,7
24491,2,6,2,0,4,2
24491,1,1,1,0,0,1
161761,8,57,12,0,45,12
161761,7,88,12,0,76,12
161761,6,157,28,0,129,28
161761,5,42,8,0,34,8
161761,4,26,5,0,21,5
161761,3,11,1,0,10,1
164158,9,13,4,0,9,4
164158,8,65,11,0,54,11
164158,7,113,22,1,91,21
164158,6,138,30,1,108,29
164158,5,38,12,0,26,12
164158,4,14,2,0,12,2
164158,3,3,2,0,1,2
164158,2,2,1,0,1,1
210232,10,150,57,4,93,53
210232,9,95,22,3,73,19
210232,8,77,26,2,51,24
210232,7,30,7,0,23,7
210232,6,22,6,1,16,5
210232,5,7,2,0,5,2
210232,4,2,1,0,1,1
210232,2,4,1,0,3,1
210232,1,3,2,0,1,2
3895,10,15,7,0,8,7
3895,9,27,10,0,17,10
3895,8,91,36,0,55,36
3895,7,122,44,0,78,44
3895,6,83,20,0,63,20
3895,5,26,6,0,20,6
3895,4,17,6,0,11,6
3895,3,8,2,0,6,2
166633,10,5,1,0,4,1
166633,9,4,2,0,2,2
166633,8,27,10,0,17,10
166633,7,73,11,0,62,11
166633,6,131,18,0,113,18
166633,5,89,13,0,76,13
166633,4,39,6,0,33,6
166633,3,13,1,0,12,1
166633,2,6,2,0,4,2
201846,10,59,32,0,27,32
201846,9,52,25,0,27,25
201846,8,91,23,0,68,23
201846,7,77,10,0,67,10
201846,6,47,8,0,39,8
201846,5,14,4,0,10,4
201846,3,4,1,0,3,1
201846,2,8,4,0,4,4
201846,1,29,10,0,19,10
234691,9,11,4,0,7,4
234691,8,81,9,0,72,9
234691,7,141,21,0,120,21
234691,6,97,17,0,80,17
234691,5,33,8,0,25,8
234691,4,14,2,0,12,2
234691,3,5,1,0,4,1
234691,2,2,1,0,1,1
132817,10,4,3,0,1,3
132817,9,14,5,0,9,5
132817,8,85,13,1,72,12
132817,7,110,29,0,81,29
132817,6,114,26,0,88,26
132817,5,42,11,0,31,11
132817,4,10,5,0,5,5
132817,3,11,2,0,9,2
146559,9,23,6,1,17,5
146559,8,115,31,2,84,29
146559,7,110,25,2,85,23
146559,6,80,17,0,63,17
146559,5,35,16,0,19,16
146559,4,10,3,0,7,3
146559,3,6,1,0,5,1
146559,2,2,1,0,1,1
172507,9,11,4,0,7,4
172507,8,51,18,0,33,18
172507,7,104,26,0,78,26
172507,6,139,20,0,119,20
172507,5,54,11,0,43,11
172507,4,15,4,0,11,4
172507,3,6,1,0,5,1
172507,2,3,1,0,2,1
2179,8,34,12,0,22,12
2179,7,98,22,0,76,22
2179,6,145,26,0,119,26
2179,5,69,16,0,53,16
2179,4,26,5,0,21,5
2179,3,10,4,0,6,4
124545,10,14,4,0,10,4
124545,9,7,5,0,2,5
124545,8,76,20,1,56,19
124545,7,108,27,0,81,27
124545,6,98,23,0,75,23
124545,5,44,19,1,25,18
124545,4,26,7,0,19,7
124545,3,8,4,0,4,4
124545,2,4,1,0,3,1
110868,8,59,9,0,50,9
110868,7,128,16,0,112,16
110868,6,113,19,0,94,19
110868,5,52,12,0,40,12
110868,4,13,2,0,11,2
110868,3,9,3,0,6,3
110868,2,8,3,0,5,3
189222,10,21,3,0,18,3
189222,9,37,12,0,25,12
189222,8,99,16,1,83,15
189222,7,111,17,2,94,15
189222,6,75,11,0,64,11
189222,5,23,3,0,20,3
189222,4,11,2,0,9,2
189222,3,6,1,0,5,1
189222,2,2,1,0,1,1
131246,10,6,1,0,5,1
131246,9,9,1,0,8,1
131246,8,87,16,0,71,16
131246,7,135,28,0,107,28
131246,6,117,23,0,94,23
131246,5,18,6,0,12,6
131246,3,1,1,0,0,1
131246,2,2,1,0,1,1
191877,10,9,2,0,7,2
191877,8,96,21,0,75,21
191877,7,104,18,0,86,18
191877,6,115,14,0,101,14
191877,5,28,4,0,24,4
191877,4,18,6,0,12,6
191877,3,6,2,0,4,2
3385,10,5,1,0,4,1
3385,9,7,4,0,3,4
3385,8,35,8,0,27,8
3385,7,66,10,0,56,10
3385,6,162,38,0,124,38
3385,5,72,25,0,47,25
3385,4,32,7,0,25,7
3385,3,3,1,0,2,1
3385,2,4,2,0,2,2
170318,10,8,3,0,5,3
170318,9,27,6,0,21,6
170318,8,141,22,3,119,19
170318,7,126,23,5,103,18
170318,6,64,11,2,53,9
170318,5,10,3,0,7,3
170318,4,5,1,0,4,1
170318,3,4,1,0,3,1
170318,1,1,1,0,0,1
22479,10,12,1,0,11,1
22479,9,17,5,0,12,5
22479,8,70,16,0,54,16
22479,7,84,23,0,61,23
22479,6,105,23,0,82,23
22479,5,59,17,0,42,17
22479,4,23,7,0,16,7
22479,3,10,2,0,8,2
22479,2,5,3,0,2,3
1257,10,6,2,0,4,2
1257,9,13,6,0,7,6
1257,8,39,17,0,22,17
1257,7,93,30,0,63,30
1257,6,128,30,0,98,30
1257,5,61,14,0,47,14
1257,4,31,10,0,21,10
1257,3,8,2,0,6,2
1257,2,5,2,0,3,2
1257,1,3,1,0,2,1
57,10,8,3,0,5,3
57,9,16,2,0,14,2
57,8,66,16,0,50,16
57,7,130,28,0,102,28
57,6,110,21,0,89,21
57,5,36,10,0,26,10
57,4,17,8,0,9,8
57,3,2,1,0,1,1
177875,10,12,6,0,6,6
177875,9,23,11,0,12,11
177875,8,92,27,1,65,26
177875,7,115,28,0,87,28
177875,6,83,22,0,61,22
177875,5,39,17,0,22,17
177875,4,13,4,1,9,3
177875,3,8,1,0,7,1
195227,10,15,4,0,11,4
195227,9,38,14,0,24,14
195227,8,140,40,2,100,38
195227,7,100,22,1,78,21
195227,6,60,12,0,48,12
195227,5,21,3,0,18,3
195227,4,11,7,0,4,7
195227,3,2,1,0,1,1
195227,2,2,1,0,1,1
23334,10,5,1,0,4,1
23334,9,4,1,0,3,1
23334,8,20,10,0,10,10
23334,7,59,15,0,44,15
23334,6,148,40,0,108,40
23334,5,74,17,0,57,17
23334,4,45,17,0,28,17
23334,3,18,6,0,12,6
23334,2,8,3,0,5,3
23334,1,6,1,0,5,1
132620,10,9,3,0,6,3
132620,9,18,3,0,15,3
132620,8,58,4,0,54,4
132620,7,106,12,0,94,12
132620,6,117,2,0,115,2
132620,5,48,4,0,44,4
132620,4,25,7,0,18,7
614,10,12,3,0,9,3
614,9,9,2,0,7,2
614,8,38,9,0,29,9
614,7,66,14,0,52,14
614,6,143,33,0,110,33
614,5,67,15,0,52,15
614,4,32,8,0,24,8
614,3,13,3,0,10,3
614,2,6,1,0,5,1
1942,10,8,2,0,6,2
1942,9,14,8,0,6,8
1942,8,80,31,0,49,31
1942,7,109,41,0,68,41
1942,6,108,39,0,69,39
1942,5,42,11,0,31,11
1942,4,13,4,0,9,4
1942,3,5,2,0,3,2
1942,2,6,2,0,4,2
81250,10,5,2,0,3,2
81250,9,24,8,0,16,8
81250,8,81,21,0,60,21
81250,7,109,20,0,89,20
81250,6,111,27,0,84,27
81250,5,33,9,0,24,9
81250,3,8,4,0,4,4
81250,2,3,3,0,0,3
97094,8,42,11,0,31,11
97094,7,103,25,0,78,25
97094,6,132,31,0,101,31
97094,5,53,8,0,45,8
97094,4,37,16,0,21,16
97094,3,8,3,0,5,3
264198,10,78,16,0,62,16
264198,9,126,23,0,103,23
264198,8,110,15,0,95,15
264198,7,41,7,0,34,7
264198,6,21,2,0,19,2
264198,4,3,2,0,1,2
264198,1,1,1,0,0,1
40483,10,7,1,0,6,1
40483,9,13,4,0,9,4
40483,8,48,8,0,40,8
40483,7,85,15,0,70,15
40483,6,134,15,0,119,15
40483,5,55,2,0,53,2
40483,4,27,5,0,22,5
40483,3,9,2,0,7,2
40483,2,7,1,0,6,1
46158,10,18,2,0,16,2
46158,9,48,4,0,44,4
46158,8,115,13,0,102,13
46158,7,106,8,0,98,8
46158,6,67,2,0,65,2
46158,5,19,1,0,18,1
1330,9,3,1,0,2,1
1330,8,17,10,0,7,10
1330,7,56,15,0,41,15
1330,6,137,44,0,93,44
1330,5,94,29,0,65,29
1330,4,48,25,0,23,25
1330,3,25,14,0,11,14
1330,2,5,1,0,4,1
1330,1,1,1,0,0,1
1964,10,5,3,0,2,3
1964,9,2,2,0,0,2
1964,8,22,9,0,13,9
1964,7,46,15,0,31,15
1964,6,123,34,0,89,34
1964,5,89,26,0,63,26
1964,4,56,14,0,42,14
1964,3,26,11,0,15,11
1964,2,13,5,0,8,5
1964,1,3,2,0,1,2
912,9,20,6,0,14,6
912,8,100,39,0,61,39
912,7,140,50,1,90,49
912,6,71,27,0,44,27
912,5,23,10,0,13,10
912,4,11,3,0,8,3
912,3,6,5,0,1,5
912,2,4,3,0,1,3
157912,9,10,4,2,6,2
157912,8,80,19,1,61,18
157912,7,94,16,5,78,11
157912,6,125,27,0,98,27
157912,5,43,8,1,35,7
157912,4,15,4,0,11,4
157912,3,14,3,0,11,3
157912,2,1,1,0,0,1
4425,10,4,2,0,2,2
4425,9,5,1,0,4,1
4425,8,40,15,0,25,15
4425,7,111,32,0,79,32
4425,6,115,27,0,88,27
4425,5,52,20,0,32,20
4425,4,37,15,0,22,15
4425,3,13,5,0,8,5
4425,2,8,3,0,5,3
723,10,16,7,0,9,7
723,8,45,16,0,29,16
723,7,75,20,0,55,20
723,6,130,37,0,93,37
723,5,64,15,0,49,15
723,4,28,7,0,21,7
723,3,17,4,0,13,4
723,2,3,3,0,0,3
723,1,2,1,0,1,1
1190,9,1,1,0,0,1
1190,8,20,5,0,15,5
1190,7,49,13,0,36,13
1190,6,113,25,0,88,25
1190,5,100,29,0,71,29
1190,4,53,15,0,38,15
1190,3,29,13,0,16,13
1190,2,11,7,0,4,7
1190,1,6,6,0,0,6
25623,10,2,1,0,1,1
25623,9,1,1,0,0,1
25623,8,12,3,0,9,3
25623,7,47,16,0,31,16
25623,6,140,45,0,95,45
25623,5,96,27,0,69,27
25623,4,42,17,0,25,17
25623,3,21,12,0,9,12
25623,2,23,13,0,10,13
15369,10,90,38,0,52,38
15369,9,94,38,0,56,38
15369,8,109,42,0,67,42
15369,7,41,20,0,21,20
15369,6,25,8,0,17,8
15369,5,10,5,0,5,5
15369,3,3,1,0,2,1
173096,10,19,5,0,14,5
173096,9,40,8,0,32,8
173096,8,122,16,0,106,16
173096,7,105,12,0,93,12
173096,6,64,4,0,60,4
173096,5,18,4,0,14,4
173096,4,7,2,0,5,2
173096,2,2,1,0,1,1
157088,10,13,4,0,9,4
157088,9,13,2,0,11,2
157088,8,110,27,2,83,25
157088,7,98,14,0,84,14
157088,6,101,15,0,86,15
157088,5,30,4,0,26,4
157088,4,13,4,0,9,4
157088,1,3,2,0,1,2
13084,10,9,3,0,6,3
13084,9,18,7,0,11,7
13084,8,113,55,0,58,55
13084,7,103,36,0,67,36
13084,6,88,38,0,50,38
13084,5,33,9,0,24,9
13084,4,12,5,0,7,5
13084,2,2,2,0,0,2
164159,10,5,1,0,4,1
164159,9,4,2,0,2,2
164159,8,38,8,0,30,8
164159,7,121,22,0,99,22
164159,6,144,33,2,111,31
164159,5,52,14,0,38,14
164159,4,19,4,0,15,4
164159,3,2,2,0,0,2
66798,10,2,1,0,1,1
66798,9,8,1,0,7,1
66798,8,40,8,0,32,8
66798,7,100,21,0,79,21
66798,6,151,20,0,131,20
66798,5,53,11,0,42,11
66798,4,22,5,0,17,5
1644,10,22,9,0,13,9
1644,9,23,7,0,16,7
1644,8,50,12,0,38,12
1644,7,76,16,0,60,16
1644,6,118,17,0,101,17
1644,5,56,13,0,43,13
1644,4,20,6,0,14,6
1644,3,13,3,0,10,3
1644,2,4,1,0,3,1
147537,10,65,10,0,55,10
147537,9,110,17,0,93,17
147537,8,115,17,0,98,17
147537,7,54,5,0,49,5
147537,6,20,3,0,17,3
147537,5,9,1,0,8,1
147537,4,5,1,0,4,1
147537,3,3,1,0,2,1
113927,10,23,1,0,22,1
113927,9,48,3,0,45,3
113927,8,120,14,0,106,14
113927,7,87,7,0,80,7
113927,6,62,10,0,52,10
113927,5,24,1,0,23,1
113927,4,12,2,0,10,2
31822,10,2,1,0,1,1
31822,9,5,1,0,4,1
31822,8,40,12,0,28,12
31822,7,82,23,0,59,23
31822,6,132,42,0,90,42
31822,5,62,17,0,45,17
31822,4,35,12,0,23,12
31822,3,16,9,0,7,9
31822,2,5,2,0,3,2
7239,10,7,2,0,5,2
7239,9,10,4,0,6,4
7239,8,60,26,0,34,26
7239,7,82,26,0,56,26
7239,6,122,34,0,88,34
7239,5,52,17,0,35,17
7239,4,27,8,0,19,8
7239,3,12,8,0,4,8
7239,2,12,12,0,0,12
5222,10,3,2,0,1,2
5222,9,11,4,0,7,4
5222,8,69,29,0,40,29
5222,7,111,39,0,72,39
5222,6,104,40,0,64,40
5222,5,49,24,0,25,24
5222,4,21,7,0,14,7
5222,3,11,4,0,7,4
5222,2,5,2,0,3,2
123129,10,10,2,0,8,2
123129,9,15,5,0,10,5
123129,8,53,10,0,43,10
123129,7,84,15,0,69,15
123129,6,108,20,1,88,19
123129,5,58,11,0,47,11
123129,4,30,6,0,24,6
123129,3,11,2,0,9,2
123129,2,7,3,0,4,3
123129,1,8,4,0,4,4
253756,10,21,6,0,15,6
253756,9,23,6,4,17,2
253756,8,88,15,1,73,14
253756,7,109,21,0,88,21
253756,6,86,17,1,69,16
253756,5,29,11,1,18,10
253756,4,17,3,0,14,3
253756,3,7,1,0,6,1
253756,2,6,2,0,4,2
204817,10,14,4,0,10,4
204817,9,27,9,1,18,8
204817,8,102,16,1,86,15
204817,7,122,17,3,105,14
204817,6,72,9,4,63,5
204817,5,25,5,0,20,5
204817,3,7,1,0,6,1
204817,1,7,4,1,3,3
129710,8,43,9,0,34,9
129710,7,92,20,0,72,20
129710,6,142,32,0,110,32
129710,5,57,15,0,42,15
129710,4,29,8,0,21,8
129710,3,9,3,0,6,3
129710,2,6,2,0,4,2
93971,10,4,1,0,3,1
93971,9,20,4,0,16,4
93971,8,73,20,0,53,20
93971,7,116,29,0,87,29
93971,6,110,25,0,85,25
93971,5,40,9,0,31,9
93971,4,12,2,0,10,2
93971,2,2,1,0,1,1
3702,9,6,1,0,5,1
3702,8,12,6,0,6,6
3702,7,35,9,0,26,9
3702,6,96,28,0,68,28
3702,5,115,33,0,82,33
3702,4,66,14,0,52,14
3702,3,36,13,0,23,13
3702,2,9,5,0,4,5
3702,1,6,2,0,4,2
109,9,4,1,0,3,1
109,8,36,14,0,22,14
109,7,101,19,0,82,19
109,6,151,34,0,117,34
109,5,56,19,0,37,19
109,4,21,6,0,15,6
109,3,7,2,0,5,2
109,2,6,3,0,3,3
125028,9,7,2,0,5,2
125028,8,26,7,0,19,7
125028,7,56,9,0,47,9
125028,6,151,25,0,126,25
125028,5,67,8,0,59,8
125028,4,48,10,0,38,10
125028,3,21,7,0,14,7
125028,2,7,2,0,5,2
2086,9,5,1,0,4,1
2086,8,19,5,0,14,5
2086,7,36,5,0,31,5
2086,6,99,15,0,84,15
2086,5,82,10,0,72,10
2086,4,80,13,0,67,13
2086,3,28,6,0,22,6
2086,2,20,8,0,12,8
2086,1,10,5,0,5,5
5014,10,7,3,0,4,3
5014,9,5,2,0,3,2
5014,8,33,8,0,25,8
5014,7,77,13,0,64,13
5014,6,145,22,0,123,22
5014,5,69,16,0,53,16
5014,4,26,6,0,20,6
5014,3,13,1,0,12,1
242667,10,13,6,0,7,6
242667,9,36,6,0,30,6
242667,8,129,20,0,109,20
242667,7,99,12,0,87,12
242667,6,59,7,0,52,7
242667,5,29,4,0,25,4
242667,4,11,5,0,6,5
242667,3,6,3,0,3,3
393,10,11,6,0,5,6
393,9,24,12,0,12,12
393,8,58,30,0,28,30
393,7,111,39,0,72,39
393,6,104,43,0,61,43
393,5,43,13,0,30,13
393,4,14,6,0,8,6
393,3,11,5,0,6,5
393,2,4,3,0,1,3
393,1,2,1,0,1,1
217321,10,1,1,0,0,1
217321,9,7,1,0,6,1
217321,8,68,10,0,58,10
217321,7,141,18,0,123,18
217321,6,123,14,0,109,14
217321,5,24,2,0,22,2
217321,4,13,2,0,11,2
36,10,16,4,0,12,4
36,9,27,9,0,18,9
36,8,52,23,0,29,23
36,7,82,18,0,64,18
36,6,96,28,0,68,28
36,5,44,15,0,29,15
36,4,41,15,0,26,15
36,3,16,11,0,5,11
36,2,7,6,0,1,6
36,1,1,1,0,0,1
83197,9,13,3,0,10,3
83197,8,40,13,0,27,13
83197,7,104,22,0,82,22
83197,6,148,34,0,114,34
83197,5,49,15,0,34,15
83197,4,15,5,0,10,5
83197,3,9,1,0,8,1
83197,2,1,1,0,0,1
161943,10,4,1,0,3,1
161943,9,14,1,0,13,1
161943,8,85,21,0,64,21
161943,7,112,21,0,91,21
161943,6,115,20,0,95,20
161943,5,32,5,0,27,5
161943,4,13,5,0,8,5
161943,3,4,1,0,3,1
1210,9,5,2,0,3,2
1210,8,32,6,0,26,6
1210,7,75,17,0,58,17
1210,6,99,23,0,76,23
1210,5,87,26,0,61,26
1210,4,49,16,0,33,16
1210,3,25,11,0,14,11
1210,2,7,2,0,5,2
1210,1,1,1,0,0,1
35614,10,61,31,0,30,31
35614,9,92,30,0,62,30
35614,8,120,46,0,74,46
35614,7,48,17,0,31,17
35614,6,30,11,0,19,11
35614,5,12,7,0,5,7
35614,4,9,6,0,3,6
35614,3,4,3,0,1,3
35614,2,3,2,0,1,2
40935,9,11,2,0,9,2
40935,8,62,21,0,41,21
40935,7,92,26,0,66,26
40935,6,138,37,0,101,37
40935,5,49,13,0,36,13
40935,4,20,4,0,16,4
40935,2,4,1,0,3,1
216974,10,2,1,0,1,1
216974,9,14,7,1,7,6
216974,8,60,16,1,44,15
216974,7,148,24,3,124,21
216974,6,110,29,2,81,27
216974,5,33,5,1,28,4
216974,4,12,2,0,10,2
216974,3,3,3,0,0,3
795,9,3,2,0,1,2
795,8,26,7,0,19,7
795,7,44,10,0,34,10
795,6,123,28,0,95,28
795,5,76,26,0,50,26
795,4,62,22,0,40,22
795,3,28,10,0,18,10
795,2,14,6,0,8,6
795,1,4,1,0,3,1
169215,10,11,2,0,9,2
169215,9,22,7,1,15,6
169215,8,94,18,0,76,18
169215,7,105,19,2,86,17
169215,6,97,14,0,83,14
169215,5,28,3,0,25,3
169215,4,12,5,0,7,5
169215,3,7,3,0,4,3
169215,2,4,2,0,2,2
11416,10,2,1,0,1,1
11416,8,6,1,0,5,1
11416,7,29,5,0,24,5
11416,6,78,10,0,68,10
11416,5,78,19,0,59,19
11416,4,76,28,0,48,28
11416,3,55,22,0,33,22
11416,2,35,17,0,18,17
11416,1,20,9,0,11,9
66613,10,2,1,0,1,1
66613,9,5,1,0,4,1
66613,8,59,11,0,48,11
66613,7,109,15,0,94,15
66613,6,139,25,0,114,25
66613,5,46,14,0,32,14
66613,4,17,1,0,16,1
66613,3,3,2,0,1,2
755,10,7,2,0,5,2
755,9,25,11,0,14,11
755,8,109,37,0,72,37
755,7,129,37,0,92,37
755,6,72,20,0,52,20
755,5,29,11,0,18,11
755,4,7,3,0,4,3
755,3,2,2,0,0,2
225167,10,119,54,2,65,52
225167,9,75,20,1,55,19
225167,8,76,14,2,62,12
225167,7,39,3,0,36,3
225167,6,35,5,0,30,5
225167,4,8,1,0,7,1
225167,3,12,3,0,9,3
225167,2,6,6,0,0,6
225167,1,1,1,0,0,1
2749,10,10,1,0,9,1
2749,9,13,3,0,10,3
2749,8,46,17,0,29,17
2749,7,50,14,0,36,14
2749,6,105,22,0,83,22
2749,5,57,17,0,40,17
2749,4,44,21,0,23,21
2749,3,31,14,0,17,14
2749,2,19,10,0,9,10
2749,1,6,4,0,2,4
170415,9,6,1,0,5,1
170415,8,40,11,0,29,11
170415,7,99,8,0,91,8
170415,6,138,19,0,119,19
170415,5,61,12,0,49,12
170415,4,21,6,0,15,6
170415,3,6,1,0,5,1
3406,10,26,11,0,15,11
3406,9,44,23,0,21,23
3406,8,89,39,0,50,39
3406,7,111,41,0,70,41
3406,6,69,26,0,43,26
3406,5,25,10,0,15,10
3406,4,8,6,0,2,6
3406,3,5,1,0,4,1
3406,2,2,1,0,1,1
38873,10,10,3,0,7,3
38873,9,9,3,0,6,3
38873,8,49,17,0,32,17
38873,7,113,36,0,77,36
38873,6,127,34,0,93,34
38873,5,50,16,0,34,16
38873,4,18,4,0,14,4
38873,3,5,2,0,3,2
35801,10,2,1,0,1,1
35801,9,7,5,0,2,5
35801,8,32,11,0,21,11
35801,7,90,20,0,70,20
35801,6,161,23,0,138,23
35801,5,51,16,0,35,16
35801,4,28,14,0,14,14
35801,3,5,3,0,2,3
35801,2,4,1,0,3,1
5135,10,3,2,0,1,2
5135,9,3,2,0,1,2
5135,8,39,9,0,30,9
5135,7,58,19,0,39,19
5135,6,127,36,0,91,36
5135,5,70,16,0,54,16
5135,4,41,12,0,29,12
5135,3,21,6,0,15,6
5135,2,9,2,0,7,2
5135,1,9,4,0,5,4
38430,10,8,2,0,6,2
38430,9,18,8,0,10,8
38430,8,84,43,0,41,43
38430,7,86,38,0,48,38
38430,6,112,34,0,78,34
38430,5,38,17,0,21,17
38430,4,20,12,0,8,12
38430,3,7,2,0,5,2
38430,2,5,3,0,2,3
38430,1,2,1,0,1,1
29805,10,18,4,0,14,4
29805,9,36,3,0,33,3
29805,8,88,16,0,72,16
29805,7,106,9,0,97,9
29805,6,82,9,0,73,9
29805,4,15,3,0,12,3
29805,3,7,3,0,4,3
29805,2,4,1,0,3,1
102610,9,13,3,0,10,3
102610,8,87,15,0,72,15
102610,7,136,24,0,112,24
102610,6,98,26,0,72,26
102610,5,23,6,0,17,6
102610,4,9,2,0,7,2
102610,3,6,4,0,2,4
102610,2,3,1,0,2,1
8243,10,3,1,0,2,1
8243,8,11,2,0,9,2
8243,7,62,11,0,51,11
8243,6,163,27,0,136,27
8243,5,79,12,0,67,12
8243,4,43,9,0,34,9
8243,3,10,3,0,7,3
8243,2,6,2,0,4,2
8243,1,1,1,0,0,1
7349,10,38,19,0,19,19
7349,9,62,26,0,36,26
7349,8,109,35,0,74,35
7349,7,92,23,0,69,23
7349,6,50,9,0,41,9
7349,5,22,2,0,20,2
7349,4,3,1,0,2,1
7349,2,1,1,0,0,1
1919,10,4,3,0,1,3
1919,9,10,5,0,5,5
1919,8,31,14,0,17,14
1919,7,67,24,0,43,24
1919,6,145,38,0,107,38
1919,5,77,24,0,53,24
1919,4,23,7,0,16,7
1919,3,17,11,0,6,11
1919,2,3,2,0,1,2
1919,1,3,2,0,1,2
195518,9,8,1,0,7,1
195518,8,38,6,0,32,6
195518,7,88,10,0,78,10
195518,6,122,22,0,100,22
195518,5,60,12,0,48,12
195518,4,32,5,0,27,5
195518,3,20,5,0,15,5
195518,2,5,2,0,3,2
1799,10,28,9,0,19,9
1799,9,34,10,0,24,10
1799,8,70,18,0,52,18
1799,7,80,24,0,56,24
1799,6,91,23,0,68,23
1799,5,41,18,0,23,18
1799,4,20,5,0,15,5
1799,3,11,4,0,7,4
1799,2,4,1,0,3,1
1799,1,1,1,0,0,1
482,9,1,1,0,0,1
482,8,13,4,0,9,4
482,7,66,22,0,44,22
482,6,136,38,0,98,38
482,5,92,28,0,64,28
482,4,44,16,0,28,16
482,3,18,2,0,16,2
482,2,9,5,0,4,5
88126,10,10,3,0,7,3
88126,9,33,1,0,32,1
88126,8,91,12,0,79,12
88126,7,107,9,0,98,9
88126,6,98,8,0,90,8
88126,5,28,2,0,26,2
216439,10,12,2,0,10,2
216439,9,19,7,0,12,7
216439,8,81,9,1,72,8
216439,7,134,14,0,120,14
216439,6,92,13,0,79,13
216439,5,28,6,0,22,6
216439,4,12,3,0,9,3
216439,2,2,2,0,0,2
2903,10,2,1,0,1,1
2903,9,8,2,0,6,2
2903,8,35,13,0,22,13
2903,7,79,22,0,57,22
2903,6,128,34,0,94,34
2903,5,77,26,0,51,26
2903,4,27,6,0,21,6
2903,3,16,6,0,10,6
2903,2,6,1,0,5,1
2903,1,1,1,0,0,1
2368,10,8,4,0,4,4
2368,9,11,5,0,6,5
2368,8,43,19,0,24,19
2368,7,87,25,0,62,25
2368,6,128,31,0,97,31
2368,5,66,21,0,45,21
2368,4,22,8,0,14,8
2368,3,10,6,0,4,6
2368,1,2,1,0,1,1
9852,10,4,1,0,3,1
9852,9,4,3,0,1,3
9852,8,17,9,0,8,9
9852,7,40,12,0,28,12
9852,6,102,32,0,70,32
9852,5,114,33,0,81,33
9852,4,65,18,0,47,18
9852,3,21,5,0,16,5
9852,2,6,2,0,4,2
9852,1,5,2,0,3,2
14736,10,3,1,0,2,1
14736,9,8,3,0,5,3
14736,8,26,2,0,24,2
14736,7,39,12,0,27,12
14736,6,121,35,0,86,35
14736,5,77,17,0,60,17
14736,4,43,11,0,32,11
14736,3,34,9,0,25,9
14736,2,18,8,0,10,8
14736,1,9,4,0,5,4
16444,10,6,2,0,4,2
16444,9,16,7,0,9,7
16444,8,41,20,0,21,20
16444,7,73,30,0,43,30
16444,6,123,42,0,81,42
16444,5,70,28,0,42,28
16444,4,37,13,0,24,13
16444,3,8,2,0,6,2
16444,2,4,1,0,3,1
7976,9,6,1,0,5,1
7976,8,43,13,0,30,13
7976,7,93,20,0,73,20
7976,6,140,34,0,106,34
7976,5,55,15,0,40,15
7976,4,29,6,0,23,6
7976,3,8,2,0,6,2
7976,2,2,1,0,1,1
1370,10,9,4,0,5,4
1370,9,8,2,0,6,2
1370,8,37,14,0,23,14
1370,7,72,21,0,51,21
1370,6,134,45,0,89,45
1370,5,73,25,0,48,25
1370,4,28,13,0,15,13
1370,3,12,5,0,7,5
1370,2,4,4,0,0,4
143981,10,10,4,0,6,4
143981,9,18,5,0,13,5
143981,8,112,27,0,85,27
143981,7,114,22,0,92,22
143981,6,89,18,0,71,18
143981,5,25,5,0,20,5
143981,4,9,2,0,7,2
39336,10,46,11,0,35,11
39336,9,73,11,0,62,11
39336,8,140,19,0,121,19
39336,7,72,2,0,70,2
39336,6,30,3,0,27,3
35035,10,32,17,0,15,17
35035,9,57,15,0,42,15
35035,8,145,38,0,107,38
35035,7,85,27,0,58,27
35035,6,33,6,0,27,6
35035,5,17,5,0,12,5
2294,9,5,3,0,2,3
2294,8,16,3,0,13,3
2294,7,54,14,0,40,14
2294,6,97,24,0,73,24
2294,5,97,28,0,69,28
2294,4,54,20,0,34,20
2294,3,26,8,0,18,8
2294,2,17,6,0,11,6
2294,1,11,5,0,6,5
3114,10,3,2,0,1,2
3114,8,26,12,0,14,12
3114,7,51,18,0,33,18
3114,6,109,30,0,79,30
3114,5,86,31,0,55,31
3114,4,49,14,0,35,14
3114,3,26,10,0,16,10
3114,2,14,4,0,10,4
3114,1,8,3,0,5,3
4991,9,8,3,0,5,3
4991,8,47,23,0,24,23
4991,7,90,38,0,52,38
4991,6,120,38,0,82,38
4991,5,56,22,0,34,22
4991,4,38,18,0,20,18
4991,3,7,2,0,5,2
4991,2,5,1,0,4,1
4991,1,4,1,0,3,1
720,10,6,1,0,5,1
720,9,17,8,0,9,8
720,8,52,13,0,39,13
720,7,99,24,0,75,24
720,6,120,41,0,79,41
720,5,44,26,0,18,26
720,4,24,8,0,16,8
720,3,9,6,0,3,6
720,2,3,2,0,1,2
720,1,3,2,0,1,2
36745,9,7,1,0,6,1
36745,8,16,3,0,13,3
36745,7,52,7,0,45,7
36745,6,108,19,0,89,19
36745,5,77,9,0,68,9
36745,4,53,12,0,41,12
36745,3,32,11,0,21,11
36745,2,22,5,0,17,5
36745,1,7,2,0,5,2
17166,10,8,4,0,4,4
17166,9,12,5,0,7,5
17166,8,33,14,0,19,14
17166,7,46,20,0,26,20
17166,6,104,29,0,75,29
17166,5,76,25,0,51,25
17166,4,52,25,0,27,25
17166,3,28,13,0,15,13
17166,2,14,5,0,9,5
17166,1,4,2,0,2,2
64675,8,34,8,0,26,8
64675,7,98,13,0,85,13
64675,6,138,26,0,112,26
64675,5,62,21,0,41,21
64675,4,31,9,0,22,9
64675,3,8,3,0,5,3
64675,2,3,1,0,2,1
33159,9,4,2,0,2,2
33159,8,34,10,0,24,10
33159,7,100,29,0,71,29
33159,6,124,38,0,86,38
33159,5,60,21,0,39,21
33159,4,33,17,0,16,17
33159,3,16,2,0,14,2
33159,2,4,2,0,2,2
36887,10,12,4,0,8,4
36887,9,21,3,0,18,3
36887,8,110,35,0,75,35
36887,7,95,27,0,68,27
36887,6,75,26,0,49,26
36887,5,23,8,0,15,8
36887,4,10,4,0,6,4
36887,3,5,3,0,2,3
36887,2,5,3,0,2,3
142379,10,42,5,1,37,4
142379,9,94,15,2,79,13
142379,8,149,26,3,123,23
142379,7,59,14,1,45,13
142379,6,30,8,1,22,7
142379,5,11,6,1,5,5
4659,10,9,7,0,2,7
4659,9,8,4,0,4,4
4659,8,35,12,0,23,12
4659,7,76,24,0,52,24
4659,6,108,33,0,75,33
4659,5,71,20,0,51,20
4659,4,36,9,0,27,9
4659,3,18,6,0,12,6
4659,2,9,5,0,4,5
4659,1,6,2,0,4,2
59960,9,7,4,0,3,4
59960,8,47,10,0,37,10
59960,7,79,18,0,61,18
59960,6,128,25,0,103,25
59960,5,53,6,0,47,6
59960,4,29,10,0,19,10
59960,3,20,9,0,11,9
59960,2,8,5,0,3,5
59960,1,4,2,0,2,2
2076,10,23,6,0,17,6
2076,9,27,10,0,17,10
2076,8,65,24,0,41,24
2076,7,79,17,0,62,17
2076,6,90,16,0,74,16
2076,5,55,14,0,41,14
2076,4,26,10,0,16,10
2076,3,5,2,0,3,2
2076,2,4,2,0,2,2
2076,1,1,1,0,0,1
14134,10,1,1,0,0,1
14134,9,5,2,0,3,2
14134,8,23,6,0,17,6
14134,7,55,10,0,45,10
14134,6,123,29,0,94,29
14134,5,89,18,0,71,18
14134,4,41,15,0,26,15
14134,3,23,10,0,13,10
14134,2,14,6,0,8,6
163277,10,4,1,0,3,1
163277,9,6,1,0,5,1
163277,8,28,5,0,23,5
163277,7,97,9,0,88,9
163277,6,152,25,0,127,25
163277,5,54,12,0,42,12
163277,4,20,3,0,17,3
163277,1,3,1,0,2,1
189350,10,10,1,0,9,1
189350,9,21,3,0,18,3
189350,8,103,29,5,74,24
189350,7,125,20,5,105,15
189350,6,72,18,2,54,16
189350,5,19,3,0,16,3
189350,4,15,3,0,12,3
189350,3,6,3,0,3,3
189350,2,3,2,0,1,2
189350,1,1,1,0,0,1
89668,9,3,3,0,0,3
89668,8,57,17,0,40,17
89668,7,121,38,0,83,38
89668,6,132,29,0,103,29
89668,5,42,7,0,35,7
89668,4,13,3,0,10,3
89668,3,3,3,0,0,3
158991,10,7,1,0,6,1
158991,9,17,6,0,11,6
158991,8,59,5,0,54,5
158991,7,102,12,0,90,12
158991,6,126,11,0,115,11
158991,5,33,6,0,27,6
158991,4,20,2,0,18,2
148531,10,4,1,0,3,1
148531,9,14,2,0,12,2
148531,8,51,10,0,41,10
148531,7,97,21,0,76,21
148531,6,134,21,0,113,21
148531,5,46,13,0,33,13
148531,4,17,4,0,13,4
148531,3,9,3,0,6,3
710,10,5,3,0,2,3
710,9,12,4,0,8,4
710,8,37,13,0,24,13
710,7,100,38,0,62,38
710,6,127,42,0,85,42
710,5,60,20,0,40,20
710,4,20,6,0,14,6
710,3,9,3,0,6,3
710,2,3,1,0,2,1
24764,10,13,4,0,9,4
24764,9,23,8,0,15,8
24764,8,53,11,0,42,11
24764,7,57,11,0,46,11
24764,6,103,26,0,77,26
24764,5,59,12,0,47,12
24764,4,25,3,0,22,3
24764,3,19,2,0,17,2
24764,2,13,1,0,12,1
24764,1,9,3,0,6,3
31612,9,7,1,0,6,1
31612,8,47,14,0,33,14
31612,7,81,27,0,54,27
31612,6,132,28,0,104,28
31612,5,59,15,0,44,15
31612,4,23,5,0,18,5
31612,3,13,6,0,7,6
31612,2,7,5,0,2,5
127920,10,13,5,1,8,4
127920,9,13,1,0,12,1
127920,8,95,24,1,71,23
127920,7,89,14,1,75,13
127920,6,92,20,1,72,19
127920,5,37,7,0,30,7
127920,4,19,4,0,15,4
127920,3,8,3,0,5,3
127920,2,3,3,0,0,3
127920,1,5,1,0,4,1
216578,10,5,1,0,4,1
216578,9,25,8,0,17,8
216578,8,88,7,0,81,7
216578,7,127,13,0,114,13
216578,6,83,9,0,74,9
216578,5,24,4,0,20,4
216578,4,12,2,0,10,2
216578,3,6,3,0,3,3
216578,2,4,2,0,2,2
1666,10,41,17,0,24,17
1666,9,54,19,0,35,19
1666,8,99,36,0,63,36
1666,7,90,19,0,71,19
1666,6,57,16,0,41,16
1666,5,24,8,0,16,8
1666,3,4,4,0,0,4
1666,2,2,2,0,0,2
159469,10,42,9,0,33,9
159469,9,72,24,0,48,24
159469,8,111,35,0,76,35
159469,7,66,12,0,54,12
159469,6,40,8,0,32,8
159469,5,22,7,0,15,7
159469,4,9,1,0,8,1
159469,3,5,2,0,3,2
159469,2,5,3,0,2,3
159469,1,1,1,0,0,1
24270,10,10,2,0,8,2
24270,9,11,3,0,8,3
24270,8,53,14,2,39,12
24270,7,91,15,1,76,14
24270,6,106,19,1,87,18
24270,5,41,10,1,31,9
24270,4,40,8,1,32,7
24270,3,10,3,0,7,3
24270,2,9,3,0,6,3
24270,1,2,2,1,0,1
9149,9,6,2,0,4,2
9149,8,39,13,0,26,13
9149,7,86,31,0,55,31
9149,6,134,39,0,95,39
9149,5,67,19,0,48,19
9149,4,23,4,0,19,4
9149,3,13,3,0,10,3
9149,1,1,1,0,0,1
108831,10,14,2,0,12,2
108831,9,23,7,0,16,7
108831,8,119,16,0,103,16
108831,7,117,28,0,89,28
108831,6,80,18,0,62,18
108831,5,15,3,0,12,3
108831,4,6,3,0,3,3
13464,10,4,1,0,3,1
13464,8,15,1,0,14,1
13464,7,61,8,0,53,8
13464,6,134,24,0,110,24
13464,5,84,11,0,73,11
13464,4,44,12,0,32,12
13464,3,18,5,0,13,5
13464,2,8,2,0,6,2
13464,1,2,1,0,1,1
4854,10,18,4,0,14,4
4854,9,39,8,0,31,8
4854,8,98,31,0,67,31
4854,7,110,29,0,81,29
4854,6,75,15,0,60,15
4854,5,20,5,0,15,5
4854,4,8,3,0,5,3
4854,3,4,1,0,3,1
2972,8,22,10,0,12,10
2972,7,70,19,0,51,19
2972,6,112,28,0,84,28
2972,5,88,22,0,66,22
2972,4,37,7,0,30,7
2972,3,27,8,0,19,8
2972,2,9,3,0,6,3
2972,1,5,2,0,3,2
206844,10,6,1,0,5,1
206844,9,10,2,0,8,2
206844,8,48,9,0,39,9
206844,7,87,9,0,78,9
206844,6,147,24,0,123,24
206844,5,47,7,0,40,7
206844,4,18,8,0,10,8
206844,1,1,1,0,0,1
88922,9,8,1,0,7,1
88922,8,26,6,0,20,6
88922,7,53,5,0,48,5
88922,6,136,26,0,110,26
88922,5,79,17,0,62,17
88922,4,41,8,0,33,8
88922,3,13,3,0,10,3
88922,2,10,5,0,5,5
11385,8,37,12,0,25,12
11385,7,88,24,0,64,24
11385,6,153,30,0,123,30
11385,5,58,14,0,44,14
11385,4,17,5,0,12,5
11385,3,6,2,0,4,2
67919,10,21,5,0,16,5
67919,9,18,4,0,14,4
67919,8,94,10,0,84,10
67919,7,109,9,0,100,9
67919,6,81,10,0,71,10
67919,5,28,3,0,25,3
67919,4,12,1,0,11,1
67919,3,6,2,0,4,2
20101,10,6,2,0,4,2
20101,9,29,12,0,17,12
20101,8,108,49,0,59,49
20101,7,97,31,0,66,31
20101,6,81,34,0,47,34
20101,5,25,12,0,13,12
20101,4,15,5,0,10,5
20101,3,9,5,0,4,5
20101,1,1,1,0,0,1
2371,10,8,2,0,6,2
2371,9,18,7,0,11,7
2371,8,46,15,0,31,15
2371,7,108,32,0,76,32
2371,6,123,38,0,85,38
2371,5,44,16,0,28,16
2371,4,21,8,0,13,8
2371,3,3,2,0,1,2
13375,9,1,1,0,0,1
13375,8,31,12,0,19,12
13375,7,59,20,0,39,20
13375,6,130,36,0,94,36
13375,5,75,26,0,49,26
13375,4,39,14,0,25,14
13375,3,14,7,0,7,7
13375,2,7,1,0,6,1
13375,1,3,1,0,2,1
240225,10,12,5,0,7,5
240225,9,17,4,0,13,4
240225,8,98,18,2,80,16
240225,7,109,15,2,94,13
240225,6,96,23,2,73,21
240225,5,25,9,0,16,9
240225,4,12,4,0,8,4
240225,3,4,2,0,2,2
240225,2,2,1,0,1,1
14080,10,14,9,0,5,9
14080,9,45,19,0,26,19
14080,8,127,39,0,88,39
14080,7,106,30,0,76,30
14080,6,57,22,0,35,22
14080,5,13,3,0,10,3
14080,4,4,1,0,3,1
14080,3,2,1,0,1,1
14080,1,3,1,0,2,1
3934,10,3,1,0,2,1
3934,8,7,4,0,3,4
3934,7,23,5,0,18,5
3934,6,65,26,0,39,26
3934,5,94,32,0,62,32
3934,4,78,27,0,51,27
3934,3,50,16,0,34,16
3934,2,23,8,0,15,8
3934,1,25,12,0,13,12
205477,10,30,11,1,19,10
205477,9,37,14,0,23,14
205477,8,119,16,0,103,16
205477,7,93,11,1,82,10
205477,6,55,12,0,43,12
205477,5,18,3,0,15,3
205477,4,8,3,0,5,3
205477,3,5,1,0,4,1
205477,2,3,1,0,2,1
205477,1,4,2,0,2,2
172073,9,10,2,0,8,2
172073,8,49,3,0,46,3
172073,7,93,12,0,81,12
172073,6,143,24,0,119,24
172073,5,45,5,0,40,5
172073,4,17,1,0,16,1
172073,3,7,2,0,5,2
227545,10,17,8,0,9,8
227545,9,40,8,0,32,8
227545,8,134,19,4,115,15
227545,7,97,19,0,78,19
227545,6,54,9,1,45,8
227545,5,21,2,0,19,2
227545,4,7,1,1,6,0
227545,3,2,1,0,1,1
227545,2,2,1,0,1,1
27380,10,3,1,0,2,1
27380,9,4,2,0,2,2
27380,8,38,9,0,29,9
27380,7,89,14,0,75,14
27380,6,127,28,0,99,28
27380,5,67,8,0,59,8
27380,4,24,8,0,16,8
27380,3,10,2,0,8,2
27380,2,8,3,0,5,3
151,10,4,3,0,1,3
151,9,23,4,0,19,4
151,8,74,28,0,46,28
151,7,87,22,0,65,22
151,6,108,43,0,65,43
151,5,45,15,0,30,15
151,4,25,6,0,19,6
151,3,4,1,0,3,1
3133,9,12,5,0,7,5
3133,8,32,13,0,19,13
3133,7,82,22,0,60,22
3133,6,145,47,0,98,47
3133,5,54,17,0,37,17
3133,4,30,14,0,16,14
3133,3,10,6,0,4,6
3133,2,2,1,0,1,1
3133,1,2,2,0,0,2
1555,10,5,4,0,1,4
1555,9,6,2,0,4,2
1555,8,28,13,0,15,13
1555,7,59,28,0,31,28
1555,6,135,63,0,72,63
1555,5,74,34,0,40,34
1555,4,38,16,0,22,16
1555,3,9,3,0,6,3
1555,2,4,3,0,1,3
1555,1,2,1,0,1,1
1289,10,6,2,0,4,2
1289,9,5,2,0,3,2
1289,8,18,10,0,8,10
1289,7,58,23,0,35,23
1289,6,120,57,0,63,57
1289,5,92,36,0,56,36
1289,4,52,23,0,29,23
1289,3,17,11,0,6,11
1289,2,3,1,0,2,1
5312,9,7,5,0,2,5
5312,8,22,4,0,18,4
5312,7,53,19,0,34,19
5312,6,96,27,0,69,27
5312,5,100,33,0,67,33
5312,4,53,20,0,33,20
5312,3,25,11,0,14,11
5312,2,11,3,0,8,3
5312,1,2,1,0,1,1
46422,10,9,2,0,7,2
46422,8,62,9,0,53,9
46422,7,104,19,0,85,19
46422,6,97,19,0,78,19
46422,5,49,11,0,38,11
46422,4,25,6,0,19,6
46422,3,10,3,0,7,3
46422,2,5,3,0,2,3
2173,10,9,2,0,7,2
2173,9,17,6,0,11,6
2173,8,41,11,0,30,11
2173,7,76,23,0,53,23
2173,6,103,28,0,75,28
2173,5,56,15,0,41,15
2173,4,38,17,0,21,17
2173,3,17,11,0,6,11
2173,2,10,3,0,7,3
2173,1,2,1,0,1,1
460,10,12,4,0,8,4
460,9,21,9,0,12,9
460,8,80,32,0,48,32
460,7,105,32,0,73,32
460,6,86,32,0,54,32
460,5,39,12,0,27,12
460,4,15,5,0,10,5
460,3,6,5,0,1,5
460,2,4,2,0,2,2
22664,9,13,2,0,11,2
22664,8,27,5,0,22,5
22664,7,63,4,0,59,4
22664,6,118,16,0,102,16
22664,5,75,18,0,57,18
22664,4,45,18,0,27,18
22664,3,14,4,0,10,4
22664,2,9,1,0,8,1
233976,9,13,2,0,11,2
233976,8,73,11,0,62,11
233976,7,109,13,0,96,13
233976,6,103,18,0,85,18
233976,5,40,10,0,30,10
233976,4,11,5,0,6,5
233976,3,9,2,0,7,2
233976,2,4,2,0,2,2
117854,10,8,3,0,5,3
117854,9,11,5,0,6,5
117854,8,68,13,0,55,13
117854,7,118,27,0,91,27
117854,6,122,27,0,95,27
117854,5,26,6,0,20,6
117854,4,12,4,0,8,4
117854,3,2,1,0,1,1
117854,2,1,1,0,0,1
128733,10,18,4,0,14,4
128733,9,21,5,0,16,5
128733,8,86,27,0,59,27
128733,7,127,30,0,97,30
128733,6,89,17,0,72,17
128733,5,17,4,0,13,4
128733,4,7,4,0,3,4
128733,3,3,1,0,2,1
41019,10,2,1,0,1,1
41019,8,30,9,0,21,9
41019,7,84,13,0,71,13
41019,6,126,25,0,101,25
41019,5,56,13,0,43,13
41019,4,41,12,0,29,12
41019,3,18,5,0,13,5
41019,2,8,2,0,6,2
41019,1,1,1,0,0,1
19358,10,12,2,0,10,2
19358,9,38,10,0,28,10
19358,8,110,18,0,92,18
19358,7,97,17,0,80,17
19358,6,68,17,0,51,17
19358,5,25,4,0,21,4
19358,4,12,3,0,9,3
19358,3,5,2,0,3,2
2212,9,5,3,0,2,3
2212,8,45,24,0,21,24
2212,7,72,35,0,37,35
2212,6,133,45,0,88,45
2212,5,58,20,0,38,20
2212,4,34,16,0,18,16
2212,3,16,6,0,10,6
2212,2,6,2,0,4,2
15261,10,2,2,0,0,2
15261,9,11,4,0,7,4
15261,8,54,14,0,40,14
15261,7,111,35,0,76,35
15261,6,134,34,0,100,34
15261,5,32,8,0,24,8
15261,4,15,7,0,8,7
15261,3,6,1,0,5,1
15261,2,4,2,0,2,2
1579,10,8,3,0,5,3
1579,9,8,5,0,3,5
1579,8,40,11,0,29,11
1579,7,67,20,0,47,20
1579,6,115,35,0,80,35
1579,5,65,18,0,47,18
1579,4,39,20,0,19,20
1579,3,20,5,0,15,5
1579,2,5,2,0,3,2
1579,1,1,1,0,0,1
41239,10,10,3,0,7,3
41239,9,23,5,0,18,5
41239,8,80,17,0,63,17
41239,7,130,19,0,111,19
41239,6,99,14,0,85,14
41239,5,18,1,0,17,1
41239,4,8,3,0,5,3
4204,10,33,9,0,24,9
4204,9,65,17,0,48,17
4204,8,152,47,0,105,47
4204,7,63,15,0,48,15
4204,6,28,6,0,22,6
4204,5,11,4,0,7,4
4204,4,8,5,0,3,5
4204,3,2,1,0,1,1
4204,2,4,1,0,3,1
4204,1,2,1,0,1,1
40816,10,9,1,0,8,1
40816,9,20,5,0,15,5
40816,8,61,9,0,52,9
40816,7,76,15,0,61,15
40816,6,110,22,0,88,22
40816,5,46,5,0,41,5
40816,4,39,9,0,30,9
40816,3,4,1,0,3,1
40816,2,4,1,0,3,1
1877,9,3,1,0,2,1
1877,8,28,14,0,14,14
1877,7,65,29,0,36,29
1877,6,121,27,0,94,27
1877,5,70,26,0,44,26
1877,4,41,12,0,29,12
1877,3,23,8,0,15,8
1877,2,10,7,0,3,7
1877,1,3,2,0,1,2
225163,9,23,3,0,20,3
225163,8,82,12,0,70,12
225163,7,118,14,0,104,14
225163,6,84,13,0,71,13
225163,5,30,6,0,24,6
225163,4,19,4,0,15,4
225163,3,5,2,0,3,2
57052,9,14,2,0,12,2
57052,8,30,5,0,25,5
57052,7,61,10,0,51,10
57052,6,113,11,0,102,11
57052,5,66,10,0,56,10
57052,4,42,2,0,40,2
57052,3,19,3,0,16,3
57052,1,6,3,0,3,3
1508,10,13,8,0,5,8
1508,9,7,2,0,5,2
1508,8,28,13,0,15,13
1508,7,73,31,0,42,31
1508,6,139,61,0,78,61
1508,5,72,21,0,51,21
1508,4,26,10,0,16,10
1508,3,10,2,0,8,2
26054,9,14,2,0,12,2
26054,8,37,3,0,34,3
26054,7,73,5,0,68,5
26054,6,137,10,0,127,10
26054,5,57,4,0,53,4
26054,4,16,2,0,14,2
26054,3,18,4,0,14,4
26054,2,6,2,0,4,2
26054,1,5,1,0,4,1
200456,10,36,10,0,26,10
200456,9,56,8,0,48,8
200456,8,136,24,0,112,24
200456,7,80,14,0,66,14
200456,6,41,5,0,36,5
200456,5,4,2,0,2,2
200456,4,9,3,0,6,3
200456,3,3,2,0,1,2
200456,2,2,1,0,1,1
171110,10,11,3,0,8,3
171110,9,18,6,1,12,5
171110,8,132,32,1,100,31
171110,7,112,21,3,91,18
171110,6,77,26,3,51,23
171110,5,14,3,0,11,3
171110,3,1,1,0,0,1
235465,9,5,1,0,4,1
235465,8,67,18,0,49,18
235465,7,117,20,0,97,20
235465,6,112,12,0,100,12
235465,5,36,6,0,30,6
235465,4,19,7,0,12,7
235465,3,5,1,0,4,1
168700,9,5,1,0,4,1
168700,8,54,15,0,39,15
168700,7,118,22,0,96,22
168700,6,115,15,0,100,15
168700,5,45,10,0,35,10
168700,4,15,5,0,10,5
168700,2,4,1,0,3,1
256066,10,45,4,0,41,4
256066,9,120,20,0,100,20
256066,8,115,20,0,95,20
256066,7,51,12,0,39,12
256066,6,23,2,0,21,2
256066,5,9,3,0,6,3
27800,8,14,2,0,12,2
27800,7,60,11,0,49,11
27800,6,130,33,0,97,33
27800,5,79,24,0,55,24
27800,4,34,13,0,21,13
27800,3,27,9,0,18,9
27800,2,17,9,0,8,9
27800,1,5,2,0,3,2
23348,10,2,1,0,1,1
23348,9,10,5,0,5,5
23348,8,55,22,0,33,22
23348,7,105,51,0,54,51
23348,6,117,36,0,81,36
23348,5,51,16,0,35,16
23348,4,19,7,0,12,7
23348,3,4,3,0,1,3
23348,2,4,1,0,3,1
1726,10,8,3,0,5,3
1726,9,10,5,0,5,5
1726,8,32,15,0,17,15
1726,7,74,28,0,46,28
1726,6,136,50,0,86,50
1726,5,56,20,0,36,20
1726,4,17,6,0,11,6
1726,3,14,6,0,8,6
1726,2,2,1,0,1,1
257726,9,11,2,0,9,2
257726,8,62,14,0,48,14
257726,7,131,17,0,114,17
257726,6,121,13,0,108,13
257726,5,23,4,0,19,4
257726,4,13,1,0,12,1
257726,3,5,2,0,3,2
274,10,5,3,0,2,3
274,9,7,2,0,5,2
274,8,54,33,0,21,33
274,7,94,35,0,59,35
274,6,128,33,0,95,33
274,5,45,12,0,33,12
274,4,16,5,0,11,5
274,3,8,2,0,6,2
274,2,8,4,0,4,4
274,1,2,1,0,1,1
185374,10,7,2,0,5,2
185374,9,11,2,0,9,2
185374,8,57,12,0,45,12
185374,7,111,12,0,99,12
185374,6,120,17,0,103,17
185374,5,39,5,0,34,5
185374,4,13,2,0,11,2
185374,3,6,1,0,5,1
185374,1,1,1,0,0,1
1146,10,3,1,0,2,1
1146,9,5,3,0,2,3
1146,8,35,13,0,22,13
1146,7,51,27,0,24,27
1146,6,120,35,0,85,35
1146,5,71,20,0,51,20
1146,4,43,12,0,31,12
1146,3,26,11,0,15,11
1146,2,7,2,0,5,2
1146,1,5,2,0,3,2
154910,10,134,43,1,91,42
154910,9,122,22,0,100,22
154910,8,65,13,0,52,13
154910,7,13,3,0,10,3
154910,6,12,6,0,6,6
154910,5,11,2,0,9,2
154910,3,3,2,0,1,2
154910,2,4,2,0,2,2
5711,10,7,3,0,4,3
5711,9,11,4,0,7,4
5711,8,52,12,0,40,12
5711,7,113,32,0,81,32
5711,6,117,26,0,91,26
5711,5,28,8,0,20,8
5711,4,20,5,0,15,5
5711,3,12,4,0,8,4
204599,10,5,2,0,3,2
204599,9,7,1,0,6,1
204599,8,54,12,0,42,12
204599,7,91,7,0,84,7
204599,6,109,12,0,97,12
204599,5,41,6,0,35,6
204599,4,10,1,0,9,1
204599,2,2,1,0,1,1
204599,1,1,1,0,0,1
2879,10,9,2,0,7,2
2879,9,12,6,0,6,6
2879,8,37,15,0,22,15
2879,7,72,20,0,52,20
2879,6,106,29,0,77,29
2879,5,55,18,0,37,18
2879,4,42,20,0,22,20
2879,3,15,7,0,8,7
2879,2,9,2,0,7,2
2879,1,9,5,0,4,5
31954,10,9,4,0,5,4
31954,9,34,9,0,25,9
31954,8,150,44,0,106,44
31954,7,102,24,0,78,24
31954,6,49,13,0,36,13
31954,5,13,6,0,7,6
31954,4,3,1,0,2,1
31954,2,2,2,0,0,2
31954,1,2,2,0,0,2
13337,10,14,5,0,9,5
13337,9,15,6,0,9,6
13337,8,65,23,0,42,23
13337,7,78,19,0,59,19
13337,6,95,25,0,70,25
13337,5,67,21,0,46,21
13337,4,23,8,0,15,8
13337,3,4,1,0,3,1
13337,2,4,4,0,0,4
61470,9,6,2,0,4,2
61470,8,30,3,0,27,3
61470,7,57,3,0,54,3
61470,6,117,8,0,109,8
61470,5,61,2,0,59,2
61470,4,39,5,0,34,5
61470,3,23,4,0,19,4
61470,2,16,8,0,8,8
61470,1,13,1,0,12,1
541,10,26,11,0,15,11
541,9,54,26,0,28,26
541,8,115,38,0,77,38
541,7,91,29,0,62,29
541,6,52,17,0,35,17
541,5,14,8,0,6,8
541,4,9,5,0,4,5
541,3,1,1,0,0,1
159141,10,5,1,0,4,1
159141,9,17,5,0,12,5
159141,8,71,18,0,53,18
159141,7,89,21,0,68,21
159141,6,104,17,0,87,17
159141,5,43,17,0,26,17
159141,4,21,5,0,16,5
159141,3,11,1,0,10,1
3855,10,15,5,0,10,5
3855,9,27,10,0,17,10
3855,8,57,11,0,46,11
3855,7,69,17,0,52,17
3855,6,65,19,0,46,19
3855,5,18,4,0,14,4
3855,4,7,2,0,5,2
149869,10,7,1,0,6,1
149869,9,8,2,0,6,2
149869,8,63,12,0,51,12
149869,7,116,13,0,103,13
149869,6,110,9,0,101,9
149869,5,31,4,0,27,4
149869,4,16,1,0,15,1
72848,10,3,1,0,2,1
72848,9,8,1,0,7,1
72848,8,56,6,0,50,6
72848,7,69,7,0,62,7
72848,6,118,20,0,98,20
72848,5,49,13,0,36,13
72848,4,32,10,1,22,9
72848,3,18,6,0,12,6
72848,2,8,2,0,6,2
72848,1,4,3,0,1,3
245961,10,17,3,0,14,3
245961,9,65,12,0,53,12
245961,8,157,31,2,126,29
245961,7,81,17,0,64,17
245961,6,32,5,0,27,5
245961,5,6,5,1,1,4
245961,4,4,2,0,2,2
245961,3,3,1,0,2,1
40251,10,4,2,0,2,2
40251,9,14,3,0,11,3
40251,8,40,11,0,29,11
40251,7,72,14,0,58,14
40251,6,114,23,0,91,23
40251,5,51,14,0,37,14
40251,4,40,8,0,32,8
40251,3,13,4,0,9,4
40251,2,10,2,0,8,2
40251,1,7,3,0,4,3
253214,10,35,4,0,31,4
253214,9,71,9,0,62,9
253214,8,127,25,0,102,25
253214,7,74,11,0,63,11
253214,6,39,7,0,32,7
253214,5,12,4,0,8,4
253214,4,10,3,0,7,3
3749,9,4,1,0,3,1
3749,8,34,17,0,17,17
3749,7,56,23,0,33,23
3749,6,151,47,0,104,47
3749,5,63,18,0,45,18
3749,4,35,16,0,19,16
3749,3,14,6,0,8,6
3749,1,3,2,0,1,2
136558,10,11,2,0,9,2
136558,9,12,3,0,9,3
136558,8,82,19,2,63,17
136558,7,123,28,0,95,28
136558,6,105,21,1,84,20
136558,5,18,7,0,11,7
136558,4,5,1,0,4,1
136558,3,4,2,0,2,2
136558,2,2,1,0,1,1
136558,1,2,2,0,0,2
103235,9,3,1,0,2,1
103235,8,55,11,0,44,11
103235,7,102,21,0,81,21
103235,6,113,35,0,78,35
103235,5,48,10,0,38,10
103235,4,24,11,0,13,11
103235,3,12,5,0,7,5
103235,2,6,2,0,4,2
103235,1,1,1,0,0,1
185538,10,99,37,5,62,32
185538,9,101,24,2,77,22
185538,8,88,15,1,73,14
185538,7,42,7,0,35,7
185538,6,13,1,0,12,1
185538,4,5,1,1,4,0
185538,3,4,1,0,3,1
185538,1,9,2,0,7,2
132758,10,9,1,0,8,1
132758,9,20,4,0,16,4
132758,8,105,22,0,83,22
132758,7,126,22,1,104,21
132758,6,78,10,0,68,10
132758,5,18,3,0,15,3
160744,10,6,1,0,5,1
160744,9,29,11,2,18,9
160744,8,97,23,5,74,18
160744,7,109,22,1,87,21
160744,6,66,9,0,57,9
160744,5,25,5,0,20,5
160744,4,17,3,0,14,3
160744,2,5,4,1,1,3
160744,1,3,2,0,1,2
4454,10,14,8,0,6,8
4454,9,26,7,0,19,7
4454,8,51,13,0,38,13
4454,7,94,25,0,69,25
4454,6,90,25,0,65,25
4454,5,41,11,0,30,11
4454,4,22,13,0,9,13
4454,3,16,5,0,11,5
4454,2,9,7,0,2,7
4454,1,1,1,0,0,1
2607,10,6,3,0,3,3
2607,9,9,3,0,6,3
2607,8,29,10,0,19,10
2607,7,76,16,0,60,16
2607,6,126,38,0,88,38
2607,5,75,21,0,54,21
2607,4,31,8,0,23,8
2607,2,4,3,0,1,3
2240,10,8,2,0,6,2
2240,9,7,2,0,5,2
2240,8,38,8,0,30,8
2240,7,43,14,0,29,14
2240,6,123,29,0,94,29
2240,5,74,25,0,49,25
2240,4,45,10,0,35,10
2240,3,19,6,0,13,6
2240,2,7,1,0,6,1
2240,1,1,1,0,0,1
230089,10,7,2,0,5,2
230089,9,14,7,0,7,7
230089,8,91,16,0,75,16
230089,7,100,16,0,84,16
230089,6,104,17,0,87,17
230089,5,34,12,0,22,12
230089,4,7,4,0,3,4
230089,3,4,2,0,2,2
230089,2,1,1,0,0,1
1435,10,3,3,0,0,3
1435,9,3,2,0,1,2
1435,8,22,12,0,10,12
1435,7,38,11,0,27,11
1435,6,121,44,0,77,44
1435,5,85,24,0,61,24
1435,4,52,21,0,31,21
1435,3,27,13,0,14,13
1435,2,10,6,0,4,6
1435,1,2,1,0,1,1
83068,10,3,1,0,2,1
83068,8,48,19,2,29,17
83068,7,63,17,2,46,15
83068,6,124,34,0,90,34
83068,5,77,19,0,58,19
83068,4,31,12,0,19,12
83068,3,8,1,0,7,1
83068,2,2,2,0,0,2
104575,10,6,1,0,5,1
104575,9,14,6,0,8,6
104575,8,63,11,0,52,11
104575,7,77,8,0,69,8
104575,6,110,20,0,90,20
104575,5,47,11,0,36,11
104575,4,25,6,0,19,6
104575,3,9,1,0,8,1
104575,1,5,2,0,3,2
124490,10,6,1,0,5,1
124490,8,60,24,0,36,24
124490,7,100,25,0,75,25
124490,6,121,27,0,94,27
124490,5,32,2,0,30,2
124490,4,25,8,0,17,8
124490,3,9,3,0,6,3
124490,2,4,4,0,0,4
250,10,9,6,0,3,6
250,9,32,5,0,27,5
250,8,68,26,0,42,26
250,7,100,32,0,68,32
250,6,77,24,0,53,24
250,5,45,16,0,29,16
250,4,17,11,0,6,11
250,3,8,3,0,5,3
250,2,4,3,0,1,3
250,1,3,1,0,2,1
124839,10,48,14,1,34,13
124839,9,89,21,0,68,21
124839,8,117,29,2,88,27
124839,7,50,10,2,40,8
124839,6,40,9,2,31,7
124839,5,13,2,0,11,2
124839,4,3,2,0,1,2
124839,3,2,1,0,1,1
124839,1,1,1,0,0,1
313,10,17,8,0,9,8
313,9,33,7,0,26,7
313,8,107,33,0,74,33
313,7,88,18,0,70,18
313,6,71,25,0,46,25
313,5,32,9,0,23,9
313,4,9,3,0,6,3
313,3,3,1,0,2,1
313,1,2,1,0,1,1
17526,10,8,1,0,7,1
17526,9,19,8,0,11,8
17526,8,63,20,0,43,20
17526,7,75,26,0,49,26
17526,6,107,36,0,71,36
17526,5,52,14,0,38,14
17526,4,20,4,0,16,4
17526,3,13,3,0,10,3
17526,2,4,1,0,3,1
163056,10,8,4,0,4,4
163056,9,14,6,0,8,6
163056,8,90,25,2,65,23
163056,7,109,21,0,88,21
163056,6,108,37,3,71,34
163056,5,27,7,0,20,7
163056,3,3,1,0,2,1
426,10,6,3,0,3,3
426,9,14,3,0,11,3
426,8,36,16,0,20,16
426,7,58,22,0,36,22
426,6,83,28,0,55,28
426,5,34,14,0,20,14
426,4,11,6,0,5,6
426,3,6,4,0,2,4
426,2,5,2,0,3,2
155451,10,73,16,0,57,16
155451,9,77,14,0,63,14
155451,8,109,24,0,85,24
155451,7,47,12,0,35,12
155451,6,29,9,0,20,9
155451,5,14,3,0,11,3
155451,4,10,5,0,5,5
155451,2,1,1,0,0,1
155451,1,4,1,0,3,1
165563,9,4,1,0,3,1
165563,8,45,11,0,34,11
165563,7,101,15,0,86,15
165563,6,139,25,0,114,25
165563,5,37,6,0,31,6
165563,4,22,3,0,19,3
165563,3,11,3,0,8,3
137154,10,7,1,0,6,1
137154,9,15,7,0,8,7
137154,8,87,28,0,59,28
137154,7,110,26,0,84,26
137154,6,93,16,0,77,16
137154,5,25,3,0,22,3
137154,4,16,4,0,12,4
137154,3,7,1,0,6,1
137154,2,2,1,0,1,1
197707,9,14,6,0,8,6
197707,8,41,11,0,30,11
197707,7,87,14,0,73,14
197707,6,112,12,0,100,12
197707,5,51,11,0,40,11
197707,4,26,5,0,21,5
197707,3,25,3,0,22,3
197707,1,2,1,0,1,1
246201,10,12,4,0,8,4
246201,9,36,7,0,29,7
246201,8,139,33,2,106,31
246201,7,96,15,2,81,13
246201,6,54,9,0,45,9
246201,5,15,6,0,9,6
246201,4,6,3,0,3,3
246201,3,3,1,1,2,0
4637,10,12,11,0,1,11
4637,9,12,8,0,4,8
4637,8,64,43,0,21,43
4637,7,95,39,0,56,39
4637,6,111,30,0,81,30
4637,5,41,12,0,29,12
4637,4,18,11,0,7,11
4637,1,1,1,0,0,1
61269,10,2,2,0,0,2
61269,8,40,6,0,34,6
61269,7,87,12,0,75,12
61269,6,127,26,0,101,26
61269,5,63,6,0,57,6
61269,4,19,1,0,18,1
61269,3,4,1,0,3,1
61269,2,5,1,0,4,1
828,10,12,7,0,5,7
828,9,19,9,0,10,9
828,8,44,19,0,25,19
828,7,88,21,0,67,21
828,6,111,27,0,84,27
828,5,47,12,0,35,12
828,4,18,8,0,10,8
828,3,13,7,0,6,7
828,2,4,2,0,2,2
828,1,5,3,0,2,3
40871,9,7,1,0,6,1
40871,8,26,5,0,21,5
40871,7,77,17,0,60,17
40871,6,93,21,0,72,21
40871,5,70,16,0,54,16
40871,4,41,8,0,33,8
40871,3,25,4,0,21,4
40871,2,13,7,0,6,7
40871,1,4,4,0,0,4
87904,10,8,1,0,7,1
87904,9,10,2,0,8,2
87904,8,54,3,0,51,3
87904,7,66,4,0,62,4
87904,6,116,16,0,100,16
87904,5,57,5,0,52,5
87904,4,30,6,0,24,6
87904,3,16,3,0,13,3
87904,2,3,2,0,1,2
2537,8,18,7,0,11,7
2537,7,63,15,0,48,15
2537,6,123,36,0,87,36
2537,5,81,18,0,63,18
2537,4,40,14,0,26,14
2537,3,22,5,0,17,5
2537,2,7,5,0,2,5
2537,1,6,2,0,4,2
142084,10,24,6,1,18,5
142084,9,32,15,0,17,15
142084,8,131,31,3,100,28
142084,7,95,20,3,75,17
142084,6,61,15,1,46,14
142084,5,6,2,1,4,1
142084,4,5,2,0,3,2
142084,3,3,1,0,2,1
142084,1,2,1,0,1,1
6381,10,4,2,0,2,2
6381,9,3,2,0,1,2
6381,8,22,2,0,20,2
6381,7,59,17,0,42,17
6381,6,126,32,0,94,32
6381,5,88,16,0,72,16
6381,4,40,12,0,28,12
6381,3,15,2,0,13,2
6381,2,4,1,0,3,1
188178,10,35,24,1,11,23
188178,9,46,27,1,19,26
188178,8,115,42,6,73,36
188178,7,77,19,1,58,18
188178,6,42,7,1,35,6
188178,5,20,7,2,13,5
188178,4,13,4,0,9,4
188178,3,3,2,0,1,2
188178,2,8,5,0,3,5
188178,1,4,3,1,1,2
154560,10,10,1,0,9,1
154560,9,10,1,0,9,1
154560,8,46,6,0,40,6
154560,7,75,8,0,67,8
154560,6,121,20,0,101,20
154560,5,60,6,0,54,6
154560,4,23,4,0,19,4
154560,3,12,7,0,5,7
154560,2,3,1,0,2,1
21150,8,20,8,0,12,8
21150,7,65,33,0,32,33
21150,6,125,49,0,76,49
21150,5,69,32,0,37,32
21150,4,42,17,0,25,17
21150,3,23,11,0,12,11
21150,2,11,6,0,5,6
21150,1,6,3,0,3,3
16693,10,9,2,0,7,2
16693,9,7,2,0,5,2
16693,8,37,6,0,31,6
16693,7,62,14,0,48,14
16693,6,131,34,0,97,34
16693,5,70,13,0,57,13
16693,4,31,11,0,20,11
16693,3,6,1,0,5,1
16693,2,5,2,0,3,2
16693,1,3,1,0,2,1
816,10,16,5,0,11,5
816,9,32,13,0,19,13
816,8,101,31,0,70,31
816,7,101,24,0,77,24
816,6,72,21,0,51,21
816,5,21,5,0,16,5
816,4,13,5,0,8,5
816,2,2,1,0,1,1
5297,10,12,6,0,6,6
5297,9,27,9,0,18,9
5297,8,64,32,0,32,32
5297,7,112,45,0,67,45
5297,6,87,29,0,58,29
5297,5,37,12,0,25,12
5297,4,14,5,0,9,5
5297,3,7,2,0,5,2
5297,1,1,1,0,0,1
85243,9,5,1,0,4,1
85243,8,21,2,0,19,2
85243,7,63,13,0,50,13
85243,6,141,27,0,114,27
85243,5,75,17,0,58,17
85243,4,30,4,0,26,4
85243,3,16,4,0,12,4
85243,2,5,1,0,4,1
4327,9,4,3,0,1,3
4327,8,21,9,0,12,9
4327,7,65,18,0,47,18
4327,6,142,42,0,100,42
4327,5,67,20,0,47,20
4327,4,41,16,0,25,16
4327,3,11,3,0,8,3
4327,2,7,3,0,4,3
5941,9,5,1,0,4,1
5941,8,52,21,0,31,21
5941,7,99,35,0,64,35
5941,6,120,38,0,82,38
5941,5,49,10,0,39,10
5941,4,24,7,0,17,7
5941,3,6,4,0,2,4
5941,1,1,1,0,0,1
9004,10,6,3,0,3,3
9004,9,7,1,0,6,1
9004,8,3,2,0,1,2
9004,7,31,10,0,21,10
9004,6,50,16,0,34,16
9004,5,88,22,0,66,22
9004,4,100,28,0,72,28
9004,3,44,14,0,30,14
9004,2,19,6,0,13,6
9004,1,12,4,0,8,4
2063,10,9,1,0,8,1
2063,9,22,11,0,11,11
2063,8,71,29,0,42,29
2063,7,100,26,0,74,26
2063,6,92,21,0,71,21
2063,5,31,15,0,16,15
2063,4,25,15,0,10,15
2063,3,7,2,0,5,2
2063,2,2,1,0,1,1
2063,1,1,1,0,0,1
206448,9,7,4,0,3,4
206448,8,47,5,0,42,5
206448,7,110,20,0,90,20
206448,6,122,12,0,110,12
206448,5,36,5,0,31,5
206448,4,24,4,0,20,4
206448,3,7,2,0,5,2
206448,2,4,1,0,3,1
231223,9,9,5,1,4,4
231223,8,70,13,1,57,12
231223,7,99,15,1,84,14
231223,6,96,17,1,79,16
231223,5,50,10,0,40,10
231223,4,23,6,1,17,5
231223,3,6,2,0,4,2
231223,2,2,1,0,1,1
6608,10,3,2,0,1,2
6608,9,9,3,0,6,3
6608,8,45,15,0,30,15
6608,7,84,28,0,56,28
6608,6,112,34,0,78,34
6608,5,52,11,0,41,11
6608,4,38,15,0,23,15
6608,3,11,6,0,5,6
6608,2,3,2,0,1,2
6608,1,3,2,0,1,2
1702,10,2,1,0,1,1
1702,9,9,1,0,8,1
1702,8,66,23,0,43,23
1702,7,83,21,0,62,21
1702,6,118,35,0,83,35
1702,5,46,13,0,33,13
1702,4,24,9,0,15,9
1702,3,11,3,0,8,3
74102,10,4,1,0,3,1
74102,8,58,11,0,47,11
74102,7,95,14,0,81,14
74102,6,114,19,0,95,19
74102,5,49,7,0,42,7
74102,4,21,6,0,15,6
74102,3,8,4,0,4,4
74102,2,7,2,0,5,2
261594,10,45,7,0,38,7
261594,9,107,14,0,93,14
261594,8,137,21,0,116,21
261594,7,48,3,0,45,3
261594,6,12,2,0,10,2
261594,5,7,2,0,5,2
261594,3,3,1,0,2,1
261594,1,1,1,0,0,1
27155,9,9,1,0,8,1
27155,8,31,10,0,21,10
27155,7,50,8,0,42,8
27155,6,117,19,0,98,19
27155,5,77,9,0,68,9
27155,4,35,4,0,31,4
27155,3,21,1,0,20,1
27155,2,10,4,0,6,4
27155,1,8,3,0,5,3
5425,8,16,1,0,15,1
5425,7,42,7,0,35,7
5425,6,110,20,0,90,20
5425,5,86,25,0,61,25
5425,4,55,8,0,47,8
5425,3,32,12,0,20,12
5425,2,10,5,0,5,5
5425,1,4,2,0,2,2
7742,10,28,15,0,13,15
7742,9,41,20,0,21,20
7742,8,71,23,0,48,23
7742,7,96,16,0,80,16
7742,6,60,19,0,41,19
7742,5,37,11,0,26,11
7742,4,10,3,0,7,3
7742,3,11,6,0,5,6
7742,2,5,4,0,1,4
37612,9,11,2,0,9,2
37612,8,25,4,0,21,4
37612,7,66,13,0,53,13
37612,6,112,20,0,92,20
37612,5,69,14,0,55,14
37612,4,36,9,0,27,9
37612,3,24,6,0,18,6
37612,1,6,2,0,4,2
206490,10,11,3,0,8,3
206490,9,46,11,0,35,11
206490,8,143,35,0,108,35
206490,7,68,16,0,52,16
206490,6,47,11,0,36,11
206490,5,20,6,0,14,6
206490,4,17,3,0,14,3
206490,3,5,3,0,2,3
206490,2,2,2,0,0,2
7989,10,11,2,0,9,2
7989,9,5,4,0,1,4
7989,8,31,13,0,18,13
7989,7,65,22,0,43,22
7989,6,139,37,0,102,37
7989,5,68,21,0,47,21
7989,4,25,10,0,15,10
7989,3,10,5,0,5,5
7989,1,1,1,0,0,1
177210,9,6,2,0,4,2
177210,8,43,8,0,35,8
177210,7,76,11,0,65,11
177210,6,121,21,0,100,21
177210,5,58,8,0,50,8
177210,4,25,8,0,17,8
177210,3,13,4,0,9,4
177210,2,12,2,0,10,2
4789,10,5,1,0,4,1
4789,8,31,5,0,26,5
4789,7,60,16,0,44,16
4789,6,93,10,0,83,10
4789,5,83,15,0,68,15
4789,4,51,10,0,41,10
4789,3,21,10,0,11,10
4789,2,11,4,0,7,4
192401,10,8,1,0,7,1
192401,9,22,3,0,19,3
192401,8,84,12,0,72,12
192401,7,96,16,2,80,14
192401,6,89,12,0,77,12
192401,5,35,3,0,32,3
192401,4,16,4,1,12,3
192401,3,5,1,0,4,1
3563,10,10,1,0,9,1
3563,9,18,6,0,12,6
3563,8,68,16,0,52,16
3563,7,95,20,0,75,20
3563,6,99,23,0,76,23
3563,5,37,12,0,25,12
3563,4,12,6,0,6,6
3563,3,8,4,0,4,4
3563,2,6,2,0,4,2
20082,10,4,1,0,3,1
20082,9,4,2,0,2,2
20082,8,39,11,0,28,11
20082,7,89,18,0,71,18
20082,6,130,27,0,103,27
20082,5,51,21,0,30,21
20082,4,28,10,0,18,10
20082,3,7,3,0,4,3
20082,2,6,3,0,3,3
180325,10,15,4,0,11,4
180325,9,24,3,0,21,3
180325,8,95,16,0,79,16
180325,7,118,19,0,99,19
180325,6,83,14,0,69,14
180325,5,17,3,0,14,3
180325,2,1,1,0,0,1
259374,9,29,5,0,24,5
259374,8,139,30,0,109,30
259374,7,100,17,0,83,17
259374,6,62,11,0,51,11
259374,5,14,2,0,12,2
259374,4,6,3,0,3,3
259374,3,3,2,0,1,2
1202,10,10,4,0,6,4
1202,9,19,6,0,13,6
1202,8,51,19,0,32,19
1202,7,73,24,0,49,24
1202,6,120,33,0,87,33
1202,5,55,14,0,41,14
1202,4,18,12,0,6,12
1202,3,7,2,0,5,2
1202,2,3,2,0,1,2
238393,10,45,8,0,37,8
238393,9,74,8,0,66,8
238393,8,120,13,0,107,13
238393,7,64,4,0,60,4
238393,6,38,1,0,37,1
238393,5,7,3,0,4,3
4318,9,8,2,0,6,2
4318,8,50,18,0,32,18
4318,7,83,27,0,56,27
4318,6,127,42,0,85,42
4318,5,46,18,0,28,18
4318,4,25,9,0,16,9
4318,3,11,5,0,6,5
4318,2,5,1,0,4,1
43,10,7,1,0,6,1
43,9,16,5,0,11,5
43,8,61,11,0,50,11
43,7,109,21,0,88,21
43,6,102,26,0,76,26
43,5,33,14,0,19,14
43,4,21,6,0,15,6
43,3,3,2,0,1,2
43,2,4,1,0,3,1
135648,10,3,1,0,2,1
135648,9,5,2,0,3,2
135648,8,15,3,0,12,3
135648,7,51,13,0,38,13
135648,6,128,21,0,107,21
135648,5,78,15,0,63,15
135648,4,44,6,0,38,6
135648,3,21,6,0,15,6
135648,2,7,3,0,4,3
135648,1,4,3,0,1,3
198287,10,44,4,0,40,4
198287,9,75,8,0,67,8
198287,8,137,12,0,125,12
198287,7,58,4,0,54,4
198287,6,28,3,0,25,3
198287,5,7,1,0,6,1
198287,4,3,3,0,0,3
198287,3,1,1,0,0,1
72667,10,17,6,0,11,6
72667,9,32,11,0,21,11
72667,8,113,35,0,78,35
72667,7,97,17,0,80,17
72667,6,73,20,0,53,20
72667,5,14,4,0,10,4
72667,4,4,1,0,3,1
72667,3,3,3,0,0,3
72667,2,1,1,0,0,1
172613,10,9,2,0,7,2
172613,9,15,4,0,11,4
172613,8,74,12,0,62,12
172613,7,112,11,0,101,11
172613,6,90,13,0,77,13
172613,5,31,8,0,23,8
172613,4,13,3,0,10,3
172613,3,10,6,0,4,6
187353,10,28,7,0,21,7
187353,9,46,4,0,42,4
187353,8,120,9,0,111,9
187353,7,87,7,0,80,7
187353,6,53,9,0,44,9
187353,5,10,1,0,9,1
187353,3,2,1,0,1,1
187353,2,5,3,0,2,3
104805,9,5,1,0,4,1
104805,8,40,11,0,29,11
104805,7,85,13,0,72,13
104805,6,156,41,0,115,41
104805,5,45,11,0,34,11
104805,4,18,9,0,9,9
104805,3,4,1,0,3,1
187687,10,59,14,0,45,14
187687,9,81,12,0,69,12
187687,8,127,13,0,114,13
187687,7,58,8,0,50,8
187687,6,18,3,0,15,3
187687,5,2,2,0,0,2
187687,4,5,1,0,4,1
187687,3,2,1,0,1,1
125148,10,11,6,0,5,6
125148,9,5,1,0,4,1
125148,8,28,5,1,23,4
125148,7,68,15,5,53,10
125148,6,99,21,1,78,20
125148,5,58,16,0,42,16
125148,4,35,12,0,23,12
125148,3,18,6,1,12,5
125148,2,15,6,1,9,5
125148,1,17,5,0,12,5
75448,10,29,5,0,24,5
75448,9,56,12,1,44,11
75448,8,112,16,0,96,16
75448,7,92,11,0,81,11
75448,6,43,9,0,34,9
75448,4,5,2,0,3,2
75448,2,2,1,0,1,1
197455,10,4,1,0,3,1
197455,9,10,2,0,8,2
197455,8,54,7,0,47,7
197455,7,97,19,0,78,19
197455,6,122,26,0,96,26
197455,5,44,8,0,36,8
197455,4,12,1,0,11,1
197455,3,9,4,0,5,4
197455,2,2,1,0,1,1
32405,9,8,2,0,6,2
32405,8,21,6,0,15,6
32405,7,64,12,0,52,12
32405,6,150,30,0,120,30
32405,5,63,14,0,49,14
32405,4,29,6,0,23,6
32405,3,13,4,0,9,4
35669,10,12,4,0,8,4
35669,9,49,14,0,35,14
35669,8,126,40,0,86,40
35669,7,94,28,0,66,28
35669,6,49,16,0,33,16
35669,5,11,4,0,7,4
35669,4,7,4,0,3,4
35669,2,2,1,0,1,1
35669,1,2,1,0,1,1
1679,10,34,13,0,21,13
1679,9,45,20,0,25,20
1679,8,95,28,0,67,28
1679,7,91,27,0,64,27
1679,6,49,12,0,37,12
1679,5,21,8,0,13,8
1679,4,11,5,0,6,5
1679,3,5,1,0,4,1
9108,10,1,1,0,0,1
9108,9,7,3,0,4,3
9108,8,37,11,0,26,11
9108,7,75,25,0,50,25
9108,6,123,25,0,98,25
9108,5,66,15,0,51,15
9108,4,32,14,0,18,14
9108,3,9,6,0,3,6
9108,2,2,1,0,1,1
944,10,4,1,0,3,1
944,9,7,2,0,5,2
944,8,31,7,0,24,7
944,7,86,32,0,54,32
944,6,118,31,0,87,31
944,5,42,10,0,32,10
944,4,32,12,0,20,12
944,3,24,15,0,9,15
944,2,5,3,0,2,3
3613,10,10,2,0,8,2
3613,9,27,9,0,18,9
3613,8,67,23,0,44,23
3613,7,99,22,0,77,22
3613,6,91,27,0,64,27
3613,5,29,10,0,19,10
3613,4,20,6,0,14,6
3613,3,5,1,0,4,1
3613,2,4,1,0,3,1
3613,1,1,1,0,0,1
2936,9,5,1,0,4,1
2936,8,30,11,0,19,11
2936,7,76,16,0,60,16
2936,6,137,37,0,100,37
2936,5,59,12,0,47,12
2936,4,31,7,0,24,7
2936,3,8,3,0,5,3
2936,2,6,1,0,5,1
645,10,2,2,0,0,2
645,9,5,3,0,2,3
645,8,29,14,0,15,14
645,7,69,20,0,49,20
645,6,119,33,0,86,33
645,5,71,24,0,47,24
645,4,39,10,0,29,10
645,3,11,5,0,6,5
645,2,7,6,0,1,6
1525,10,5,4,0,1,4
1525,9,9,4,0,5,4
1525,8,53,23,0,30,23
1525,7,79,26,0,53,26
1525,6,115,35,0,80,35
1525,5,59,24,0,35,24
1525,4,17,6,0,11,6
1525,3,14,6,0,8,6
42206,10,3,1,0,2,1
42206,9,8,3,0,5,3
42206,8,23,8,0,15,8
42206,7,71,20,0,51,20
42206,6,146,33,0,113,33
42206,5,61,13,0,48,13
42206,4,25,4,0,21,4
42206,3,9,2,0,7,2
183572,10,37,6,0,31,6
183572,9,50,5,0,45,5
183572,8,117,11,0,106,11
183572,7,75,6,0,69,6
183572,6,56,5,0,51,5
183572,5,8,2,0,6,2
183572,4,6,1,0,5,1
183572,2,1,1,0,0,1
91671,10,10,4,0,6,4
91671,9,14,5,0,9,5
91671,8,54,13,0,41,13
91671,7,84,22,0,62,22
91671,6,102,17,0,85,17
91671,5,47,7,0,40,7
91671,4,26,3,0,23,3
91671,3,11,3,0,8,3
91671,2,3,1,0,2,1
10520,10,2,1,0,1,1
10520,9,7,1,0,6,1
10520,8,35,12,0,23,12
10520,7,81,18,0,63,18
10520,6,122,29,0,93,29
10520,5,60,18,0,42,18
10520,4,29,9,0,20,9
10520,3,10,3,0,7,3
10520,2,5,3,0,2,3
10520,1,1,1,0,0,1
85769,10,46,16,0,30,16
85769,9,71,17,0,54,17
85769,8,114,32,0,82,32
85769,7,68,14,0,54,14
85769,6,25,10,0,15,10
85769,5,10,4,0,6,4
85769,4,7,3,0,4,3
85769,3,5,3,0,2,3
85769,2,2,2,0,0,2
21854,9,9,4,0,5,4
21854,8,38,12,0,26,12
21854,7,78,33,0,45,33
21854,6,145,56,0,89,56
21854,5,43,13,0,30,13
21854,4,26,9,0,17,9
21854,3,8,6,0,2,6
21854,2,2,1,0,1,1
55911,9,5,2,0,3,2
55911,8,35,7,0,28,7
55911,7,78,25,0,53,25
55911,6,131,33,0,98,33
55911,5,61,13,0,48,13
55911,4,26,7,0,19,7
55911,3,8,1,0,7,1
141735,9,5,1,0,4,1
141735,8,48,8,0,40,8
141735,7,86,13,0,73,13
141735,6,115,32,0,83,32
141735,5,52,13,0,39,13
141735,4,30,5,0,25,5
141735,3,10,2,0,8,2
10672,10,4,2,0,2,2
10672,9,4,1,0,3,1
10672,8,36,20,0,16,20
10672,7,62,25,0,37,25
10672,6,124,59,0,65,59
10672,5,76,30,0,46,30
10672,4,28,14,0,14,14
10672,3,11,8,0,3,8
10672,2,6,4,0,2,4
175222,10,6,1,0,5,1
175222,9,13,1,0,12,1
175222,8,97,20,0,77,20
175222,7,123,22,0,101,22
175222,6,77,10,0,67,10
175222,5,22,5,0,17,5
175222,4,8,1,0,7,1
175222,3,3,1,0,2,1
127282,10,10,3,0,7,3
127282,9,21,9,0,12,9
127282,8,74,18,0,56,18
127282,7,97,29,0,68,29
127282,6,81,30,0,51,30
127282,5,33,13,0,20,13
127282,4,19,9,0,10,9
127282,3,13,5,0,8,5
127282,2,3,1,0,2,1
765,9,4,1,0,3,1
765,8,25,6,0,19,6
765,7,83,22,0,61,22
765,6,122,38,0,84,38
765,5,64,17,0,47,17
765,4,36,10,0,26,10
765,3,9,2,0,7,2
765,1,2,2,0,0,2
224133,10,17,9,0,8,9
224133,9,38,9,0,29,9
224133,8,113,30,0,83,30
224133,7,91,13,0,78,13
224133,6,70,19,0,51,19
224133,5,18,6,0,12,6
159575,10,13,7,0,6,7
159575,9,29,8,1,21,7
159575,8,82,19,1,63,18
159575,7,105,15,1,90,14
159575,6,92,14,1,78,13
159575,5,20,3,0,17,3
159575,4,3,1,0,2,1
159575,3,5,2,1,3,1
3947,10,5,1,0,4,1
3947,9,13,5,0,8,5
3947,8,25,10,0,15,10
3947,7,60,14,0,46,14
3947,6,115,30,0,85,30
3947,5,61,13,0,48,13
3947,4,43,13,0,30,13
3947,3,16,7,0,9,7
3947,2,10,6,0,4,6
3947,1,3,3,0,0,3
161965,9,5,1,0,4,1
161965,8,59,15,1,44,14
161965,7,103,13,0,90,13
161965,6,108,23,0,85,23
161965,5,49,10,0,39,10
161965,4,14,4,0,10,4
161965,2,3,2,0,1,2
2350,10,10,2,0,8,2
2350,9,8,5,0,3,5
2350,8,20,4,0,16,4
2350,7,42,17,0,25,17
2350,6,140,48,0,92,48
2350,5,85,32,0,53,32
2350,4,31,17,0,14,17
2350,3,11,5,0,6,5
2350,2,3,1,0,2,1
3263,10,24,7,0,17,7
3263,9,63,19,0,44,19
3263,8,147,43,0,104,43
3263,7,76,24,0,52,24
3263,6,28,8,0,20,8
3263,5,8,1,0,7,1
3263,4,3,2,0,1,2
243430,10,11,3,0,8,3
243430,9,22,5,0,17,5
243430,8,88,18,0,70,18
243430,7,131,26,0,105,26
243430,6,71,12,0,59,12
243430,5,19,5,0,14,5
243430,4,6,2,0,4,2
3553,10,40,15,0,25,15
3553,9,66,21,0,45,21
3553,8,131,39,0,92,39
3553,7,52,10,0,42,10
3553,6,40,19,0,21,19
3553,5,13,5,0,8,5
3553,4,2,2,0,0,2
3553,3,2,1,0,1,1
3553,1,2,1,0,1,1
3413,10,10,1,0,9,1
3413,9,16,8,0,8,8
3413,8,114,42,0,72,42
3413,7,117,43,0,74,43
3413,6,61,24,0,37,24
3413,5,20,8,0,12,8
3413,4,9,6,0,3,6
3413,1,1,1,0,0,1
134150,9,12,1,0,11,1
134150,8,72,15,0,57,15
134150,7,97,10,0,87,10
134150,6,102,15,0,87,15
134150,5,46,6,0,40,6
134150,4,13,2,0,11,2
134150,3,4,1,0,3,1
27739,10,18,5,0,13,5
27739,9,53,27,0,26,27
27739,8,149,57,2,92,55
27739,7,71,30,0,41,30
27739,6,35,13,0,22,13
27739,5,13,7,0,6,7
27739,4,3,1,0,2,1
27739,3,4,1,0,3,1
27739,2,2,1,0,1,1
27739,1,2,1,0,1,1
2139,10,6,4,0,2,4
2139,9,5,1,0,4,1
2139,8,31,8,0,23,8
2139,7,45,16,0,29,16
2139,6,105,33,0,72,33
2139,5,82,23,0,59,23
2139,4,37,12,0,25,12
2139,3,25,8,0,17,8
2139,2,7,5,0,2,5
2139,1,7,5,0,2,5
33155,9,2,1,0,1,1
33155,8,42,12,0,30,12
33155,7,92,26,0,66,26
33155,6,138,36,0,102,36
33155,5,51,6,0,45,6
33155,4,19,5,0,14,5
33155,3,2,2,0,0,2
33155,2,3,1,0,2,1
126613,10,20,6,0,14,6
126613,9,36,4,0,32,4
126613,8,75,15,0,60,15
126613,7,82,5,0,77,5
126613,6,72,13,0,59,13
126613,5,27,4,0,23,4
126613,3,8,1,0,7,1
126613,2,6,2,0,4,2
126613,1,10,2,0,8,2
219832,10,21,3,0,18,3
219832,9,46,12,3,34,9
219832,8,136,26,5,110,21
219832,7,79,10,1,69,9
219832,6,38,5,0,33,5
219832,5,18,7,1,11,6
219832,4,5,3,0,2,3
219832,3,6,1,0,5,1
219832,2,1,1,0,0,1
6542,10,25,9,0,16,9
6542,9,44,17,0,27,17
6542,8,116,41,0,75,41
6542,7,79,25,0,54,25
6542,6,55,21,0,34,21
6542,5,19,10,0,9,10
6542,4,5,4,0,1,4
6542,3,2,2,0,0,2
499,10,3,2,0,1,2
499,9,5,2,0,3,2
499,8,59,20,0,39,20
499,7,90,33,0,57,33
499,6,121,44,0,77,44
499,5,49,22,0,27,22
499,4,19,3,0,16,3
499,3,4,1,0,3,1
156457,10,8,2,0,6,2
156457,9,7,4,0,3,4
156457,8,28,4,0,24,4
156457,7,77,11,0,66,11
156457,6,150,17,0,133,17
156457,5,50,10,0,40,10
156457,4,17,1,0,16,1
156457,3,10,1,0,9,1
263,10,1,1,0,0,1
263,8,29,9,0,20,9
263,7,91,21,0,70,21
263,6,142,35,0,107,35
263,5,61,14,0,47,14
263,4,17,2,0,15,2
263,2,2,1,0,1,1
164237,9,9,1,0,8,1
164237,8,65,10,0,55,10
164237,7,106,19,2,87,17
164237,6,113,29,0,84,29
164237,5,31,8,0,23,8
164237,4,15,2,0,13,2
42929,10,15,4,0,11,4
42929,9,28,7,0,21,7
42929,8,129,31,0,98,31
42929,7,93,22,0,71,22
42929,6,49,16,0,33,16
42929,5,18,6,0,12,6
42929,4,11,4,0,7,4
42929,3,2,1,0,1,1
42929,2,4,1,0,3,1
152510,9,28,5,0,23,5
152510,8,82,10,0,72,10
152510,7,125,24,0,101,24
152510,6,76,6,0,70,6
152510,5,16,1,0,15,1
152510,4,4,1,0,3,1
152510,3,2,1,0,1,1
152510,1,2,1,0,1,1
67,10,17,5,0,12,5
67,9,11,2,0,9,2
67,8,50,15,0,35,15
67,7,70,21,0,49,21
67,6,102,33,0,69,33
67,5,58,18,0,40,18
67,4,17,5,0,12,5
67,3,19,8,0,11,8
67,2,5,1,0,4,1
18127,9,3,2,0,1,2
18127,8,26,10,0,16,10
18127,7,68,34,0,34,34
18127,6,132,40,0,92,40
18127,5,67,29,0,38,29
18127,4,24,13,0,11,13
18127,3,17,7,0,10,7
18127,2,9,4,0,5,4
18127,1,1,1,0,0,1
104655,10,1,1,0,0,1
104655,9,4,1,0,3,1
104655,8,32,10,2,22,8
104655,7,80,24,1,56,23
104655,6,126,29,1,97,28
104655,5,62,15,3,47,12
104655,4,30,9,1,21,8
104655,3,12,4,0,8,4
147194,8,50,12,0,38,12
147194,7,85,9,0,76,9
147194,6,119,16,0,103,16
147194,5,45,10,0,35,10
147194,4,25,3,0,22,3
147194,3,5,1,0,4,1
147194,2,3,1,0,2,1
24568,10,10,3,0,7,3
24568,9,23,3,0,20,3
24568,8,81,11,0,70,11
24568,7,104,20,0,84,20
24568,6,101,17,0,84,17
24568,5,24,2,0,22,2
24568,4,5,1,0,4,1
121993,9,4,1,0,3,1
121993,8,36,5,0,31,5
121993,7,113,21,0,92,21
121993,6,134,24,0,110,24
121993,5,35,4,0,31,4
121993,4,12,2,0,10,2
121993,3,8,2,0,6,2
121993,1,1,1,0,0,1
162378,9,10,3,0,7,3
162378,8,44,5,0,39,5
162378,7,80,11,0,69,11
162378,6,130,20,0,110,20
162378,5,53,9,0,44,9
162378,4,17,2,0,15,2
162378,3,6,1,0,5,1
162378,2,3,1,0,2,1
38858,9,4,2,0,2,2
38858,8,37,11,0,26,11
38858,7,94,24,0,70,24
38858,6,132,17,0,115,17
38858,5,48,15,0,33,15
38858,4,18,7,0,11,7
38858,3,8,5,0,3,5
7320,10,1,1,0,0,1
7320,9,2,2,0,0,2
7320,8,8,5,0,3,5
7320,7,23,13,0,10,13
7320,6,58,23,0,35,23
7320,5,81,26,0,55,26
7320,4,89,32,0,57,32
7320,3,44,13,0,31,13
7320,2,26,13,0,13,13
7320,1,16,6,0,10,6
232079,10,12,5,0,7,5
232079,9,15,8,0,7,8
232079,8,60,10,0,50,10
232079,7,102,13,0,89,13
232079,6,114,19,0,95,19
232079,5,24,2,0,22,2
232079,4,14,7,0,7,7
232079,2,2,1,0,1,1
18975,10,6,5,0,1,5
18975,9,13,8,0,5,8
18975,8,49,22,0,27,22
18975,7,81,33,0,48,33
18975,6,102,34,0,68,34
18975,5,49,18,0,31,18
18975,4,27,12,0,15,12
18975,3,17,9,0,8,9
18975,2,3,1,0,2,1
2978,10,5,2,0,3,2
2978,9,10,5,0,5,5
2978,8,30,7,0,23,7
2978,7,71,18,0,53,18
2978,6,122,15,0,107,15
2978,5,68,15,0,53,15
2978,4,25,4,0,21,4
2978,3,12,2,0,10,2
2978,2,5,4,0,1,4
158564,10,9,3,0,6,3
158564,9,18,9,0,9,9
158564,8,58,13,1,45,12
158564,7,77,18,0,59,18
158564,6,108,22,0,86,22
158564,5,34,1,0,33,1
158564,4,24,7,0,17,7
158564,3,7,1,0,6,1
158564,2,9,2,0,7,2
158564,1,4,1,0,3,1
245444,10,16,3,0,13,3
245444,9,28,8,0,20,8
245444,8,66,15,0,51,15
245444,7,70,11,0,59,11
245444,6,92,13,0,79,13
245444,5,25,5,0,20,5
245444,4,22,8,0,14,8
245444,3,13,2,0,11,2
245444,2,13,6,0,7,6
245444,1,5,2,0,3,2
199780,10,12,1,0,11,1
199780,9,16,4,0,12,4
199780,8,69,12,0,57,12
199780,7,115,19,0,96,19
199780,6,80,12,0,68,12
199780,5,30,6,0,24,6
199780,4,11,1,0,10,1
199780,3,9,4,0,5,4
199780,2,4,1,0,3,1
134520,10,39,12,0,27,12
134520,9,83,30,0,53,30
134520,8,134,31,0,103,31
134520,7,54,11,1,43,10
134520,6,26,9,0,17,9
33172,10,5,3,0,2,3
33172,8,54,22,0,32,22
33172,7,92,31,0,61,31
33172,6,118,38,0,80,38
33172,5,44,13,0,31,13
33172,4,13,9,0,4,9
33172,3,12,8,0,4,8
33172,2,6,2,0,4,2
2265,10,2,2,0,0,2
2265,9,7,2,0,5,2
2265,8,34,9,0,25,9
2265,7,65,14,0,51,14
2265,6,118,22,0,96,22
2265,5,83,19,0,64,19
2265,4,24,8,0,16,8
2265,3,8,3,0,5,3
2265,2,4,1,0,3,1
2265,1,2,2,0,0,2
72644,10,15,2,0,13,2
72644,9,25,2,0,23,2
72644,8,83,9,0,74,9
72644,7,85,16,0,69,16
72644,6,111,20,0,91,20
72644,5,19,6,0,13,6
72644,4,6,1,0,5,1
30804,10,40,8,0,32,8
30804,9,59,17,0,42,17
30804,8,114,26,0,88,26
30804,7,81,17,0,64,17
30804,6,37,7,0,30,7
30804,5,10,4,0,6,4
30804,4,3,1,0,2,1
1701,10,2,1,0,1,1
1701,8,14,5,0,9,5
1701,7,53,12,0,41,12
1701,6,157,38,0,119,38
1701,5,63,16,0,47,16
1701,4,33,9,0,24,9
1701,3,11,1,0,10,1
1701,2,10,3,0,7,3
1701,1,2,2,0,0,2
137900,9,16,4,0,12,4
137900,8,81,15,0,66,15
137900,7,100,27,0,73,27
137900,6,101,21,0,80,21
137900,5,32,9,0,23,9
137900,4,6,2,0,4,2
137900,3,4,2,0,2,2
137900,1,2,1,0,1,1
228668,10,37,4,0,33,4
228668,9,63,10,0,53,10
228668,8,157,28,0,129,28
228668,7,59,7,0,52,7
228668,6,17,5,0,12,5
228668,5,7,1,0,6,1
228668,3,1,1,0,0,1
228668,2,2,1,0,1,1
228668,1,2,1,0,1,1
13328,8,29,4,0,25,4
13328,7,59,5,0,54,5
13328,6,110,12,0,98,12
13328,5,63,9,0,54,9
13328,4,50,13,0,37,13
13328,3,18,8,0,10,8
13328,1,4,1,0,3,1
40603,10,44,10,3,34,7
40603,9,58,17,1,41,16
40603,8,103,30,4,73,26
40603,7,65,11,0,54,11
40603,6,50,8,0,42,8
40603,5,15,7,0,8,7
40603,4,3,1,0,2,1
40603,3,4,3,0,1,3
40603,2,2,1,0,1,1
40603,1,2,1,0,1,1
162041,10,4,1,0,3,1
162041,9,14,8,0,6,8
162041,8,51,17,0,34,17
162041,7,102,17,0,85,17
162041,6,115,16,0,99,16
162041,5,41,8,0,33,8
162041,4,11,1,0,10,1
162041,1,1,1,0,0,1
3149,10,5,1,0,4,1
3149,9,12,4,0,8,4
3149,8,49,17,0,32,17
3149,7,70,22,0,48,22
3149,6,108,35,0,73,35
3149,5,61,20,0,41,20
3149,4,26,6,0,20,6
3149,3,10,3,0,7,3
3149,2,5,2,0,3,2
18755,10,5,3,0,2,3
18755,9,7,1,0,6,1
18755,8,20,3,0,17,3
18755,7,34,7,0,27,7
18755,6,92,21,0,71,21
18755,5,72,15,0,57,15
18755,4,52,10,0,42,10
18755,3,38,12,0,26,12
18755,2,17,3,0,14,3
18755,1,8,1,0,7,1
163841,10,34,5,0,29,5
163841,9,85,14,0,71,14
163841,8,133,34,0,99,34
163841,7,60,13,1,47,12
163841,6,25,6,0,19,6
163841,4,1,1,0,0,1
163841,3,1,1,0,0,1
14403,10,12,3,0,9,3
14403,9,16,2,0,14,2
14403,8,64,16,0,48,16
14403,7,112,16,0,96,16
14403,6,79,20,0,59,20
14403,5,32,6,0,26,6
14403,4,13,5,0,8,5
14403,3,6,4,0,2,4
34583,9,3,1,0,2,1
34583,8,13,1,0,12,1
34583,7,41,7,0,34,7
34583,6,108,24,0,84,24
34583,5,76,23,0,53,23
34583,4,59,19,0,40,19
34583,3,27,10,0,17,10
34583,2,10,4,0,6,4
34583,1,6,2,0,4,2
235627,10,7,1,0,6,1
235627,9,11,3,0,8,3
235627,8,90,12,0,78,12
235627,7,118,14,0,104,14
235627,6,81,15,0,66,15
235627,5,25,8,0,17,8
235627,4,8,2,0,6,2
235627,2,1,1,0,0,1
175846,8,16,7,1,9,6
175846,7,42,8,1,34,7
175846,6,133,26,1,107,25
175846,5,82,18,0,64,18
175846,4,37,9,0,28,9
175846,3,18,7,1,11,6
175846,2,7,3,0,4,3
175846,1,5,1,0,4,1
15047,10,8,3,0,5,3
15047,9,10,1,0,9,1
15047,8,40,7,0,33,7
15047,7,47,14,0,33,14
15047,6,122,19,0,103,19
15047,5,62,16,0,46,16
15047,4,30,9,0,21,9
15047,3,14,4,0,10,4
15047,2,9,2,0,7,2
125977,10,52,24,0,28,24
125977,9,92,24,0,68,24
125977,8,107,29,0,78,29
125977,7,38,13,0,25,13
125977,6,34,10,0,24,10
125977,5,10,4,0,6,4
125977,4,7,6,0,1,6
125977,3,6,4,0,2,4
128537,10,3,1,0,2,1
128537,8,42,4,0,38,4
128537,7,74,10,0,64,10
128537,6,143,33,0,110,33
128537,5,47,5,0,42,5
128537,4,22,4,0,18,4
128537,3,3,1,0,2,1
128537,2,3,2,0,1,2
19624,9,5,1,0,4,1
19624,8,69,25,0,44,25
19624,7,114,41,0,73,41
19624,6,109,37,0,72,37
19624,5,26,12,0,14,12
19624,4,13,7,0,6,7
10869,10,5,1,0,4,1
10869,9,3,3,0,0,3
10869,8,23,11,0,12,11
10869,7,49,14,0,35,14
10869,6,113,34,0,79,34
10869,5,65,19,0,46,19
10869,4,47,20,0,27,20
10869,3,27,14,0,13,14
10869,2,11,4,0,7,4
28805,10,27,5,0,22,5
28805,9,37,4,0,33,4
28805,8,93,15,0,78,15
28805,7,85,10,0,75,10
28805,6,60,14,0,46,14
28805,5,22,3,0,19,3
28805,4,9,1,0,8,1
27451,10,6,1,0,5,1
27451,9,14,2,0,12,2
27451,8,50,5,0,45,5
27451,7,73,11,0,62,11
27451,6,106,15,0,91,15
27451,4,26,2,0,24,2
27451,3,18,4,0,14,4
27451,2,3,1,0,2,1
2611,10,13,2,0,11,2
2611,9,22,7,0,15,7
2611,8,79,26,0,53,26
2611,7,80,26,0,54,26
2611,6,69,18,0,51,18
2611,5,32,15,0,17,15
2611,4,27,6,0,21,6
2611,3,15,4,0,11,4
2611,2,3,1,0,2,1
148729,10,4,2,0,2,2
148729,9,29,6,0,23,6
148729,8,111,34,0,77,34
148729,7,100,33,1,67,32
148729,6,60,19,0,41,19
148729,5,23,10,0,13,10
148729,4,8,3,0,5,3
148729,3,3,1,0,2,1
161681,10,20,7,0,13,7
161681,9,17,3,0,14,3
161681,8,82,21,3,61,18
161681,7,86,11,0,75,11
161681,6,94,22,1,72,21
161681,5,24,2,0,22,2
161681,4,14,7,0,7,7
161681,3,4,2,0,2,2
79067,10,15,3,0,12,3
79067,9,22,1,0,21,1
79067,8,79,20,0,59,20
79067,7,90,10,0,80,10
79067,6,83,12,0,71,12
79067,5,26,6,0,20,6
79067,4,14,4,0,10,4
79067,3,6,2,0,4,2
79067,2,3,2,0,1,2
79067,1,4,3,0,1,3
34829,10,3,1,0,2,1
34829,9,3,2,0,1,2
34829,8,39,12,0,27,12
34829,7,95,34,0,61,34
34829,6,121,30,0,91,30
34829,5,45,21,0,24,21
34829,4,22,7,0,15,7
34829,3,10,5,0,5,5
34829,2,2,2,0,0,2
5255,10,14,4,0,10,4
5255,9,24,4,0,20,4
5255,8,48,12,0,36,12
5255,7,90,20,0,70,20
5255,6,82,30,0,52,30
5255,5,46,12,0,34,12
5255,4,20,10,0,10,10
5255,3,9,4,0,5,4
5255,2,4,1,0,3,1
5255,1,5,1,0,4,1
171037,10,8,2,0,6,2
171037,9,10,1,0,9,1
171037,8,51,5,0,46,5
171037,7,73,6,0,67,6
171037,6,127,11,0,116,11
171037,5,37,2,0,35,2
171037,4,18,2,0,16,2
171037,3,11,2,0,9,2
171037,2,7,3,0,4,3
21859,10,2,1,0,1,1
21859,9,1,1,0,0,1
21859,8,15,5,0,10,5
21859,7,41,13,0,28,13
21859,6,111,36,0,75,36
21859,5,77,22,0,55,22
21859,4,53,22,0,31,22
21859,3,29,9,0,20,9
21859,2,10,3,0,7,3
21859,1,3,2,0,1,2
8128,10,1,1,0,0,1
8128,9,4,1,0,3,1
8128,8,32,12,0,20,12
8128,7,57,15,0,42,15
8128,6,124,36,0,88,36
8128,5,61,22,0,39,22
8128,4,33,14,0,19,14
8128,3,19,11,0,8,11
8128,2,9,3,0,6,3
8128,1,2,1,0,1,1
5718,10,5,3,0,2,3
5718,9,18,12,0,6,12
5718,8,47,32,0,15,32
5718,7,64,41,0,23,41
5718,6,90,44,0,46,44
5718,5,62,24,0,38,24
5718,4,38,18,0,20,18
5718,3,11,3,0,8,3
5718,2,5,4,0,1,4
5718,1,2,1,0,1,1
56342,10,6,2,0,4,2
56342,8,35,4,0,31,4
56342,7,81,9,0,72,9
56342,6,101,16,0,85,16
56342,5,55,11,0,44,11
56342,4,31,8,0,23,8
56342,3,11,1,0,10,1
56342,2,14,2,0,12,2
56342,1,3,1,0,2,1
226255,10,8,1,0,7,1
226255,9,13,1,0,12,1
226255,8,77,12,0,65,12
226255,7,116,13,1,103,12
226255,6,87,10,0,77,10
226255,5,24,6,0,18,6
226255,4,12,3,0,9,3
226255,3,3,1,0,2,1
235655,10,7,1,0,6,1
235655,9,20,6,0,14,6
235655,8,59,18,0,41,18
235655,7,100,17,0,83,17
235655,6,110,18,0,92,18
235655,5,27,6,0,21,6
235655,4,12,3,0,9,3
235655,3,6,1,0,5,1
235655,2,1,1,0,0,1
230852,10,12,5,0,7,5
230852,9,20,4,0,16,4
230852,8,69,14,0,55,14
230852,7,86,14,0,72,14
230852,6,81,10,0,71,10
230852,5,41,6,0,35,6
230852,4,23,7,0,16,7
230852,3,5,3,0,2,3
161138,10,6,2,0,4,2
161138,8,32,2,0,30,2
161138,7,95,11,0,84,11
161138,6,118,12,0,106,12
161138,5,43,9,0,34,9
161138,4,27,9,0,18,9
161138,3,9,1,0,8,1
170300,10,3,1,0,2,1
170300,9,16,9,0,7,9
170300,8,68,19,3,49,16
170300,7,87,14,0,73,14
170300,6,110,25,1,85,24
170300,5,36,8,0,28,8
170300,4,17,4,0,13,4
170300,3,2,1,1,1,0
170300,2,1,1,1,0,0
173460,10,5,3,0,2,3
173460,9,11,4,0,7,4
173460,8,66,21,4,45,17
173460,7,105,18,3,87,15
173460,6,104,19,1,85,18
173460,5,31,3,0,28,3
173460,4,14,3,0,11,3
173460,2,1,1,0,0,1
6923,10,10,3,0,7,3
6923,9,26,6,0,20,6
6923,8,59,10,0,49,10
6923,7,100,13,0,87,13
6923,6,95,13,0,82,13
6923,5,31,8,0,23,8
6923,4,12,5,0,7,5
6923,3,7,1,0,6,1
120426,9,1,1,0,0,1
120426,8,14,3,0,11,3
120426,7,17,6,0,11,6
120426,6,78,14,0,64,14
120426,5,70,16,0,54,16
120426,4,70,13,1,57,12
120426,3,46,14,0,32,14
120426,2,22,7,0,15,7
120426,1,21,13,0,8,13
229956,10,7,1,0,6,1
229956,9,28,11,0,17,11
229956,8,99,22,0,77,22
229956,7,95,26,0,69,26
229956,6,67,20,0,47,20
229956,5,24,9,0,15,9
229956,4,11,6,0,5,6
229956,3,6,3,0,3,3
229956,2,4,2,0,2,2
30024,10,12,5,0,7,5
30024,9,16,3,0,13,3
30024,8,48,16,0,32,16
30024,7,105,31,0,74,31
30024,6,108,38,0,70,38
30024,5,35,12,0,23,12
30024,4,11,4,0,7,4
30024,2,2,1,0,1,1
150014,10,33,10,0,23,10
150014,9,17,4,0,13,4
150014,8,60,10,0,50,10
150014,7,67,7,1,60,6
150014,6,91,14,0,77,14
150014,5,46,12,1,34,11
150014,4,16,6,0,10,6
150014,3,7,1,0,6,1
140612,10,7,1,0,6,1
140612,9,10,2,0,8,2
140612,8,39,9,0,30,9
140612,7,103,18,0,85,18
140612,6,108,18,0,90,18
140612,5,40,11,0,29,11
140612,4,18,7,0,11,7
140612,3,7,2,0,5,2
140612,2,6,3,0,3,3
2680,10,12,4,0,8,4
2680,9,7,3,0,4,3
2680,8,30,7,0,23,7
2680,7,49,14,0,35,14
2680,6,100,26,0,74,26
2680,5,54,13,0,41,13
2680,4,45,21,0,24,21
2680,3,23,13,0,10,13
2680,2,15,11,0,4,11
2680,1,5,4,0,1,4
108157,8,48,9,0,39,9
108157,7,80,12,0,68,12
108157,6,115,16,0,99,16
108157,5,52,10,0,42,10
108157,4,26,5,0,21,5
108157,3,8,3,0,5,3
108157,2,4,2,0,2,2
108157,1,2,1,0,1,1
5740,10,39,17,0,22,17
5740,9,33,16,0,17,16
5740,8,80,27,0,53,27
5740,7,75,24,0,51,24
5740,6,59,22,0,37,22
5740,5,23,2,0,21,2
5740,4,15,6,0,9,6
5740,3,9,3,0,6,3
5740,2,5,4,0,1,4
5740,1,2,2,0,0,2
227273,10,18,4,0,14,4
227273,9,40,6,0,34,6
227273,8,141,13,0,128,13
227273,7,93,14,0,79,14
227273,6,37,8,0,29,8
227273,5,4,1,0,3,1
132326,10,10,2,0,8,2
132326,9,38,7,0,31,7
132326,8,86,11,0,75,11
132326,7,91,15,0,76,15
132326,6,77,20,0,57,20
132326,5,20,2,0,18,2
132326,4,13,5,0,8,5
132326,3,4,1,0,3,1
983,10,2,1,0,1,1
983,9,6,1,0,5,1
983,8,28,9,0,19,9
983,7,48,14,0,34,14
983,6,124,39,0,85,39
983,5,70,21,0,49,21
983,4,44,10,0,34,10
983,3,13,5,0,8,5
983,2,3,2,0,1,2
983,1,2,1,0,1,1
4910,8,5,4,0,1,4
4910,7,23,6,0,17,6
4910,6,63,14,0,49,14
4910,5,91,18,0,73,18
4910,4,69,20,0,49,20
4910,3,46,14,0,32,14
4910,2,25,7,0,18,7
4910,1,14,3,0,11,3
1591,10,5,2,0,3,2
1591,9,8,4,0,4,4
1591,8,46,12,0,34,12
1591,7,64,35,0,29,35
1591,6,133,31,0,102,31
1591,5,52,15,0,37,15
1591,4,20,12,0,8,12
1591,3,9,4,0,5,4
1591,2,3,2,0,1,2
38387,10,7,3,0,4,3
38387,9,6,2,0,4,2
38387,8,34,10,0,24,10
38387,7,84,28,0,56,28
38387,6,147,48,0,99,48
38387,5,47,9,0,38,9
38387,4,12,4,0,8,4
234429,10,7,1,0,6,1
234429,9,19,5,0,14,5
234429,8,87,16,0,71,16
234429,7,101,6,0,95,6
234429,6,80,12,0,68,12
234429,5,23,4,0,19,4
234429,4,12,3,0,9,3
234429,3,6,2,0,4,2
234429,2,4,1,0,3,1
16500,8,23,5,0,18,5
16500,7,59,14,0,45,14
16500,6,111,20,0,91,20
16500,5,72,13,0,59,13
16500,4,40,14,0,26,14
16500,3,19,9,0,10,9
16500,2,9,2,0,7,2
245357,10,11,3,0,8,3
245357,9,30,8,0,22,8
245357,8,108,21,0,87,21
245357,7,94,17,0,77,17
245357,6,53,6,0,47,6
245357,5,24,5,0,19,5
245357,4,7,2,0,5,2
245357,3,8,3,0,5,3
245357,2,3,1,0,2,1
4282,9,3,1,0,2,1
4282,8,21,8,0,13,8
4282,7,40,6,0,34,6
4282,6,92,26,0,66,26
4282,5,70,17,0,53,17
4282,4,46,21,0,25,21
4282,3,26,11,0,15,11
4282,2,14,8,0,6,8
4282,1,3,2,0,1,2
304,8,8,3,0,5,3
304,7,57,22,0,35,22
304,6,138,42,0,96,42
304,5,80,21,0,59,21
304,4,27,10,0,17,10
304,3,20,10,0,10,10
304,2,6,3,0,3,3
151835,9,7,1,0,6,1
151835,8,50,10,0,40,10
151835,7,103,19,0,84,19
151835,6,113,24,0,89,24
151835,5,43,3,0,40,3
151835,4,16,4,0,12,4
151835,3,7,1,0,6,1
151835,1,1,1,0,0,1
178007,10,6,3,0,3,3
178007,9,21,9,0,12,9
178007,8,89,28,0,61,28
178007,7,86,25,0,61,25
178007,6,77,19,0,58,19
178007,5,31,9,0,22,9
178007,4,16,7,0,9,7
178007,3,8,3,0,5,3
191438,10,3,1,0,2,1
191438,9,14,2,0,12,2
191438,8,99,17,0,82,17
191438,7,98,17,0,81,17
191438,6,81,14,0,67,14
191438,5,22,3,0,19,3
191438,4,15,4,0,11,4
191438,3,5,2,0,3,2
191438,2,3,1,0,2,1
4934,10,13,7,0,6,7
4934,9,13,6,0,7,6
4934,8,57,34,0,23,34
4934,7,57,33,0,24,33
4934,6,86,36,0,50,36
4934,5,52,22,0,30,22
4934,4,34,16,0,18,16
4934,3,15,6,0,9,6
4934,2,7,3,0,4,3
4934,1,5,3,0,2,3
25605,8,52,12,0,40,12
25605,7,102,19,0,83,19
25605,6,117,25,0,92,25
25605,5,45,9,0,36,9
25605,4,11,3,0,8,3
25605,3,5,3,0,2,3
3484,9,2,2,0,0,2
3484,8,15,2,0,13,2
3484,7,45,9,0,36,9
3484,6,94,31,0,63,31
3484,5,77,16,0,61,16
3484,4,51,18,0,33,18
3484,3,32,13,0,19,13
3484,2,16,8,0,8,8
3484,1,3,1,0,2,1
205185,10,6,1,0,5,1
205185,9,15,3,1,12,2
205185,8,82,14,1,68,13
205185,7,100,17,2,83,15
205185,6,91,20,0,71,20
205185,5,27,8,0,19,8
205185,4,12,2,0,10,2
205185,3,4,3,0,1,3
221230,10,5,1,0,4,1
221230,9,12,3,0,9,3
221230,8,101,25,5,76,20
221230,7,115,13,4,102,9
221230,6,69,17,0,52,17
221230,5,24,5,0,19,5
221230,4,8,2,0,6,2
221230,3,2,1,0,1,1
221230,2,2,1,0,1,1
825,10,4,1,0,3,1
825,9,11,2,0,9,2
825,8,18,10,0,8,10
825,7,64,22,0,42,22
825,6,136,53,0,83,53
825,5,64,24,0,40,24
825,4,29,9,0,20,9
825,3,7,3,0,4,3
825,2,2,2,0,0,2
825,1,3,1,0,2,1
181811,10,8,5,0,3,5
181811,9,20,7,0,13,7
181811,8,70,20,0,50,20
181811,7,112,18,0,94,18
181811,6,74,19,0,55,19
181811,5,20,4,0,16,4
181811,4,23,9,0,14,9
181811,3,8,3,0,5,3
181811,2,3,2,0,1,2
19464,10,6,2,0,4,2
19464,9,12,7,0,5,7
19464,8,49,24,1,25,23
19464,7,83,31,0,52,31
19464,6,93,23,0,70,23
19464,5,42,14,0,28,14
19464,4,24,7,0,17,7
19464,3,7,3,0,4,3
19464,2,8,4,0,4,4
19464,1,14,6,0,8,6
23241,10,3,1,0,2,1
23241,8,22,9,0,13,9
23241,7,80,24,0,56,24
23241,6,120,33,0,87,33
23241,5,53,17,0,36,17
23241,4,25,7,0,18,7
23241,3,22,9,0,13,9
23241,2,7,2,0,5,2
23241,1,6,1,0,5,1
232829,10,12,5,0,7,5
232829,9,18,7,0,11,7
232829,8,64,18,0,46,18
232829,7,113,10,0,103,10
232829,6,95,12,0,83,12
232829,5,24,1,0,23,1
232829,4,5,1,0,4,1
232829,3,6,3,0,3,3
2470,10,32,18,0,14,18
2470,9,32,13,0,19,13
2470,8,100,38,0,62,38
2470,7,85,17,0,68,17
2470,6,56,12,0,44,12
2470,5,18,4,0,14,4
2470,4,6,3,0,3,3
2470,3,3,2,0,1,2
2470,2,2,1,0,1,1
2470,1,3,1,0,2,1
8508,10,5,2,0,3,2
8508,9,4,1,0,3,1
8508,8,34,15,0,19,15
8508,7,67,13,0,54,13
8508,6,101,24,0,77,24
8508,5,72,18,0,54,18
8508,4,33,11,0,22,11
8508,3,8,5,0,3,5
8508,2,11,7,0,4,7
8508,1,2,1,0,1,1
224894,10,7,1,0,6,1
224894,9,13,3,0,10,3
224894,8,91,15,0,76,15
224894,7,112,14,0,98,14
224894,6,76,13,0,63,13
224894,5,21,5,0,16,5
224894,4,8,3,0,5,3
224894,1,4,2,0,2,2
27306,10,2,1,0,1,1
27306,9,6,2,0,4,2
27306,8,46,17,0,29,17
27306,7,93,28,0,65,28
27306,6,113,23,0,90,23
27306,5,48,15,0,33,15
27306,4,21,9,0,12,9
27306,3,7,4,0,3,4
198110,10,12,2,0,10,2
198110,9,17,1,0,16,1
198110,8,77,11,0,66,11
198110,7,101,15,0,86,15
198110,6,81,15,0,66,15
198110,5,31,5,0,26,5
198110,4,9,3,0,6,3
198110,3,5,1,0,4,1
198110,1,1,1,0,0,1
141653,10,5,2,0,3,2
141653,9,14,1,0,13,1
141653,8,75,20,0,55,20
141653,7,100,26,0,74,26
141653,6,97,23,1,74,22
141653,5,35,9,0,26,9
141653,4,8,1,0,7,1
150016,10,6,3,0,3,3
150016,9,20,8,0,12,8
150016,8,68,17,0,51,17
150016,7,98,26,0,72,26
150016,6,110,30,0,80,30
150016,5,25,5,0,20,5
150016,4,8,3,0,5,3
150016,3,2,1,0,1,1
206327,10,29,13,2,16,11
206327,9,43,15,2,28,13
206327,8,146,25,3,121,22
206327,7,72,12,2,60,10
206327,6,39,10,0,29,10
206327,5,6,1,0,5,1
206327,2,1,1,0,0,1
2242,9,3,1,0,2,1
2242,8,11,4,0,7,4
2242,7,38,9,0,29,9
2242,6,92,19,0,73,19
2242,5,88,17,0,71,17
2242,4,43,11,0,32,11
2242,3,35,13,0,22,13
2242,2,14,2,0,12,2
2242,1,11,4,0,7,4
42306,10,19,5,0,14,5
42306,9,32,5,0,27,5
42306,8,103,22,0,81,22
42306,7,92,19,0,73,19
42306,6,61,14,0,47,14
42306,5,19,6,0,13,6
42306,2,1,1,0,0,1
161297,10,22,12,0,10,12
161297,9,26,6,0,20,6
161297,8,114,25,3,89,22
161297,7,71,18,2,53,16
161297,6,66,13,2,53,11
161297,5,22,6,0,16,6
161297,4,11,1,0,10,1
161297,3,2,1,0,1,1
161297,2,2,1,1,1,0
1387,10,2,1,0,1,1
1387,8,26,6,1,20,5
1387,7,68,16,0,52,16
1387,6,119,31,0,88,31
1387,5,70,19,0,51,19
1387,4,29,7,0,22,7
1387,3,19,7,0,12,7
154602,9,4,2,0,2,2
154602,8,22,3,0,19,3
154602,7,65,10,0,55,10
154602,6,99,11,0,88,11
154602,5,67,8,0,59,8
154602,4,37,8,0,29,8
154602,3,29,5,0,24,5
154602,2,11,1,0,10,1
145,9,11,6,0,5,6
145,8,52,14,0,38,14
145,7,95,16,0,79,16
145,6,105,27,0,78,27
145,5,43,15,0,28,15
145,4,21,5,0,16,5
145,3,4,1,0,3,1
145,2,1,1,0,0,1
639,10,18,12,0,6,12
639,9,32,15,0,17,15
639,8,80,27,0,53,27
639,7,80,29,0,51,29
639,6,75,34,0,41,34
639,5,26,11,0,15,11
639,4,12,6,0,6,6
639,3,6,4,0,2,4
639,2,6,2,0,4,2
239942,10,135,18,2,117,16
239942,9,79,21,1,58,20
239942,8,67,12,2,55,10
239942,7,30,8,0,22,8
239942,6,11,3,0,8,3
239942,5,5,2,0,3,2
239942,4,2,1,0,1,1
239942,3,2,1,0,1,1
239942,1,12,6,0,6,6
236461,10,4,2,0,2,2
236461,9,22,4,0,18,4
236461,8,105,10,0,95,10
236461,7,126,11,0,115,11
236461,6,60,10,0,50,10
236461,5,12,2,0,10,2
236461,4,4,1,0,3,1
236461,3,1,1,0,0,1
103877,9,9,2,0,7,2
103877,8,55,9,0,46,9
103877,7,106,19,0,87,19
103877,6,115,29,0,86,29
103877,5,27,5,0,22,5
103877,4,16,6,0,10,6
103877,3,6,2,0,4,2
103877,2,2,1,0,1,1
55679,10,13,5,0,8,5
55679,9,15,8,0,7,8
55679,8,47,12,0,35,12
55679,7,92,19,0,73,19
55679,6,89,21,0,68,21
55679,5,35,13,0,22,13
55679,4,25,8,0,17,8
55679,3,12,7,0,5,7
55679,2,5,3,0,2,3
172560,9,12,2,0,10,2
172560,8,54,9,0,45,9
172560,7,91,14,0,77,14
172560,6,118,14,0,104,14
172560,5,31,7,0,24,7
172560,4,15,2,0,13,2
172560,3,9,3,0,6,3
84889,10,68,24,0,44,24
84889,9,72,32,0,40,32
84889,8,85,37,1,48,36
84889,7,38,13,0,25,13
84889,6,41,12,0,29,12
84889,5,12,2,0,10,2
84889,4,14,9,0,5,9
84889,3,4,1,0,3,1
301,9,5,1,0,4,1
301,8,26,4,0,22,4
301,7,77,13,0,64,13
301,6,153,28,0,125,28
301,5,53,9,0,44,9
301,4,13,4,0,9,4
301,3,6,1,0,5,1
2484,10,2,1,0,1,1
2484,9,1,1,0,0,1
2484,8,12,2,0,10,2
2484,7,29,3,0,26,3
2484,6,92,26,0,66,26
2484,5,79,24,0,55,24
2484,4,64,18,0,46,18
2484,3,40,14,0,26,14
2484,2,12,4,0,8,4
2484,1,5,4,0,1,4
229632,10,9,1,0,8,1
229632,9,18,3,0,15,3
229632,8,79,7,0,72,7
229632,7,108,19,0,89,19
229632,6,90,10,0,80,10
229632,5,22,4,0,18,4
229632,4,6,3,0,3,3
15880,8,13,7,0,6,7
15880,7,53,17,0,36,17
15880,6,126,41,0,85,41
15880,5,82,26,0,56,26
15880,4,36,9,0,27,9
15880,3,14,4,0,10,4
15880,2,6,2,0,4,2
15880,1,4,3,0,1,3
94915,8,51,8,0,43,8
94915,7,52,2,0,50,2
94915,6,104,18,0,86,18
94915,5,55,7,0,48,7
94915,4,27,7,0,20,7
94915,3,13,3,0,10,3
94915,2,7,3,0,4,3
94915,1,3,1,0,2,1
164354,9,12,1,0,11,1
164354,8,57,10,0,47,10
164354,7,103,12,0,91,12
164354,6,109,19,0,90,19
164354,5,31,3,0,28,3
164354,4,13,3,0,10,3
164354,2,1,1,0,0,1
18750,8,12,4,0,8,4
18750,7,41,18,0,23,18
18750,6,105,32,0,73,32
18750,5,69,21,0,48,21
18750,4,48,23,0,25,23
18750,3,26,12,0,14,12
18750,2,23,9,0,14,9
18750,1,10,6,0,4,6
4211,10,23,7,0,16,7
4211,9,43,20,0,23,20
4211,8,121,34,0,87,34
4211,7,87,16,0,71,16
4211,6,42,8,0,34,8
4211,5,11,5,0,6,5
4211,4,4,2,0,2,2
2771,8,15,8,0,7,8
2771,7,51,15,0,36,15
2771,6,118,41,0,77,41
2771,5,74,20,0,54,20
2771,4,48,16,0,32,16
2771,3,22,9,0,13,9
2771,2,5,4,0,1,4
2771,1,1,1,0,0,1
1806,10,2,1,0,1,1
1806,9,9,1,0,8,1
1806,8,33,15,0,18,15
1806,7,62,19,0,43,19
1806,6,122,41,0,81,41
1806,5,63,19,0,44,19
1806,4,26,7,0,19,7
1806,3,10,2,0,8,2
1806,2,5,3,0,2,3
1558,9,8,3,0,5,3
1558,8,36,9,0,27,9
1558,7,81,21,0,60,21
1558,6,102,30,0,72,30
1558,5,53,11,0,42,11
1558,4,33,9,0,24,9
1558,3,8,3,0,5,3
1558,2,7,5,0,2,5
1558,1,2,1,0,1,1
66076,8,68,7,0,61,7
66076,7,83,15,0,68,15
66076,6,97,19,0,78,19
66076,5,45,7,0,38,7
66076,4,18,4,0,14,4
66076,3,10,2,0,8,2
66076,2,2,1,0,1,1
125493,10,11,3,0,8,3
125493,9,22,6,1,16,5
125493,8,46,8,0,38,8
125493,7,62,11,0,51,11
125493,6,103,25,3,78,22
125493,5,53,7,1,46,6
125493,4,23,5,0,18,5
125493,3,6,3,0,3,3
125493,2,5,2,0,3,2
125493,1,3,1,0,2,1
2077,10,16,7,0,9,7
2077,9,29,10,0,19,10
2077,8,109,34,0,75,34
2077,7,97,21,0,76,21
2077,6,56,16,0,40,16
2077,5,21,8,0,13,8
2077,4,4,1,0,3,1
417,10,1,1,0,0,1
417,9,1,1,0,0,1
417,8,14,7,0,7,7
417,7,24,8,0,16,8
417,6,59,18,0,41,18
417,5,65,23,0,42,23
417,4,76,19,0,57,19
417,3,40,17,0,23,17
417,2,35,19,0,16,19
417,1,17,9,0,8,9
76883,9,7,1,0,6,1
76883,8,44,7,0,37,7
76883,7,103,19,0,84,19
76883,6,117,16,0,101,16
76883,5,43,14,0,29,14
76883,4,10,1,0,9,1
76883,3,3,1,0,2,1
76883,1,2,2,0,0,2
125854,9,7,3,0,4,3
125854,8,33,7,2,26,5
125854,7,64,17,1,47,16
125854,6,120,26,2,94,24
125854,5,62,19,2,43,17
125854,4,28,8,0,20,8
125854,3,11,4,1,7,3
125854,2,6,2,0,4,2
125854,1,1,1,0,0,1
118385,10,8,2,0,6,2
118385,9,27,7,0,20,7
118385,8,70,14,0,56,14
118385,7,119,18,0,101,18
118385,6,69,17,0,52,17
118385,5,28,6,0,22,6
118385,4,7,1,0,6,1
118385,3,2,1,0,1,1
39383,10,9,6,0,3,6
39383,9,19,7,0,12,7
39383,8,72,24,0,48,24
39383,7,93,33,0,60,33
39383,6,82,24,0,58,24
39383,5,31,16,0,15,16
39383,4,16,9,0,7,9
39383,3,6,5,0,1,5
39383,2,4,2,0,2,2
229543,8,46,5,1,41,4
229543,7,87,17,3,70,14
229543,6,108,19,2,89,17
229543,5,34,4,2,30,2
229543,4,28,7,0,21,7
229543,3,15,4,1,11,3
229543,2,2,2,0,0,2
244212,10,10,3,0,7,3
244212,9,17,3,0,14,3
244212,8,73,20,2,53,18
244212,7,85,17,2,68,15
244212,6,87,16,2,71,14
244212,5,36,9,1,27,8
244212,4,13,6,0,7,6
244212,3,12,6,0,6,6
2947,10,4,2,0,2,2
2947,8,19,4,0,15,4
2947,7,64,14,0,50,14
2947,6,121,25,0,96,25
2947,5,68,12,0,56,12
2947,4,33,8,0,25,8
2947,3,10,2,0,8,2
2947,2,9,1,0,8,1
2947,1,1,1,0,0,1
204575,10,10,2,0,8,2
204575,9,19,1,0,18,1
204575,8,119,12,0,107,12
204575,7,96,6,0,90,6
204575,6,53,7,0,46,7
204575,5,21,5,0,16,5
204575,4,11,3,0,8,3
204575,3,7,3,0,4,3
1251,9,5,2,0,3,2
1251,8,30,7,0,23,7
1251,7,67,24,0,43,24
1251,6,140,30,0,110,30
1251,5,47,8,0,39,8
1251,4,28,5,0,23,5
1251,3,10,6,0,4,6
1251,2,2,1,0,1,1
55835,10,4,1,0,3,1
55835,9,9,5,0,4,5
55835,8,28,7,0,21,7
55835,7,52,8,0,44,8
55835,6,119,22,0,97,22
55835,5,73,7,0,66,7
55835,4,34,11,0,23,11
55835,3,10,4,0,6,4
55835,1,1,1,0,0,1
222219,10,14,1,0,13,1
222219,9,30,3,0,27,3
222219,8,113,11,0,102,11
222219,7,103,8,0,95,8
222219,6,41,4,0,37,4
222219,5,16,2,0,14,2
222219,4,10,2,0,8,2
222219,3,4,1,0,3,1
135215,10,28,13,1,15,12
135215,9,10,2,0,8,2
135215,8,61,9,0,52,9
135215,7,97,7,0,90,7
135215,6,80,15,1,65,14
135215,5,28,4,0,24,4
135215,4,17,4,0,13,4
135215,3,5,3,0,2,3
135215,1,2,1,0,1,1
147624,10,4,2,0,2,2
147624,9,10,1,0,9,1
147624,8,62,9,0,53,9
147624,7,85,15,0,70,15
147624,6,104,14,0,90,14
147624,5,40,13,0,27,13
147624,4,10,3,0,7,3
147624,3,13,1,0,12,1
147624,1,2,1,0,1,1
214484,10,54,17,1,37,16
214484,9,63,10,1,53,9
214484,8,99,18,2,81,16
214484,7,59,14,0,45,14
214484,6,32,8,1,24,7
214484,5,15,1,0,14,1
214484,4,7,1,0,6,1
203740,10,12,4,0,8,4
203740,9,22,4,0,18,4
203740,8,89,18,0,71,18
203740,7,82,11,0,71,11
203740,6,73,12,0,61,12
203740,5,32,5,0,27,5
203740,4,14,2,0,12,2
203740,3,4,1,0,3,1
37376,10,2,1,0,1,1
37376,8,14,5,0,9,5
37376,7,47,19,0,28,19
37376,6,126,33,0,93,33
37376,5,77,23,0,54,23
37376,4,31,13,0,18,13
37376,3,19,11,0,8,11
37376,2,7,1,0,6,1
37376,1,4,3,0,1,3
162591,9,16,3,0,13,3
162591,8,58,12,0,46,12
162591,7,78,10,0,68,10
162591,6,99,14,0,85,14
162591,5,34,4,0,30,4
162591,4,21,4,0,17,4
17075,10,5,2,0,3,2
17075,8,25,8,0,17,8
17075,7,70,21,0,49,21
17075,6,118,30,0,88,30
17075,5,57,23,0,34,23
17075,4,33,18,0,15,18
17075,3,15,6,0,9,6
17075,2,5,2,0,3,2
3845,9,1,1,0,0,1
3845,8,13,7,0,6,7
3845,7,22,11,0,11,11
3845,6,88,38,0,50,38
3845,5,97,27,0,70,27
3845,4,57,21,0,36,21
3845,3,27,15,0,12,15
3845,2,21,9,0,12,9
231991,10,12,4,0,8,4
231991,9,38,6,0,32,6
231991,8,109,15,0,94,15
231991,7,80,15,0,65,15
231991,6,46,8,0,38,8
231991,5,27,9,0,18,9
231991,4,12,6,0,6,6
231991,3,6,3,0,3,3
231991,2,2,1,0,1,1
1101,8,23,9,0,14,9
1101,7,61,17,0,44,17
1101,6,140,40,0,100,40
1101,5,56,16,0,40,16
1101,4,33,14,0,19,14
1101,3,11,6,0,5,6
1101,1,1,1,0,0,1
244513,10,24,5,0,19,5
244513,9,29,2,0,27,2
244513,8,114,11,0,103,11
244513,7,102,16,0,86,16
244513,6,41,8,0,33,8
244513,5,13,1,0,12,1
244513,2,2,1,0,1,1
244513,1,1,1,0,0,1
251053,10,8,2,0,6,2
251053,9,37,8,0,29,8
251053,8,126,19,0,107,19
251053,7,79,11,0,68,11
251053,6,53,13,0,40,13
251053,5,17,5,0,12,5
251053,4,5,2,0,3,2
251053,3,3,1,0,2,1
66126,9,10,2,0,8,2
66126,8,101,25,2,76,23
66126,7,119,22,1,97,21
66126,6,66,19,1,47,18
66126,5,19,4,0,15,4
66126,4,10,5,0,5,5
66126,3,2,1,0,1,1
27826,8,15,4,0,11,4
27826,7,29,7,0,22,7
27826,6,101,21,0,80,21
27826,5,79,10,0,69,10
27826,4,50,12,0,38,12
27826,3,36,5,0,31,5
27826,2,12,1,0,11,1
27826,1,7,3,0,4,3
112991,10,20,1,0,19,1
112991,9,18,2,0,16,2
112991,8,47,6,0,41,6
112991,7,80,7,0,73,7
112991,6,79,6,0,73,6
112991,5,42,3,0,39,3
112991,4,29,5,0,24,5
112991,3,5,2,0,3,2
112991,2,9,3,0,6,3
4213,10,18,7,0,11,7
4213,9,28,12,0,16,12
4213,8,42,11,0,31,11
4213,7,39,10,0,29,10
4213,6,72,23,0,49,23
4213,5,32,15,0,17,15
4213,4,28,9,0,19,9
4213,3,17,7,0,10,7
4213,2,26,9,0,17,9
4213,1,28,17,0,11,17
8944,10,8,4,0,4,4
8944,9,9,1,0,8,1
8944,8,38,14,0,24,14
8944,7,46,13,0,33,13
8944,6,93,20,0,73,20
8944,5,69,20,0,49,20
8944,4,45,19,0,26,19
8944,3,11,5,0,6,5
8944,2,10,5,0,5,5
8944,1,1,1,0,0,1
139147,10,15,2,0,13,2
139147,9,30,7,0,23,7
139147,8,81,16,0,65,16
139147,7,66,16,0,50,16
139147,6,69,5,0,64,5
139147,5,28,8,0,20,8
139147,4,28,6,0,22,6
139147,3,10,5,0,5,5
139147,2,2,1,0,1,1
139147,1,1,1,0,0,1
524,9,3,1,0,2,1
524,8,20,3,0,17,3
524,7,56,18,0,38,18
524,6,112,40,0,72,40
524,5,62,23,0,39,23
524,4,49,21,0,28,21
524,3,17,10,0,7,10
524,2,6,3,0,3,3
524,1,4,2,0,2,2
233006,10,5,2,0,3,2
233006,9,22,3,0,19,3
233006,8,115,21,0,94,21
233006,7,92,16,0,76,16
233006,6,59,12,0,47,12
233006,5,24,6,0,18,6
233006,4,8,3,0,5,3
233006,3,4,3,0,1,3
233006,1,1,1,0,0,1
234469,9,11,1,0,10,1
234469,8,72,12,0,60,12
234469,7,108,12,0,96,12
234469,6,103,17,0,86,17
234469,5,20,4,0,16,4
234469,4,9,1,0,8,1
216234,10,8,2,1,6,1
216234,9,15,4,0,11,4
216234,8,65,7,1,58,6
216234,7,84,20,0,64,20
216234,6,113,16,0,97,16
216234,5,28,4,0,24,4
216234,4,10,1,0,9,1
216234,3,3,1,0,2,1
216234,2,2,1,0,1,1
216234,1,1,1,0,0,1
2428,10,2,1,0,1,1
2428,9,6,2,0,4,2
2428,8,33,13,0,20,13
2428,7,37,14,0,23,14
2428,6,110,50,0,60,50
2428,5,72,29,0,43,29
2428,4,41,13,0,28,13
2428,3,18,8,0,10,8
2428,2,9,6,0,3,6
2428,1,2,2,0,0,2
12545,10,6,2,0,4,2
12545,8,10,1,0,9,1
12545,7,31,2,0,29,2
12545,6,76,14,0,62,14
12545,5,73,17,0,56,17
12545,4,76,26,0,50,26
12545,3,28,5,0,23,5
12545,2,19,5,0,14,5
12545,1,7,2,0,5,2
24028,10,4,2,0,2,2
24028,9,6,1,0,5,1
24028,8,33,10,0,23,10
24028,7,67,21,0,46,21
24028,6,108,28,0,80,28
24028,5,55,19,0,36,19
24028,4,36,13,0,23,13
24028,3,11,4,0,7,4
24028,2,5,4,0,1,4
24028,1,3,2,0,1,2
204675,9,14,4,0,10,4
204675,8,80,16,0,64,16
204675,7,99,19,0,80,19
204675,6,87,9,0,78,9
204675,5,27,6,0,21,6
204675,3,5,2,0,3,2
204675,2,2,1,0,1,1
107704,10,26,5,1,21,4
107704,9,41,3,0,38,3
107704,8,102,18,1,84,17
107704,7,70,8,0,62,8
107704,6,48,7,0,41,7
107704,5,20,2,0,18,2
107704,4,12,1,0,11,1
107704,3,6,2,0,4,2
107704,2,2,1,0,1,1
107704,1,2,1,0,1,1
231218,10,17,5,0,12,5
231218,9,52,18,1,34,17
231218,8,156,39,5,117,34
231218,7,67,14,2,53,12
231218,6,38,13,2,25,11
231218,5,5,3,0,2,3
231218,3,2,1,0,1,1
195296,10,8,4,0,4,4
195296,9,18,6,0,12,6
195296,8,61,9,1,52,8
195296,7,94,20,4,74,16
195296,6,85,17,3,68,14
195296,5,36,7,1,29,6
195296,4,10,2,0,8,2
195296,3,10,3,0,7,3
195296,2,4,2,0,2,2
15046,8,23,6,0,17,6
15046,7,41,6,0,35,6
15046,6,87,17,0,70,17
15046,5,83,11,0,72,11
15046,4,41,7,0,34,7
15046,3,24,8,0,16,8
15046,2,14,4,0,10,4
122943,8,69,24,0,45,24
122943,7,90,31,0,59,31
122943,6,126,33,0,93,33
122943,5,26,9,0,17,9
122943,4,10,6,0,4,6
122943,3,1,1,0,0,1
387,9,1,1,0,0,1
387,8,28,9,0,19,9
387,7,61,15,0,46,15
387,6,113,28,0,85,28
387,5,82,19,0,63,19
387,4,35,8,0,27,8
387,3,5,1,0,4,1
387,2,3,2,0,1,2
41493,9,6,3,0,3,3
41493,8,36,9,0,27,9
41493,7,76,27,0,49,27
41493,6,113,26,0,87,26
41493,5,60,16,0,44,16
41493,4,24,9,0,15,9
41493,3,5,1,0,4,1
154510,10,34,20,0,14,20
154510,9,55,22,1,33,21
154510,8,92,22,0,70,22
154510,7,59,14,0,45,14
154510,6,41,9,0,32,9
154510,5,17,6,1,11,5
154510,4,15,8,0,7,8
154510,3,10,1,0,9,1
154510,2,5,1,0,4,1
62709,10,6,1,0,5,1
62709,9,6,4,0,2,4
62709,8,19,3,0,16,3
62709,7,63,13,0,50,13
62709,6,112,17,0,95,17
62709,5,58,8,0,50,8
62709,4,32,7,0,25,7
62709,3,20,6,0,14,6
62709,2,8,4,0,4,4
62709,1,4,1,0,3,1
137669,10,2,1,0,1,1
137669,9,10,3,0,7,3
137669,8,25,2,0,23,2
137669,7,65,10,0,55,10
137669,6,76,11,0,65,11
137669,5,57,11,0,46,11
137669,4,46,9,0,37,9
137669,3,28,8,0,20,8
137669,2,12,4,0,8,4
137669,1,6,1,0,5,1
147707,9,16,6,0,10,6
147707,8,99,24,0,75,24
147707,7,115,28,0,87,28
147707,6,62,12,0,50,12
147707,5,23,4,0,19,4
147707,4,6,2,0,4,2
147707,3,2,1,0,1,1
176524,10,35,7,1,28,6
176524,9,61,12,0,49,12
176524,8,132,26,2,106,24
176524,7,47,10,1,37,9
176524,6,39,9,2,30,7
176524,5,9,1,0,8,1
176524,4,1,1,0,0,1
176524,3,2,1,0,1,1
3577,10,30,18,0,12,18
3577,9,45,22,0,23,22
3577,8,84,40,0,44,40
3577,7,82,30,0,52,30
3577,6,53,14,0,39,14
3577,5,16,6,0,10,6
3577,4,8,5,0,3,5
3577,3,5,4,0,1,4
3577,2,2,1,0,1,1
3577,1,2,1,0,1,1
18265,10,1,1,0,0,1
18265,9,1,1,0,0,1
18265,8,16,9,0,7,9
18265,7,60,17,0,43,17
18265,6,132,40,0,92,40
18265,5,66,21,0,45,21
18265,4,36,13,0,23,13
18265,3,11,7,0,4,7
15826,10,43,23,0,20,23
15826,9,68,27,0,41,27
15826,8,89,30,0,59,30
15826,7,55,17,0,38,17
15826,6,35,13,0,22,13
15826,5,15,6,0,9,6
15826,4,7,5,0,2,5
15826,3,8,4,0,4,4
15826,2,3,1,0,2,1
15826,1,5,2,0,3,2
1335,9,3,1,0,2,1
1335,8,38,11,0,27,11
1335,7,70,24,0,46,24
1335,6,114,29,0,85,29
1335,5,57,13,0,44,13
1335,4,30,10,0,20,10
1335,3,11,3,0,8,3
1335,2,2,1,0,1,1
1335,1,2,1,0,1,1
147568,10,8,1,0,7,1
147568,9,18,6,0,12,6
147568,8,62,16,0,46,16
147568,7,80,12,0,68,12
147568,6,100,20,0,80,20
147568,5,31,4,0,27,4
147568,4,15,4,0,11,4
147568,3,5,1,0,4,1
147568,2,6,2,0,4,2
17394,10,28,18,0,10,18
17394,9,58,30,0,28,30
17394,8,113,34,0,79,34
17394,7,68,17,0,51,17
17394,6,36,10,0,26,10
17394,5,9,2,0,7,2
17394,4,9,6,0,3,6
17394,3,2,1,0,1,1
17394,1,2,1,0,1,1
131261,10,10,2,0,8,2
131261,9,18,3,0,15,3
131261,8,46,11,0,35,11
131261,7,94,14,0,80,14
131261,6,91,11,0,80,11
131261,5,27,6,0,21,6
131261,4,18,3,0,15,3
131261,3,13,3,0,10,3
131261,1,7,2,0,5,2
193670,10,33,5,1,28,4
193670,9,61,23,3,38,20
193670,8,121,25,3,96,22
193670,7,58,12,0,46,12
193670,6,32,6,0,26,6
193670,5,16,3,0,13,3
193670,2,2,1,0,1,1
67631,10,3,1,0,2,1
67631,8,28,4,0,24,4
67631,7,58,15,0,43,15
67631,6,111,24,0,87,24
67631,5,75,21,0,54,21
67631,4,32,9,0,23,9
67631,3,9,4,0,5,4
67631,2,7,2,0,5,2
67631,1,1,1,0,0,1
11733,10,5,1,0,4,1
11733,9,16,4,0,12,4
11733,8,49,12,0,37,12
11733,7,72,23,0,49,23
11733,6,111,37,0,74,37
11733,5,38,18,0,20,18
11733,4,22,6,0,16,6
11733,3,5,1,0,4,1
11733,2,4,1,0,3,1
11733,1,4,1,0,3,1
204592,10,3,2,0,1,2
204592,9,5,1,0,4,1
204592,8,34,11,0,23,11
204592,7,71,18,0,53,18
204592,6,92,18,0,74,18
204592,5,71,15,0,56,15
204592,4,26,1,0,25,1
204592,3,12,5,0,7,5
204592,2,9,3,0,6,3
109548,10,6,3,0,3,3
109548,9,20,7,0,13,7
109548,8,75,28,0,47,28
109548,7,98,18,1,80,17
109548,6,94,22,0,72,22
109548,5,21,3,0,18,3
109548,4,9,3,0,6,3
109548,2,2,1,0,1,1
110102,9,16,2,0,14,2
110102,8,82,13,0,69,13
110102,7,118,28,0,90,28
110102,6,70,14,0,56,14
110102,5,26,4,0,22,4
110102,4,9,3,0,6,3
110102,3,4,3,0,1,3
160418,10,30,8,0,22,8
160418,9,91,36,0,55,36
160418,8,112,31,0,81,31
160418,7,52,11,0,41,11
160418,6,22,7,0,15,7
160418,5,10,4,0,6,4
160418,4,7,4,0,3,4
3710,10,9,3,0,6,3
3710,9,23,9,0,14,9
3710,8,61,15,0,46,15
3710,7,89,20,0,69,20
3710,6,84,19,0,65,19
3710,5,35,7,0,28,7
3710,4,12,6,0,6,6
3710,3,8,3,0,5,3
3710,2,3,1,0,2,1
154902,8,47,12,0,35,12
154902,7,77,17,0,60,17
154902,6,109,22,1,87,21
154902,5,49,10,0,39,10
154902,4,24,6,0,18,6
154902,3,6,1,0,5,1
154902,2,1,1,0,0,1
154902,1,2,2,0,0,2
4212,10,30,14,0,16,14
4212,9,45,13,0,32,13
4212,8,113,26,0,87,26
4212,7,84,22,0,62,22
4212,6,34,6,0,28,6
4212,5,12,2,0,10,2
4212,4,3,1,0,2,1
234248,9,17,8,0,9,8
234248,8,87,23,0,64,23
234248,7,132,21,0,111,21
234248,6,59,6,0,53,6
234248,5,23,3,0,20,3
234248,4,7,4,0,3,4
234248,2,1,1,0,0,1
232045,8,37,8,0,29,8
232045,7,82,10,0,72,10
232045,6,123,13,0,110,13
232045,5,38,7,0,31,7
232045,4,19,2,0,17,2
232045,1,4,2,0,2,2
216864,9,10,6,1,4,5
216864,8,77,18,2,59,16
216864,7,98,23,2,75,21
216864,6,80,16,0,64,16
216864,5,36,9,0,27,9
216864,4,11,2,0,9,2
216864,3,5,1,0,4,1
216864,2,4,1,0,3,1
183959,10,7,2,0,5,2
183959,9,16,7,1,9,6
183959,8,69,22,1,47,21
183959,7,115,21,0,94,21
183959,6,74,15,0,59,15
183959,5,27,2,0,25,2
183959,4,13,4,0,9,4
183959,1,1,1,0,0,1
4,10,2,1,0,1,1
4,9,17,6,0,11,6
4,8,56,16,0,40,16
4,7,94,18,0,76,18
4,6,101,30,0,71,30
4,5,39,11,0,28,11
4,4,11,5,0,6,5
4,3,4,3,0,1,3
224031,9,5,1,0,4,1
224031,8,50,3,0,47,3
224031,7,89,8,0,81,8
224031,6,88,11,0,77,11
224031,5,24,1,0,23,1
224031,4,8,3,0,5,3
224031,3,2,1,0,1,1
17162,10,3,1,0,2,1
17162,9,13,2,0,11,2
17162,8,53,22,0,31,22
17162,7,86,20,0,66,20
17162,6,111,30,0,81,30
17162,5,38,5,0,33,5
17162,4,11,3,0,8,3
17162,2,3,1,0,2,1
22266,9,4,1,0,3,1
22266,8,26,9,0,17,9
22266,7,50,18,0,32,18
22266,6,111,40,0,71,40
22266,5,79,27,0,52,27
22266,4,27,7,0,20,7
22266,3,17,4,0,13,4
22266,2,8,3,0,5,3
22266,1,1,1,0,0,1
206939,10,4,1,0,3,1
206939,9,19,3,0,16,3
206939,8,51,6,0,45,6
206939,7,117,8,0,109,8
206939,6,93,6,0,87,6
206939,5,27,2,0,25,2
206939,4,9,1,0,8,1
206939,3,2,2,0,0,2
668,9,9,2,0,7,2
668,8,61,24,0,37,24
668,7,100,27,0,73,27
668,6,104,32,0,72,32
668,5,31,8,0,23,8
668,4,12,9,0,3,9
668,3,2,2,0,0,2
668,2,2,1,0,1,1
30324,9,13,2,0,11,2
30324,8,56,10,0,46,10
30324,7,88,19,0,69,19
30324,6,90,15,0,75,15
30324,5,31,5,0,26,5
30324,4,19,6,0,13,6
30324,2,8,1,0,7,1
30324,1,3,2,0,1,2
68227,10,4,3,0,1,3
68227,9,2,1,0,1,1
68227,8,29,5,0,24,5
68227,7,65,15,0,50,15
68227,6,107,12,0,95,12
68227,5,60,16,0,44,16
68227,4,35,11,0,24,11
68227,3,10,4,0,6,4
68227,2,5,2,0,3,2
68227,1,6,4,0,2,4
90009,10,10,4,0,6,4
90009,9,27,2,0,25,2
90009,8,78,10,0,68,10
90009,7,101,8,0,93,8
90009,6,76,10,0,66,10
90009,5,14,2,0,12,2
90009,3,3,1,0,2,1
90009,2,5,1,0,4,1
101737,8,10,5,0,5,5
101737,7,20,8,0,12,8
101737,6,65,13,0,52,13
101737,5,81,24,0,57,24
101737,4,75,23,0,52,23
101737,3,44,17,0,27,17
101737,2,20,6,0,14,6
101737,1,7,1,0,6,1
24067,8,6,1,0,5,1
24067,7,21,8,0,13,8
24067,6,62,17,0,45,17
24067,5,72,17,0,55,17
24067,4,59,19,0,40,19
24067,3,54,22,0,32,22
24067,2,33,13,0,20,13
24067,1,11,4,0,7,4
4258,10,28,14,0,14,14
4258,9,52,20,0,32,20
4258,8,103,20,0,83,20
4258,7,69,16,0,53,16
4258,6,38,14,0,24,14
4258,5,15,4,0,11,4
4258,4,11,4,0,7,4
4258,3,4,3,0,1,3
37931,10,8,1,0,7,1
37931,9,2,1,0,1,1
37931,8,31,5,0,26,5
37931,7,52,16,0,36,16
37931,6,122,24,0,98,24
37931,5,67,18,0,49,18
37931,4,29,8,0,21,8
37931,3,8,1,0,7,1
37931,2,3,2,0,1,2
183264,10,3,2,0,1,2
183264,9,5,1,0,4,1
183264,8,38,10,0,28,10
183264,7,81,13,0,68,13
183264,6,119,16,0,103,16
183264,5,49,8,0,41,8
183264,4,17,4,0,13,4
183264,2,1,1,0,0,1
63395,9,9,3,0,6,3
63395,8,59,20,0,39,20
63395,7,69,16,0,53,16
63395,6,131,18,0,113,18
63395,5,24,7,0,17,7
63395,4,19,7,0,12,7
63395,3,8,3,0,5,3
63395,2,2,1,0,1,1
128174,10,5,2,0,3,2
128174,9,16,3,0,13,3
128174,8,55,9,0,46,9
128174,7,76,11,0,65,11
128174,6,93,13,0,80,13
128174,5,34,6,0,28,6
128174,4,18,1,0,17,1
128174,3,13,1,0,12,1
128174,2,7,3,0,4,3
128174,1,5,2,0,3,2
205831,10,6,4,0,2,4
205831,9,15,5,0,10,5
205831,8,62,17,0,45,17
205831,7,87,11,0,76,11
205831,6,79,10,0,69,10
205831,5,43,8,0,35,8
205831,4,14,1,0,13,1
205831,3,9,2,0,7,2
192701,9,5,1,0,4,1
192701,8,32,8,0,24,8
192701,7,80,11,0,69,11
192701,6,116,13,0,103,13
192701,5,52,8,0,44,8
192701,4,24,3,0,21,3
192701,3,7,2,0,5,2
5709,8,13,2,0,11,2
5709,7,46,6,0,40,6
5709,6,101,10,0,91,10
5709,5,78,19,0,59,19
5709,4,49,11,0,38,11
5709,3,24,9,0,15,9
5709,2,5,1,0,4,1
110286,10,6,2,0,4,2
110286,9,12,6,1,6,5
110286,8,66,17,0,49,17
110286,7,86,17,1,69,16
110286,6,97,23,3,74,20
110286,5,28,8,0,20,8
110286,4,13,4,0,9,4
110286,3,9,4,0,5,4
14039,9,6,2,0,4,2
14039,8,45,23,0,22,23
14039,7,78,19,0,59,19
14039,6,130,24,0,106,24
14039,5,33,5,0,28,5
14039,4,21,9,0,12,9
176589,8,34,7,0,27,7
176589,7,88,24,2,64,22
176589,6,131,21,2,110,19
176589,5,38,6,0,32,6
176589,4,20,5,0,15,5
176589,3,4,1,0,3,1
233149,9,12,2,0,10,2
233149,8,37,12,0,25,12
233149,7,73,17,3,56,14
233149,6,95,24,4,71,20
233149,5,38,12,1,26,11
233149,4,26,8,0,18,8
233149,3,17,4,1,13,3
233149,2,15,7,0,8,7
233149,1,3,1,0,2,1
68076,10,40,7,0,33,7
68076,9,97,15,0,82,15
68076,8,125,22,0,103,22
68076,7,38,6,0,32,6
68076,6,11,2,0,9,2
68076,3,2,2,0,0,2
182770,10,32,4,0,28,4
182770,9,45,3,0,42,3
182770,8,109,14,0,95,14
182770,7,71,6,0,65,6
182770,6,42,5,0,37,5
182770,4,5,1,0,4,1
182770,2,3,3,0,0,3
182770,1,4,1,0,3,1
193485,10,9,2,0,7,2
193485,9,13,5,0,8,5
193485,8,34,6,0,28,6
193485,7,92,13,0,79,13
193485,6,110,22,0,88,22
193485,5,36,4,0,32,4
193485,4,11,4,0,7,4
193485,3,12,2,0,10,2
193485,2,3,2,0,1,2
5704,9,1,1,0,0,1
5704,8,14,9,0,5,9
5704,7,55,32,0,23,32
5704,6,121,46,0,75,46
5704,5,82,36,0,46,36
5704,4,33,21,0,12,21
5704,3,8,7,0,1,7
5704,2,7,4,0,3,4
204605,10,16,3,0,13,3
204605,9,25,5,0,20,5
204605,8,107,14,0,93,14
204605,7,83,13,0,70,13
204605,6,53,9,0,44,9
204605,5,15,3,0,12,3
204605,4,8,2,0,6,2
204605,3,8,1,0,7,1
204605,2,6,2,0,4,2
7263,10,21,11,0,10,11
7263,9,14,3,0,11,3
7263,8,55,22,0,33,22
7263,7,62,18,0,44,18
7263,6,79,21,0,58,21
7263,5,38,15,0,23,15
7263,4,27,10,0,17,10
7263,3,17,8,0,9,8
7263,2,6,2,0,4,2
89918,8,30,5,0,25,5
89918,7,76,7,0,69,7
89918,6,107,13,0,94,13
89918,5,43,10,0,33,10
89918,4,31,5,0,26,5
89918,3,14,6,0,8,6
89918,2,8,5,0,3,5
89918,1,3,2,0,1,2
182605,8,40,9,0,31,9
182605,7,74,13,0,61,13
182605,6,112,11,0,101,11
182605,5,47,5,0,42,5
182605,4,35,4,0,31,4
182605,3,9,1,0,8,1
182605,2,1,1,0,0,1
207729,10,107,45,4,62,41
207729,9,92,18,2,74,16
207729,8,74,13,3,61,10
207729,7,18,6,1,12,5
207729,6,9,2,0,7,2
207729,3,2,2,0,0,2
207729,2,3,1,0,2,1
207729,1,7,1,0,6,1
344,10,3,1,0,2,1
344,9,14,4,0,10,4
344,8,54,11,0,43,11
344,7,91,33,0,58,33
344,6,114,31,0,83,31
344,5,28,6,0,22,6
344,4,7,2,0,5,2
344,3,9,3,0,6,3
135877,10,5,1,0,4,1
135877,9,18,7,0,11,7
135877,8,89,26,0,63,26
135877,7,105,26,0,79,26
135877,6,71,14,0,57,14
135877,5,22,4,0,18,4
135877,4,6,1,0,5,1
135877,3,1,1,0,0,1
680,9,7,2,0,5,2
680,8,21,7,0,14,7
680,7,24,9,0,15,9
680,6,57,14,0,43,14
680,5,38,8,0,30,8
680,4,23,5,0,18,5
680,3,7,2,0,5,2
680,2,6,1,0,5,1
147240,10,9,1,0,8,1
147240,9,19,4,0,15,4
147240,8,52,12,0,40,12
147240,7,86,11,0,75,11
147240,6,100,14,0,86,14
147240,5,37,5,0,32,5
147240,4,13,4,0,9,4
147240,2,2,1,0,1,1
211533,10,12,6,0,6,6
211533,8,30,7,0,23,7
211533,7,73,11,0,62,11
211533,6,92,14,0,78,14
211533,5,53,8,0,45,8
211533,4,33,11,0,22,11
211533,3,10,3,0,7,3
211533,1,3,1,0,2,1
204886,10,4,1,0,3,1
204886,9,12,4,0,8,4
204886,8,40,5,0,35,5
204886,7,70,12,0,58,12
204886,6,124,23,0,101,23
204886,5,42,8,0,34,8
204886,4,16,5,0,11,5
204886,3,8,1,0,7,1
204886,2,3,3,0,0,3
171136,9,11,2,0,9,2
171136,8,56,9,0,47,9
171136,7,84,8,0,76,8
171136,6,106,13,0,93,13
171136,5,32,3,0,29,3
171136,4,14,3,0,11,3
171136,3,9,2,0,7,2
17997,10,4,1,0,3,1
17997,9,13,1,0,12,1
17997,8,69,6,0,63,6
17997,7,108,8,0,100,8
17997,6,90,7,0,83,7
17997,5,20,3,0,17,3
17997,4,10,5,0,5,5
17997,3,2,1,0,1,1
295,9,10,2,0,8,2
295,8,39,12,0,27,12
295,7,77,25,0,52,25
295,6,77,20,0,57,20
295,5,51,15,0,36,15
295,4,38,19,0,19,19
295,3,15,7,0,8,7
295,2,9,3,0,6,3
295,1,1,1,0,0,1
82,10,8,2,0,6,2
82,9,18,11,2,7,9
82,8,87,35,0,52,35
82,7,87,31,1,56,30
82,6,65,24,1,41,23
82,5,29,7,0,22,7
82,4,14,7,0,7,7
82,3,7,2,0,5,2
82,2,3,2,0,1,2
82,1,1,1,0,0,1
2130,9,2,1,0,1,1
2130,8,13,5,0,8,5
2130,7,34,6,0,28,6
2130,6,62,15,0,47,15
2130,5,71,18,0,53,18
2130,4,63,26,0,37,26
2130,3,45,18,0,27,18
2130,2,24,16,0,8,16
2130,1,2,1,0,1,1
155827,10,18,2,0,16,2
155827,8,81,8,0,73,8
155827,7,76,7,0,69,7
155827,6,68,9,0,59,9
155827,5,28,4,0,24,4
155827,4,9,2,0,7,2
155827,3,10,3,0,7,3
155827,1,1,1,0,0,1
193164,9,6,2,0,4,2
193164,8,28,5,0,23,5
193164,7,81,14,1,67,13
193164,6,115,22,1,93,21
193164,5,55,6,0,49,6
193164,4,20,6,0,14,6
193164,3,7,2,0,5,2
226254,9,26,2,0,24,2
226254,8,123,15,0,108,15
226254,7,83,21,0,62,21
226254,6,56,8,0,48,8
226254,5,14,2,0,12,2
226254,4,9,4,0,5,4
226254,3,5,1,0,4,1
2672,9,4,1,0,3,1
2672,8,22,8,0,14,8
2672,7,78,20,0,58,20
2672,6,119,21,0,98,21
2672,5,54,11,0,43,11
2672,4,20,7,0,13,7
2672,3,15,2,0,13,2
2672,2,6,3,0,3,3
2672,1,1,1,0,0,1
34819,9,6,2,0,4,2
34819,8,36,6,0,30,6
34819,7,58,14,0,44,14
34819,6,111,29,0,82,29
34819,5,69,19,0,50,19
34819,4,27,8,0,19,8
34819,3,7,3,0,4,3
34819,2,4,3,0,1,3
10293,10,10,2,0,8,2
10293,9,5,1,0,4,1
10293,8,19,4,0,15,4
10293,7,27,5,0,22,5
10293,6,102,22,0,80,22
10293,5,79,19,0,60,19
10293,4,38,7,0,31,7
10293,3,19,3,0,16,3
10293,2,15,4,0,11,4
10293,1,4,3,0,1,3
50849,10,3,1,0,2,1
50849,8,7,2,0,5,2
50849,7,20,5,0,15,5
50849,6,43,17,0,26,17
50849,5,79,24,0,55,24
50849,4,67,26,0,41,26
50849,3,45,16,0,29,16
50849,2,17,8,0,9,8
50849,1,34,18,0,16,18
17923,10,4,1,0,3,1
17923,8,74,9,0,65,9
17923,7,126,15,0,111,15
17923,6,73,11,0,62,11
17923,5,16,4,0,12,4
17923,4,7,3,0,4,3
62,8,17,5,0,12,5
62,7,37,16,0,21,16
62,6,100,26,0,74,26
62,5,74,20,0,54,20
62,4,47,17,0,30,17
62,3,25,14,0,11,14
62,2,5,2,0,3,2
62,1,9,5,0,4,5
210663,10,3,1,0,2,1
210663,9,11,1,1,10,0
210663,8,72,17,2,55,15
210663,7,110,20,3,90,17
210663,6,74,14,1,60,13
210663,5,23,4,0,19,4
210663,4,20,5,0,15,5
210663,3,4,1,0,3,1
210663,2,1,1,0,0,1
210663,1,1,1,0,0,1
1497,10,2,1,0,1,1
1497,9,3,1,0,2,1
1497,8,15,8,0,7,8
1497,7,44,11,0,33,11
1497,6,85,35,0,50,35
1497,5,74,30,0,44,30
1497,4,52,22,0,30,22
1497,3,31,14,0,17,14
1497,2,7,3,0,4,3
1497,1,5,2,0,3,2
25,10,2,1,0,1,1
25,9,6,1,0,5,1
25,8,24,4,0,20,4
25,7,74,21,0,53,21
25,6,101,33,0,68,33
25,5,61,21,0,40,21
25,4,25,10,0,15,10
25,3,18,8,0,10,8
25,2,5,2,0,3,2
25,1,1,1,0,0,1
98762,10,2,2,0,0,2
98762,9,12,5,0,7,5
98762,8,61,25,0,36,25
98762,7,90,30,0,60,30
98762,6,103,28,0,75,28
98762,5,30,9,0,21,9
98762,4,14,5,0,9,5
98762,3,3,2,0,1,2
98762,2,2,1,0,1,1
255615,9,32,4,0,28,4
255615,8,127,17,0,110,17
255615,7,82,14,0,68,14
255615,6,45,6,0,39,6
255615,4,6,2,0,4,2
255615,2,1,1,0,0,1
255615,1,2,1,0,1,1
5684,10,35,8,0,27,8
5684,9,43,11,0,32,11
5684,8,112,39,0,73,39
5684,7,67,21,0,46,21
5684,6,32,11,0,21,11
5684,5,13,8,0,5,8
5684,4,6,5,0,1,5
5684,3,5,1,0,4,1
127188,10,1,1,0,0,1
127188,8,43,15,0,28,15
127188,7,82,29,0,53,29
127188,6,125,33,0,92,33
127188,5,40,14,0,26,14
127188,4,15,6,0,9,6
127188,3,9,4,0,5,4
4746,10,11,3,0,8,3
4746,9,13,3,0,10,3
4746,8,33,12,0,21,12
4746,7,40,13,0,27,13
4746,6,101,32,0,69,32
4746,5,68,23,0,45,23
4746,4,25,10,0,15,10
4746,3,14,5,0,9,5
4746,2,10,4,0,6,4
148083,10,16,4,1,12,3
148083,9,21,5,0,16,5
148083,8,75,22,3,53,19
148083,7,104,18,0,86,18
148083,6,74,14,2,60,12
148083,5,18,5,0,13,5
148083,4,7,2,0,5,2
148083,3,1,1,0,0,1
148083,1,2,1,0,1,1
144526,8,54,10,0,44,10
144526,7,107,13,0,94,13
144526,6,99,27,0,72,27
144526,5,27,7,0,20,7
144526,4,8,2,0,6,2
144526,3,6,1,0,5,1
69582,9,1,1,0,0,1
69582,8,29,5,0,24,5
69582,7,46,8,0,38,8
69582,6,120,12,0,108,12
69582,5,59,7,0,52,7
69582,4,32,5,0,27,5
69582,3,16,3,0,13,3
69582,2,8,1,0,7,1
23779,10,4,2,0,2,2
23779,9,16,4,0,12,4
23779,8,59,24,0,35,24
23779,7,98,39,0,59,39
23779,6,87,30,0,57,30
23779,5,38,18,0,20,18
23779,4,10,6,0,4,6
23779,3,2,2,0,0,2
23779,2,1,1,0,0,1
2004,10,7,2,0,5,2
2004,9,4,1,0,3,1
2004,8,4,1,0,3,1
2004,7,22,7,0,15,7
2004,6,46,4,0,42,4
2004,5,45,12,0,33,12
2004,4,71,23,0,48,23
2004,3,52,21,0,31,21
2004,2,39,11,0,28,11
2004,1,26,15,0,11,15
123844,10,6,3,0,3,3
123844,9,17,7,1,10,6
123844,8,70,15,2,55,13
123844,7,77,13,3,64,10
123844,6,84,23,2,61,21
123844,5,30,9,1,21,8
123844,4,21,3,0,18,3
123844,2,3,1,0,2,1
191624,10,4,1,0,3,1
191624,9,4,2,0,2,2
191624,8,20,10,0,10,10
191624,7,54,9,0,45,9
191624,6,83,22,0,61,22
191624,5,65,12,0,53,12
191624,4,51,13,0,38,13
191624,3,26,12,0,14,12
191624,2,7,2,0,5,2
49276,9,13,3,0,10,3
49276,8,74,31,0,43,31
49276,7,102,35,0,67,35
49276,6,92,32,0,60,32
49276,5,19,9,0,10,9
49276,4,5,3,0,2,3
49276,2,1,1,0,0,1
172542,9,5,3,0,2,3
172542,8,36,13,0,23,13
172542,7,72,16,0,56,16
172542,6,135,29,1,106,28
172542,5,41,9,0,32,9
172542,4,15,1,0,14,1
172542,3,8,1,0,7,1
172542,2,4,1,0,3,1
115288,10,12,1,0,11,1
115288,9,23,4,0,19,4
115288,8,88,17,0,71,17
115288,7,78,10,0,68,10
115288,6,80,14,0,66,14
115288,5,22,5,0,17,5
115288,3,4,3,0,1,3
115288,1,2,1,0,1,1
189453,9,15,6,0,9,6
189453,8,93,10,0,83,10
189453,7,106,16,0,90,16
189453,6,59,11,0,48,11
189453,5,27,11,0,16,11
189453,3,6,3,0,3,3
189453,2,2,2,0,0,2
189453,1,3,1,0,2,1
123536,10,13,3,0,10,3
123536,9,26,4,0,22,4
123536,8,84,9,0,75,9
123536,7,88,10,0,78,10
123536,6,63,15,0,48,15
123536,5,29,6,0,23,6
123536,4,9,3,0,6,3
7308,10,6,3,0,3,3
7308,9,2,1,0,1,1
7308,7,21,6,0,15,6
7308,6,59,16,0,43,16
7308,5,74,24,0,50,24
7308,4,65,17,0,48,17
7308,3,43,12,0,31,12
7308,2,29,11,0,18,11
7308,1,10,4,0,6,4
52568,10,7,1,0,6,1
52568,9,8,3,0,5,3
52568,8,51,8,0,43,8
52568,7,92,16,0,76,16
52568,6,109,18,0,91,18
52568,5,31,8,0,23,8
52568,4,9,1,0,8,1
52568,3,3,1,0,2,1
52568,2,4,1,0,3,1
52568,1,1,1,0,0,1
156840,10,16,3,0,13,3
156840,9,31,4,0,27,4
156840,8,106,23,0,83,23
156840,7,78,15,0,63,15
156840,6,55,18,0,37,18
156840,5,16,6,0,10,6
156840,4,9,2,0,7,2
156840,3,2,1,0,1,1
156840,2,2,1,0,1,1
156840,1,1,1,0,0,1
2342,10,7,2,0,5,2
2342,9,13,5,0,8,5
2342,8,29,10,0,19,10
2342,7,57,19,0,38,19
2342,6,110,36,0,74,36
2342,5,53,14,0,39,14
2342,4,36,12,0,24,12
2342,3,8,2,0,6,2
94483,10,2,2,0,0,2
94483,9,11,4,0,7,4
94483,8,54,20,0,34,20
94483,7,88,23,0,65,23
94483,6,99,19,0,80,19
94483,5,42,8,0,34,8
94483,4,16,4,0,12,4
137406,10,5,3,0,2,3
137406,9,9,1,0,8,1
137406,8,51,14,4,37,10
137406,7,80,17,1,63,16
137406,6,101,24,1,77,23
137406,5,40,7,0,33,7
137406,4,16,6,0,10,6
137406,3,11,3,1,8,2
137406,2,2,1,0,1,1
170901,10,12,3,0,9,3
170901,9,21,4,0,17,4
170901,8,80,17,0,63,17
170901,7,96,14,1,82,13
170901,6,82,18,0,64,18
170901,5,13,2,0,11,2
170901,4,4,2,0,2,2
170901,3,5,1,0,4,1
170901,1,1,1,0,0,1
17209,10,4,2,0,2,2
17209,9,6,2,0,4,2
17209,8,29,8,0,21,8
17209,7,42,12,0,30,12
17209,6,108,33,0,75,33
17209,5,59,22,0,37,22
17209,4,40,17,0,23,17
17209,3,19,9,0,10,9
17209,2,7,4,0,3,4
256541,10,5,1,0,4,1
256541,9,13,4,0,9,4
256541,8,56,10,0,46,10
256541,7,108,14,0,94,14
256541,6,74,12,0,62,12
256541,5,25,6,0,19,6
256541,4,14,1,0,13,1
256541,3,8,1,0,7,1
256541,2,8,2,0,6,2
256541,1,3,1,0,2,1
163929,10,9,2,0,7,2
163929,9,28,7,0,21,7
163929,8,83,18,1,65,17
163929,7,101,23,0,78,23
163929,6,65,16,1,49,15
163929,5,15,2,0,13,2
163929,4,8,2,0,6,2
249505,10,8,4,0,4,4
249505,9,20,6,0,14,6
249505,8,47,8,0,39,8
249505,7,82,15,0,67,15
249505,6,100,14,0,86,14
249505,5,24,5,0,19,5
249505,4,15,4,0,11,4
249505,3,7,3,0,4,3
249505,2,7,1,0,6,1
249505,1,5,1,0,4,1
4102,10,37,12,0,25,12
4102,9,30,7,0,23,7
4102,8,48,16,0,32,16
4102,7,60,15,0,45,15
4102,6,74,22,0,52,22
4102,5,20,6,0,14,6
4102,4,16,8,0,8,8
4102,3,13,6,0,7,6
4102,2,10,5,0,5,5
4102,1,6,4,0,2,4
235922,10,4,2,0,2,2
235922,9,15,1,0,14,1
235922,8,57,10,0,47,10
235922,7,104,16,0,88,16
235922,6,96,12,0,84,12
235922,5,26,6,0,20,6
235922,4,11,2,0,9,2
65334,10,12,4,0,8,4
65334,9,15,5,0,10,5
65334,8,76,24,0,52,24
65334,7,86,24,0,62,24
65334,6,72,16,0,56,16
65334,5,28,9,0,19,9
65334,4,9,4,0,5,4
65334,3,6,4,0,2,4
65334,2,3,2,0,1,2
65334,1,6,2,0,4,2
33876,10,8,3,0,5,3
33876,9,15,3,0,12,3
33876,8,36,5,0,31,5
33876,7,52,8,0,44,8
33876,6,70,11,0,59,11
33876,5,46,6,0,40,6
33876,4,31,5,0,26,5
33876,3,31,11,0,20,11
33876,2,13,6,0,7,6
33876,1,11,6,0,5,6
188720,10,28,5,0,23,5
188720,9,47,15,4,32,11
188720,8,112,21,2,91,19
188720,7,46,11,1,35,10
188720,6,36,4,1,32,3
188720,5,19,2,0,17,2
188720,4,9,1,0,8,1
188720,3,6,1,0,5,1
188720,2,7,1,0,6,1
188720,1,2,1,0,1,1
160419,9,13,1,0,12,1
160419,8,62,8,0,54,8
160419,7,100,18,3,82,15
160419,6,92,15,1,77,14
160419,5,30,5,0,25,5
160419,4,7,2,0,5,2
160419,3,7,3,0,4,3
72131,10,3,1,0,2,1
72131,9,8,1,0,7,1
72131,8,34,10,0,24,10
72131,7,66,18,0,48,18
72131,6,103,24,0,79,24
72131,5,44,17,0,27,17
72131,4,26,4,0,22,4
72131,3,18,5,0,13,5
72131,2,9,5,0,4,5
108637,10,11,5,0,6,5
108637,9,20,9,0,11,9
108637,8,53,11,0,42,11
108637,7,95,20,0,75,20
108637,6,75,10,0,65,10
108637,5,28,11,0,17,11
108637,4,16,4,0,12,4
108637,3,12,3,0,9,3
108637,2,3,2,0,1,2
195194,10,13,4,0,9,4
195194,9,17,1,0,16,1
195194,8,84,19,1,65,18
195194,7,107,13,1,94,12
195194,6,56,8,2,48,6
195194,5,27,4,0,23,4
195194,4,6,2,0,4,2
66459,9,2,1,0,1,1
66459,8,23,6,0,17,6
66459,7,43,11,0,32,11
66459,6,83,13,0,70,13
66459,5,66,16,0,50,16
66459,4,47,16,0,31,16
66459,3,26,10,0,16,10
66459,2,17,8,0,9,8
66459,1,6,1,0,5,1
26447,10,18,7,0,11,7
26447,9,42,17,0,25,17
26447,8,89,28,0,61,28
26447,7,62,15,0,47,15
26447,6,48,17,0,31,17
26447,5,23,9,0,14,9
26447,4,24,10,0,14,10
26447,3,6,6,0,0,6
8138,10,4,1,0,3,1
8138,9,21,12,0,9,12
8138,8,82,29,0,53,29
8138,7,93,25,0,68,25
8138,6,63,22,0,41,22
8138,5,28,12,0,16,12
8138,4,12,6,0,6,6
8138,2,7,4,0,3,4
2135,10,5,3,0,2,3
2135,9,17,10,0,7,10
2135,8,57,20,0,37,20
2135,7,47,17,0,30,17
2135,6,77,20,0,57,20
2135,5,64,16,0,48,16
2135,4,26,9,0,17,9
2135,3,12,2,0,10,2
2135,2,6,1,0,5,1
2135,1,1,1,0,0,1
3414,10,7,1,0,6,1
3414,9,16,3,0,13,3
3414,8,91,29,0,62,29
3414,7,101,28,0,73,28
3414,6,60,17,0,43,17
3414,5,23,9,0,14,9
3414,4,8,5,0,3,5
3414,3,3,2,0,1,2
3414,2,3,3,0,0,3
13976,9,7,3,0,4,3
13976,8,47,17,0,30,17
13976,7,68,21,0,47,21
13976,6,103,29,0,74,29
13976,5,45,14,0,31,14
13976,4,26,12,0,14,12
13976,3,11,4,0,7,4
13976,2,4,3,0,1,3
193265,10,7,1,0,6,1
193265,9,10,2,0,8,2
193265,8,48,5,0,43,5
193265,7,101,15,0,86,15
193265,6,95,9,0,86,9
193265,5,38,5,0,33,5
193265,4,9,2,0,7,2
193265,3,5,1,0,4,1
191986,9,9,1,0,8,1
191986,8,71,11,0,60,11
191986,7,104,18,0,86,18
191986,6,74,12,0,62,12
191986,5,26,6,0,20,6
191986,4,18,2,0,16,2
191986,3,4,2,0,2,2
191986,2,3,1,0,2,1
8515,10,29,20,0,9,20
8515,9,35,17,0,18,17
8515,8,85,23,0,62,23
8515,7,74,12,0,62,12
8515,6,64,10,0,54,10
8515,5,13,5,0,8,5
8515,4,8,2,0,6,2
8515,3,2,1,0,1,1
2422,10,5,3,0,2,3
2422,9,8,3,0,5,3
2422,8,43,17,0,26,17
2422,7,84,23,0,61,23
2422,6,108,29,0,79,29
2422,5,40,14,0,26,14
2422,4,16,7,0,9,7
2422,3,4,2,0,2,2
2422,2,3,2,0,1,2
23848,9,4,2,0,2,2
23848,8,35,17,0,18,17
23848,7,54,14,0,40,14
23848,6,111,56,0,55,56
23848,5,47,18,0,29,18
23848,4,39,23,0,16,23
23848,3,13,4,0,9,4
23848,2,5,3,0,2,3
23848,1,1,1,0,0,1
130295,9,19,7,0,12,7
130295,8,89,22,0,67,22
130295,7,83,23,0,60,23
130295,6,77,24,0,53,24
130295,5,19,1,0,18,1
130295,4,10,2,0,8,2
130295,3,6,3,0,3,3
130295,2,3,2,0,1,2
260300,10,12,2,0,10,2
260300,9,28,5,0,23,5
260300,8,73,13,0,60,13
260300,7,78,11,0,67,11
260300,6,80,17,0,63,17
260300,5,23,5,0,18,5
260300,4,15,3,0,12,3
260300,3,3,2,0,1,2
260300,2,2,1,0,1,1
260300,1,2,2,0,0,2
6531,9,7,5,0,2,5
6531,8,25,13,0,12,13
6531,7,39,16,0,23,16
6531,6,95,38,0,57,38
6531,5,74,25,0,49,25
6531,4,39,18,0,21,18
6531,3,18,8,0,10,8
6531,2,9,5,0,4,5
6531,1,4,3,0,1,3
53804,10,6,2,0,4,2
53804,9,2,1,0,1,1
53804,8,6,3,0,3,3
53804,7,40,9,0,31,9
53804,6,95,21,0,74,21
53804,5,77,15,0,62,15
53804,4,52,18,0,34,18
53804,3,23,10,0,13,10
53804,2,8,1,0,7,1
3707,10,8,3,0,5,3
3707,9,9,2,0,7,2
3707,8,40,10,0,30,10
3707,7,69,15,0,54,15
3707,6,114,30,0,84,30
3707,5,37,6,0,31,6
3707,4,22,9,0,13,9
3707,3,4,2,0,2,2
3707,2,6,3,0,3,3
19727,10,7,4,0,3,4
19727,9,18,6,0,12,6
19727,8,59,17,0,42,17
19727,7,83,22,0,61,22
19727,6,80,32,0,48,32
19727,5,29,13,0,16,13
19727,4,19,6,0,13,6
19727,3,9,3,0,6,3
19727,2,5,4,0,1,4
19727,1,2,1,0,1,1
171541,10,4,1,0,3,1
171541,9,4,1,0,3,1
171541,8,36,6,0,30,6
171541,7,81,8,0,73,8
171541,6,124,18,0,106,18
171541,5,35,5,0,30,5
171541,4,16,6,0,10,6
75333,10,6,3,0,3,3
75333,9,18,6,0,12,6
75333,8,68,16,0,52,16
75333,7,91,20,0,71,20
75333,6,89,21,0,68,21
75333,5,17,5,0,12,5
75333,4,8,5,0,3,5
75333,3,10,2,0,8,2
75333,2,4,1,0,3,1
10707,9,17,4,0,13,4
10707,8,39,7,0,32,7
10707,7,72,19,0,53,19
10707,6,101,22,0,79,22
10707,5,47,15,0,32,15
10707,4,17,5,0,12,5
10707,3,7,4,0,3,4
10707,2,5,1,0,4,1
14188,10,40,13,0,27,13
14188,9,37,23,0,14,23
14188,8,88,35,0,53,35
14188,7,60,21,0,39,21
14188,6,51,21,0,30,21
14188,5,13,4,0,9,4
14188,4,12,4,0,8,4
14188,3,3,1,0,2,1
14188,2,3,2,0,1,2
1380,9,13,3,0,10,3
1380,8,48,10,0,38,10
1380,7,76,14,0,62,14
1380,6,100,23,0,77,23
1380,5,42,15,0,27,15
1380,4,21,3,0,18,3
1380,3,7,3,0,4,3
853,9,10,3,0,7,3
853,8,37,8,0,29,8
853,7,97,32,0,65,32
853,6,112,23,0,89,23
853,5,31,7,0,24,7
853,4,13,2,0,11,2
853,3,7,2,0,5,2
5035,10,9,2,0,7,2
5035,9,10,4,0,6,4
5035,8,41,20,0,21,20
5035,7,58,23,0,35,23
5035,6,114,31,0,83,31
5035,5,44,17,0,27,17
5035,4,21,11,0,10,11
5035,3,10,6,0,4,6
5035,1,2,1,0,1,1
450,10,12,7,0,5,7
450,9,24,8,0,16,8
450,8,64,27,0,37,27
450,7,66,25,0,41,25
450,6,88,31,0,57,31
450,5,38,9,0,29,9
450,4,11,2,0,9,2
450,3,6,4,0,2,4
450,2,1,1,0,0,1
335,10,4,1,0,3,1
335,9,3,1,0,2,1
335,8,19,5,0,14,5
335,7,51,20,0,31,20
335,6,108,30,0,78,30
335,5,87,33,0,54,33
335,4,28,10,0,18,10
335,2,3,1,0,2,1
335,1,1,1,0,0,1
11705,10,3,1,0,2,1
11705,9,5,1,0,4,1
11705,8,52,35,0,17,35
11705,7,100,38,0,62,38
11705,6,87,49,0,38,49
11705,5,42,16,0,26,16
11705,4,16,7,0,9,7
11705,3,3,2,0,1,2
11705,1,1,1,0,0,1
12633,8,20,10,0,10,10
12633,7,67,27,0,40,27
12633,6,86,31,0,55,31
12633,5,61,29,0,32,29
12633,4,44,24,0,20,24
12633,3,13,7,0,6,7
12633,2,11,7,0,4,7
12633,1,5,4,0,1,4
129122,10,48,19,0,29,19
129122,9,71,17,2,54,15
129122,8,107,29,0,78,29
129122,7,44,11,0,33,11
129122,6,29,13,0,16,13
129122,5,5,1,0,4,1
129122,4,2,1,0,1,1
42328,9,27,7,0,20,7
42328,8,123,44,0,79,44
42328,7,92,25,0,67,25
42328,6,36,12,0,24,12
42328,5,12,3,0,9,3
42328,4,7,4,0,3,4
42328,2,2,1,0,1,1
205079,10,11,2,0,9,2
205079,9,15,1,0,14,1
205079,8,42,4,0,38,4
205079,7,91,12,0,79,12
205079,6,95,7,0,88,7
205079,5,27,3,0,24,3
205079,4,15,3,0,12,3
205079,3,8,1,0,7,1
142063,10,29,4,0,25,4
142063,9,45,11,1,34,10
142063,8,85,13,2,72,11
142063,7,70,11,1,59,10
142063,6,44,7,0,37,7
142063,5,17,2,0,15,2
142063,3,5,2,1,3,1
142063,2,4,3,0,1,3
66781,10,7,1,0,6,1
66781,9,19,3,0,16,3
66781,8,92,24,0,68,24
66781,7,84,25,0,59,25
66781,6,72,26,1,46,25
66781,5,14,5,0,9,5
66781,4,12,5,0,7,5
66781,3,5,4,0,1,4
66781,2,3,2,0,1,2
1585,10,30,13,0,17,13
1585,9,72,24,0,48,24
1585,8,108,31,0,77,31
1585,7,57,15,0,42,15
1585,6,25,6,0,19,6
1585,5,10,6,0,4,6
1585,4,3,2,0,1,2
16226,8,5,1,0,4,1
16226,7,33,9,0,24,9
16226,6,125,34,0,91,34
16226,5,71,16,0,55,16
16226,4,46,20,0,26,20
16226,3,14,7,0,7,7
16226,2,8,1,0,7,1
16226,1,3,2,0,1,2
231554,10,11,4,1,7,3
231554,9,12,2,0,10,2
231554,8,68,11,0,57,11
231554,7,91,15,1,76,14
231554,6,87,12,0,75,12
231554,5,19,4,0,15,4
231554,4,10,2,0,8,2
231554,3,7,3,0,4,3
231554,2,3,1,0,2,1
9560,8,9,4,0,5,4
9560,7,57,18,0,39,18
9560,6,121,36,0,85,36
9560,5,63,15,0,48,15
9560,4,31,5,0,26,5
9560,3,13,3,0,10,3
9560,2,13,6,0,7,6
2962,8,15,6,0,9,6
2962,7,40,16,0,24,16
2962,6,98,31,0,67,31
2962,5,84,28,0,56,28
2962,4,45,14,0,31,14
2962,3,11,3,0,8,3
2962,2,11,4,0,7,4
6191,10,7,3,0,4,3
6191,9,15,8,0,7,8
6191,8,53,16,0,37,16
6191,7,71,25,0,46,25
6191,6,95,23,0,72,23
6191,5,37,8,0,29,8
6191,4,19,3,0,16,3
6191,3,7,3,0,4,3
6191,2,3,1,0,2,1
31697,10,9,4,0,5,4
31697,9,9,4,0,5,4
31697,8,74,33,0,41,33
31697,7,96,33,0,63,33
31697,6,83,33,0,50,33
31697,5,20,10,0,10,10
31697,4,8,4,0,4,4
31697,3,4,1,0,3,1
31697,2,3,3,0,0,3
165556,10,1,1,0,0,1
165556,9,9,5,0,4,5
165556,8,56,17,0,39,17
165556,7,101,27,0,74,27
165556,6,101,21,0,80,21
165556,5,27,6,0,21,6
165556,4,9,2,0,7,2
13354,10,17,4,0,13,4
13354,9,21,5,0,16,5
13354,8,80,20,0,60,20
13354,7,85,24,0,61,24
13354,6,77,12,0,65,12
13354,5,20,7,0,13,7
13354,4,6,2,0,4,2
198707,10,30,3,0,27,3
198707,9,46,6,1,40,5
198707,8,108,15,0,93,15
198707,7,75,12,0,63,12
198707,6,43,12,1,31,11
198707,3,2,1,0,1,1
198707,2,1,1,0,0,1
3084,10,5,3,0,2,3
3084,9,7,5,0,2,5
3084,8,27,11,0,16,11
3084,7,55,22,0,33,22
3084,6,105,40,0,65,40
3084,5,39,14,0,25,14
3084,4,25,4,0,21,4
3084,3,5,1,0,4,1
3084,2,7,5,0,2,5
3084,1,2,1,0,1,1
214491,10,5,1,0,4,1
214491,8,49,10,0,39,10
214491,7,92,14,0,78,14
214491,6,106,8,0,98,8
214491,5,25,2,0,23,2
214491,4,13,2,0,11,2
214491,3,6,3,0,3,3
2268,10,11,2,0,9,2
2268,9,11,6,0,5,6
2268,8,52,17,0,35,17
2268,7,80,29,0,51,29
2268,6,90,28,0,62,28
2268,5,34,12,0,22,12
2268,4,15,7,0,8,7
2268,2,3,2,0,1,2
2268,1,4,1,0,3,1
104555,8,31,8,0,23,8
104555,7,58,13,0,45,13
104555,6,122,26,0,96,26
104555,5,52,8,0,44,8
104555,4,26,4,0,22,4
104555,3,7,3,0,4,3
104555,2,5,1,0,4,1
129380,10,5,1,0,4,1
129380,9,12,4,0,8,4
129380,8,38,9,0,29,9
129380,7,86,14,0,72,14
129380,6,84,11,0,73,11
129380,5,46,11,0,35,11
129380,4,11,1,0,10,1
129380,3,14,4,0,10,4
129380,2,9,2,0,7,2
238164,10,47,19,1,28,18
238164,9,25,10,0,15,10
238164,8,79,28,4,51,24
238164,7,56,9,0,47,9
238164,6,33,5,0,28,5
238164,5,14,8,0,6,8
238164,4,6,3,2,3,1
238164,3,3,1,1,2,0
238164,2,3,2,0,1,2
238164,1,45,23,3,22,20
107861,10,10,6,0,4,6
107861,9,14,5,0,9,5
107861,8,47,12,0,35,12
107861,7,59,8,0,51,8
107861,6,83,12,0,71,12
107861,5,55,14,0,41,14
107861,4,21,7,0,14,7
107861,3,9,5,0,4,5
107861,2,5,1,0,4,1
107861,1,2,1,0,1,1
169530,10,17,6,0,11,6
169530,9,15,5,0,10,5
169530,8,57,15,1,42,14
169530,7,71,15,1,56,14
169530,6,78,16,0,62,16
169530,5,40,7,1,33,6
169530,4,17,10,1,7,9
169530,3,6,2,0,4,2
169530,2,3,1,0,2,1
219232,10,6,3,0,3,3
219232,9,15,2,0,13,2
219232,8,70,7,0,63,7
219232,7,100,7,0,93,7
219232,6,85,12,0,73,12
219232,5,16,3,0,13,3
219232,4,10,1,0,9,1
193953,10,26,6,0,20,6
193953,9,48,10,0,38,10
193953,8,113,21,3,92,18
193953,7,52,11,0,41,11
193953,6,43,9,0,34,9
193953,5,14,2,0,12,2
193953,4,4,2,0,2,2
193953,2,2,1,0,1,1
193953,1,2,1,0,1,1
177844,10,26,3,0,23,3
177844,9,15,2,0,13,2
177844,8,40,6,0,34,6
177844,7,53,7,0,46,7
177844,6,87,14,5,73,9
177844,5,41,6,1,35,5
177844,4,20,5,0,15,5
177844,3,12,2,0,10,2
177844,2,6,1,0,5,1
177844,1,5,2,0,3,2
180179,9,7,3,0,4,3
180179,8,43,6,0,37,6
180179,7,92,11,0,81,11
180179,6,106,14,0,92,14
180179,5,37,4,1,33,3
180179,4,5,1,0,4,1
180179,3,10,4,0,6,4
243696,9,13,1,0,12,1
243696,8,72,10,0,62,10
243696,7,103,15,0,88,15
243696,6,78,11,0,67,11
243696,5,20,7,0,13,7
243696,4,8,3,0,5,3
243696,3,4,1,0,3,1
3679,9,5,2,0,3,2
3679,8,42,9,0,33,9
3679,7,73,19,0,54,19
3679,6,116,22,0,94,22
3679,5,37,8,0,29,8
3679,4,20,3,0,17,3
3679,3,7,2,0,5,2
3679,2,2,1,0,1,1
3679,1,1,1,0,0,1
28907,10,10,2,0,8,2
28907,9,22,9,0,13,9
28907,8,85,29,0,56,29
28907,7,76,28,0,48,28
28907,6,78,32,0,46,32
28907,5,27,10,0,17,10
28907,4,5,1,0,4,1
28907,3,2,2,0,0,2
736,8,29,11,0,18,11
736,7,98,28,0,70,28
736,6,105,27,0,78,27
736,5,46,12,0,34,12
736,4,19,5,0,14,5
736,3,3,2,0,1,2
736,2,3,2,0,1,2
5015,8,6,3,0,3,3
5015,7,14,5,0,9,5
5015,6,26,7,0,19,7
5015,5,77,19,0,58,19
5015,4,93,32,0,61,32
5015,3,50,11,0,39,11
5015,2,28,11,0,17,11
5015,1,9,4,0,5,4
68820,10,101,39,0,62,39
68820,9,87,20,0,67,20
68820,8,79,22,0,57,22
68820,7,19,8,0,11,8
68820,6,8,4,0,4,4
68820,5,4,2,0,2,2
68820,4,3,2,0,1,2
68820,1,4,1,0,3,1
125993,10,10,4,0,6,4
125993,9,54,22,0,32,22
125993,8,134,39,0,95,39
125993,7,64,17,0,47,17
125993,6,30,12,0,18,12
125993,5,7,6,0,1,6
125993,4,5,1,0,4,1
200551,10,6,2,0,4,2
200551,9,12,6,0,6,6
200551,8,64,20,0,44,20
200551,7,92,24,0,68,24
200551,6,89,32,0,57,32
200551,5,26,8,0,18,8
200551,4,13,5,0,8,5
153238,9,6,2,0,4,2
153238,8,58,15,0,43,15
153238,7,89,26,0,63,26
153238,6,97,23,0,74,23
153238,5,31,10,0,21,10
153238,4,16,3,0,13,3
153238,3,6,1,0,5,1
232473,10,23,6,1,17,5
232473,9,20,4,0,16,4
232473,8,77,11,1,66,10
232473,7,93,10,2,83,8
232473,6,64,2,0,62,2
232473,5,9,1,0,8,1
232473,4,8,5,0,3,5
232473,3,4,1,0,3,1
232473,1,2,1,0,1,1
4008,10,9,5,0,4,5
4008,9,15,6,0,9,6
4008,8,60,37,0,23,37
4008,7,89,36,0,53,36
4008,6,83,22,0,61,22
4008,5,32,10,0,22,10
4008,4,6,1,0,5,1
4008,3,7,3,0,4,3
4008,2,3,2,0,1,2
6090,9,1,1,0,0,1
6090,7,18,4,0,14,4
6090,6,110,33,0,77,33
6090,5,66,16,0,50,16
6090,4,54,18,0,36,18
6090,3,32,10,0,22,10
6090,2,10,4,0,6,4
67917,10,5,3,0,2,3
67917,9,13,3,0,10,3
67917,8,89,20,1,69,19
67917,7,90,23,0,67,23
67917,6,66,10,0,56,10
67917,5,25,10,0,15,10
67917,4,9,4,0,5,4
67917,3,2,1,0,1,1
67917,2,2,1,0,1,1
67917,1,1,1,0,0,1
27969,10,17,3,0,14,3
27969,9,33,11,0,22,11
27969,8,117,37,0,80,37
27969,7,74,19,0,55,19
27969,6,32,10,0,22,10
27969,5,13,2,0,11,2
27969,4,13,4,0,9,4
27969,3,2,2,0,0,2
27969,2,2,2,0,0,2
3378,10,2,2,0,0,2
3378,8,17,7,0,10,7
3378,7,33,12,0,21,12
3378,6,102,33,0,69,33
3378,5,78,22,0,56,22
3378,4,41,19,0,22,19
3378,3,19,10,0,9,10
3378,2,5,2,0,3,2
3378,1,1,1,0,0,1
5281,10,4,2,0,2,2
5281,9,16,6,0,10,6
5281,8,46,18,0,28,18
5281,7,78,39,0,39,39
5281,6,103,29,0,74,29
5281,5,31,10,0,21,10
5281,4,17,5,0,12,5
5281,3,2,2,0,0,2
5281,2,4,3,0,1,3
5281,1,2,1,0,1,1
66198,10,5,1,0,4,1
66198,9,3,1,0,2,1
66198,8,12,2,0,10,2
66198,7,36,8,0,28,8
66198,6,88,20,0,68,20
66198,5,74,8,0,66,8
66198,4,47,14,0,33,14
66198,3,20,5,0,15,5
66198,2,10,2,0,8,2
66198,1,8,1,0,7,1
107638,10,3,1,0,2,1
107638,9,4,1,0,3,1
107638,8,35,7,0,28,7
107638,7,75,18,0,57,18
107638,6,105,20,0,85,20
107638,5,46,11,0,35,11
107638,4,25,7,0,18,7
107638,3,5,1,0,4,1
107638,2,4,3,0,1,3
230591,10,6,1,0,5,1
230591,9,12,1,0,11,1
230591,8,44,10,0,34,10
230591,7,86,8,0,78,8
230591,6,92,13,0,79,13
230591,5,42,14,0,28,14
230591,4,12,2,0,10,2
230591,3,4,1,0,3,1
230591,2,3,2,0,1,2
234877,9,12,2,0,10,2
234877,8,58,4,0,54,4
234877,7,101,14,0,87,14
234877,6,79,6,0,73,6
234877,5,40,5,0,35,5
234877,4,11,3,0,8,3
114684,10,12,1,0,11,1
114684,9,18,1,0,17,1
114684,8,43,9,5,34,4
114684,7,78,10,1,68,9
114684,6,92,17,4,75,13
114684,5,33,7,1,26,6
114684,4,19,2,0,17,2
114684,3,6,2,0,4,2
114684,2,2,1,0,1,1
21022,10,12,2,0,10,2
21022,9,13,5,0,8,5
21022,8,69,14,0,55,14
21022,7,85,15,0,70,15
21022,6,67,6,0,61,6
21022,5,30,4,0,26,4
21022,4,17,1,0,16,1
19591,9,3,1,0,2,1
19591,8,19,3,0,16,3
19591,7,56,23,0,33,23
19591,6,124,37,0,87,37
19591,5,51,14,0,37,14
19591,4,25,12,0,13,12
19591,3,11,8,0,3,8
19591,2,8,3,0,5,3
47218,9,9,1,0,8,1
47218,8,27,7,0,20,7
47218,7,62,19,0,43,19
47218,6,125,28,0,97,28
47218,5,40,9,0,31,9
47218,4,28,10,0,18,10
47218,3,9,3,0,6,3
173074,10,4,1,0,3,1
173074,8,25,5,0,20,5
173074,7,54,5,0,49,5
173074,6,119,22,0,97,22
173074,5,48,10,0,38,10
173074,4,31,4,0,27,4
173074,3,10,1,0,9,1
173074,2,5,1,0,4,1
5445,10,43,20,0,23,20
5445,9,35,13,0,22,13
5445,8,62,31,0,31,31
5445,7,52,15,0,37,15
5445,6,60,19,0,41,19
5445,5,27,10,0,17,10
5445,4,12,4,0,8,4
5445,2,6,3,0,3,3
5445,1,1,1,0,0,1
305,9,7,1,0,6,1
305,8,28,3,0,25,3
305,7,60,16,0,44,16
305,6,118,25,0,93,25
305,5,56,6,0,50,6
305,4,19,4,0,15,4
305,3,6,2,0,4,2
305,2,5,2,0,3,2
305,1,1,1,0,0,1
6584,9,13,3,0,10,3
6584,8,38,9,0,29,9
6584,7,67,8,0,59,8
6584,6,96,21,0,75,21
6584,5,45,7,0,38,7
6584,4,25,10,0,15,10
6584,3,7,3,0,4,3
6584,2,5,1,0,4,1
6584,1,1,1,0,0,1
186302,10,15,4,0,11,4
186302,9,11,2,0,9,2
186302,8,56,8,0,48,8
186302,7,67,13,0,54,13
186302,6,98,11,0,87,11
186302,5,26,3,0,23,3
186302,4,15,3,0,12,3
186302,3,7,2,0,5,2
186302,2,8,1,0,7,1
204135,9,24,2,0,22,2
204135,8,67,8,0,59,8
204135,7,110,10,0,100,10
204135,6,66,13,0,53,13
204135,5,18,1,0,17,1
204135,4,8,2,0,6,2
204135,2,2,1,0,1,1
12616,10,3,1,0,2,1
12616,9,4,3,0,1,3
12616,8,20,7,0,13,7
12616,7,32,14,0,18,14
12616,6,71,21,0,50,21
12616,5,87,17,0,70,17
12616,4,54,17,0,37,17
12616,3,21,6,0,15,6
12616,2,8,4,0,4,4
12616,1,2,1,0,1,1
4980,9,6,4,0,2,4
4980,8,32,15,0,17,15
4980,7,88,34,0,54,34
4980,6,104,41,0,63,41
4980,5,44,17,0,27,17
4980,4,18,7,0,11,7
4980,3,4,4,0,0,4
4980,2,3,1,0,2,1
122890,10,3,1,0,2,1
122890,9,13,4,0,9,4
122890,8,76,15,0,61,15
122890,7,89,18,0,71,18
122890,6,65,13,0,52,13
122890,5,32,8,0,24,8
122890,4,19,7,0,12,7
122890,3,3,2,0,1,2
122890,2,2,1,0,1,1
218580,10,6,3,1,3,2
218580,9,14,3,0,11,3
218580,8,99,23,3,76,20
218580,7,99,26,1,73,25
218580,6,47,12,0,35,12
218580,5,15,4,0,11,4
218580,4,13,3,0,10,3
218580,3,6,3,0,3,3
155460,9,24,3,0,21,3
155460,8,73,13,0,60,13
155460,7,95,20,0,75,20
155460,6,67,8,0,59,8
155460,5,15,4,0,11,4
155460,4,9,3,0,6,3
155460,3,3,3,0,0,3
155460,2,3,1,0,2,1
36482,10,20,4,0,16,4
36482,9,29,4,0,25,4
36482,8,82,9,0,73,9
36482,7,92,10,0,82,10
36482,6,61,7,0,54,7
36482,4,3,2,0,1,2
22826,9,9,2,0,7,2
22826,8,37,14,0,23,14
22826,7,61,12,0,49,12
22826,6,99,23,0,76,23
22826,5,47,13,0,34,13
22826,4,25,8,0,17,8
22826,3,10,1,0,9,1
2543,10,5,1,0,4,1
2543,9,6,1,0,5,1
2543,8,31,3,0,28,3
2543,7,81,16,0,65,16
2543,6,104,22,0,82,22
2543,5,39,7,0,32,7
2543,4,21,9,0,12,9
2543,3,11,4,0,7,4
2543,2,2,1,0,1,1
7972,9,1,1,0,0,1
7972,8,6,1,0,5,1
7972,7,23,11,0,12,11
7972,6,64,21,0,43,21
7972,5,56,25,0,31,25
7972,4,60,18,0,42,18
7972,3,35,15,0,20,15
7972,2,36,13,0,23,13
7972,1,20,6,0,14,6
38504,8,16,6,0,10,6
38504,7,38,9,0,29,9
38504,6,118,34,0,84,34
38504,5,60,16,0,44,16
38504,4,45,12,0,33,12
38504,3,14,4,0,10,4
38504,2,9,4,0,5,4
4079,10,11,8,0,3,8
4079,9,31,20,0,11,20
4079,8,85,32,0,53,32
4079,7,79,24,0,55,24
4079,6,69,25,0,44,25
4079,5,19,6,0,13,6
4079,4,5,1,0,4,1
4079,3,2,1,0,1,1
175592,10,3,2,0,1,2
175592,9,5,1,0,4,1
175592,8,30,6,0,24,6
175592,7,72,12,0,60,12
175592,6,86,11,0,75,11
175592,5,55,14,0,41,14
175592,4,22,6,0,16,6
175592,3,12,2,0,10,2
175592,2,11,5,0,6,5
175592,1,4,2,0,2,2
20675,10,7,1,0,6,1
20675,9,6,1,0,5,1
20675,8,32,8,0,24,8
20675,7,38,13,0,25,13
20675,6,94,24,0,70,24
20675,5,66,25,0,41,25
20675,4,34,12,0,22,12
20675,3,15,3,0,12,3
20675,2,5,5,0,0,5
72800,10,9,3,0,6,3
72800,9,12,5,0,7,5
72800,8,69,14,0,55,14
72800,7,83,14,0,69,14
72800,6,91,31,0,60,31
72800,5,23,6,0,17,6
72800,4,7,6,0,1,6
72800,3,6,1,0,5,1
32838,10,40,12,0,28,12
32838,9,65,22,0,43,22
32838,8,103,32,0,71,32
32838,7,46,12,0,34,12
32838,6,27,8,0,19,8
32838,5,9,2,0,7,2
32838,4,5,3,0,2,3
32838,2,2,1,0,1,1
4958,10,10,2,0,8,2
4958,9,22,6,0,16,6
4958,8,88,31,0,57,31
4958,7,100,28,0,72,28
4958,6,50,11,0,39,11
4958,5,18,4,0,14,4
4958,4,7,3,0,4,3
4958,1,1,1,0,0,1
131332,10,7,1,0,6,1
131332,9,15,3,1,12,2
131332,8,53,14,1,39,13
131332,7,79,14,0,65,14
131332,6,80,13,0,67,13
131332,5,29,7,0,22,7
131332,4,20,5,0,15,5
131332,3,8,2,0,6,2
131332,2,3,2,0,1,2
131332,1,6,4,0,2,4
124833,10,9,2,0,7,2
124833,9,6,1,0,5,1
124833,8,23,3,0,20,3
124833,7,41,10,0,31,10
124833,6,91,18,2,73,16
124833,5,48,12,0,36,12
124833,4,30,8,0,22,8
124833,3,18,5,0,13,5
124833,2,20,9,0,11,9
124833,1,13,5,0,8,5
128938,10,3,1,0,2,1
128938,9,10,3,1,7,2
128938,8,51,9,1,42,8
128938,7,72,11,1,61,10
128938,6,101,26,3,75,23
128938,5,36,7,0,29,7
128938,4,18,4,1,14,3
128938,3,6,1,0,5,1
246228,10,14,1,0,13,1
246228,9,20,6,0,14,6
246228,8,64,9,0,55,9
246228,7,88,11,0,77,11
246228,6,65,11,0,54,11
246228,5,22,2,0,20,2
246228,3,11,2,0,9,2
246228,1,2,2,0,0,2
204543,10,6,1,0,5,1
204543,8,9,3,0,6,3
204543,7,32,4,0,28,4
204543,6,93,8,0,85,8
204543,5,55,8,0,47,8
204543,4,43,9,0,34,9
204543,3,27,6,0,21,6
204543,2,15,4,0,11,4
204543,1,17,6,0,11,6
257067,10,9,1,0,8,1
257067,9,23,5,0,18,5
257067,8,76,13,0,63,13
257067,7,89,14,0,75,14
257067,6,67,9,0,58,9
257067,5,23,3,0,20,3
257067,4,8,2,0,6,2
257067,3,5,1,0,4,1
10400,10,5,4,0,1,4
10400,9,4,2,0,2,2
10400,8,5,2,0,3,2
10400,7,16,3,0,13,3
10400,6,67,22,0,45,22
10400,5,72,25,0,47,25
10400,4,70,22,0,48,22
10400,3,28,7,0,21,7
10400,2,24,8,0,16,8
10400,1,7,4,0,3,4
33495,10,20,3,0,17,3
33495,9,34,8,0,26,8
33495,8,86,11,0,75,11
33495,7,71,8,0,63,8
33495,6,59,5,0,54,5
33495,4,5,1,0,4,1
136245,10,3,1,0,2,1
136245,9,9,2,0,7,2
136245,8,33,9,0,24,9
136245,7,88,10,0,78,10
136245,6,103,19,0,84,19
136245,5,34,6,0,28,6
136245,4,19,3,0,16,3
136245,3,7,1,0,6,1
136245,1,1,1,0,0,1
7118,10,16,10,0,6,10
7118,9,24,9,0,15,9
7118,8,73,31,0,42,31
7118,7,98,30,0,68,30
7118,6,58,17,0,41,17
7118,5,22,7,0,15,7
7118,4,6,3,0,3,3
7118,3,2,1,0,1,1
3231,10,1,1,0,0,1
3231,8,34,12,0,22,12
3231,7,68,21,0,47,21
3231,6,106,30,0,76,30
3231,5,58,19,0,39,19
3231,4,25,8,0,17,8
3231,3,4,1,0,3,1
3231,2,2,1,0,1,1
3231,1,1,1,0,0,1
229370,10,9,2,0,7,2
229370,9,24,4,0,20,4
229370,8,126,26,3,100,23
229370,7,75,17,0,58,17
229370,6,49,7,1,42,6
229370,5,11,5,0,6,5
229370,4,3,1,0,2,1
229370,3,1,1,0,0,1
229370,1,1,1,0,0,1
127134,10,3,1,0,2,1
127134,9,8,1,0,7,1
127134,8,24,3,0,21,3
127134,7,59,9,0,50,9
127134,6,132,18,0,114,18
127134,5,44,5,0,39,5
127134,4,22,2,0,20,2
25409,8,39,10,0,29,10
25409,7,74,23,0,51,23
25409,6,107,20,0,87,20
25409,5,48,13,0,35,13
25409,4,20,8,0,12,8
25409,3,6,3,0,3,3
25409,2,1,1,0,0,1
60316,10,5,1,0,4,1
60316,9,8,2,0,6,2
60316,8,16,3,0,13,3
60316,7,58,9,0,49,9
60316,6,118,25,0,93,25
60316,5,35,10,0,25,10
60316,4,39,10,0,29,10
60316,3,10,3,0,7,3
60316,2,5,2,0,3,2
60316,1,5,2,0,3,2
6566,8,21,8,0,13,8
6566,7,49,14,0,35,14
6566,6,116,29,0,87,29
6566,5,48,10,0,38,10
6566,4,36,17,0,19,17
6566,3,13,9,0,4,9
6566,2,10,5,0,5,5
189192,10,12,2,0,10,2
189192,9,13,1,0,12,1
189192,8,72,20,4,52,16
189192,7,95,15,1,80,14
189192,6,65,16,1,49,15
189192,5,27,3,0,24,3
189192,4,5,2,0,3,2
189192,3,4,3,0,1,3
203270,10,16,2,0,14,2
203270,9,27,6,0,21,6
203270,8,94,22,0,72,22
203270,7,73,9,0,64,9
203270,6,61,13,0,48,13
203270,5,18,5,0,13,5
203270,4,7,1,0,6,1
203270,1,1,1,0,0,1
6646,10,8,5,0,3,5
6646,9,10,3,0,7,3
6646,8,36,10,0,26,10
6646,7,68,19,0,49,19
6646,6,99,17,0,82,17
6646,5,47,10,0,37,10
6646,4,16,4,0,12,4
6646,3,9,3,0,6,3
6646,2,4,3,0,1,3
4376,8,8,2,0,6,2
4376,7,32,10,0,22,10
4376,6,80,20,0,60,20
4376,5,82,24,0,58,24
4376,4,56,20,0,36,20
4376,3,21,10,0,11,10
4376,2,14,7,0,7,7
101796,10,6,2,0,4,2
101796,9,10,4,0,6,4
101796,8,39,12,0,27,12
101796,7,73,17,0,56,17
101796,6,88,20,0,68,20
101796,5,44,14,0,30,14
101796,4,22,5,0,17,5
101796,3,12,4,0,8,4
101796,2,2,1,0,1,1
222643,10,19,3,1,16,2
222643,9,15,4,0,11,4
222643,8,80,17,1,63,16
222643,7,78,6,1,72,5
222643,6,67,13,0,54,13
222643,5,24,4,0,20,4
222643,4,8,2,0,6,2
222643,3,6,2,0,4,2
237031,10,40,11,0,29,11
237031,9,65,17,0,48,17
237031,8,96,21,0,75,21
237031,7,50,13,0,37,13
237031,6,27,6,0,21,6
237031,5,9,3,0,6,3
237031,4,5,3,0,2,3
237031,3,2,1,0,1,1
237031,2,4,2,0,2,2
127981,10,8,2,0,6,2
127981,9,7,1,1,6,0
127981,8,53,18,0,35,18
127981,7,64,13,0,51,13
127981,6,100,23,1,77,22
127981,5,39,10,3,29,7
127981,4,15,5,0,10,5
127981,3,10,6,0,4,6
127981,1,2,1,0,1,1
173649,10,4,2,0,2,2
173649,9,10,5,0,5,5
173649,8,75,20,0,55,20
173649,7,88,23,0,65,23
173649,6,78,26,0,52,26
173649,5,26,9,0,17,9
173649,4,7,1,0,6,1
173649,3,1,1,0,0,1
173649,2,8,2,0,6,2
181176,10,16,9,0,7,9
181176,9,36,13,0,23,13
181176,8,105,31,2,74,29
181176,7,67,16,0,51,16
181176,6,52,7,0,45,7
181176,5,11,2,0,9,2
181176,4,5,2,0,3,2
181176,3,4,2,0,2,2
1920,10,7,4,0,3,4
1920,9,4,2,0,2,2
1920,8,21,6,0,15,6
1920,7,62,20,0,42,20
1920,6,96,24,0,72,24
1920,5,55,11,0,44,11
1920,4,35,13,0,22,13
1920,3,14,5,0,9,5
1920,1,2,1,0,1,1
213549,10,19,5,0,14,5
213549,9,17,6,0,11,6
213549,8,76,15,0,61,15
213549,7,94,10,0,84,10
213549,6,60,11,0,49,11
213549,5,21,3,0,18,3
213549,3,4,2,0,2,2
1482,10,2,2,0,0,2
1482,9,7,1,0,6,1
1482,8,30,9,0,21,9
1482,7,43,12,0,31,12
1482,6,81,31,0,50,31
1482,5,36,6,0,30,6
1482,4,44,18,0,26,18
1482,3,28,10,0,18,10
1482,2,17,7,0,10,7
1482,1,10,7,0,3,7
46362,10,7,1,0,6,1
46362,9,16,7,0,9,7
46362,8,45,7,0,38,7
46362,7,56,16,0,40,16
46362,6,101,16,0,85,16
46362,5,44,10,0,34,10
46362,4,17,5,0,12,5
46362,3,8,3,0,5,3
94365,10,9,1,0,8,1
94365,8,42,3,0,39,3
94365,7,66,8,0,58,8
94365,6,107,12,0,95,12
94365,5,42,3,0,39,3
94365,4,18,1,0,17,1
82424,10,3,1,0,2,1
82424,9,6,3,0,3,3
82424,8,40,9,0,31,9
82424,7,75,15,0,60,15
82424,6,110,29,0,81,29
82424,5,36,9,0,27,9
82424,4,17,6,0,11,6
82424,3,10,5,0,5,5
82424,2,1,1,0,0,1
13542,9,8,2,0,6,2
13542,8,26,7,0,19,7
13542,7,72,13,0,59,13
13542,6,110,23,0,87,23
13542,5,39,7,0,32,7
13542,4,23,6,0,17,6
13542,3,10,5,1,5,4
13542,2,5,2,0,3,2
3059,9,5,4,0,1,4
3059,8,17,5,0,12,5
3059,7,37,10,0,27,10
3059,6,104,35,0,69,35
3059,5,74,26,0,48,26
3059,4,42,13,0,29,13
3059,3,11,2,0,9,2
3059,2,5,1,0,4,1
608,10,2,2,0,0,2
608,9,8,4,0,4,4
608,8,47,15,0,32,15
608,7,68,23,0,45,23
608,6,105,35,0,70,35
608,5,35,9,0,26,9
608,4,25,11,0,14,11
608,3,6,3,0,3,3
176817,10,12,2,0,10,2
176817,9,18,5,0,13,5
176817,8,63,19,0,44,19
176817,7,85,18,0,67,18
176817,6,71,15,0,56,15
176817,5,23,11,0,12,11
176817,4,11,3,0,8,3
176817,3,8,3,0,5,3
176817,2,3,1,0,2,1
176817,1,3,3,0,0,3
175458,10,7,1,0,6,1
175458,8,14,2,0,12,2
175458,7,47,8,0,39,8
175458,6,104,25,0,79,25
175458,5,63,15,0,48,15
175458,4,38,7,0,31,7
175458,3,16,7,0,9,7
175458,2,3,1,0,2,1
10682,9,7,3,0,4,3
10682,8,39,15,0,24,15
10682,7,79,30,0,49,30
10682,6,117,35,0,82,35
10682,5,35,11,0,24,11
10682,4,14,6,0,8,6
10682,3,3,2,0,1,2
233973,10,17,8,0,9,8
233973,9,21,5,0,16,5
233973,8,67,10,0,57,10
233973,7,82,8,0,74,8
233973,6,83,11,0,72,11
233973,5,18,1,0,17,1
233973,4,5,2,0,3,2
233973,3,2,1,0,1,1
233973,2,2,1,0,1,1
172596,8,35,5,0,30,5
172596,7,72,9,0,63,9
172596,6,101,18,0,83,18
172596,5,46,8,0,38,8
172596,4,16,2,0,14,2
172596,3,14,5,0,9,5
172596,2,6,3,0,3,3
1575,10,8,4,0,4,4
1575,9,5,3,0,2,3
1575,8,32,12,0,20,12
1575,7,43,10,0,33,10
1575,6,92,31,0,61,31
1575,5,57,19,0,38,19
1575,4,35,17,0,18,17
1575,3,14,9,0,5,9
1575,2,9,5,0,4,5
1575,1,2,1,0,1,1
39232,10,11,6,0,5,6
39232,9,19,9,0,10,9
39232,8,90,28,0,62,28
39232,7,87,32,0,55,32
39232,6,59,16,0,43,16
39232,5,15,5,1,10,4
39232,4,6,5,0,1,5
39232,3,5,3,0,2,3
39232,2,3,1,1,2,0
55763,10,10,3,0,7,3
55763,9,12,4,0,8,4
55763,8,57,9,0,48,9
55763,7,93,12,0,81,12
55763,6,79,9,0,70,9
55763,5,21,6,0,15,6
17517,8,15,3,0,12,3
17517,7,46,11,0,35,11
17517,6,93,24,0,69,24
17517,5,74,22,0,52,22
17517,4,34,9,0,25,9
17517,3,16,3,0,13,3
17517,2,8,3,0,5,3
233974,10,6,3,0,3,3
233974,9,21,4,0,17,4
233974,8,61,13,0,48,13
233974,7,109,18,0,91,18
233974,6,73,12,0,61,12
233974,5,18,2,0,16,2
233974,4,5,1,0,4,1
233974,2,2,1,0,1,1
140279,9,17,4,0,13,4
140279,8,40,7,0,33,7
140279,7,81,13,0,68,13
140279,6,84,9,0,75,9
140279,5,29,3,0,26,3
140279,4,25,5,0,20,5
140279,2,4,1,0,3,1
8196,10,3,2,0,1,2
8196,9,7,2,0,5,2
8196,8,18,1,0,17,1
8196,7,50,5,0,45,5
8196,6,93,11,0,82,11
8196,5,68,18,0,50,18
8196,4,38,13,0,25,13
8196,3,13,6,0,7,6
8196,2,5,4,0,1,4
161527,10,18,1,0,17,1
161527,9,23,1,0,22,1
161527,8,93,17,0,76,17
161527,7,77,8,0,69,8
161527,6,64,10,0,54,10
161527,5,14,1,0,13,1
161527,4,6,1,0,5,1
1817,9,4,1,0,3,1
1817,8,8,5,0,3,5
1817,7,16,6,0,10,6
1817,6,64,17,0,47,17
1817,5,83,24,0,59,24
1817,4,61,15,0,46,15
1817,3,32,15,0,17,15
1817,2,18,10,0,8,10
1817,1,7,5,0,2,5
6535,10,3,1,0,2,1
6535,8,9,5,0,4,5
6535,7,16,6,0,10,6
6535,6,50,17,0,33,17
6535,5,64,16,0,48,16
6535,4,72,16,0,56,16
6535,3,38,12,0,26,12
6535,2,36,14,0,22,14
6535,1,8,1,0,7,1
171964,10,49,13,1,36,12
171964,9,42,8,0,34,8
171964,8,93,10,1,83,9
171964,7,50,7,1,43,6
171964,6,33,6,0,27,6
171964,5,11,1,0,10,1
171964,4,5,3,0,2,3
171964,3,8,3,0,5,3
171964,2,4,3,0,1,3
27680,10,28,9,0,19,9
27680,9,34,5,0,29,5
27680,8,114,27,0,87,27
27680,7,64,7,0,57,7
27680,6,39,9,0,30,9
27680,5,9,3,0,6,3
6353,10,11,7,0,4,7
6353,9,28,13,0,15,13
6353,8,101,41,0,60,41
6353,7,80,20,0,60,20
6353,6,38,10,0,28,10
6353,5,16,9,0,7,9
6353,4,8,5,0,3,5
6353,3,6,3,0,3,3
6353,2,3,2,0,1,2
6353,1,5,3,0,2,3
159515,10,7,4,0,3,4
159515,9,13,5,1,8,4
159515,8,54,15,2,39,13
159515,7,71,15,0,56,15
159515,6,65,14,0,51,14
159515,5,42,3,0,39,3
159515,4,26,9,0,17,9
159515,3,10,3,0,7,3
159515,2,7,3,0,4,3
16804,10,12,9,0,3,9
16804,9,30,16,0,14,16
16804,8,90,23,0,67,23
16804,7,69,19,0,50,19
16804,6,48,13,0,35,13
16804,5,27,9,0,18,9
16804,4,10,4,0,6,4
16804,3,6,4,0,2,4
16804,1,2,1,0,1,1
34745,8,16,7,0,9,7
34745,7,41,20,0,21,20
34745,6,104,49,0,55,49
34745,5,67,29,0,38,29
34745,4,39,16,0,23,16
34745,3,16,10,0,6,10
34745,2,7,4,0,3,4
34745,1,3,1,0,2,1
1867,9,4,2,0,2,2
1867,8,16,2,0,14,2
1867,7,24,3,0,21,3
1867,6,83,14,0,69,14
1867,5,78,20,0,58,20
1867,4,49,12,0,37,12
1867,3,24,9,0,15,9
1867,2,10,4,0,6,4
1867,1,4,2,0,2,2
155802,9,6,2,0,4,2
155802,8,40,13,0,27,13
155802,7,76,14,0,62,14
155802,6,118,18,0,100,18
155802,5,26,5,0,21,5
155802,4,18,7,0,11,7
155802,3,6,2,0,4,2
10527,10,23,4,0,19,4
10527,9,21,6,0,15,6
10527,8,50,18,0,32,18
10527,7,69,20,0,49,20
10527,6,79,15,0,64,15
10527,5,32,7,0,25,7
10527,4,13,3,0,10,3
10527,3,4,2,0,2,2
10527,2,3,1,0,2,1
12422,10,3,1,0,2,1
12422,8,13,8,0,5,8
12422,7,19,5,0,14,5
12422,6,78,32,0,46,32
12422,5,70,24,0,46,24
12422,4,64,26,0,38,26
12422,3,23,13,0,10,13
12422,2,18,10,0,8,10
12422,1,7,4,0,3,4
1551,9,4,1,0,3,1
1551,8,19,5,0,14,5
1551,7,51,16,0,35,16
1551,6,105,35,0,70,35
1551,5,71,28,0,43,28
1551,4,28,10,0,18,10
1551,3,13,7,0,6,7
1551,2,3,2,0,1,2
574,10,6,2,0,4,2
574,9,9,4,0,5,4
574,8,49,19,0,30,19
574,7,80,21,0,59,21
574,6,90,22,0,68,22
574,5,28,10,0,18,10
574,4,25,9,0,16,9
574,3,4,2,0,2,2
574,1,2,1,0,1,1
316,10,11,8,0,3,8
316,9,21,12,0,9,12
316,8,57,26,0,31,26
316,7,89,42,0,47,42
316,6,74,30,0,44,30
316,5,26,6,0,20,6
316,4,10,4,0,6,4
316,3,4,2,0,2,2
316,2,2,2,0,0,2
188188,9,11,1,0,10,1
188188,8,82,5,0,77,5
188188,7,89,3,0,86,3
188188,6,65,4,0,61,4
188188,5,28,4,0,24,4
188188,4,12,1,0,11,1
5472,10,11,2,0,9,2
5472,8,14,4,0,10,4
5472,7,27,5,0,22,5
5472,6,80,20,0,60,20
5472,5,64,19,0,45,19
5472,4,53,16,0,37,16
5472,3,26,6,0,20,6
5472,2,12,3,0,9,3
5472,1,6,2,0,4,2
145654,10,14,4,0,10,4
145654,9,20,5,0,15,5
145654,8,80,20,0,60,20
145654,7,79,16,0,63,16
145654,6,65,10,0,55,10
145654,5,15,2,0,13,2
145654,4,15,6,0,9,6
145654,1,2,1,0,1,1
4961,10,7,4,0,3,4
4961,9,7,2,0,5,2
4961,8,32,18,0,14,18
4961,7,64,22,0,42,22
4961,6,98,43,0,55,43
4961,5,40,21,0,19,21
4961,4,25,12,0,13,12
4961,3,11,4,0,7,4
4961,2,7,3,0,4,3
4961,1,3,1,0,2,1
82610,10,8,2,0,6,2
82610,9,10,2,0,8,2
82610,8,47,11,0,36,11
82610,7,54,13,0,41,13
82610,6,94,15,0,79,15
82610,5,50,12,0,38,12
82610,4,14,3,0,11,3
82610,3,10,3,0,7,3
82610,2,6,4,0,2,4
82610,1,1,1,0,0,1
1835,10,8,4,0,4,4
1835,9,17,4,0,13,4
1835,8,54,16,0,38,16
1835,7,71,22,0,49,22
1835,6,81,23,0,58,23
1835,5,33,8,0,25,8
1835,4,21,3,0,18,3
1835,3,3,1,0,2,1
1835,2,3,2,0,1,2
6688,10,26,15,0,11,15
6688,9,35,16,0,19,16
6688,8,86,39,0,47,39
6688,7,66,29,0,37,29
6688,6,44,18,0,26,18
6688,5,23,3,0,20,3
6688,4,9,2,0,7,2
6688,3,3,1,0,2,1
6688,2,1,1,0,0,1
841,9,6,3,0,3,3
841,8,35,9,0,26,9
841,7,84,9,0,75,9
841,6,109,28,0,81,28
841,5,36,10,0,26,10
841,4,14,3,0,11,3
841,3,5,1,0,4,1
841,1,1,1,0,0,1
13285,8,11,3,0,8,3
13285,7,29,8,0,21,8
13285,6,61,14,0,47,14
13285,5,77,24,0,53,24
13285,4,61,7,0,54,7
13285,3,37,12,0,25,12
13285,2,10,7,0,3,7
13285,1,6,1,0,5,1
17651,10,20,9,0,11,9
17651,9,51,17,0,34,17
17651,8,107,30,0,77,30
17651,7,70,23,0,47,23
17651,6,26,8,0,18,8
17651,5,13,6,0,7,6
17651,4,4,2,0,2,2
143882,10,10,7,0,3,7
143882,9,14,1,0,13,1
143882,8,53,13,0,40,13
143882,7,88,14,0,74,14
143882,6,89,20,0,69,20
143882,5,27,8,0,19,8
143882,3,3,1,0,2,1
143882,2,3,1,0,2,1
153728,10,32,7,0,25,7
153728,9,78,21,0,57,21
153728,8,122,18,0,104,18
153728,7,26,4,0,22,4
153728,6,16,7,0,9,7
153728,5,9,1,0,8,1
153728,4,7,5,0,2,5
5086,10,8,3,0,5,3
5086,9,15,4,0,11,4
5086,8,16,5,0,11,5
5086,7,45,11,0,34,11
5086,6,68,20,0,48,20
5086,5,50,13,0,37,13
5086,4,51,17,0,34,17
5086,3,21,6,0,15,6
5086,2,14,4,0,10,4
5086,1,5,3,0,2,3
4106,9,9,4,0,5,4
4106,8,51,15,0,36,15
4106,7,92,29,0,63,29
4106,6,94,37,0,57,37
4106,5,30,7,0,23,7
4106,4,12,6,0,6,6
4106,3,4,1,0,3,1
26983,10,19,8,0,11,8
26983,9,19,5,0,14,5
26983,8,69,23,0,46,23
26983,7,62,11,0,51,11
26983,6,73,19,0,54,19
26983,5,30,8,0,22,8
26983,4,12,4,0,8,4
26983,3,8,3,0,5,3
26983,2,1,1,0,0,1
96345,9,14,1,0,13,1
96345,8,35,5,0,30,5
96345,7,57,1,0,56,1
96345,6,108,10,0,98,10
96345,5,43,1,0,42,1
96345,4,20,4,0,16,4
96345,3,7,1,0,6,1
96345,1,4,1,0,3,1
39798,10,4,1,0,3,1
39798,9,8,3,0,5,3
39798,8,32,8,0,24,8
39798,7,48,13,0,35,13
39798,6,93,25,0,68,25
39798,5,55,13,0,42,13
39798,4,24,7,0,17,7
39798,3,16,4,0,12,4
39798,2,10,3,0,7,3
39798,1,2,1,0,1,1
213661,9,10,2,0,8,2
213661,8,69,8,1,61,7
213661,7,92,9,1,83,8
213661,6,88,23,2,65,21
213661,5,19,3,0,16,3
170041,10,3,2,0,1,2
170041,9,2,1,0,1,1
170041,8,40,5,0,35,5
170041,7,73,6,0,67,6
170041,6,113,4,0,109,4
170041,5,41,6,0,35,6
170041,3,3,2,0,1,2
150580,10,4,1,0,3,1
150580,9,9,1,0,8,1
150580,8,43,12,0,31,12
150580,7,81,12,0,69,12
150580,6,96,17,0,79,17
150580,5,29,9,0,20,9
150580,4,23,5,0,18,5
158544,10,7,2,0,5,2
158544,9,22,9,0,13,9
158544,8,84,23,2,61,21
158544,7,73,9,1,64,8
158544,6,73,13,0,60,13
158544,5,21,10,1,11,9
158544,4,9,3,0,6,3
158544,3,3,1,0,2,1
93688,9,4,3,0,1,3
93688,8,18,8,0,10,8
93688,7,25,6,0,19,6
93688,6,60,16,0,44,16
93688,5,80,24,0,56,24
93688,4,66,21,0,45,21
93688,3,27,7,0,20,7
93688,2,8,3,0,5,3
93688,1,4,1,0,3,1
82397,9,4,2,0,2,2
82397,8,23,5,0,18,5
82397,7,50,16,0,34,16
82397,6,88,21,0,67,21
82397,5,48,14,0,34,14
82397,4,21,6,0,15,6
82397,3,14,4,0,10,4
82397,2,8,4,0,4,4
2843,9,5,2,0,3,2
2843,8,10,2,0,8,2
2843,7,45,10,0,35,10
2843,6,112,19,0,93,19
2843,5,57,12,0,45,12
2843,4,39,15,0,24,15
2843,3,13,6,0,7,6
2843,2,8,5,0,3,5
2843,1,2,1,0,1,1
24318,8,23,6,0,17,6
24318,7,42,5,0,37,5
24318,6,82,10,0,72,10
24318,5,83,12,0,71,12
24318,4,29,2,0,27,2
24318,3,15,3,0,12,3
24318,2,10,5,0,5,5
124548,10,9,4,1,5,3
124548,9,12,2,1,10,1
124548,8,43,7,1,36,6
124548,7,65,20,0,45,20
124548,6,69,12,1,57,11
124548,5,39,6,0,33,6
124548,4,21,8,0,13,8
124548,3,16,9,0,7,9
124548,2,12,5,0,7,5
124548,1,7,4,0,3,4
2478,8,31,8,0,23,8
2478,7,66,23,0,43,23
2478,6,112,39,0,73,39
2478,5,54,18,0,36,18
2478,4,12,6,0,6,6
2478,3,3,1,0,2,1
2478,2,3,2,0,1,2
2478,1,3,1,0,2,1
3061,10,9,4,0,5,4
3061,9,17,1,0,16,1
3061,8,53,12,0,41,12
3061,7,61,9,0,52,9
3061,6,27,5,0,22,5
3061,5,7,1,0,6,1
3061,1,2,2,0,0,2
209664,9,14,2,0,12,2
209664,8,75,15,0,60,15
209664,7,82,10,0,72,10
209664,6,81,8,1,73,7
209664,5,20,2,0,18,2
209664,4,7,1,0,6,1
209664,2,3,1,0,2,1
79312,10,2,1,0,1,1
79312,8,38,7,0,31,7
79312,7,53,14,0,39,14
79312,6,82,16,0,66,16
79312,5,49,8,0,41,8
79312,4,28,9,0,19,9
79312,3,21,5,0,16,5
79312,2,7,3,0,4,3
79312,1,8,5,0,3,5
36783,9,3,1,0,2,1
36783,8,16,4,0,12,4
36783,7,19,3,0,16,3
36783,6,82,17,0,65,17
36783,5,57,12,0,45,12
36783,4,58,14,0,44,14
36783,3,37,4,0,33,4
36783,2,9,3,0,6,3
36783,1,10,7,0,3,7
170381,8,20,3,0,17,3
170381,7,38,6,0,32,6
170381,6,133,31,0,102,31
170381,5,69,12,0,57,12
170381,4,16,7,0,9,7
170381,3,9,1,0,8,1
170381,2,2,1,0,1,1
170381,1,2,1,0,1,1
7614,10,56,15,0,41,15
7614,9,49,17,0,32,17
7614,8,72,20,0,52,20
7614,7,56,15,0,41,15
7614,6,22,8,0,14,8
7614,5,13,3,0,10,3
7614,4,11,6,0,5,6
7614,3,5,2,0,3,2
7614,2,6,3,0,3,3
7614,1,2,2,0,0,2
22544,10,5,1,0,4,1
22544,9,11,2,0,9,2
22544,8,43,9,0,34,9
22544,7,67,10,0,57,10
22544,6,95,14,0,81,14
22544,5,39,8,0,31,8
22544,4,22,2,0,20,2
22544,3,4,1,0,3,1
22544,2,3,3,0,0,3
145103,10,8,2,0,6,2
145103,9,7,1,0,6,1
145103,8,59,10,0,49,10
145103,7,94,21,0,73,21
145103,6,83,17,0,66,17
145103,5,29,4,0,25,4
163163,10,9,1,0,8,1
163163,9,39,10,0,29,10
163163,8,87,23,0,64,23
163163,7,85,21,0,64,21
163163,6,41,12,0,29,12
163163,5,14,6,0,8,6
163163,4,9,3,0,6,3
163163,3,3,2,0,1,2
163163,2,3,1,0,2,1
163163,1,1,1,0,0,1
130552,10,27,6,0,21,6
130552,9,37,2,0,35,2
130552,8,77,4,0,73,4
130552,7,66,5,0,61,5
130552,6,55,7,0,48,7
130552,5,11,1,0,10,1
130552,4,10,2,0,8,2
130552,3,1,1,0,0,1
108783,8,41,14,0,27,14
108783,7,75,14,0,61,14
108783,6,106,19,0,87,19
108783,5,31,3,0,28,3
108783,4,22,6,0,16,6
108783,3,6,2,0,4,2
108783,2,5,3,0,2,3
172362,10,2,1,0,1,1
172362,9,9,1,0,8,1
172362,8,50,14,0,36,14
172362,7,79,11,0,68,11
172362,6,99,11,0,88,11
172362,5,36,6,0,30,6
172362,4,15,6,0,9,6
165959,10,7,2,0,5,2
165959,8,51,9,0,42,9
165959,7,64,8,0,56,8
165959,6,103,10,0,93,10
165959,5,38,6,0,32,6
165959,4,14,3,0,11,3
165959,3,5,1,0,4,1
215437,10,31,7,0,24,7
215437,9,52,10,0,42,10
215437,8,101,12,0,89,12
215437,7,54,10,0,44,10
215437,6,30,6,0,24,6
215437,5,13,4,0,9,4
215437,4,6,1,0,5,1
246684,9,42,8,0,34,8
246684,8,122,12,0,110,12
246684,7,64,12,0,52,12
246684,6,36,10,0,26,10
246684,5,9,1,0,8,1
140857,9,5,2,0,3,2
140857,8,17,5,0,12,5
140857,7,64,13,0,51,13
140857,6,106,21,0,85,21
140857,5,47,9,0,38,9
140857,4,31,8,0,23,8
140857,3,13,4,0,9,4
140857,2,6,3,0,3,3
155122,10,12,3,1,9,2
155122,9,22,4,0,18,4
155122,8,119,27,4,92,23
155122,7,73,17,1,56,16
155122,6,38,9,1,29,8
155122,5,13,3,1,10,2
155122,4,7,3,0,4,3
155122,3,1,1,0,0,1
155122,2,5,3,0,2,3
1832,10,2,1,0,1,1
1832,8,27,10,0,17,10
1832,7,49,12,0,37,12
1832,6,99,29,0,70,29
1832,5,60,16,0,44,16
1832,4,33,8,0,25,8
1832,3,11,3,0,8,3
1832,2,4,1,0,3,1
1832,1,3,2,0,1,2
20228,8,49,24,0,25,24
20228,7,81,31,0,50,31
20228,6,105,43,0,62,43
20228,5,30,12,0,18,12
20228,4,14,8,0,6,8
20228,3,6,3,0,3,3
4221,10,8,4,0,4,4
4221,9,4,3,0,1,3
4221,8,27,12,0,15,12
4221,7,33,13,0,20,13
4221,6,87,24,0,63,24
4221,5,61,13,0,48,13
4221,4,37,16,0,21,16
4221,3,16,7,0,9,7
4221,2,12,6,0,6,6
4221,1,5,4,0,1,4
3712,10,5,3,0,2,3
3712,9,15,7,0,8,7
3712,8,34,11,0,23,11
3712,7,74,15,0,59,15
3712,6,73,17,0,56,17
3712,5,54,10,0,44,10
3712,4,20,8,0,12,8
3712,3,10,7,0,3,7
3712,2,5,2,0,3,2
37672,10,19,7,0,12,7
37672,9,30,3,0,27,3
37672,8,70,17,0,53,17
37672,7,79,16,0,63,16
37672,6,57,13,0,44,13
37672,5,16,2,0,14,2
37672,4,4,2,0,2,2
37672,3,5,2,0,3,2
37672,2,2,1,0,1,1
37672,1,8,1,0,7,1
4522,10,9,2,0,7,2
4522,9,14,2,0,12,2
4522,8,54,25,0,29,25
4522,7,76,16,0,60,16
4522,6,80,18,0,62,18
4522,5,32,10,0,22,10
4522,4,14,4,0,10,4
4522,3,9,3,0,6,3
4522,2,2,2,0,0,2
2297,8,13,4,0,9,4
2297,7,34,9,0,25,9
2297,6,90,18,0,72,18
2297,5,75,18,0,57,18
2297,4,35,8,0,27,8
2297,3,24,13,0,11,13
2297,2,13,6,0,7,6
2297,1,3,2,0,1,2
125996,10,11,5,0,6,5
125996,9,20,10,0,10,10
125996,8,73,13,0,60,13
125996,7,78,18,0,60,18
125996,6,64,6,1,58,5
125996,5,27,5,1,22,4
125996,4,11,7,0,4,7
223602,9,7,1,0,6,1
223602,8,54,7,0,47,7
223602,7,102,15,0,87,15
223602,6,79,14,0,65,14
223602,5,26,2,0,24,2
223602,4,10,6,0,4,6
223602,3,4,2,0,2,2
223602,2,5,2,0,3,2
144468,10,4,1,0,3,1
144468,9,9,2,0,7,2
144468,8,41,4,0,37,4
144468,7,65,6,0,59,6
144468,6,96,5,0,91,5
144468,5,40,3,0,37,3
144468,4,24,4,0,20,4
144468,3,6,3,0,3,3
144468,2,2,2,0,0,2
82272,9,7,3,0,4,3
82272,8,44,13,0,31,13
82272,7,88,25,0,63,25
82272,6,85,31,0,54,31
82272,5,33,10,0,23,10
82272,4,13,4,0,9,4
82272,3,12,4,0,8,4
82272,2,3,1,0,2,1
82272,1,3,3,0,0,3
25900,10,22,6,0,16,6
25900,9,44,15,0,29,15
25900,8,117,30,0,87,30
25900,7,60,12,0,48,12
25900,6,31,9,0,22,9
25900,5,11,2,0,9,2
25900,3,2,2,0,0,2
25900,2,2,2,0,0,2
476,10,18,8,0,10,8
476,9,7,3,0,4,3
476,8,41,20,0,21,20
476,7,83,24,0,59,24
476,6,77,20,0,57,20
476,5,38,9,0,29,9
476,4,19,5,0,14,5
146228,10,29,9,0,20,9
146228,9,37,10,0,27,10
146228,8,79,30,0,49,30
146228,7,60,17,0,43,17
146228,6,32,14,0,18,14
146228,5,15,7,0,8,7
146228,4,15,6,0,9,6
146228,3,5,2,0,3,2
146228,2,6,3,0,3,3
146228,1,11,4,0,7,4
40213,10,2,1,0,1,1
40213,9,12,4,0,8,4
40213,8,40,8,0,32,8
40213,7,67,13,0,54,13
40213,6,99,27,0,72,27
40213,5,40,8,0,32,8
40213,4,13,4,0,9,4
40213,3,9,3,0,6,3
41474,10,13,3,0,10,3
41474,9,20,5,0,15,5
41474,8,97,25,0,72,25
41474,7,75,14,0,61,14
41474,6,52,8,0,44,8
41474,5,15,2,0,13,2
41474,4,7,2,0,5,2
41474,3,5,2,0,3,2
97655,8,28,6,0,22,6
97655,7,59,12,0,47,12
97655,6,114,14,0,100,14
97655,5,32,4,0,28,4
97655,4,31,8,0,23,8
97655,3,9,3,0,6,3
97655,2,10,5,0,5,5
241491,10,3,1,0,2,1
241491,9,14,2,0,12,2
241491,8,48,4,0,44,4
241491,7,81,7,0,74,7
241491,6,85,10,0,75,10
241491,5,29,2,0,27,2
241491,3,9,2,0,7,2
241491,2,5,2,0,3,2
1633,9,12,5,0,7,5
1633,8,29,10,0,19,10
1633,7,87,21,0,66,21
1633,6,89,29,0,60,29
1633,5,36,10,0,26,10
1633,4,14,4,0,10,4
1633,3,9,2,0,7,2
1633,2,3,1,0,2,1
1910,10,2,1,0,1,1
1910,9,3,2,0,1,2
1910,8,17,1,0,16,1
1910,7,60,9,0,51,9
1910,6,100,15,0,85,15
1910,5,55,10,0,45,10
1910,4,28,15,0,13,15
1910,3,18,5,0,13,5
1910,2,5,1,0,4,1
4920,10,13,2,0,11,2
4920,9,31,7,0,24,7
4920,8,73,16,0,57,16
4920,7,86,21,0,65,21
4920,6,59,11,0,48,11
4920,5,21,4,0,17,4
4920,3,2,1,0,1,1
3887,10,12,3,0,9,3
3887,9,10,4,0,6,4
3887,8,42,7,0,35,7
3887,7,52,17,0,35,17
3887,6,77,22,0,55,22
3887,5,50,18,0,32,18
3887,4,34,15,0,19,15
3887,3,6,2,0,4,2
3887,2,4,3,0,1,3
181290,10,15,2,0,13,2
181290,9,24,5,0,19,5
181290,8,49,10,0,39,10
181290,7,79,11,0,68,11
181290,6,80,24,0,56,24
181290,5,23,7,0,16,7
181290,4,8,3,0,5,3
181290,3,8,1,0,7,1
201308,10,12,2,0,10,2
201308,9,23,6,0,17,6
201308,8,82,15,0,67,15
201308,7,89,14,0,75,14
201308,6,54,12,0,42,12
201308,5,16,5,0,11,5
201308,4,11,3,0,8,3
13121,8,12,4,0,8,4
13121,7,37,10,0,27,10
13121,6,90,28,0,62,28
13121,5,55,16,0,39,16
13121,4,46,9,0,37,9
13121,3,26,10,0,16,10
13121,2,12,7,0,5,7
13121,1,5,1,0,4,1
175334,10,18,5,0,13,5
175334,9,21,6,0,15,6
175334,8,95,15,0,80,15
175334,7,68,1,0,67,1
175334,6,52,15,0,37,15
175334,5,25,3,0,22,3
175334,4,7,1,0,6,1
175334,3,2,1,0,1,1
10174,10,30,25,0,5,25
10174,9,44,23,0,21,23
10174,8,99,33,0,66,33
10174,7,73,27,0,46,27
10174,6,20,8,0,12,8
10174,5,12,6,0,6,6
10174,4,3,1,0,2,1
4014,10,14,8,0,6,8
4014,9,20,7,0,13,7
4014,8,50,16,0,34,16
4014,7,69,16,0,53,16
4014,6,83,25,0,58,25
4014,5,31,10,0,21,10
4014,4,16,5,0,11,5
4014,3,3,1,0,2,1
4014,2,2,1,0,1,1
247160,10,7,1,0,6,1
247160,8,82,10,0,72,10
247160,7,88,9,0,79,9
247160,6,69,15,0,54,15
247160,5,15,4,0,11,4
247160,4,7,1,0,6,1
247160,3,5,2,0,3,2
144566,10,10,2,0,8,2
144566,9,15,8,0,7,8
144566,8,119,38,0,81,38
144566,7,68,16,0,52,16
144566,6,51,14,0,37,14
144566,5,8,4,0,4,4
144566,4,7,2,0,5,2
144566,3,6,3,0,3,3
144566,2,2,1,0,1,1
144566,1,1,1,0,0,1
150364,10,7,1,0,6,1
150364,9,10,6,1,4,5
150364,8,37,12,5,25,7
150364,7,63,12,1,51,11
150364,6,100,23,4,77,19
150364,5,45,6,1,39,5
150364,4,15,5,1,10,4
150364,3,7,2,0,5,2
150364,2,2,1,0,1,1
150364,1,1,1,0,0,1
192656,10,6,1,0,5,1
192656,9,21,4,0,17,4
192656,8,48,7,0,41,7
192656,7,76,8,0,68,8
192656,6,84,6,2,78,4
192656,5,27,5,0,22,5
192656,4,17,2,0,15,2
192656,3,7,1,0,6,1
13855,10,16,6,0,10,6
13855,9,36,12,0,24,12
13855,8,96,30,0,66,30
13855,7,74,15,0,59,15
13855,6,35,8,0,27,8
13855,5,15,4,0,11,4
13855,4,8,4,0,4,4
13855,3,7,5,0,2,5
159566,10,9,5,0,4,5
159566,9,9,1,0,8,1
159566,8,28,12,0,16,12
159566,7,53,14,0,39,14
159566,6,90,15,0,75,15
159566,5,60,11,0,49,11
159566,4,18,3,0,15,3
159566,3,11,3,0,8,3
159566,1,5,2,0,3,2
168537,10,56,34,1,22,33
168537,9,55,24,2,31,22
168537,8,78,27,2,51,25
168537,7,35,9,1,26,8
168537,6,37,8,0,29,8
168537,4,8,2,1,6,1
168537,3,3,2,0,1,2
168537,2,5,4,0,1,4
236709,10,11,6,0,5,6
236709,9,10,4,0,6,4
236709,8,34,8,0,26,8
236709,7,69,6,0,63,6
236709,6,97,18,0,79,18
236709,5,31,4,0,27,4
236709,4,22,2,0,20,2
236709,3,12,3,0,9,3
1471,10,6,3,0,3,3
1471,9,10,4,0,6,4
1471,8,38,17,0,21,17
1471,7,65,28,0,37,28
1471,6,92,23,0,69,23
1471,5,48,13,0,35,13
1471,4,18,6,0,12,6
1471,3,7,3,0,4,3
1471,2,3,1,0,2,1
139137,10,7,2,0,5,2
139137,9,12,2,0,10,2
139137,8,22,3,0,19,3
139137,7,44,6,0,38,6
139137,6,84,8,0,76,8
139137,5,48,11,1,37,10
139137,4,32,11,0,21,11
139137,3,19,8,0,11,8
139137,2,11,3,0,8,3
139137,1,8,5,0,3,5
207572,10,30,9,0,21,9
207572,9,105,22,0,83,22
207572,8,102,27,0,75,27
207572,7,32,12,0,20,12
207572,6,12,4,0,8,4
207572,3,1,1,0,0,1
207572,2,1,1,0,0,1
207572,1,1,1,0,0,1
252526,10,21,6,0,15,6
252526,9,48,7,0,41,7
252526,8,125,18,0,107,18
252526,7,61,8,0,53,8
252526,6,22,2,0,20,2
252526,5,5,1,0,4,1
101865,10,44,9,0,35,9
101865,9,49,13,0,36,13
101865,8,99,33,0,66,33
101865,7,62,10,0,52,10
101865,6,17,3,0,14,3
101865,4,2,1,0,1,1
101865,3,2,1,0,1,1
2567,9,5,3,0,2,3
2567,8,16,3,0,13,3
2567,7,62,26,0,36,26
2567,6,92,23,0,69,23
2567,5,56,15,0,41,15
2567,4,29,12,0,17,12
2567,3,19,9,0,10,9
2567,2,7,6,0,1,6
59936,10,4,1,0,3,1
59936,9,10,1,0,9,1
59936,8,78,20,0,58,20
59936,7,89,21,4,68,17
59936,6,67,16,0,51,16
59936,5,27,6,0,21,6
59936,4,7,2,0,5,2
59936,3,3,1,0,2,1
59936,1,1,1,0,0,1
146275,10,5,1,0,4,1
146275,8,19,3,0,16,3
146275,7,40,4,0,36,4
146275,6,81,13,0,68,13
146275,5,45,6,0,39,6
146275,4,50,8,0,42,8
146275,3,24,2,0,22,2
146275,2,12,5,0,7,5
146275,1,5,2,0,3,2
18400,9,6,2,0,4,2
18400,8,60,33,0,27,33
18400,7,68,25,0,43,25
18400,6,82,36,0,46,36
18400,5,44,9,0,35,9
18400,4,17,5,0,12,5
18400,3,5,3,0,2,3
25727,10,24,10,0,14,10
25727,9,45,9,0,36,9
25727,8,114,35,0,79,35
25727,7,55,12,0,43,12
25727,6,32,4,0,28,4
25727,5,8,1,0,7,1
25727,3,3,1,0,2,1
25727,2,1,1,0,0,1
25727,1,2,1,0,1,1
6927,10,16,5,0,11,5
6927,9,37,11,0,26,11
6927,8,88,27,0,61,27
6927,7,76,19,0,57,19
6927,6,55,13,0,42,13
6927,5,9,3,0,6,3
6927,4,2,1,0,1,1
3074,10,3,2,0,1,2
3074,8,10,5,0,5,5
3074,7,8,4,0,4,4
3074,6,28,10,0,18,10
3074,5,58,23,0,35,23
3074,4,72,28,0,44,28
3074,3,51,18,0,33,18
3074,2,41,13,0,28,13
3074,1,15,8,0,7,8
25142,10,1,1,0,0,1
25142,9,4,3,0,1,3
25142,8,22,4,0,18,4
25142,7,65,20,0,45,20
25142,6,105,28,0,77,28
25142,5,46,10,0,36,10
25142,4,28,7,0,21,7
25142,3,8,1,0,7,1
25142,2,4,1,0,3,1
25142,1,3,1,0,2,1
147614,10,9,1,0,8,1
147614,9,34,2,0,32,2
147614,8,69,4,0,65,4
147614,7,61,10,0,51,10
147614,6,62,9,0,53,9
147614,5,25,2,0,23,2
147614,4,15,1,0,14,1
147614,3,8,2,0,6,2
196305,10,6,1,0,5,1
196305,9,31,2,0,29,2
196305,8,97,16,0,81,16
196305,7,92,12,0,80,12
196305,6,40,4,0,36,4
196305,5,13,1,0,12,1
196305,4,6,2,0,4,2
3095,10,10,2,0,8,2
3095,9,18,9,0,9,9
3095,8,70,28,0,42,28
3095,7,82,27,0,55,27
3095,6,69,23,0,46,23
3095,5,23,8,0,15,8
3095,4,9,5,0,4,5
3095,3,3,1,0,2,1
3095,2,1,1,0,0,1
6201,9,2,2,0,0,2
6201,8,9,3,0,6,3
6201,7,27,6,0,21,6
6201,6,79,22,0,57,22
6201,5,50,19,0,31,19
6201,4,41,16,0,25,16
6201,3,35,19,0,16,19
6201,2,32,15,0,17,15
6201,1,11,5,0,6,5
125326,10,9,5,2,4,3
125326,9,12,2,0,10,2
125326,8,37,13,2,24,11
125326,7,49,9,1,40,8
125326,6,63,13,1,50,12
125326,5,46,18,4,28,14
125326,4,23,7,1,16,6
125326,3,18,7,1,11,6
125326,2,15,3,0,12,3
125326,1,14,10,1,4,9
149361,10,7,2,0,5,2
149361,9,27,10,0,17,10
149361,8,99,31,0,68,31
149361,7,90,16,0,74,16
149361,6,43,13,0,30,13
149361,5,14,10,0,4,10
149361,4,2,1,0,1,1
23631,9,3,1,0,2,1
23631,8,16,2,0,14,2
23631,7,39,11,0,28,11
23631,6,101,35,0,66,35
23631,5,39,18,0,21,18
23631,4,28,12,0,16,12
23631,3,26,12,0,14,12
23631,2,26,18,0,8,18
23631,1,5,3,0,2,3
4206,10,31,11,0,20,11
4206,9,36,13,0,23,13
4206,8,111,28,0,83,28
4206,7,65,18,0,47,18
4206,6,29,6,0,23,6
4206,5,8,4,0,4,4
2678,10,12,9,0,3,9
2678,9,18,5,0,13,5
2678,8,55,15,0,40,15
2678,7,63,14,0,49,14
2678,6,87,24,0,63,24
2678,5,34,12,0,22,12
2678,4,12,4,0,8,4
2678,3,3,1,0,2,1
2678,1,1,1,0,0,1
1578,9,5,1,0,4,1
1578,8,27,10,0,17,10
1578,7,59,24,0,35,24
1578,6,109,25,0,84,25
1578,5,43,12,0,31,12
1578,4,19,6,0,13,6
1578,3,14,6,0,8,6
1578,2,6,4,0,2,4
1578,1,2,1,0,1,1
8139,10,15,8,0,7,8
8139,9,19,11,0,8,11
8139,8,50,14,0,36,14
8139,7,46,18,0,28,18
8139,6,85,25,0,60,25
8139,5,33,13,0,20,13
8139,4,23,5,0,18,5
8139,3,10,3,0,7,3
8139,1,3,1,0,2,1
186767,9,8,2,0,6,2
186767,8,39,9,0,30,9
186767,7,82,20,0,62,20
186767,6,115,24,0,91,24
186767,5,22,7,0,15,7
186767,4,10,1,0,9,1
186767,2,3,1,0,2,1
133405,10,7,4,0,3,4
133405,9,11,4,0,7,4
133405,8,63,17,1,46,16
133405,7,84,16,0,68,16
133405,6,82,17,1,65,16
133405,5,28,6,1,22,5
133405,4,7,3,0,4,3
133405,2,1,1,0,0,1
3099,10,4,2,0,2,2
3099,9,5,3,0,2,3
3099,8,15,5,0,10,5
3099,7,38,14,0,24,14
3099,6,62,22,0,40,22
3099,5,41,14,0,27,14
3099,4,31,14,0,17,14
3099,3,13,6,0,7,6
3099,2,5,1,0,4,1
3099,1,2,1,0,1,1
243759,10,78,12,2,66,10
243759,9,74,9,1,65,8
243759,8,89,16,5,73,11
243759,7,34,5,0,29,5
243759,6,12,4,2,8,2
243759,5,3,1,0,2,1
243759,4,1,1,0,0,1
255455,10,14,4,0,10,4
255455,9,23,3,0,20,3
255455,8,88,11,0,77,11
255455,7,85,18,0,67,18
255455,6,51,10,0,41,10
255455,5,12,1,0,11,1
255455,4,10,2,0,8,2
255455,3,1,1,0,0,1
255455,1,2,1,0,1,1
25008,10,5,1,0,4,1
25008,9,18,6,0,12,6
25008,8,60,20,0,40,20
25008,7,81,22,0,59,22
25008,6,84,32,0,52,32
25008,5,23,8,0,15,8
25008,4,8,4,0,4,4
25008,3,4,2,0,2,2
25008,2,2,1,0,1,1
138704,10,8,3,0,5,3
138704,9,21,2,0,19,2
138704,8,95,32,0,63,32
138704,7,67,20,0,47,20
138704,6,58,18,0,40,18
138704,5,21,9,0,12,9
138704,4,15,10,0,5,10
152567,9,7,2,0,5,2
152567,8,55,11,0,44,11
152567,7,93,31,0,62,31
152567,6,88,16,0,72,16
152567,5,26,4,0,22,4
152567,4,10,2,0,8,2
175254,10,16,8,0,8,8
175254,9,24,5,0,19,5
175254,8,86,17,2,69,15
175254,7,71,13,0,58,13
175254,6,33,13,1,20,12
175254,5,20,6,1,14,5
175254,4,12,5,0,7,5
175254,3,7,3,0,4,3
175254,2,11,7,0,4,7
175254,1,5,1,0,4,1
160434,8,28,6,0,22,6
160434,7,60,10,0,50,10
160434,6,104,12,0,92,12
160434,5,48,7,0,41,7
160434,4,22,4,0,18,4
160434,3,15,4,0,11,4
160434,2,5,1,0,4,1
138105,10,10,5,0,5,5
138105,9,12,2,0,10,2
138105,8,57,8,0,49,8
138105,7,63,10,0,53,10
138105,6,78,7,0,71,7
138105,5,25,1,0,24,1
138105,4,27,7,0,20,7
138105,3,8,1,0,7,1
138105,2,2,1,0,1,1
39564,10,4,1,0,3,1
39564,8,17,2,0,15,2
39564,7,35,5,0,30,5
39564,6,89,7,0,82,7
39564,5,65,5,0,60,5
39564,4,40,5,0,35,5
39564,3,17,2,0,15,2
39564,2,8,1,0,7,1
39564,1,3,2,0,1,2
24933,8,41,10,0,31,10
24933,7,71,16,0,55,16
24933,6,97,26,0,71,26
24933,5,45,13,0,32,13
24933,4,17,4,0,13,4
24933,3,3,1,0,2,1
15712,10,7,4,0,3,4
15712,9,10,5,0,5,5
15712,8,21,8,0,13,8
15712,7,52,15,0,37,15
15712,6,62,21,0,41,21
15712,5,49,13,0,36,13
15712,4,36,14,0,22,14
15712,3,28,15,0,13,15
15712,2,15,3,0,12,3
15712,1,4,1,0,3,1
285,9,3,1,0,2,1
285,8,24,10,0,14,10
285,7,52,21,0,31,21
285,6,91,32,0,59,32
285,5,67,26,0,41,26
285,4,23,10,0,13,10
285,3,20,8,0,12,8
33427,10,8,6,0,2,6
33427,9,9,3,0,6,3
33427,8,34,12,0,22,12
33427,7,50,8,0,42,8
33427,6,85,9,0,76,9
33427,5,55,8,0,47,8
33427,4,21,5,0,16,5
33427,3,16,2,0,14,2
33427,2,4,1,0,3,1
126207,9,2,1,0,1,1
126207,8,10,3,0,7,3
126207,7,22,5,0,17,5
126207,6,71,12,0,59,12
126207,5,55,12,0,43,12
126207,4,53,8,0,45,8
126207,3,25,10,0,15,10
126207,2,28,11,0,17,11
126207,1,14,4,0,10,4
173804,10,20,9,0,11,9
173804,9,14,6,0,8,6
173804,8,46,10,1,36,9
173804,7,76,16,0,60,16
173804,6,68,12,2,56,10
173804,5,35,4,0,31,4
173804,4,14,3,0,11,3
173804,3,10,3,1,7,2
158915,9,6,3,0,3,3
158915,8,24,3,0,21,3
158915,7,101,20,0,81,20
158915,6,102,17,1,85,16
158915,5,35,8,1,27,7
158915,4,12,2,0,10,2
158915,3,2,1,0,1,1
13089,10,13,2,0,11,2
13089,9,21,3,0,18,3
13089,8,70,10,0,60,10
13089,7,87,11,0,76,11
13089,6,59,5,0,54,5
13089,5,20,3,0,17,3
13089,4,9,1,0,8,1
13089,1,1,1,0,0,1
171542,9,3,1,0,2,1
171542,8,23,4,0,19,4
171542,7,62,2,0,60,2
171542,6,103,16,0,87,16
171542,5,49,10,0,39,10
171542,4,25,10,0,15,10
171542,3,12,4,0,8,4
171542,2,4,1,0,3,1
44614,9,9,2,0,7,2
44614,8,40,11,0,29,11
44614,7,59,22,0,37,22
44614,6,93,28,0,65,28
44614,5,45,6,0,39,6
44614,4,20,8,0,12,8
44614,3,7,1,0,6,1
44614,2,4,3,0,1,3
7475,10,9,5,0,4,5
7475,9,15,5,0,10,5
7475,8,30,11,0,19,11
7475,7,48,12,0,36,12
7475,6,77,26,0,51,26
7475,5,45,14,0,31,14
7475,4,36,17,0,19,17
7475,3,13,4,0,9,4
7475,2,6,3,0,3,3
7475,1,4,1,0,3,1
128412,10,5,1,0,4,1
128412,8,56,11,0,45,11
128412,7,93,15,0,78,15
128412,6,82,12,0,70,12
128412,5,26,4,0,22,4
128412,4,8,3,0,5,3
128412,3,3,1,0,2,1
234828,10,7,3,0,4,3
234828,9,25,5,0,20,5
234828,8,106,10,0,96,10
234828,7,84,9,0,75,9
234828,6,47,4,0,43,4
234828,5,5,2,0,3,2
234828,4,5,3,0,2,3
234828,3,2,1,0,1,1
234828,1,3,1,0,2,1
220778,10,9,1,0,8,1
220778,9,9,4,0,5,4
220778,8,60,14,0,46,14
220778,7,65,7,0,58,7
220778,6,78,6,0,72,6
220778,5,30,3,0,27,3
220778,4,23,4,0,19,4
1319,9,2,1,0,1,1
1319,8,25,15,0,10,15
1319,7,53,21,0,32,21
1319,6,114,43,0,71,43
1319,5,61,17,0,44,17
1319,4,20,5,0,15,5
1319,2,4,1,0,3,1
61028,10,6,2,0,4,2
61028,9,15,5,0,10,5
61028,8,49,13,0,36,13
61028,7,76,30,0,46,30
61028,6,95,38,1,57,37
61028,5,25,10,0,15,10
61028,4,12,4,0,8,4
61028,3,4,3,0,1,3
62030,10,5,3,0,2,3
62030,9,19,6,0,13,6
62030,8,59,15,0,44,15
62030,7,59,14,0,45,14
62030,6,76,14,0,62,14
62030,5,29,11,0,18,11
62030,4,14,8,0,6,8
62030,3,17,10,0,7,10
62030,2,5,2,0,3,2
4214,10,23,7,0,16,7
4214,9,45,20,0,25,20
4214,8,97,24,0,73,24
4214,7,75,18,0,57,18
4214,6,27,5,0,22,5
4214,5,10,3,0,7,3
4214,4,4,2,0,2,2
4214,3,1,1,0,0,1
1629,10,6,4,0,2,4
1629,9,7,4,0,3,4
1629,8,28,17,0,11,17
1629,7,31,12,0,19,12
1629,6,55,23,0,32,23
1629,5,59,26,0,33,26
1629,4,39,16,0,23,16
1629,3,37,22,0,15,22
1629,2,16,9,0,7,9
1629,1,5,4,0,1,4
169062,10,10,2,0,8,2
169062,9,8,2,0,6,2
169062,8,32,3,0,29,3
169062,7,55,6,0,49,6
169062,6,94,11,0,83,11
169062,5,39,9,0,30,9
169062,4,24,3,0,21,3
169062,3,12,5,0,7,5
195547,10,47,17,4,30,13
195547,9,27,8,0,19,8
195547,8,52,16,0,36,16
195547,7,49,13,4,36,9
195547,6,34,7,0,27,7
195547,5,12,3,1,9,2
195547,4,10,1,0,9,1
195547,3,8,3,0,5,3
195547,1,34,12,1,22,11
11706,9,5,3,0,2,3
11706,8,27,11,0,16,11
11706,7,58,28,0,30,28
11706,6,105,47,0,58,47
11706,5,50,22,0,28,22
11706,4,23,11,0,12,11
11706,3,7,3,0,4,3
11706,2,4,2,0,2,2
152851,9,11,3,0,8,3
152851,8,34,3,0,31,3
152851,7,69,15,0,54,15
152851,6,100,12,0,88,12
152851,5,46,7,0,39,7
152851,4,14,2,0,12,2
152851,3,3,2,0,1,2
152851,1,1,1,0,0,1
22420,10,21,3,0,18,3
22420,9,35,12,0,23,12
22420,8,91,22,0,69,22
22420,7,66,19,0,47,19
22420,6,39,10,0,29,10
22420,5,20,7,0,13,7
22420,4,5,5,0,0,5
22420,3,3,2,0,1,2
22420,1,1,1,0,0,1
13709,10,5,2,0,3,2
13709,9,27,17,0,10,17
13709,8,86,35,0,51,35
13709,7,92,34,0,58,34
13709,6,57,22,0,35,22
13709,5,6,3,0,3,3
13709,4,6,1,0,5,1
13709,3,3,2,0,1,2
178550,10,37,15,1,22,14
178550,9,62,22,2,40,20
178550,8,98,32,4,66,28
178550,7,42,9,1,33,8
178550,6,23,7,0,16,7
178550,5,10,2,0,8,2
178550,3,1,1,0,0,1
178550,1,2,1,0,1,1
222862,10,20,4,0,16,4
222862,9,14,4,1,10,3
222862,8,76,15,4,61,11
222862,7,75,9,0,66,9
222862,6,55,10,0,45,10
222862,5,21,7,1,14,6
222862,4,9,2,0,7,2
222862,3,9,5,1,4,4
222862,2,3,1,0,2,1
166640,10,1,1,0,0,1
166640,9,5,2,0,3,2
166640,8,43,4,1,39,3
166640,7,56,6,0,50,6
166640,6,101,31,3,70,28
166640,5,33,13,1,20,12
166640,4,20,3,1,17,2
166640,3,13,5,0,8,5
166640,2,5,3,0,2,3
166640,1,4,3,0,1,3
230791,10,169,40,1,129,39
230791,9,56,15,0,41,15
230791,8,25,5,0,20,5
230791,7,13,3,1,10,2
230791,6,3,1,0,2,1
230791,5,4,3,1,1,2
230791,1,6,3,2,3,1
144557,8,7,3,0,4,3
144557,7,32,4,0,28,4
144557,6,82,16,3,66,13
144557,5,55,9,1,46,8
144557,4,43,12,0,31,12
144557,3,27,9,1,18,8
144557,2,19,6,0,13,6
144557,1,11,3,0,8,3
99479,9,6,2,0,4,2
99479,8,35,8,0,27,8
99479,7,86,22,0,64,22
99479,6,90,21,0,69,21
99479,5,32,9,0,23,9
99479,4,17,6,0,11,6
99479,3,7,2,0,5,2
99479,2,2,1,0,1,1
99479,1,2,1,0,1,1
248584,10,3,1,0,2,1
248584,9,10,4,0,6,4
248584,8,46,5,0,41,5
248584,7,73,13,0,60,13
248584,6,88,10,0,78,10
248584,5,37,7,0,30,7
248584,4,13,5,0,8,5
248584,3,10,3,0,7,3
248584,2,3,1,0,2,1
120669,10,14,5,0,9,5
120669,9,37,6,0,31,6
120669,8,102,26,0,76,26
120669,7,61,12,0,49,12
120669,6,39,12,0,27,12
120669,5,18,5,0,13,5
120669,4,4,3,0,1,3
120669,3,5,2,0,3,2
120669,2,1,1,0,0,1
95893,7,39,4,0,35,4
95893,6,94,19,0,75,19
95893,5,66,19,0,47,19
95893,4,41,8,0,33,8
95893,3,19,5,0,14,5
95893,2,7,2,0,5,2
711,10,10,5,0,5,5
711,9,33,4,0,29,4
711,8,69,10,0,59,10
711,7,71,19,0,52,19
711,6,45,12,0,33,12
711,5,18,6,0,12,6
711,4,12,4,0,8,4
711,3,4,2,0,2,2
2115,8,8,2,0,6,2
2115,7,25,6,0,19,6
2115,6,88,27,0,61,27
2115,5,78,15,0,63,15
2115,4,46,14,0,32,14
2115,3,22,8,0,14,8
2115,2,5,3,0,2,3
65825,10,7,2,0,5,2
65825,9,17,8,0,9,8
65825,8,102,33,0,69,33
65825,7,82,30,0,52,30
65825,6,36,11,0,25,11
65825,5,15,4,0,11,4
65825,4,5,2,0,3,2
75782,10,5,1,0,4,1
75782,9,15,5,0,10,5
75782,8,53,20,0,33,20
75782,7,82,29,0,53,29
75782,6,66,19,0,47,19
75782,5,25,11,0,14,11
75782,4,19,9,0,10,9
75782,3,11,5,0,6,5
75782,1,4,2,0,2,2
1681,10,25,14,0,11,14
1681,9,25,7,0,18,7
1681,8,77,19,0,58,19
1681,7,62,20,0,42,20
1681,6,46,8,0,38,8
1681,5,22,4,0,18,4
1681,4,12,5,0,7,5
1681,3,10,6,0,4,6
965,8,19,6,0,13,6
965,7,48,14,0,34,14
965,6,95,32,0,63,32
965,5,71,25,0,46,25
965,4,25,8,0,17,8
965,3,14,6,0,8,6
965,2,4,2,0,2,2
38980,10,9,3,0,6,3
38980,9,23,10,0,13,10
38980,8,66,20,0,46,20
38980,7,47,16,0,31,16
38980,6,71,22,0,49,22
38980,5,25,6,0,19,6
38980,4,17,6,0,11,6
38980,3,14,6,0,8,6
38980,2,6,2,0,4,2
38980,1,2,1,0,1,1
42713,10,12,2,0,10,2
42713,9,22,8,0,14,8
42713,8,47,14,0,33,14
42713,7,46,5,0,41,5
42713,6,76,19,0,57,19
42713,5,36,5,0,31,5
42713,4,20,7,0,13,7
42713,3,12,3,0,9,3
42713,2,6,4,0,2,4
5791,10,16,10,0,6,10
5791,9,14,7,0,7,7
5791,8,51,17,0,34,17
5791,7,76,24,0,52,24
5791,6,62,24,0,38,24
5791,5,28,12,0,16,12
5791,4,20,8,0,12,8
5791,3,9,3,0,6,3
5791,2,4,2,0,2,2
26162,9,5,1,0,4,1
26162,8,32,9,0,23,9
26162,7,77,24,0,53,24
26162,6,96,35,0,61,35
26162,5,29,9,0,20,9
26162,4,25,10,0,15,10
26162,3,8,3,0,5,3
26162,2,6,2,0,4,2
34701,10,5,4,0,1,4
34701,9,8,3,0,5,3
34701,8,48,21,0,27,21
34701,7,81,23,0,58,23
34701,6,89,19,0,70,19
34701,5,27,4,0,23,4
34701,4,13,3,0,10,3
34701,2,4,1,0,3,1
142557,10,10,1,0,9,1
142557,9,13,3,0,10,3
142557,8,45,7,0,38,7
142557,7,89,11,0,78,11
142557,6,87,12,0,75,12
142557,5,21,3,0,18,3
142557,4,11,1,0,10,1
142557,3,2,2,0,0,2
188614,10,4,1,0,3,1
188614,9,10,2,0,8,2
188614,8,29,7,0,22,7
188614,7,60,14,0,46,14
188614,6,99,10,0,89,10
188614,5,40,9,0,31,9
188614,4,23,4,0,19,4
188614,3,9,4,0,5,4
3339,10,10,5,0,5,5
3339,9,8,4,0,4,4
3339,8,45,22,0,23,22
3339,7,75,26,0,49,26
3339,6,82,28,0,54,28
3339,5,32,11,0,21,11
3339,4,16,6,0,10,6
3339,3,5,3,0,2,3
3339,2,4,2,0,2,2
3339,1,2,2,0,0,2
3097,10,41,20,0,21,20
3097,9,78,24,0,54,24
3097,8,90,29,0,61,29
3097,7,35,9,0,26,9
3097,6,21,3,0,18,3
3097,5,5,3,0,2,3
3097,4,5,1,0,4,1
3097,3,3,1,0,2,1
350,10,3,3,0,0,3
350,9,9,2,0,7,2
350,8,44,11,0,33,11
350,7,88,30,0,58,30
350,6,87,29,0,58,29
350,5,28,8,0,20,8
350,4,12,3,0,9,3
350,3,6,3,0,3,3
350,2,2,1,0,1,1
1300,9,4,3,0,1,3
1300,8,23,11,0,12,11
1300,7,65,17,0,48,17
1300,6,103,21,0,82,21
1300,5,47,14,0,33,14
1300,4,16,7,0,9,7
1300,3,12,2,0,10,2
1300,2,6,3,0,3,3
1300,1,2,1,0,1,1
111172,10,4,2,0,2,2
111172,9,5,1,0,4,1
111172,8,23,6,0,17,6
111172,7,82,11,0,71,11
111172,6,106,21,0,85,21
111172,5,32,7,0,25,7
111172,4,13,1,0,12,1
111172,3,9,2,0,7,2
42105,9,12,1,0,11,1
42105,8,42,6,0,36,6
42105,7,71,3,0,68,3
42105,6,81,9,0,72,9
42105,5,34,2,0,32,2
42105,4,13,3,0,10,3
42105,3,12,2,0,10,2
42105,1,2,1,0,1,1
137550,10,4,1,0,3,1
137550,9,4,1,0,3,1
137550,8,15,5,0,10,5
137550,7,29,4,1,25,3
137550,6,67,10,0,57,10
137550,5,59,12,0,47,12
137550,4,46,12,1,34,11
137550,3,26,5,2,21,3
137550,2,17,7,0,10,7
137550,1,12,6,0,6,6
24959,9,5,1,0,4,1
24959,7,6,3,0,3,3
24959,6,29,4,0,25,4
24959,5,42,14,0,28,14
24959,4,61,7,0,54,7
24959,3,44,9,0,35,9
24959,2,44,17,0,27,17
24959,1,42,20,0,22,20
147887,10,44,16,1,28,15
147887,9,60,20,1,40,19
147887,8,96,25,3,71,22
147887,7,40,9,2,31,7
147887,6,32,7,0,25,7
147887,5,3,1,0,2,1
147887,4,2,1,0,1,1
17274,10,8,3,0,5,3
17274,9,8,4,0,4,4
17274,8,40,27,0,13,27
17274,7,53,23,0,30,23
17274,6,81,34,0,47,34
17274,5,45,24,0,21,24
17274,4,29,14,0,15,14
17274,3,2,1,0,1,1
17274,2,7,4,0,3,4
17274,1,5,2,0,3,2
3285,9,2,1,0,1,1
3285,8,8,1,0,7,1
3285,7,22,6,0,16,6
3285,6,55,15,0,40,15
3285,5,71,22,0,49,22
3285,4,53,10,0,43,10
3285,3,32,16,0,16,16
3285,2,25,11,0,14,11
3285,1,10,3,0,7,3
219512,10,10,4,1,6,3
219512,9,21,5,0,16,5
219512,8,101,14,2,87,12
219512,7,79,15,0,64,15
219512,6,45,8,0,37,8
219512,5,5,1,0,4,1
219512,4,9,5,0,4,5
219512,3,6,1,0,5,1
4041,10,1,1,0,0,1
4041,9,2,1,0,1,1
4041,8,10,4,0,6,4
4041,7,16,4,0,12,4
4041,6,46,18,0,28,18
4041,5,65,22,0,43,22
4041,4,70,22,0,48,22
4041,3,45,11,0,34,11
4041,2,19,9,0,10,9
4041,1,5,1,0,4,1
22677,10,8,2,0,6,2
22677,9,15,5,0,10,5
22677,8,74,18,0,56,18
22677,7,80,30,0,50,30
22677,6,54,18,0,36,18
22677,5,27,11,0,16,11
22677,4,7,3,0,4,3
22677,3,10,4,0,6,4
22677,2,2,2,0,0,2
22677,1,2,2,0,0,2
42142,10,60,24,0,36,24
42142,9,51,16,0,35,16
42142,8,78,31,0,47,31
42142,7,43,17,0,26,17
42142,6,33,12,0,21,12
42142,4,3,2,0,1,2
181370,10,61,32,5,29,27
181370,9,18,7,2,11,5
181370,8,35,7,1,28,6
181370,7,44,8,1,36,7
181370,6,68,22,4,46,18
181370,5,27,2,1,25,1
181370,4,11,2,1,9,1
181370,2,7,2,0,5,2
349,8,11,8,0,3,8
349,7,45,9,0,36,9
349,6,109,31,0,78,31
349,5,67,18,0,49,18
349,4,29,6,0,23,6
349,3,8,2,0,6,2
67309,9,7,6,0,1,6
67309,8,36,17,0,19,17
67309,7,71,22,0,49,22
67309,6,100,27,0,73,27
67309,5,36,16,0,20,16
67309,4,18,6,0,12,6
67309,3,5,1,0,4,1
189869,9,11,3,0,8,3
189869,8,56,19,5,37,14
189869,7,91,23,5,68,18
189869,6,86,20,1,66,19
189869,5,24,9,0,15,9
29285,10,77,32,0,45,32
29285,9,73,21,0,52,21
29285,8,73,19,0,54,19
29285,7,16,4,0,12,4
29285,6,15,5,0,10,5
29285,5,5,1,0,4,1
29285,4,5,3,0,2,3
29285,3,5,2,0,3,2
29285,2,7,3,0,4,3
9963,10,8,7,0,1,7
9963,9,17,12,0,5,12
9963,8,55,23,0,32,23
9963,7,39,14,0,25,14
9963,6,25,16,0,9,16
9963,5,8,5,0,3,5
9963,4,1,1,0,0,1
23757,10,5,4,0,1,4
23757,9,8,3,0,5,3
23757,8,46,19,0,27,19
23757,7,59,16,0,43,16
23757,6,93,27,0,66,27
23757,5,37,14,0,23,14
23757,4,20,5,0,15,5
23757,3,8,3,0,5,3
23757,2,2,1,0,1,1
176816,10,5,3,0,2,3
176816,9,5,3,0,2,3
176816,8,33,10,0,23,10
176816,7,44,3,0,41,3
176816,6,120,14,0,106,14
176816,5,39,2,0,37,2
176816,3,9,2,0,7,2
176816,2,1,1,0,0,1
27938,9,6,3,0,3,3
27938,8,28,7,0,21,7
27938,7,79,18,0,61,18
27938,6,104,22,0,82,22
27938,5,38,5,0,33,5
27938,4,13,5,0,8,5
27938,3,5,1,0,4,1
6283,8,8,2,0,6,2
6283,7,6,3,0,3,3
6283,6,20,7,0,13,7
6283,5,17,5,0,12,5
6283,4,28,10,0,18,10
6283,3,34,8,0,26,8
6283,2,57,21,0,36,21
6283,1,104,56,0,48,56
242653,10,66,19,0,47,19
242653,9,58,11,0,47,11
242653,8,93,20,1,73,19
242653,7,34,5,1,29,4
242653,6,19,2,0,17,2
242653,5,8,2,0,6,2
242653,1,3,1,0,2,1
9211,10,6,1,0,5,1
9211,9,8,4,0,4,4
9211,8,19,7,0,12,7
9211,7,30,9,0,21,9
9211,6,78,22,0,56,22
9211,5,64,20,0,44,20
9211,4,43,19,0,24,19
9211,3,20,5,0,15,5
9211,2,7,3,0,4,3
9211,1,2,1,0,1,1
1586,9,5,1,0,4,1
1586,8,21,7,0,14,7
1586,7,39,13,0,26,13
1586,6,107,22,0,85,22
1586,5,52,8,0,44,8
1586,4,33,13,0,20,13
1586,3,12,5,0,7,5
1586,2,4,2,0,2,2
1586,1,1,1,0,0,1
25412,8,17,8,0,9,8
25412,7,42,11,0,31,11
25412,6,87,20,0,67,20
25412,5,62,16,0,46,16
25412,4,38,9,0,29,9
25412,3,15,6,0,9,6
25412,2,10,4,0,6,4
25412,1,6,1,0,5,1
46323,10,15,3,0,12,3
46323,9,14,5,0,9,5
46323,8,61,26,0,35,26
46323,7,72,27,0,45,27
46323,6,70,20,0,50,20
46323,5,28,12,0,16,12
46323,4,12,8,0,4,8
46323,3,3,1,0,2,1
46323,2,2,1,0,1,1
148767,10,1,1,0,0,1
148767,9,9,3,0,6,3
148767,8,51,13,0,38,13
148767,7,74,11,0,63,11
148767,6,88,15,0,73,15
148767,5,33,10,0,23,10
148767,4,17,5,0,12,5
148767,3,4,1,0,3,1
220203,10,2,1,0,1,1
220203,9,13,2,0,11,2
220203,8,56,8,0,48,8
220203,7,86,13,0,73,13
220203,6,87,17,0,70,17
220203,5,19,2,0,17,2
220203,4,7,1,0,6,1
220203,3,5,2,0,3,2
220203,2,1,1,0,0,1
220988,9,10,3,0,7,3
220988,8,36,6,0,30,6
220988,7,81,14,0,67,14
220988,6,96,21,1,75,20
220988,5,28,6,0,22,6
220988,4,18,6,0,12,6
220988,3,6,1,0,5,1
4974,10,15,4,0,11,4
4974,9,26,11,0,15,11
4974,8,64,24,0,40,24
4974,7,76,21,0,55,21
4974,6,59,24,0,35,24
4974,5,25,6,0,19,6
4974,4,9,5,0,4,5
4974,3,1,1,0,0,1
4974,2,1,1,0,0,1
67600,10,36,12,0,24,12
67600,9,69,10,0,59,10
67600,8,111,36,0,75,36
67600,7,42,9,0,33,9
67600,6,13,4,0,9,4
67600,4,1,1,0,0,1
85108,9,23,8,0,15,8
85108,8,73,17,0,56,17
85108,7,71,18,0,53,18
85108,6,61,21,0,40,21
85108,5,23,9,0,14,9
85108,4,11,5,0,6,5
85108,3,2,2,0,0,2
85108,1,2,1,0,1,1
158982,10,20,5,0,15,5
158982,9,14,4,0,10,4
158982,8,53,10,0,43,10
158982,7,72,13,0,59,13
158982,6,70,2,0,68,2
158982,5,21,8,0,13,8
158982,4,12,4,0,8,4
158982,3,10,2,0,8,2
158982,2,2,1,0,1,1
158982,1,2,1,0,1,1
12157,10,12,2,0,10,2
12157,9,22,2,0,20,2
12157,8,59,9,0,50,9
12157,7,76,8,0,68,8
12157,6,71,9,0,62,9
12157,5,21,3,0,18,3
12157,4,13,2,0,11,2
2458,10,4,1,0,3,1
2458,9,4,2,0,2,2
2458,8,15,9,0,6,9
2458,7,43,12,0,31,12
2458,6,64,18,0,46,18
2458,5,61,18,0,43,18
2458,4,39,18,0,21,18
2458,3,30,13,0,17,13
2458,2,15,10,0,5,10
2458,1,1,1,0,0,1
125879,10,3,1,0,2,1
125879,9,5,2,0,3,2
125879,8,20,6,0,14,6
125879,7,31,4,0,27,4
125879,6,56,9,2,47,7
125879,5,37,10,1,27,9
125879,4,30,17,0,13,17
125879,3,28,12,0,16,12
125879,2,16,8,2,8,6
125879,1,50,29,8,21,21
118025,9,4,2,0,2,2
118025,8,24,4,0,20,4
118025,7,64,11,0,53,11
118025,6,109,12,0,97,12
118025,5,44,7,0,37,7
118025,4,14,5,0,9,5
118025,3,12,4,0,8,4
118025,2,3,1,0,2,1
31897,10,3,1,0,2,1
31897,9,11,4,0,7,4
31897,8,53,17,0,36,17
31897,7,98,21,0,77,21
31897,6,81,20,0,61,20
31897,5,20,2,0,18,2
31897,4,8,2,0,6,2
174611,9,10,2,1,8,1
174611,8,45,9,1,36,8
174611,7,78,10,2,68,8
174611,6,90,20,1,70,19
174611,5,29,3,0,26,3
174611,4,15,3,0,12,3
174611,3,4,2,1,2,1
408,10,3,1,0,2,1
408,8,11,4,0,7,4
408,7,39,8,0,31,8
408,6,92,21,0,71,21
408,5,66,16,0,50,16
408,4,38,14,0,24,14
153724,10,1,1,1,0,0
153724,8,21,6,1,15,5
153724,7,52,11,0,41,11
153724,6,97,23,1,74,22
153724,5,55,9,0,46,9
153724,4,23,2,0,21,2
153724,3,12,1,0,11,1
153724,2,10,1,0,9,1
153724,1,2,1,0,1,1
440,10,3,1,0,2,1
440,9,5,2,0,3,2
440,8,38,10,0,28,10
440,7,79,23,0,56,23
440,6,101,32,0,69,32
440,5,32,7,0,25,7
440,4,15,4,0,11,4
195242,10,24,5,0,19,5
195242,9,36,8,0,28,8
195242,8,77,11,0,66,11
195242,7,73,6,0,67,6
195242,6,49,11,0,38,11
195242,5,9,1,0,8,1
195242,4,2,1,0,1,1
195242,3,3,2,0,1,2
195242,2,2,1,0,1,1
195242,1,1,1,0,0,1
5928,10,6,1,0,5,1
5928,9,16,6,0,10,6
5928,8,36,8,0,28,8
5928,7,65,15,0,50,15
5928,6,85,23,0,62,23
5928,5,41,9,0,32,9
5928,4,13,4,0,9,4
5928,3,10,6,0,4,6
5928,2,4,2,0,2,2
6544,10,7,3,0,4,3
6544,9,6,4,0,2,4
6544,8,36,21,0,15,21
6544,7,57,24,0,33,24
6544,6,92,46,0,46,46
6544,5,49,20,0,29,20
6544,4,15,7,0,8,7
6544,3,12,3,0,9,3
13933,8,22,5,0,17,5
13933,7,72,26,0,46,26
13933,6,110,36,0,74,36
13933,5,44,16,0,28,16
13933,4,15,3,0,12,3
13933,3,4,1,0,3,1
13933,2,3,2,0,1,2
149097,10,16,8,0,8,8
149097,9,22,8,0,14,8
149097,8,78,23,1,55,22
149097,7,69,10,1,59,9
149097,6,49,13,0,36,13
149097,5,27,7,0,20,7
149097,4,7,3,0,4,3
149097,2,2,1,0,1,1
149097,1,3,1,0,2,1
126000,9,10,2,0,8,2
126000,8,61,16,0,45,16
126000,7,86,16,0,70,16
126000,6,76,10,0,66,10
126000,5,32,9,0,23,9
126000,4,7,2,0,5,2
3177,9,8,2,0,6,2
3177,8,39,17,0,22,17
3177,7,103,38,0,65,38
3177,6,82,28,0,54,28
3177,5,27,8,0,19,8
3177,4,9,1,0,8,1
56294,10,8,2,0,6,2
56294,9,10,3,0,7,3
56294,8,46,10,0,36,10
56294,7,70,7,0,63,7
56294,6,96,11,0,85,11
56294,5,27,3,0,24,3
56294,4,12,3,0,9,3
56294,3,2,1,0,1,1
245431,10,12,1,0,11,1
245431,9,14,3,0,11,3
245431,8,53,11,0,42,11
245431,7,68,6,0,62,6
245431,6,78,9,0,69,9
245431,5,21,3,0,18,3
245431,4,17,8,0,9,8
245431,3,9,5,0,4,5
245431,2,3,3,0,0,3
245431,1,2,1,0,1,1
172207,8,51,9,2,42,7
172207,7,96,15,5,81,10
172207,6,71,8,1,63,7
172207,5,21,2,0,19,2
172207,4,14,3,0,11,3
172207,2,3,3,0,0,3
172207,1,3,1,0,2,1
8993,10,32,19,0,13,19
8993,9,44,13,0,31,13
8993,8,65,20,0,45,20
8993,7,61,19,0,42,19
8993,6,42,7,0,35,7
8993,5,18,4,0,14,4
8993,4,7,3,0,4,3
8993,2,2,1,0,1,1
21798,9,4,2,0,2,2
21798,8,32,8,0,24,8
21798,7,63,13,0,50,13
21798,6,84,12,0,72,12
21798,5,38,17,0,21,17
21798,4,23,6,0,17,6
21798,3,17,8,0,9,8
21798,2,11,5,0,6,5
217553,10,7,3,0,4,3
217553,9,5,2,0,3,2
217553,8,44,7,0,37,7
217553,7,72,11,0,61,11
217553,6,93,10,0,83,10
217553,5,29,5,0,24,5
217553,4,16,2,0,14,2
217553,3,7,1,0,6,1
63170,10,111,38,0,73,38
63170,9,61,19,0,42,19
63170,8,63,18,0,45,18
63170,7,18,8,0,10,8
63170,6,11,4,0,7,4
63170,2,2,1,0,1,1
63170,1,2,1,0,1,1
177697,9,11,1,0,10,1
177697,8,57,9,0,48,9
177697,7,94,13,0,81,13
177697,6,76,9,0,67,9
177697,5,14,2,0,12,2
177697,3,9,2,0,7,2
12896,10,28,6,0,22,6
12896,9,59,15,0,44,15
12896,8,99,19,0,80,19
12896,7,55,14,0,41,14
12896,6,23,9,0,14,9
12896,4,3,1,0,2,1
12896,3,2,1,0,1,1
12896,2,1,1,0,0,1
2224,10,7,2,0,5,2
2224,9,11,3,0,8,3
2224,8,62,25,0,37,25
2224,7,72,19,0,53,19
2224,6,77,20,0,57,20
2224,5,27,4,0,23,4
2224,4,9,4,0,5,4
2224,3,6,2,0,4,2
2224,2,2,1,0,1,1
5367,8,6,1,0,5,1
5367,7,17,8,0,9,8
5367,6,57,16,0,41,16
5367,5,73,23,0,50,23
5367,4,74,25,0,49,25
5367,3,26,14,0,12,14
5367,2,13,7,0,6,7
5367,1,7,4,0,3,4
6980,9,6,1,0,5,1
6980,8,14,4,0,10,4
6980,7,54,25,0,29,25
6980,6,109,41,0,68,41
6980,5,56,18,0,38,18
6980,4,22,7,0,15,7
6980,3,8,3,0,5,3
6980,2,3,1,0,2,1
66590,9,4,2,0,2,2
66590,8,11,1,0,10,1
66590,7,40,10,0,30,10
66590,6,100,25,0,75,25
66590,5,58,18,0,40,18
66590,4,33,12,0,21,12
66590,3,15,4,0,11,4
66590,2,10,2,0,8,2
66590,1,1,1,0,0,1
367,9,7,3,0,4,3
367,8,18,4,0,14,4
367,7,31,8,0,23,8
367,6,74,17,0,57,17
367,5,57,16,0,41,16
367,4,48,17,0,31,17
367,3,24,11,0,13,11
367,2,12,5,0,7,5
367,1,1,1,0,0,1
7103,10,7,4,0,3,4
7103,9,24,9,0,15,9
7103,8,58,23,0,35,23
7103,7,86,24,0,62,24
7103,6,72,19,0,53,19
7103,5,21,9,0,12,9
7103,3,2,1,0,1,1
56880,8,38,10,0,28,10
56880,7,75,13,0,62,13
56880,6,104,17,0,87,17
56880,5,26,7,0,19,7
56880,4,20,4,0,16,4
56880,3,4,2,0,2,2
56880,2,3,2,0,1,2
124960,10,5,2,0,3,2
124960,8,20,4,0,16,4
124960,7,41,9,0,32,9
124960,6,85,15,0,70,15
124960,5,47,10,0,37,10
124960,4,42,10,0,32,10
124960,3,22,3,0,19,3
124960,2,5,1,0,4,1
124960,1,3,1,0,2,1
4375,9,9,1,0,8,1
4375,8,23,4,0,19,4
4375,7,59,14,0,45,14
4375,6,97,14,0,83,14
4375,5,51,10,0,41,10
4375,4,22,7,0,15,7
4375,3,7,4,0,3,4
38703,10,7,3,0,4,3
38703,9,9,5,0,4,5
38703,8,52,9,0,43,9
38703,7,62,15,0,47,15
38703,6,69,10,0,59,10
38703,5,31,4,0,27,4
38703,4,27,10,0,17,10
38703,3,9,4,0,5,4
38703,2,4,2,0,2,2
38703,1,3,2,0,1,2
3597,10,18,9,0,9,9
3597,9,30,10,0,20,10
3597,8,83,28,0,55,28
3597,7,57,22,0,35,22
3597,6,44,13,0,31,13
3597,5,18,6,0,12,6
3597,4,12,5,0,7,5
3597,3,4,2,0,2,2
3597,2,6,2,0,4,2
23685,10,16,7,0,9,7
23685,9,37,14,0,23,14
23685,8,96,25,0,71,25
23685,7,61,13,0,48,13
23685,6,37,13,0,24,13
23685,5,8,5,0,3,5
23685,4,11,8,0,3,8
23685,3,2,1,0,1,1
23685,2,2,2,0,0,2
23685,1,3,1,0,2,1
152241,10,11,1,0,10,1
152241,9,18,1,0,17,1
152241,8,52,6,0,46,6
152241,7,67,5,0,62,5
152241,6,76,6,0,70,6
152241,4,11,2,0,9,2
152241,3,7,2,0,5,2
152241,2,6,2,0,4,2
152241,1,2,1,0,1,1
2123,10,9,3,0,6,3
2123,9,14,3,0,11,3
2123,8,38,10,0,28,10
2123,7,70,7,0,63,7
2123,6,76,20,0,56,20
2123,5,34,11,0,23,11
2123,4,17,3,0,14,3
2123,3,11,3,0,8,3
2123,1,1,1,0,0,1
2938,10,6,1,0,5,1
2938,9,11,2,0,9,2
2938,8,47,6,0,41,6
2938,7,62,13,0,49,13
2938,6,82,14,0,68,14
2938,5,35,9,0,26,9
2938,4,18,2,0,16,2
2938,3,7,3,0,4,3
2938,2,4,3,0,1,3
164589,9,2,1,0,1,1
164589,8,28,9,1,19,8
164589,7,72,19,0,53,19
164589,6,94,16,4,78,12
164589,5,41,5,1,36,4
164589,4,21,7,1,14,6
164589,3,8,2,0,6,2
164589,2,4,2,0,2,2
223518,9,14,3,0,11,3
223518,8,49,5,0,44,5
223518,7,67,11,0,56,11
223518,6,83,22,0,61,22
223518,5,30,8,0,22,8
223518,4,13,3,0,10,3
223518,3,6,3,0,3,3
223518,2,4,2,0,2,2
36325,10,8,1,0,7,1
36325,9,22,5,0,17,5
36325,8,81,35,0,46,35
36325,7,75,20,0,55,20
36325,6,56,7,0,49,7
36325,5,17,5,0,12,5
36325,4,8,3,0,5,3
36325,3,3,2,0,1,2
36325,2,1,1,0,0,1
172866,10,5,3,0,2,3
172866,9,8,4,0,4,4
172866,8,35,9,2,26,7
172866,7,60,16,2,44,14
172866,6,93,28,2,65,26
172866,5,41,11,1,30,10
172866,4,18,4,0,14,4
172866,3,8,3,0,5,3
172866,1,1,1,0,0,1
360,8,21,7,0,14,7
360,7,34,9,0,25,9
360,6,82,20,0,62,20
360,5,62,18,0,44,18
360,4,31,14,0,17,14
360,3,23,10,0,13,10
360,2,13,4,0,9,4
360,1,3,1,0,2,1
38154,10,3,1,0,2,1
38154,8,10,1,0,9,1
38154,7,33,4,0,29,4
38154,6,90,13,0,77,13
38154,5,64,9,0,55,9
38154,4,47,9,0,38,9
38154,3,11,5,0,6,5
9048,10,1,1,0,0,1
9048,9,2,1,0,1,1
9048,8,13,8,0,5,8
9048,7,45,16,0,29,16
9048,6,92,50,0,42,50
9048,5,76,27,0,49,27
9048,4,29,14,0,15,14
9048,3,9,5,0,4,5
9048,2,3,1,0,2,1
9048,1,2,2,0,0,2
153939,9,2,1,0,1,1
153939,8,18,3,0,15,3
153939,7,53,11,0,42,11
153939,6,92,18,0,74,18
153939,5,50,17,1,33,16
153939,4,25,5,0,20,5
153939,3,14,3,0,11,3
153939,1,2,2,0,0,2
34001,8,33,10,0,23,10
34001,7,62,15,0,47,15
34001,6,110,29,0,81,29
34001,5,32,12,0,20,12
34001,4,19,5,0,14,5
34001,3,8,3,0,5,3
34001,2,3,1,0,2,1
45319,8,29,8,0,21,8
45319,7,70,15,0,55,15
45319,6,87,15,0,72,15
45319,5,44,8,0,36,8
45319,4,25,10,0,15,10
45319,3,8,2,0,6,2
45319,2,2,1,0,1,1
45319,1,1,1,0,0,1
63897,10,3,1,0,2,1
63897,9,3,2,0,1,2
63897,8,18,2,0,16,2
63897,7,38,14,0,24,14
63897,6,83,21,0,62,21
63897,5,60,16,0,44,16
63897,4,43,8,0,35,8
63897,3,14,7,0,7,7
63897,2,7,2,0,5,2
63897,1,3,2,0,1,2
23329,8,29,9,0,20,9
23329,7,50,10,0,40,10
23329,6,94,22,0,72,22
23329,5,56,23,0,33,23
23329,4,27,6,0,21,6
23329,3,10,4,0,6,4
23329,2,3,2,0,1,2
104627,10,7,1,0,6,1
104627,9,41,11,0,30,11
104627,8,90,15,0,75,15
104627,7,67,6,0,61,6
104627,6,44,7,1,37,6
104627,5,12,3,0,9,3
104627,4,4,1,0,3,1
12963,9,6,2,0,4,2
12963,8,26,16,0,10,16
12963,7,52,21,0,31,21
12963,6,89,32,0,57,32
12963,5,44,22,0,22,22
12963,4,28,14,0,14,14
12963,3,10,6,0,4,6
12963,2,14,9,0,5,9
5833,10,9,1,0,8,1
5833,9,30,4,0,26,4
5833,8,73,13,0,60,13
5833,7,82,14,0,68,14
5833,6,46,13,0,33,13
5833,5,23,12,0,11,12
5833,4,7,2,0,5,2
164874,10,4,4,0,0,4
164874,9,17,6,0,11,6
164874,8,85,36,6,49,30
164874,7,70,17,0,53,17
164874,6,64,24,2,40,22
164874,5,19,6,1,13,5
164874,4,3,1,0,2,1
2904,10,10,2,0,8,2
2904,9,21,8,0,13,8
2904,8,53,13,0,40,13
2904,7,59,16,0,43,16
2904,6,58,17,0,41,17
2904,5,34,12,0,22,12
2904,4,13,7,0,6,7
2904,3,8,3,0,5,3
2904,2,12,10,0,2,10
2904,1,3,2,0,1,2
958,9,1,1,0,0,1
958,8,12,4,0,8,4
958,7,41,10,0,31,10
958,6,94,35,0,59,35
958,5,55,14,0,41,14
958,4,48,14,0,34,14
958,3,13,2,0,11,2
958,2,7,3,0,4,3
39635,9,13,3,0,10,3
39635,8,50,26,0,24,26
39635,7,75,31,0,44,31
39635,6,84,30,0,54,30
39635,5,24,8,0,16,8
39635,4,14,4,0,10,4
39635,3,8,2,0,6,2
129946,10,4,2,0,2,2
129946,9,10,4,0,6,4
129946,8,28,10,0,18,10
129946,7,70,17,0,53,17
129946,6,95,20,0,75,20
129946,5,43,15,0,28,15
129946,4,14,4,0,10,4
129946,3,6,3,0,3,3
85394,10,3,1,0,2,1
85394,9,7,1,0,6,1
85394,8,26,4,0,22,4
85394,7,44,8,0,36,8
85394,6,74,11,0,63,11
85394,5,52,9,0,43,9
85394,4,32,7,0,25,7
85394,3,17,1,0,16,1
85394,2,8,2,0,6,2
32743,7,34,2,0,32,2
32743,6,87,11,0,76,11
32743,5,57,8,0,49,8
32743,4,30,4,0,26,4
32743,3,25,2,0,23,2
32743,2,9,3,0,6,3
32743,1,5,1,0,4,1
218421,10,66,17,2,49,15
218421,9,81,20,1,61,19
218421,8,78,14,1,64,13
218421,7,22,2,0,20,2
218421,6,13,2,0,11,2
218421,5,6,2,0,4,2
218421,1,3,1,0,2,1
155042,10,2,1,0,1,1
155042,9,8,3,0,5,3
155042,8,67,24,2,43,22
155042,7,83,24,2,59,22
155042,6,73,18,1,55,17
155042,5,23,8,0,15,8
155042,4,9,3,0,6,3
155042,3,3,2,0,1,2
172557,10,3,2,0,1,2
172557,9,4,1,0,3,1
172557,8,33,9,1,24,8
172557,7,38,5,0,33,5
172557,6,86,16,0,70,16
172557,5,57,13,0,44,13
172557,4,27,3,0,24,3
172557,3,12,2,0,10,2
172557,2,6,5,0,1,5
172557,1,5,2,0,3,2
37983,9,6,3,0,3,3
37983,8,29,6,0,23,6
37983,7,50,18,0,32,18
37983,6,92,26,0,66,26
37983,5,57,17,0,40,17
37983,4,13,5,0,8,5
37983,3,13,3,0,10,3
37983,2,9,3,0,6,3
7553,9,3,2,0,1,2
7553,8,13,5,0,8,5
7553,7,49,22,0,27,22
7553,6,91,33,0,58,33
7553,5,55,20,0,35,20
7553,4,29,6,0,23,6
7553,3,17,7,0,10,7
7553,2,6,2,0,4,2
7553,1,5,2,0,3,2
201406,10,10,3,0,7,3
201406,9,20,3,0,17,3
201406,8,52,8,2,44,6
201406,7,54,9,0,45,9
201406,6,64,12,2,52,10
201406,5,29,8,0,21,8
201406,4,15,5,0,10,5
201406,3,15,5,0,10,5
201406,2,9,3,0,6,3
201406,1,2,2,0,0,2
107635,10,1,1,0,0,1
107635,9,12,2,0,10,2
107635,8,56,16,0,40,16
107635,7,89,16,0,73,16
107635,6,75,15,0,60,15
107635,5,24,7,0,17,7
107635,4,7,2,0,5,2
107635,3,4,1,0,3,1
107635,2,2,2,0,0,2
10989,10,16,9,0,7,9
10989,9,16,2,0,14,2
10989,8,73,29,0,44,29
10989,7,63,19,0,44,19
10989,6,60,19,0,41,19
10989,5,22,4,0,18,4
10989,4,9,2,0,7,2
10989,3,4,2,0,2,2
10989,2,5,1,0,4,1
3022,10,10,4,0,6,4
3022,9,9,3,0,6,3
3022,8,19,6,0,13,6
3022,7,50,11,0,39,11
3022,6,64,17,0,47,17
3022,5,64,17,0,47,17
3022,4,25,3,0,22,3
3022,3,18,11,0,7,11
3022,2,8,4,0,4,4
3022,1,3,1,0,2,1
92852,9,16,5,0,11,5
92852,8,59,19,0,40,19
92852,7,85,18,0,67,18
92852,6,78,19,0,59,19
92852,5,17,2,0,15,2
92852,4,5,1,0,4,1
92852,3,6,3,0,3,3
19796,8,15,2,0,13,2
19796,7,43,5,0,38,5
19796,6,102,18,0,84,18
19796,5,54,12,0,42,12
19796,4,28,10,0,18,10
19796,3,13,5,0,8,5
19796,2,9,2,0,7,2
67693,9,8,2,0,6,2
67693,8,58,21,0,37,21
67693,7,72,15,0,57,15
67693,6,73,12,0,61,12
67693,5,26,8,0,18,8
67693,4,23,6,0,17,6
67693,3,6,2,0,4,2
67693,2,3,1,0,2,1
2895,9,7,4,0,3,4
2895,8,23,7,0,16,7
2895,7,48,13,0,35,13
2895,6,91,32,0,59,32
2895,5,51,19,0,32,19
2895,4,34,14,0,20,14
2895,3,7,3,0,4,3
2895,2,3,1,0,2,1
2895,1,4,3,0,1,3
237251,10,8,1,0,7,1
237251,9,34,10,0,24,10
237251,8,96,19,0,77,19
237251,7,79,11,0,68,11
237251,6,37,6,0,31,6
237251,5,10,5,0,5,5
94724,8,34,5,0,29,5
94724,7,55,11,0,44,11
94724,6,74,11,0,63,11
94724,5,35,4,0,31,4
94724,4,20,6,0,14,6
94724,3,9,4,0,5,4
94724,2,3,1,0,2,1
94724,1,3,1,0,2,1
4031,10,5,1,0,4,1
4031,9,5,2,0,3,2
4031,8,15,2,0,13,2
4031,7,50,12,0,38,12
4031,6,107,30,0,77,30
4031,5,52,14,0,38,14
4031,4,20,7,0,13,7
4031,3,11,5,0,6,5
4031,2,2,1,0,1,1
4031,1,3,1,0,2,1
34696,9,2,2,0,0,2
34696,8,23,5,0,18,5
34696,7,53,7,0,46,7
34696,6,114,18,0,96,18
34696,5,34,7,0,27,7
34696,4,32,5,0,27,5
34696,3,11,4,0,7,4
34696,2,1,1,0,0,1
40491,8,43,5,0,38,5
40491,7,90,17,0,73,17
40491,6,94,14,0,80,14
40491,4,9,1,0,8,1
8630,10,11,1,0,10,1
8630,9,12,5,0,7,5
8630,8,49,14,0,35,14
8630,7,62,17,0,45,17
8630,6,74,18,0,56,18
8630,5,39,23,0,16,23
8630,4,13,4,0,9,4
8630,3,2,1,0,1,1
8630,2,4,2,0,2,2
68603,10,12,6,0,6,6
68603,9,20,11,0,9,11
68603,8,94,34,0,60,34
68603,7,56,15,0,41,15
68603,6,56,16,0,40,16
68603,5,17,4,0,13,4
68603,4,7,3,0,4,3
68603,2,4,4,0,0,4
65516,9,4,1,0,3,1
65516,8,26,8,0,18,8
65516,7,52,10,0,42,10
65516,6,105,29,0,76,29
65516,5,48,12,0,36,12
65516,4,23,9,0,14,9
65516,3,6,3,0,3,3
65516,2,2,2,0,0,2
194723,10,8,2,0,6,2
194723,9,14,1,0,13,1
194723,8,97,18,0,79,18
194723,7,76,19,1,57,18
194723,6,49,8,0,41,8
194723,5,11,3,0,8,3
194723,3,3,1,0,2,1
194723,2,2,1,0,1,1
194723,1,2,1,0,1,1
224079,10,8,1,0,7,1
224079,9,17,5,1,12,4
224079,8,73,6,0,67,6
224079,7,63,8,0,55,8
224079,6,61,13,2,48,11
224079,5,32,9,0,23,9
224079,4,11,4,0,7,4
224079,2,2,1,0,1,1
156737,10,7,1,0,6,1
156737,9,15,4,0,11,4
156737,8,44,12,0,32,12
156737,7,66,13,0,53,13
156737,6,70,8,0,62,8
156737,5,35,6,0,29,6
156737,4,18,3,0,15,3
156737,3,9,6,0,3,6
156737,1,2,2,0,0,2
197072,10,8,2,0,6,2
197072,9,23,7,0,16,7
197072,8,108,28,0,80,28
197072,7,82,24,0,58,24
197072,6,33,11,0,22,11
197072,5,8,1,0,7,1
197072,4,5,3,0,2,3
176435,10,7,1,0,6,1
176435,9,15,2,0,13,2
176435,8,76,12,1,64,11
176435,7,63,10,0,53,10
176435,6,65,16,2,49,14
176435,5,23,3,0,20,3
176435,4,13,2,2,11,0
176435,2,3,1,0,2,1
176435,1,2,1,0,1,1
7180,10,8,1,0,7,1
7180,9,4,1,0,3,1
7180,8,30,5,0,25,5
7180,7,45,7,0,38,7
7180,6,73,13,0,60,13
7180,5,54,7,0,47,7
7180,4,24,6,0,18,6
7180,3,15,3,0,12,3
7180,2,12,3,0,9,3
7180,1,4,1,0,3,1
153639,10,12,2,1,10,1
153639,9,17,1,1,16,0
153639,8,60,12,0,48,12
153639,7,74,14,0,60,14
153639,6,68,13,0,55,13
153639,5,22,3,0,19,3
153639,4,10,3,0,7,3
153639,3,2,1,0,1,1
153639,2,3,1,0,2,1
153639,1,1,1,0,0,1
192312,10,12,2,0,10,2
192312,9,15,6,0,9,6
192312,8,103,30,4,73,26
192312,7,81,22,0,59,22
192312,6,46,15,1,31,14
192312,5,7,3,1,4,2
192312,4,3,1,0,2,1
192312,3,3,3,1,0,2
15209,9,9,2,0,7,2
15209,8,48,9,0,39,9
15209,7,72,21,0,51,21
15209,6,97,23,0,74,23
15209,5,26,5,0,21,5
15209,4,12,3,0,9,3
937,10,10,6,0,4,6
937,9,23,10,0,13,10
937,8,67,25,0,42,25
937,7,80,29,0,51,29
937,6,43,13,0,30,13
937,5,20,6,0,14,6
937,4,9,2,0,7,2
937,3,9,6,0,3,6
937,2,6,2,0,4,2
2546,10,5,1,0,4,1
2546,9,5,3,0,2,3
2546,8,22,7,0,15,7
2546,7,42,16,0,26,16
2546,6,89,16,0,73,16
2546,5,51,17,0,34,17
2546,4,20,6,0,14,6
2546,3,11,3,0,8,3
2546,2,1,1,0,0,1
208411,10,6,1,0,5,1
208411,9,2,2,0,0,2
208411,8,40,13,1,27,12
208411,7,58,11,2,47,9
208411,6,97,18,2,79,16
208411,5,33,4,0,29,4
208411,4,16,7,0,9,7
208411,3,7,3,0,4,3
208411,2,6,2,0,4,2
208411,1,3,1,0,2,1
369,10,10,7,0,3,7
369,9,6,5,0,1,5
369,8,28,12,0,16,12
369,7,66,31,0,35,31
369,6,95,33,0,62,33
369,5,30,10,0,20,10
369,4,23,11,0,12,11
369,3,9,3,0,6,3
1627,10,5,2,0,3,2
1627,8,24,5,0,19,5
1627,7,46,20,0,26,20
1627,6,95,26,0,69,26
1627,5,41,17,0,24,17
1627,4,27,7,0,20,7
1627,3,17,8,0,9,8
1627,2,6,1,0,5,1
1627,1,3,1,0,2,1
12234,10,77,29,0,48,29
12234,9,68,16,0,52,16
12234,8,63,22,0,41,22
12234,7,23,6,0,17,6
12234,6,15,4,0,11,4
12234,5,6,2,0,4,2
12234,3,4,1,0,3,1
148231,9,13,4,0,9,4
148231,8,55,17,0,38,17
148231,7,84,22,0,62,22
148231,6,71,11,0,60,11
148231,5,25,6,0,19,6
148231,4,11,5,0,6,5
148231,3,3,1,0,2,1
2285,10,4,1,0,3,1
2285,9,9,3,0,6,3
2285,8,30,11,0,19,11
2285,7,40,9,0,31,9
2285,6,85,20,0,65,20
2285,5,60,16,0,44,16
2285,4,22,6,0,16,6
2285,3,5,2,0,3,2
2285,2,8,2,0,6,2
2285,1,5,3,0,2,3
233956,10,2,1,0,1,1
233956,9,8,2,0,6,2
233956,8,75,17,0,58,17
233956,7,96,22,0,74,22
233956,6,64,12,0,52,12
233956,5,18,4,0,14,4
233956,4,4,1,0,3,1
1436,9,5,3,0,2,3
1436,8,12,3,0,9,3
1436,7,29,11,0,18,11
1436,6,69,19,0,50,19
1436,5,71,26,0,45,26
1436,4,44,8,0,36,8
1436,3,19,9,0,10,9
1436,2,16,6,0,10,6
1436,1,1,1,0,0,1
139572,8,52,14,2,38,12
139572,7,77,15,0,62,15
139572,6,75,29,0,46,29
139572,5,29,5,0,24,5
139572,4,16,5,0,11,5
139572,3,4,3,0,1,3
139572,2,1,1,0,0,1
6581,10,47,16,0,31,16
6581,9,68,24,0,44,24
6581,8,97,29,0,68,29
6581,7,28,7,0,21,7
6581,6,10,1,0,9,1
6581,5,7,3,0,4,3
6581,4,2,2,0,0,2
6581,3,3,1,0,2,1
606,9,2,1,0,1,1
606,8,17,11,0,6,11
606,7,56,26,0,30,26
606,6,104,44,0,60,44
606,5,47,18,0,29,18
606,4,26,12,0,14,12
606,3,9,5,0,4,5
606,2,2,1,0,1,1
7720,8,12,5,0,7,5
7720,7,25,8,0,17,8
7720,6,78,14,0,64,14
7720,5,56,12,0,44,12
7720,4,40,15,0,25,15
7720,3,33,9,0,24,9
7720,2,16,7,0,9,7
7720,1,7,2,0,5,2
15832,9,3,1,0,2,1
15832,8,11,6,0,5,6
15832,7,29,9,0,20,9
15832,6,65,27,0,38,27
15832,5,57,23,0,34,23
15832,4,56,22,0,34,22
15832,3,28,9,0,19,9
15832,2,16,4,0,12,4
207330,8,56,10,0,46,10
207330,7,67,13,0,54,13
207330,6,55,17,0,38,17
207330,5,21,3,0,18,3
35122,9,3,2,0,1,2
35122,8,25,11,0,14,11
35122,7,46,20,0,26,20
35122,6,101,33,0,68,33
35122,5,41,11,0,30,11
35122,4,22,2,0,20,2
35122,3,14,7,0,7,7
35122,2,9,6,0,3,6
35122,1,4,4,0,0,4
2125,10,14,10,0,4,10
2125,9,32,18,0,14,18
2125,8,73,22,0,51,22
2125,7,53,19,0,34,19
2125,6,65,31,0,34,31
2125,5,15,8,0,7,8
2125,4,10,4,0,6,4
2125,3,5,1,0,4,1
183447,10,12,3,1,9,2
183447,9,16,3,0,13,3
183447,8,51,14,1,37,13
183447,7,59,11,3,48,8
183447,6,80,13,1,67,12
183447,5,33,4,1,29,3
183447,4,5,1,0,4,1
178835,10,56,24,0,32,24
178835,9,23,9,0,14,9
178835,8,46,5,0,41,5
178835,7,40,9,0,31,9
178835,6,42,2,0,40,2
178835,5,21,4,0,17,4
178835,4,17,1,0,16,1
178835,3,8,2,0,6,2
178835,1,8,1,0,7,1
10523,10,1,1,0,0,1
10523,9,8,6,0,2,6
10523,8,56,31,0,25,31
10523,7,57,21,0,36,21
10523,6,81,33,0,48,33
10523,5,44,20,0,24,20
10523,4,16,5,0,11,5
10523,3,4,3,0,1,3
102107,9,4,1,0,3,1
102107,8,38,9,0,29,9
102107,7,48,6,0,42,6
102107,6,97,20,1,77,19
102107,5,48,9,1,39,8
102107,4,13,3,0,10,3
102107,3,6,3,0,3,3
102107,2,5,2,0,3,2
192830,10,9,1,0,8,1
192830,9,3,1,0,2,1
192830,8,40,10,0,30,10
192830,7,87,16,1,71,15
192830,6,92,13,2,79,11
192830,5,22,5,0,17,5
192830,4,10,2,1,8,1
26156,8,43,10,0,33,10
26156,7,94,17,0,77,17
26156,6,89,11,0,78,11
26156,5,22,5,0,17,5
26156,3,4,1,0,3,1
26156,2,3,1,0,2,1
7843,9,25,4,0,21,4
7843,8,99,26,0,73,26
7843,7,83,17,0,66,17
7843,6,37,12,0,25,12
7843,5,7,4,0,3,4
7843,4,5,5,0,0,5
7843,1,1,1,0,0,1
207898,10,13,4,0,9,4
207898,9,30,3,0,27,3
207898,8,97,21,0,76,21
207898,7,62,7,1,55,6
207898,6,45,11,0,34,11
207898,5,11,2,0,9,2
207898,4,6,3,0,3,3
207898,2,2,1,0,1,1
66507,9,3,1,0,2,1
66507,8,16,8,0,8,8
66507,7,42,10,0,32,10
66507,6,132,41,0,91,41
66507,5,34,15,0,19,15
66507,4,17,4,0,13,4
66507,3,14,6,0,8,6
66507,2,7,1,0,6,1
66507,1,1,1,0,0,1
22673,9,3,3,0,0,3
22673,8,21,10,0,11,10
22673,7,41,17,0,24,17
22673,6,111,39,0,72,39
22673,5,53,16,0,37,16
22673,4,27,13,0,14,13
22673,3,7,3,0,4,3
22673,2,3,1,0,2,1
1894,10,7,1,0,6,1
1894,9,15,2,0,13,2
1894,8,86,32,0,54,32
1894,7,78,14,0,64,14
1894,6,59,16,0,43,16
1894,5,13,5,0,8,5
1894,4,6,4,0,2,4
1894,3,2,2,0,0,2
98443,10,3,1,0,2,1
98443,9,14,6,0,8,6
98443,8,73,27,2,46,25
98443,7,76,14,1,62,13
98443,6,64,14,1,50,13
98443,5,18,6,1,12,5
98443,4,7,4,0,3,4
98443,3,4,1,1,3,0
98443,2,5,4,0,1,4
98443,1,2,1,0,1,1
125609,8,25,4,2,21,2
125609,7,48,7,0,41,7
125609,6,86,14,1,72,13
125609,5,51,11,1,40,10
125609,4,33,4,2,29,2
125609,3,9,4,0,5,4
125609,2,4,2,0,2,2
2997,10,8,4,0,4,4
2997,9,8,1,0,7,1
2997,8,38,15,0,23,15
2997,7,77,20,0,57,20
2997,6,73,27,0,46,27
2997,5,34,7,0,27,7
2997,4,20,11,0,9,11
2997,2,2,2,0,0,2
1147,10,2,1,0,1,1
1147,9,2,1,0,1,1
1147,8,15,6,0,9,6
1147,7,26,4,0,22,4
1147,6,41,12,0,29,12
1147,5,65,17,0,48,17
1147,4,55,27,0,28,27
1147,3,31,8,0,23,8
1147,2,20,6,0,14,6
1147,1,9,5,0,4,5
207910,10,8,2,1,6,1
207910,9,16,2,0,14,2
207910,8,109,16,1,93,15
207910,7,70,10,1,60,9
207910,6,43,6,0,37,6
207910,5,10,2,0,8,2
207910,4,9,2,0,7,2
207910,2,2,1,0,1,1
1249,9,3,2,0,1,2
1249,8,4,3,0,1,3
1249,7,35,11,0,24,11
1249,6,86,30,0,56,30
1249,5,79,24,0,55,24
1249,4,35,9,0,26,9
1249,3,17,8,0,9,8
1249,2,4,2,0,2,2
2891,10,11,3,0,8,3
2891,9,14,7,0,7,7
2891,8,58,26,0,32,26
2891,7,81,20,0,61,20
2891,6,63,15,0,48,15
2891,5,24,9,0,15,9
2891,4,11,3,0,8,3
2891,2,2,1,0,1,1
34375,10,4,1,0,3,1
34375,9,5,1,0,4,1
34375,8,35,15,0,20,15
34375,7,50,15,0,35,15
34375,6,104,39,0,65,39
34375,5,41,7,0,34,7
34375,4,16,4,0,12,4
34375,2,4,3,0,1,3
260757,10,10,3,0,7,3
260757,9,13,3,0,10,3
260757,8,109,15,1,94,14
260757,7,78,11,0,67,11
260757,6,42,13,0,29,13
260757,5,10,1,0,9,1
260757,4,3,1,0,2,1
260757,1,1,1,0,0,1
2132,10,7,2,0,5,2
2132,9,22,10,0,12,10
2132,8,31,9,0,22,9
2132,7,63,15,0,48,15
2132,6,73,22,0,51,22
2132,5,36,14,0,22,14
2132,4,20,6,0,14,6
2132,3,13,5,0,8,5
2132,1,1,1,0,0,1
147999,10,1,1,0,0,1
147999,9,17,6,0,11,6
147999,8,58,9,0,49,9
147999,7,81,14,0,67,14
147999,6,80,19,0,61,19
147999,5,23,6,0,17,6
40,10,13,3,0,10,3
40,9,22,10,0,12,10
40,8,54,22,0,32,22
40,7,63,19,0,44,19
40,6,63,19,0,44,19
40,5,30,10,0,20,10
40,4,12,5,0,7,5
40,3,4,2,0,2,2
40,2,4,4,0,0,4
751,10,3,1,0,2,1
751,9,10,5,0,5,5
751,8,40,8,0,32,8
751,7,72,15,0,57,15
751,6,83,17,0,66,17
751,5,34,8,0,26,8
751,4,15,5,0,10,5
751,3,7,3,0,4,3
751,2,1,1,0,0,1
223931,10,39,4,0,35,4
223931,9,74,7,0,67,7
223931,8,100,8,0,92,8
223931,7,33,4,0,29,4
223931,6,14,5,0,9,5
223931,3,2,2,0,0,2
1434,10,7,3,0,4,3
1434,9,5,1,0,4,1
1434,8,13,9,0,4,9
1434,7,47,21,0,26,21
1434,6,102,32,0,70,32
1434,5,53,12,0,41,12
1434,4,22,13,0,9,13
1434,3,12,6,0,6,6
1961,9,7,4,0,3,4
1961,8,15,3,0,12,3
1961,7,34,8,0,26,8
1961,6,82,25,0,57,25
1961,5,62,11,0,51,11
1961,4,39,8,0,31,8
1961,3,14,2,0,12,2
1961,2,7,6,0,1,6
1961,1,3,2,0,1,2
203405,10,2,1,0,1,1
203405,9,8,3,0,5,3
203405,8,52,13,0,39,13
203405,7,78,18,0,60,18
203405,6,69,13,0,56,13
203405,5,34,7,0,27,7
203405,4,15,3,0,12,3
203405,3,6,2,0,4,2
389,9,6,1,0,5,1
389,8,22,7,0,15,7
389,7,63,25,0,38,25
389,6,98,17,0,81,17
389,5,49,14,0,35,14
389,4,18,6,0,12,6
389,3,7,3,0,4,3
1031,9,1,1,0,0,1
1031,8,18,6,0,12,6
1031,7,32,13,0,19,13
1031,6,96,31,0,65,31
1031,5,56,15,0,41,15
1031,4,35,15,0,20,15
1031,3,17,8,0,9,8
1031,2,5,4,0,1,4
1031,1,3,2,0,1,2
4921,10,12,2,0,10,2
4921,9,30,9,0,21,9
4921,8,82,17,0,65,17
4921,7,73,20,0,53,20
4921,6,47,10,0,37,10
4921,5,14,2,0,12,2
4921,3,3,2,0,1,2
31790,10,46,11,0,35,11
31790,9,91,27,0,64,27
31790,8,89,23,0,66,23
31790,7,27,8,0,19,8
31790,6,8,1,0,7,1
31790,4,2,2,0,0,2
1187,10,10,4,0,6,4
1187,9,12,3,0,9,3
1187,8,30,17,0,13,17
1187,7,57,16,0,41,16
1187,6,69,17,0,52,17
1187,5,44,11,0,33,11
1187,4,27,11,0,16,11
1187,3,9,4,0,5,4
1187,2,6,1,0,5,1
1663,9,4,1,0,3,1
1663,8,26,6,0,20,6
1663,7,44,9,0,35,9
1663,6,87,12,0,75,12
1663,5,60,16,0,44,16
1663,4,21,10,0,11,10
1663,3,14,1,0,13,1
1663,2,2,1,0,1,1
1663,1,2,1,0,1,1
72204,10,6,2,0,4,2
72204,9,9,5,0,4,5
72204,8,42,16,2,26,14
72204,7,64,23,2,41,21
72204,6,70,21,1,49,20
72204,5,30,5,1,25,4
72204,4,22,5,0,17,5
72204,3,6,4,0,2,4
72204,2,12,4,0,8,4
72204,1,3,3,1,0,2
2638,9,12,3,0,9,3
2638,8,81,39,0,42,39
2638,7,79,30,0,49,30
2638,6,52,18,0,34,18
2638,5,24,11,0,13,11
2638,4,6,2,0,4,2
2638,3,3,2,0,1,2
2638,1,1,1,0,0,1
3507,9,1,1,0,0,1
3507,8,29,12,0,17,12
3507,7,51,15,0,36,15
3507,6,102,29,0,73,29
3507,5,61,21,0,40,21
3507,4,17,9,0,8,9
2444,10,2,1,0,1,1
2444,8,21,9,0,12,9
2444,7,55,18,0,37,18
2444,6,96,43,0,53,43
2444,5,54,26,0,28,26
2444,4,21,12,0,9,12
2444,3,7,5,0,2,5
2444,2,2,2,0,0,2
7164,10,6,2,0,4,2
7164,9,12,3,0,9,3
7164,8,42,12,0,30,12
7164,7,48,9,0,39,9
7164,6,63,23,0,40,23
7164,5,41,10,0,31,10
7164,4,20,9,0,11,9
7164,3,17,4,0,13,4
7164,2,9,5,0,4,5
7164,1,6,2,0,4,2
10156,10,26,16,0,10,16
10156,9,41,16,0,25,16
10156,8,103,39,0,64,39
10156,7,49,20,0,29,20
10156,6,29,11,0,18,11
10156,5,7,2,0,5,2
10156,4,5,2,0,3,2
10156,3,1,1,0,0,1
10156,2,3,3,0,0,3
40843,10,8,3,0,5,3
40843,9,9,1,0,8,1
40843,8,27,3,0,24,3
40843,7,40,10,0,30,10
40843,6,103,15,0,88,15
40843,5,39,11,0,28,11
40843,4,26,5,0,21,5
40843,3,5,1,0,4,1
40843,2,6,1,0,5,1
153004,9,5,1,0,4,1
153004,8,34,11,0,23,11
153004,7,83,18,0,65,18
153004,6,99,12,0,87,12
153004,5,29,10,0,19,10
153004,4,11,1,0,10,1
153004,3,4,1,0,3,1
19665,10,4,2,0,2,2
19665,9,5,2,0,3,2
19665,8,25,11,0,14,11
19665,7,76,18,0,58,18
19665,6,94,20,0,74,20
19665,5,40,9,0,31,9
19665,4,16,9,0,7,9
19665,3,3,3,0,0,3
218310,10,3,1,0,2,1
218310,9,12,3,1,9,2
218310,8,61,9,2,52,7
218310,7,55,9,2,46,7
218310,6,88,17,1,71,16
218310,5,23,4,0,19,4
218310,4,12,3,0,9,3
218310,3,6,2,0,4,2
4667,10,6,3,0,3,3
4667,9,14,6,0,8,6
4667,8,44,19,0,25,19
4667,7,78,20,1,58,19
4667,6,77,32,0,45,32
4667,5,25,6,0,19,6
4667,4,11,4,0,7,4
4667,3,7,3,0,4,3
4667,2,1,1,0,0,1
4667,1,1,1,0,0,1
35293,9,2,1,0,1,1
35293,8,45,17,0,28,17
35293,7,83,21,0,62,21
35293,6,87,19,0,68,19
35293,5,33,9,0,24,9
35293,4,8,1,0,7,1
35293,3,3,1,0,2,1
35293,2,1,1,0,0,1
108377,9,13,4,0,9,4
108377,8,63,11,0,52,11
108377,7,75,15,0,60,15
108377,6,67,5,0,62,5
108377,5,19,1,0,18,1
108377,4,10,2,0,8,2
108377,3,9,5,0,4,5
108377,2,4,2,0,2,2
172965,10,19,7,1,12,6
172965,9,45,13,0,32,13
172965,8,80,13,0,67,13
172965,7,47,8,0,39,8
172965,6,41,7,0,34,7
172965,5,16,5,0,11,5
172965,4,9,6,0,3,6
172965,3,5,2,0,3,2
172965,2,2,1,0,1,1
166988,10,1,1,0,0,1
166988,9,9,1,0,8,1
166988,8,68,13,4,55,9
166988,7,79,18,3,61,15
166988,6,81,15,2,66,13
166988,5,11,4,0,7,4
166988,4,10,1,0,9,1
166988,3,3,2,1,1,1
166988,1,1,1,0,0,1
237728,10,7,3,0,4,3
237728,9,15,2,0,13,2
237728,8,64,11,0,53,11
237728,7,65,11,1,54,10
237728,6,60,9,0,51,9
237728,5,23,6,0,17,6
237728,4,16,5,0,11,5
237728,3,9,2,0,7,2
237728,2,5,3,0,2,3
174192,9,11,2,0,9,2
174192,8,56,11,0,45,11
174192,7,80,12,0,68,12
174192,6,75,19,0,56,19
174192,5,24,4,0,20,4
174192,4,12,5,0,7,5
174192,3,1,1,0,0,1
174192,2,2,1,0,1,1
174192,1,1,1,0,0,1
23919,10,6,1,0,5,1
23919,9,21,4,0,17,4
23919,8,79,24,0,55,24
23919,7,80,21,0,59,21
23919,6,57,17,0,40,17
23919,5,14,6,0,8,6
23919,4,4,2,0,2,2
23919,3,2,2,0,0,2
28302,10,9,3,0,6,3
28302,9,12,5,0,7,5
28302,8,37,9,0,28,9
28302,7,53,19,0,34,19
28302,6,89,22,0,67,22
28302,5,34,4,0,30,4
28302,4,19,7,0,12,7
28302,3,8,4,0,4,4
142924,10,4,3,0,1,3
142924,9,15,2,0,13,2
142924,8,55,18,0,37,18
142924,7,69,10,0,59,10
142924,6,67,12,0,55,12
142924,5,20,4,0,16,4
142924,4,14,2,0,12,2
142924,3,10,3,0,7,3
142924,2,7,3,0,4,3
142924,1,2,2,0,0,2
174893,8,37,8,0,29,8
174893,7,91,20,0,71,20
174893,6,95,15,0,80,15
174893,5,26,2,0,24,2
174893,4,5,1,0,4,1
174893,3,2,2,0,0,2
240980,10,100,65,4,35,61
240980,9,37,17,3,20,14
240980,8,19,5,0,14,5
240980,7,17,2,0,15,2
240980,6,9,3,0,6,3
240980,5,4,2,0,2,2
240980,4,10,4,0,6,4
240980,3,11,8,1,3,7
240980,2,11,5,0,6,5
240980,1,48,15,0,33,15
120305,10,2,1,0,1,1
120305,8,30,5,0,25,5
120305,7,66,7,0,59,7
120305,6,93,13,0,80,13
120305,5,51,11,0,40,11
120305,4,11,3,0,8,3
120305,3,5,2,0,3,2
169427,10,145,42,5,103,37
169427,9,69,10,0,59,10
169427,8,30,4,0,26,4
169427,7,9,2,0,7,2
169427,6,1,1,0,0,1
169427,5,4,2,0,2,2
169427,4,2,1,0,1,1
169427,3,3,2,0,1,2
169427,1,10,5,0,5,5
2254,10,17,11,0,6,11
2254,9,22,6,0,16,6
2254,8,48,22,0,26,22
2254,7,58,24,0,34,24
2254,6,57,17,0,40,17
2254,5,39,15,0,24,15
2254,4,8,4,0,4,4
2254,3,8,4,0,4,4
2254,2,4,3,0,1,3
2254,1,2,2,0,0,2
30706,9,1,1,0,0,1
30706,8,30,9,0,21,9
30706,7,60,19,0,41,19
30706,6,77,21,0,56,21
30706,5,53,21,0,32,21
30706,4,27,11,0,16,11
30706,3,11,2,0,9,2
30706,1,1,1,0,0,1
119265,10,2,1,0,1,1
119265,9,2,2,0,0,2
119265,8,24,7,0,17,7
119265,7,62,12,0,50,12
119265,6,88,16,0,72,16
119265,5,49,7,0,42,7
119265,4,26,3,0,23,3
119265,3,6,2,0,4,2
119265,2,2,2,0,0,2
1607,9,5,1,0,4,1
1607,8,21,8,0,13,8
1607,7,25,8,0,17,8
1607,6,78,19,0,59,19
1607,5,70,16,0,54,16
1607,4,32,7,0,25,7
1607,3,20,8,0,12,8
1607,2,5,2,0,3,2
188076,10,30,9,0,21,9
188076,9,53,9,0,44,9
188076,8,103,16,0,87,16
188076,7,43,8,0,35,8
188076,6,23,3,0,20,3
188076,5,7,1,0,6,1
10453,10,5,3,0,2,3
10453,9,2,1,0,1,1
10453,8,8,3,0,5,3
10453,7,25,7,0,18,7
10453,6,47,14,0,33,14
10453,5,50,12,0,38,12
10453,4,73,21,0,52,21
10453,3,32,8,0,24,8
10453,2,16,6,0,10,6
10453,1,4,2,0,2,2
2773,9,5,1,0,4,1
2773,8,27,9,0,18,9
2773,7,51,15,0,36,15
2773,6,87,26,0,61,26
2773,5,48,13,0,35,13
2773,4,25,9,0,16,9
2773,3,13,5,0,8,5
2773,2,3,3,0,0,3
21463,9,2,1,0,1,1
21463,8,30,7,0,23,7
21463,7,62,18,0,44,18
21463,6,94,27,0,67,27
21463,5,50,13,0,37,13
21463,4,9,2,0,7,2
21463,3,8,2,0,6,2
21463,2,6,1,0,5,1
160432,9,8,2,0,6,2
160432,8,74,20,0,54,20
160432,7,84,18,0,66,18
160432,6,64,12,0,52,12
160432,5,20,5,0,15,5
160432,4,8,4,0,4,4
160432,3,2,2,0,0,2
5750,8,16,2,0,14,2
5750,7,21,2,0,19,2
5750,6,66,13,0,53,13
5750,5,75,21,0,54,21
5750,4,43,12,0,31,12
5750,3,19,8,0,11,8
5750,2,12,3,0,9,3
5750,1,5,1,0,4,1
6583,9,10,3,0,7,3
6583,8,16,3,0,13,3
6583,7,47,10,0,37,10
6583,6,96,24,0,72,24
6583,5,47,13,0,34,13
6583,4,23,10,0,13,10
6583,3,10,5,0,5,5
6583,2,9,6,0,3,6
6583,1,2,1,0,1,1
103368,10,8,1,0,7,1
103368,9,18,9,0,9,9
103368,8,66,17,0,49,17
103368,7,60,10,0,50,10
103368,6,71,32,0,39,32
103368,5,30,9,0,21,9
103368,4,5,2,0,3,2
103368,3,4,2,0,2,2
59223,10,2,1,0,1,1
59223,9,4,1,0,3,1
59223,8,31,11,0,20,11
59223,7,55,11,0,44,11
59223,6,100,17,0,83,17
59223,5,39,5,0,34,5
59223,4,19,3,0,16,3
59223,3,8,3,0,5,3
59223,2,2,1,0,1,1
196306,10,5,1,0,4,1
196306,9,22,3,0,19,3
196306,8,99,11,0,88,11
196306,7,75,5,0,70,5
196306,6,41,6,0,35,6
196306,5,13,1,0,12,1
2562,10,4,2,0,2,2
2562,8,27,13,0,14,13
2562,7,57,19,0,38,19
2562,6,77,18,0,59,18
2562,5,48,11,0,37,11
2562,4,22,6,0,16,6
2562,3,14,8,0,6,8
2562,2,5,2,0,3,2
2562,1,2,1,0,1,1
246150,10,6,2,0,4,2
246150,8,57,14,0,43,14
246150,7,93,13,0,80,13
246150,6,58,9,0,49,9
246150,5,22,9,0,13,9
246150,4,8,2,0,6,2
246150,2,4,1,0,3,1
62225,10,10,4,0,6,4
62225,9,32,13,0,19,13
62225,8,102,20,0,82,20
62225,7,74,17,0,57,17
62225,6,29,10,0,19,10
62225,4,2,1,0,1,1
62225,3,2,1,0,1,1
62225,2,2,2,0,0,2
13284,10,1,1,0,0,1
13284,9,4,2,0,2,2
13284,8,14,4,0,10,4
13284,7,33,9,0,24,9
13284,6,92,21,0,71,21
13284,5,53,15,0,38,15
13284,4,40,10,0,30,10
13284,3,15,2,0,13,2
13284,2,7,1,0,6,1
13284,1,2,1,0,1,1
184371,10,7,1,0,6,1
184371,9,13,2,0,11,2
184371,8,43,8,0,35,8
184371,7,71,8,0,63,8
184371,6,72,6,0,66,6
184371,5,31,1,0,30,1
184371,4,15,4,0,11,4
184371,2,2,1,0,1,1
10712,10,3,1,0,2,1
10712,8,10,3,0,7,3
10712,6,33,6,0,27,6
10712,5,58,14,0,44,14
10712,4,59,10,0,49,10
10712,3,46,14,0,32,14
10712,2,30,6,0,24,6
10712,1,8,3,0,5,3
128137,10,9,5,0,4,5
128137,9,10,3,0,7,3
128137,8,53,17,1,36,16
128137,7,66,14,0,52,14
128137,6,68,10,0,58,10
128137,5,27,10,0,17,10
128137,4,21,9,1,12,8
128137,3,3,1,0,2,1
136416,8,33,9,0,24,9
136416,7,61,14,0,47,14
136416,6,101,14,0,87,14
136416,5,37,9,0,28,9
136416,4,17,5,0,12,5
136416,2,2,1,0,1,1
12747,10,4,1,0,3,1
12747,8,18,1,0,17,1
12747,7,77,10,0,67,10
12747,6,110,6,0,104,6
12747,5,31,8,0,23,8
12747,4,11,2,0,9,2
12747,3,4,1,0,3,1
232830,10,13,4,0,9,4
232830,9,18,5,0,13,5
232830,8,69,12,0,57,12
232830,7,67,15,0,52,15
232830,6,66,7,0,59,7
232830,5,12,1,0,11,1
232830,4,11,2,0,9,2
192508,10,4,1,0,3,1
192508,9,13,4,0,9,4
192508,8,47,10,2,37,8
192508,7,62,10,1,52,9
192508,6,79,8,0,71,8
192508,5,31,7,0,24,7
192508,4,15,3,0,12,3
192508,3,6,1,0,5,1
192508,2,4,2,0,2,2
69601,10,38,9,0,29,9
69601,9,84,21,0,63,21
69601,8,88,23,0,65,23
69601,7,34,8,0,26,8
69601,6,14,3,0,11,3
69601,4,2,1,0,1,1
69601,3,2,1,0,1,1
39699,8,12,2,0,10,2
39699,7,59,15,0,44,15
39699,6,103,22,0,81,22
39699,5,45,11,0,34,11
39699,4,21,5,0,16,5
39699,3,12,3,0,9,3
39699,2,6,3,0,3,3
1467,10,3,1,0,2,1
1467,9,3,1,0,2,1
1467,8,12,7,0,5,7
1467,7,31,11,0,20,11
1467,6,74,25,0,49,25
1467,5,63,23,0,40,23
1467,4,37,16,0,21,16
1467,3,25,11,0,14,11
1467,2,9,6,0,3,6
1467,1,4,2,0,2,2
174,8,8,2,0,6,2
174,7,42,10,0,32,10
174,6,97,30,0,67,30
174,5,67,23,0,44,23
174,4,28,8,0,20,8
174,3,13,7,0,6,7
174,2,5,1,0,4,1
174,1,1,1,0,0,1
5071,10,15,3,0,12,3
5071,9,16,7,0,9,7
5071,8,46,14,0,32,14
5071,7,66,15,0,51,15
5071,6,75,20,0,55,20
5071,5,21,5,0,16,5
5071,4,13,2,0,11,2
5071,3,4,2,0,2,2
5071,1,3,1,0,2,1
1730,10,3,1,0,2,1
1730,9,3,1,0,2,1
1730,8,10,2,0,8,2
1730,7,18,5,0,13,5
1730,6,53,12,0,41,12
1730,5,61,11,0,50,11
1730,4,51,9,0,42,9
1730,3,36,8,0,28,8
1730,2,19,2,0,17,2
1730,1,6,1,0,5,1
24376,9,5,1,0,4,1
24376,7,23,1,0,22,1
24376,6,63,16,0,47,16
24376,5,59,15,0,44,15
24376,4,47,12,0,35,12
24376,3,28,9,0,19,9
24376,2,15,3,0,12,3
255653,10,31,13,0,18,13
255653,9,63,17,0,46,17
255653,8,86,21,0,65,21
255653,7,42,6,0,36,6
255653,6,28,6,0,22,6
255653,5,3,2,0,1,2
255653,4,4,1,0,3,1
255653,2,1,1,0,0,1
255653,1,2,1,0,1,1
57368,9,4,1,0,3,1
57368,8,27,6,0,21,6
57368,7,50,10,0,40,10
57368,6,85,16,0,69,16
57368,5,56,10,0,46,10
57368,4,17,4,0,13,4
57368,3,14,3,0,11,3
57368,2,3,1,0,2,1
175989,10,13,3,0,10,3
175989,9,15,2,1,13,1
175989,8,47,8,1,39,7
175989,7,70,13,1,57,12
175989,6,61,7,1,54,6
175989,5,23,4,1,19,3
175989,4,18,10,1,8,9
175989,3,8,5,0,3,5
175989,2,4,1,1,3,0
172358,9,6,3,0,3,3
172358,8,36,3,0,33,3
172358,7,50,8,0,42,8
172358,6,102,12,0,90,12
172358,5,43,9,0,34,9
172358,4,19,5,0,14,5
191071,9,18,2,0,16,2
191071,8,53,4,0,49,4
191071,7,72,7,0,65,7
191071,6,58,5,0,53,5
191071,5,27,4,0,23,4
191071,4,14,2,0,12,2
191071,3,6,2,0,4,2
191071,2,5,1,0,4,1
7086,9,14,6,0,8,6
7086,8,89,35,0,54,35
7086,7,95,34,0,61,34
7086,6,37,9,0,28,9
7086,5,11,6,0,5,6
7086,4,8,3,0,5,3
7086,3,3,2,0,1,2
63027,10,11,3,0,8,3
63027,9,24,6,0,18,6
63027,8,73,11,0,62,11
63027,7,72,20,0,52,20
63027,6,51,13,0,38,13
63027,5,14,2,0,12,2
63027,4,4,2,0,2,2
63027,3,7,3,0,4,3
63027,1,1,1,0,0,1
39862,10,8,4,0,4,4
39862,9,11,2,0,9,2
39862,8,50,15,1,35,14
39862,7,47,13,0,34,13
39862,6,68,12,0,56,12
39862,5,35,7,0,28,7
39862,4,18,5,0,13,5
39862,3,10,3,0,7,3
39862,2,10,3,0,7,3
39862,1,3,1,0,2,1
7718,8,26,11,0,15,11
7718,7,71,29,0,42,29
7718,6,107,34,0,73,34
7718,5,31,10,0,21,10
7718,4,21,5,0,16,5
7718,3,1,1,0,0,1
268,9,3,1,0,2,1
268,8,30,8,0,22,8
268,7,62,21,0,41,21
268,6,109,32,0,77,32
268,5,37,9,0,28,9
268,4,14,7,0,7,7
268,2,1,1,0,0,1
155081,9,6,4,0,2,4
155081,8,14,2,0,12,2
155081,7,29,3,0,26,3
155081,6,60,6,0,54,6
155081,5,58,8,0,50,8
155081,4,46,9,0,37,9
155081,3,26,4,1,22,3
155081,2,14,5,0,9,5
8487,10,3,1,0,2,1
8487,8,4,3,0,1,3
8487,7,9,3,0,6,3
8487,6,34,14,0,20,14
8487,5,59,22,0,37,22
8487,4,85,30,0,55,30
8487,3,34,6,0,28,6
8487,2,21,3,0,18,3
8487,1,9,4,0,5,4
67910,9,1,1,0,0,1
67910,8,21,3,0,18,3
67910,7,56,13,0,43,13
67910,6,101,22,0,79,22
67910,5,42,16,0,26,16
67910,4,25,10,0,15,10
67910,3,6,1,0,5,1
67910,2,6,5,0,1,5
40347,9,7,2,0,5,2
40347,8,14,2,0,12,2
40347,7,25,2,0,23,2
40347,6,66,7,0,59,7
40347,5,56,9,0,47,9
40347,4,44,9,0,35,9
40347,3,21,1,0,20,1
40347,2,14,6,0,8,6
40347,1,10,2,0,8,2
139032,10,3,1,0,2,1
139032,9,12,2,1,10,1
139032,8,38,8,1,30,7
139032,7,72,12,2,60,10
139032,6,69,12,2,57,10
139032,5,34,6,1,28,5
139032,4,16,5,0,11,5
139032,2,6,3,0,3,3
139032,1,3,1,0,2,1
13532,10,48,14,0,34,14
13532,9,63,14,0,49,14
13532,8,83,21,0,62,21
13532,7,33,10,0,23,10
13532,6,15,6,0,9,6
13532,5,4,1,0,3,1
13532,4,4,2,0,2,2
13532,3,4,1,0,3,1
13532,2,2,1,0,1,1
165404,9,16,4,0,12,4
165404,8,58,16,0,42,16
165404,7,63,14,0,49,14
165404,6,69,20,0,49,20
165404,5,22,5,0,17,5
165404,4,14,5,0,9,5
165404,3,3,2,0,1,2
165404,2,6,2,0,4,2
165186,10,25,13,0,12,13
165186,9,32,13,0,19,13
165186,8,80,23,0,57,23
165186,7,39,11,0,28,11
165186,6,29,8,0,21,8
165186,5,17,10,0,7,10
165186,4,8,4,0,4,4
165186,3,6,4,0,2,4
165186,2,7,5,0,2,5
165186,1,16,10,0,6,10
5757,8,11,5,0,6,5
5757,7,52,13,0,39,13
5757,6,97,29,0,68,29
5757,5,49,14,0,35,14
5757,4,26,7,0,19,7
5757,3,13,5,0,8,5
5757,2,8,3,0,5,3
5757,1,3,1,0,2,1
1571,9,1,1,0,0,1
1571,8,12,5,0,7,5
1571,7,45,10,0,35,10
1571,6,92,25,0,67,25
1571,5,61,21,0,40,21
1571,4,29,11,0,18,11
1571,3,10,4,0,6,4
1571,2,9,2,0,7,2
10431,10,34,17,0,17,17
10431,9,45,15,0,30,15
10431,8,71,14,0,57,14
10431,7,54,12,0,42,12
10431,6,26,11,0,15,11
10431,5,17,6,0,11,6
10431,4,5,3,0,2,3
10431,2,2,1,0,1,1
145393,10,3,1,0,2,1
145393,9,12,4,0,8,4
145393,8,63,16,0,47,16
145393,7,74,20,0,54,20
145393,6,72,13,0,59,13
145393,5,20,7,0,13,7
145393,4,13,6,0,7,6
55492,9,7,2,0,5,2
55492,8,31,10,0,21,10
55492,7,39,5,0,34,5
55492,6,64,18,0,46,18
55492,5,46,13,0,33,13
55492,4,33,10,0,23,10
55492,3,23,9,0,14,9
55492,2,10,5,0,5,5
55492,1,3,1,0,2,1
4210,10,18,2,0,16,2
4210,9,30,9,0,21,9
4210,8,85,15,0,70,15
4210,7,74,22,0,52,22
4210,6,42,9,0,33,9
4210,5,7,3,0,4,3
4210,4,3,1,0,2,1
133637,9,2,1,0,1,1
133637,8,11,4,0,7,4
133637,7,45,13,0,32,13
133637,6,101,24,0,77,24
133637,5,55,6,0,49,6
133637,4,30,5,0,25,5
133637,1,2,1,0,1,1
118339,10,2,1,0,1,1
118339,9,2,1,0,1,1
118339,8,18,4,0,14,4
118339,7,30,5,0,25,5
118339,6,78,23,0,55,23
118339,5,52,12,0,40,12
118339,4,36,13,0,23,13
118339,3,25,8,0,17,8
118339,2,12,2,0,10,2
4453,10,25,15,0,10,15
4453,9,19,7,0,12,7
4453,8,52,13,0,39,13
4453,7,67,28,0,39,28
4453,6,57,13,0,44,13
4453,5,21,6,0,15,6
4453,4,10,1,0,9,1
4453,3,4,1,0,3,1
4453,2,2,1,0,1,1
6368,7,34,7,0,27,7
6368,6,72,10,0,62,10
6368,5,59,7,0,52,7
6368,4,50,8,0,42,8
6368,3,15,7,0,8,7
6368,2,12,5,0,7,5
6368,1,3,1,0,2,1
209166,9,11,3,0,8,3
209166,8,46,4,0,42,4
209166,7,79,9,0,70,9
209166,6,76,12,0,64,12
209166,5,25,4,0,21,4
209166,4,13,4,0,9,4
209166,3,7,3,0,4,3
209166,2,1,1,0,0,1
34747,10,2,2,0,0,2
34747,9,6,2,0,4,2
34747,8,64,26,0,38,26
34747,7,81,34,0,47,34
34747,6,72,30,0,42,30
34747,5,17,6,0,11,6
34747,4,12,5,0,7,5
34747,3,3,1,0,2,1
34747,2,1,1,0,0,1
201046,10,16,3,1,13,2
201046,9,17,5,0,12,5
201046,8,45,12,2,33,10
201046,7,48,9,2,39,7
201046,6,67,16,0,51,16
201046,5,32,4,1,28,3
201046,4,14,3,0,11,3
201046,3,12,1,1,11,0
201046,1,5,2,0,3,2
80933,8,56,14,0,42,14
80933,7,47,4,0,43,4
80933,6,78,14,0,64,14
80933,5,26,2,0,24,2
80933,4,16,3,0,13,3
80933,3,8,2,0,6,2
80933,2,9,5,0,4,5
9386,10,5,1,0,4,1
9386,9,7,2,0,5,2
9386,8,39,14,0,25,14
9386,7,74,30,0,44,30
9386,6,82,23,0,59,23
9386,5,29,15,0,14,15
9386,4,16,7,0,9,7
9386,3,5,4,0,1,4
3602,10,3,2,0,1,2
3602,9,3,1,0,2,1
3602,8,8,7,0,1,7
3602,7,24,11,0,13,11
3602,6,43,18,0,25,18
3602,5,55,21,0,34,21
3602,4,43,15,0,28,15
3602,3,44,19,0,25,19
3602,2,21,10,0,11,10
3602,1,14,3,0,11,3
260332,10,17,2,0,15,2
260332,9,25,3,0,22,3
260332,8,79,12,0,67,12
260332,7,80,19,0,61,19
260332,6,47,4,0,43,4
260332,5,6,1,0,5,1
260332,4,4,1,0,3,1
261,9,2,1,0,1,1
261,8,23,9,0,14,9
261,7,59,14,0,45,14
261,6,106,27,0,79,27
261,5,47,14,0,33,14
261,4,14,6,0,8,6
261,3,7,3,0,4,3
154476,9,2,1,0,1,1
154476,8,18,6,0,12,6
154476,7,28,8,0,20,8
154476,6,97,15,0,82,15
154476,5,64,17,0,47,17
154476,4,33,5,0,28,5
154476,3,10,3,0,7,3
154476,2,6,1,0,5,1
193693,9,8,3,0,5,3
193693,8,64,20,0,44,20
193693,7,86,14,0,72,14
193693,6,71,19,0,52,19
193693,5,18,6,0,12,6
193693,3,4,2,0,2,2
193693,1,2,2,0,0,2
5251,10,16,8,0,8,8
5251,9,19,10,0,9,10
5251,8,34,22,0,12,22
5251,7,68,26,0,42,26
5251,6,72,30,0,42,30
5251,5,34,12,0,22,12
5251,4,12,5,0,7,5
5251,3,1,1,0,0,1
37988,8,18,7,0,11,7
37988,7,46,6,0,40,6
37988,6,69,12,0,57,12
37988,5,53,11,0,42,11
37988,4,29,5,0,24,5
37988,3,23,11,0,12,11
37988,2,10,3,0,7,3
37988,1,2,1,0,1,1
156108,10,7,3,0,4,3
156108,9,6,2,0,4,2
156108,8,37,2,0,35,2
156108,7,46,5,0,41,5
156108,6,81,14,0,67,14
156108,5,49,7,0,42,7
156108,4,20,6,0,14,6
156108,3,9,2,0,7,2
156108,2,2,1,0,1,1
414,9,2,1,0,1,1
414,8,17,7,0,10,7
414,7,36,9,0,27,9
414,6,74,18,0,56,18
414,5,32,9,0,23,9
414,4,15,3,0,12,3
414,3,3,2,0,1,2
414,2,3,1,0,2,1
160396,9,5,3,0,2,3
160396,8,30,5,0,25,5
160396,7,66,12,1,54,11
160396,6,72,20,0,52,20
160396,5,37,8,1,29,7
160396,4,26,11,0,15,11
160396,3,11,3,0,8,3
160396,2,8,1,0,7,1
225482,10,7,3,0,4,3
225482,9,17,4,0,13,4
225482,8,71,22,0,49,22
225482,7,89,21,0,68,21
225482,6,46,7,0,39,7
225482,5,18,5,0,13,5
225482,3,1,1,0,0,1
126242,10,4,1,0,3,1
126242,9,17,4,0,13,4
126242,8,60,16,0,44,16
126242,7,65,21,0,44,21
126242,6,64,9,0,55,9
126242,5,26,3,0,23,3
126242,4,11,5,0,6,5
126242,3,10,2,0,8,2
142558,10,9,2,0,7,2
142558,9,18,2,0,16,2
142558,8,38,4,0,34,4
142558,7,73,11,0,62,11
142558,6,79,12,0,67,12
142558,5,28,5,0,23,5
142558,4,7,1,0,6,1
142558,3,3,2,0,1,2
129382,8,48,14,0,34,14
129382,7,86,12,0,74,12
129382,6,85,18,0,67,18
129382,5,20,4,0,16,4
129382,4,9,5,0,4,5
129382,2,1,1,0,0,1
3408,10,11,4,0,7,4
3408,9,41,17,0,24,17
3408,8,92,33,0,59,33
3408,7,68,21,0,47,21
3408,6,31,13,0,18,13
3408,5,9,3,0,6,3
3408,4,4,4,0,0,4
24082,10,1,1,0,0,1
24082,9,2,1,0,1,1
24082,8,23,9,0,14,9
24082,7,64,22,0,42,22
24082,6,109,43,0,66,43
24082,5,33,10,0,23,10
24082,4,18,7,0,11,7
24082,3,4,3,0,1,3
24082,2,4,2,0,2,2
216381,10,21,5,0,16,5
216381,9,49,15,2,34,13
216381,8,89,15,0,74,15
216381,7,58,13,2,45,11
216381,6,19,7,1,12,6
216381,5,10,3,0,7,3
216381,4,8,2,1,6,1
216381,2,1,1,0,0,1
216381,1,3,2,0,1,2
2524,10,9,4,0,5,4
2524,9,13,5,0,8,5
2524,8,38,12,0,26,12
2524,7,49,17,0,32,17
2524,6,68,24,0,44,24
2524,5,42,13,0,29,13
2524,4,20,8,0,12,8
2524,3,11,6,0,5,6
2524,2,6,3,0,3,3
2524,1,1,1,0,0,1
110160,10,2,1,0,1,1
110160,8,7,2,0,5,2
110160,7,56,13,0,43,13
110160,6,91,24,0,67,24
110160,5,47,14,0,33,14
110160,4,32,11,0,21,11
110160,3,12,6,0,6,6
110160,2,7,5,0,2,5
27802,8,49,10,0,39,10
27802,7,74,19,0,55,19
27802,6,71,12,0,59,12
27802,5,29,4,0,25,4
27802,4,19,7,0,12,7
27802,2,3,1,0,2,1
187787,10,2,1,0,1,1
187787,9,2,1,0,1,1
187787,8,18,2,0,16,2
187787,7,43,2,0,41,2
187787,6,80,12,0,68,12
187787,5,57,15,2,42,13
187787,4,32,9,1,23,8
187787,3,11,5,0,6,5
187787,2,9,2,0,7,2
40370,8,42,13,0,29,13
40370,7,74,12,0,62,12
40370,6,92,20,0,72,20
40370,5,22,5,0,17,5
40370,4,15,4,0,11,4
40370,3,6,1,0,5,1
40370,2,1,1,0,0,1
204493,10,35,7,0,28,7
204493,9,43,11,0,32,11
204493,8,83,16,0,67,16
204493,7,52,9,0,43,9
204493,6,28,6,0,22,6
204493,5,7,1,0,6,1
204493,4,6,1,0,5,1
247360,10,13,4,0,9,4
247360,9,15,4,0,11,4
247360,8,62,12,0,50,12
247360,7,99,24,0,75,24
247360,6,52,11,0,41,11
247360,5,13,3,0,10,3
247360,3,1,1,0,0,1
17705,10,3,3,0,0,3
17705,9,6,4,0,2,4
17705,8,36,13,0,23,13
17705,7,51,22,0,29,22
17705,6,78,17,0,61,17
17705,5,39,8,0,31,8
17705,4,29,10,0,19,10
17705,3,10,5,0,5,5
17705,2,4,2,0,2,2
129945,10,4,2,0,2,2
129945,9,10,6,0,4,6
129945,8,58,20,0,38,20
129945,7,76,19,0,57,19
129945,6,79,27,0,52,27
129945,5,13,3,0,10,3
129945,2,2,1,0,1,1
129945,1,2,1,0,1,1
67038,8,19,6,0,13,6
67038,7,49,11,0,38,11
67038,6,86,16,0,70,16
67038,5,59,12,0,47,12
67038,4,28,6,0,22,6
67038,3,8,3,0,5,3
76810,10,3,1,0,2,1
76810,9,7,1,0,6,1
76810,8,25,9,0,16,9
76810,7,68,18,0,50,18
76810,6,94,25,0,69,25
76810,5,35,8,0,27,8
76810,4,13,4,0,9,4
76810,3,7,4,0,3,4
76810,1,2,1,0,1,1
772,10,1,1,0,0,1
772,9,2,1,0,1,1
772,8,21,5,0,16,5
772,7,63,11,0,52,11
772,6,106,25,0,81,25
772,5,42,14,0,28,14
772,4,13,6,0,7,6
772,3,4,1,0,3,1
772,2,2,1,0,1,1
772,1,1,1,0,0,1
58601,10,41,10,0,31,10
58601,9,59,9,0,50,9
58601,8,102,18,0,84,18
58601,7,41,10,0,31,10
58601,6,9,3,0,6,3
58601,4,1,1,0,0,1
161108,10,40,16,0,24,16
161108,9,52,22,1,30,21
161108,8,64,16,0,48,16
161108,7,57,14,0,43,14
161108,6,20,6,0,14,6
161108,5,10,3,0,7,3
161108,4,6,1,0,5,1
161108,3,3,1,0,2,1
14102,10,3,1,0,2,1
14102,9,3,1,0,2,1
14102,8,12,4,0,8,4
14102,7,36,12,0,24,12
14102,6,88,29,0,59,29
14102,5,72,32,0,40,32
14102,4,22,10,0,12,10
14102,3,10,5,0,5,5
14102,2,7,4,0,3,4
14102,1,2,1,0,1,1
27837,8,14,3,0,11,3
27837,7,33,5,0,28,5
27837,6,72,14,0,58,14
27837,5,64,6,0,58,6
27837,4,35,7,0,28,7
27837,3,24,4,0,20,4
27837,2,12,4,0,8,4
57998,10,28,5,0,23,5
57998,9,38,3,0,35,3
57998,8,83,11,0,72,11
57998,7,63,6,0,57,6
57998,6,30,6,0,24,6
57998,5,8,4,0,4,4
164448,10,7,3,0,4,3
164448,9,14,6,0,8,6
164448,8,54,16,3,38,13
164448,7,66,13,0,53,13
164448,6,48,10,1,38,9
164448,5,28,6,1,22,5
164448,4,10,2,0,8,2
164448,3,12,3,0,9,3
164448,2,10,3,1,7,2
164448,1,6,2,0,4,2
68188,10,19,10,0,9,10
68188,9,20,10,0,10,10
68188,8,54,24,0,30,24
68188,7,51,14,0,37,14
68188,6,75,26,0,49,26
68188,5,17,3,0,14,3
68188,4,13,7,0,6,7
68188,3,4,3,0,1,3
68188,2,2,1,0,1,1
111081,10,9,3,0,6,3
111081,9,19,4,0,15,4
111081,8,68,15,0,53,15
111081,7,83,11,0,72,11
111081,6,52,10,0,42,10
111081,5,20,7,0,13,7
82702,10,3,1,0,2,1
82702,8,31,9,0,22,9
82702,7,46,10,0,36,10
82702,6,92,27,0,65,27
82702,5,37,9,0,28,9
82702,4,21,9,0,12,9
82702,3,10,4,0,6,4
82702,2,10,5,0,5,5
82702,1,1,1,0,0,1
470,10,6,1,0,5,1
470,9,13,5,0,8,5
470,8,37,15,0,22,15
470,7,52,16,0,36,16
470,6,72,17,0,55,17
470,5,30,7,0,23,7
470,4,23,11,0,12,11
470,3,13,7,0,6,7
470,2,7,4,0,3,4
1965,9,10,5,0,5,5
1965,8,42,16,0,26,16
1965,7,66,23,0,43,23
1965,6,85,21,0,64,21
1965,5,33,10,0,23,10
1965,4,12,3,0,9,3
1965,3,4,2,0,2,2
1965,1,1,1,0,0,1
184842,10,2,1,0,1,1
184842,9,8,3,0,5,3
184842,8,36,6,0,30,6
184842,7,81,12,0,69,12
184842,6,86,9,0,77,9
184842,5,31,3,0,28,3
184842,4,6,1,0,5,1
184842,3,3,1,0,2,1
3466,10,11,3,0,8,3
3466,9,11,5,0,6,5
3466,8,35,12,0,23,12
3466,7,52,18,0,34,18
3466,6,64,17,0,47,17
3466,5,50,13,0,37,13
3466,4,21,4,0,17,4
3466,3,5,2,0,3,2
3466,2,3,1,0,2,1
3138,9,4,4,0,0,4
3138,8,23,8,0,15,8
3138,7,56,26,0,30,26
3138,6,87,33,0,54,33
3138,5,41,13,0,28,13
3138,4,25,5,0,20,5
3138,3,10,2,0,8,2
3138,2,5,2,0,3,2
3138,1,2,1,0,1,1
129010,10,6,3,0,3,3
129010,9,6,2,0,4,2
129010,8,45,13,2,32,11
129010,7,69,12,3,57,9
129010,6,76,12,2,64,10
129010,5,34,10,2,24,8
129010,4,11,2,0,9,2
129010,3,3,1,0,2,1
129010,2,4,1,0,3,1
3427,9,4,1,0,3,1
3427,8,9,3,0,6,3
3427,7,37,14,0,23,14
3427,6,75,29,0,46,29
3427,5,73,26,0,47,26
3427,4,35,11,0,24,11
3427,3,16,7,0,9,7
3427,2,4,1,0,3,1
228766,10,14,3,0,11,3
228766,9,24,6,0,18,6
228766,8,64,10,0,54,10
228766,7,75,21,0,54,21
228766,6,45,13,1,32,12
228766,5,25,7,0,18,7
6749,10,9,2,0,7,2
6749,9,4,2,0,2,2
6749,8,10,4,0,6,4
6749,7,19,8,0,11,8
6749,6,55,16,0,39,16
6749,5,48,11,0,37,11
6749,4,43,18,0,25,18
6749,3,21,15,0,6,15
6749,2,23,10,0,13,10
6749,1,22,5,0,17,5
2884,9,3,1,0,2,1
2884,8,31,14,0,17,14
2884,7,61,12,0,49,12
2884,6,101,32,0,69,32
2884,5,27,7,0,20,7
2884,4,23,11,0,12,11
2884,2,1,1,0,0,1
29411,10,1,1,0,0,1
29411,9,6,3,0,3,3
29411,8,37,10,0,27,10
29411,7,74,26,0,48,26
29411,6,100,27,0,73,27
29411,5,23,3,0,20,3
29411,4,7,2,0,5,2
29411,3,4,2,0,2,2
29411,2,2,1,0,1,1
4330,10,5,2,0,3,2
4330,9,8,4,0,4,4
4330,8,33,16,0,17,16
4330,7,63,23,0,40,23
4330,6,80,23,0,57,23
4330,5,31,7,0,24,7
4330,4,20,11,0,9,11
4330,3,9,6,0,3,6
4330,2,5,1,0,4,1
191612,10,62,27,0,35,27
191612,9,85,22,0,63,22
191612,8,66,13,0,53,13
191612,7,21,3,0,18,3
191612,6,12,5,0,7,5
191612,5,4,1,0,3,1
191612,4,3,1,0,2,1
147716,10,12,3,0,9,3
147716,9,24,2,0,22,2
147716,8,84,12,0,72,12
147716,7,56,5,0,51,5
147716,6,53,7,0,46,7
147716,5,14,2,0,12,2
147716,4,10,1,0,9,1
147716,1,2,1,0,1,1
4323,10,2,1,0,1,1
4323,9,6,2,0,4,2
4323,8,26,9,0,17,9
4323,7,53,22,0,31,22
4323,6,91,38,0,53,38
4323,5,42,16,0,26,16
4323,4,13,9,0,4,9
4323,3,16,7,0,9,7
1826,10,2,1,0,1,1
1826,9,1,1,0,0,1
1826,8,7,3,0,4,3
1826,7,25,6,0,19,6
1826,6,71,24,0,47,24
1826,5,56,13,0,43,13
1826,4,55,18,0,37,18
1826,3,21,10,0,11,10
1826,2,10,5,0,5,5
1826,1,5,1,0,4,1
199242,10,12,4,0,8,4
199242,9,16,5,0,11,5
199242,8,88,22,0,66,22
199242,7,72,22,0,50,22
199242,6,50,17,0,33,17
199242,5,10,7,0,3,7
199242,4,4,2,0,2,2
65134,8,13,3,0,10,3
65134,7,31,5,0,26,5
65134,6,85,16,0,69,16
65134,5,64,15,0,49,15
65134,4,37,9,0,28,9
65134,3,14,2,0,12,2
65134,2,5,3,0,2,3
799,10,6,1,0,5,1
799,9,9,5,0,4,5
799,8,45,15,0,30,15
799,7,66,19,0,47,19
799,6,69,20,0,49,20
799,5,26,10,0,16,10
799,4,21,8,0,13,8
799,3,7,4,0,3,4
799,2,2,1,0,1,1
799,1,2,1,0,1,1
9556,9,12,8,0,4,8
9556,8,37,13,0,24,13
9556,7,55,16,0,39,16
9556,6,78,23,0,55,23
9556,5,36,12,0,24,12
9556,4,21,10,0,11,10
9556,3,5,3,0,2,3
9556,2,2,1,0,1,1
191038,10,4,3,0,1,3
191038,9,8,3,0,5,3
191038,8,43,9,0,34,9
191038,7,65,6,0,59,6
191038,6,74,11,0,63,11
191038,5,31,8,0,23,8
191038,4,12,4,0,8,4
191038,3,11,4,0,7,4
191038,1,3,1,0,2,1
193213,10,7,2,0,5,2
193213,9,12,1,0,11,1
193213,8,43,7,0,36,7
193213,7,69,12,0,57,12
193213,6,74,8,0,66,8
193213,5,24,6,0,18,6
193213,4,14,4,0,10,4
193213,3,9,2,0,7,2
311,10,3,1,0,2,1
311,9,18,7,0,11,7
311,8,48,17,0,31,17
311,7,81,20,0,61,20
311,6,63,18,0,45,18
311,5,24,4,0,20,4
311,4,10,3,0,7,3
311,2,3,2,0,1,2
162367,10,3,2,0,1,2
162367,9,4,2,0,2,2
162367,8,26,3,0,23,3
162367,7,60,8,0,52,8
162367,6,102,19,0,83,19
162367,5,29,6,0,23,6
162367,4,13,2,0,11,2
162367,3,9,4,0,5,4
162367,2,5,1,0,4,1
173486,10,7,1,0,6,1
173486,9,25,4,0,21,4
173486,8,61,14,0,47,14
173486,7,72,15,0,57,15
173486,6,47,15,0,32,15
173486,5,24,8,0,16,8
173486,4,7,5,0,2,5
173486,3,1,1,0,0,1
173486,2,6,3,0,3,3
18297,9,4,1,0,3,1
18297,8,26,11,0,15,11
18297,7,56,18,0,38,18
18297,6,106,30,0,76,30
18297,5,33,8,0,25,8
18297,4,19,13,0,6,13
18297,3,5,3,0,2,3
164031,10,11,1,0,10,1
164031,9,21,2,0,19,2
164031,8,55,8,0,47,8
164031,7,58,10,0,48,10
164031,6,59,8,0,51,8
164031,5,30,1,0,29,1
164031,4,7,2,0,5,2
164031,2,6,1,0,5,1
164031,1,2,2,0,0,2
38707,10,9,2,0,7,2
38707,9,15,4,0,11,4
38707,8,49,12,0,37,12
38707,7,50,6,0,44,6
38707,6,58,18,0,40,18
38707,5,29,4,0,25,4
38707,4,19,7,0,12,7
38707,3,15,6,0,9,6
38707,2,7,2,0,5,2
38707,1,2,2,0,0,2
232895,9,3,1,0,2,1
232895,8,7,1,0,6,1
232895,7,15,6,0,9,6
232895,6,36,6,0,30,6
232895,5,22,6,0,16,6
232895,4,41,14,0,27,14
232895,3,38,8,0,30,8
232895,2,46,15,0,31,15
232895,1,43,22,0,21,22
181265,10,18,9,0,9,9
181265,9,29,12,1,17,11
181265,8,65,18,2,47,16
181265,7,66,11,2,55,9
181265,6,38,7,1,31,6
181265,5,17,3,0,14,3
181265,4,13,5,1,8,4
11269,10,12,4,0,8,4
11269,9,31,8,0,23,8
11269,8,101,28,0,73,28
11269,7,63,20,0,43,20
11269,6,30,7,0,23,7
11269,5,7,4,0,3,4
11269,4,6,3,0,3,3
11269,3,2,1,0,1,1
3279,10,30,13,0,17,13
3279,9,22,10,0,12,10
3279,8,48,11,0,37,11
3279,7,54,16,0,38,16
3279,6,57,19,0,38,19
3279,5,21,5,0,16,5
3279,4,12,3,0,9,3
32226,9,6,2,0,4,2
32226,8,28,8,0,20,8
32226,7,53,14,0,39,14
32226,6,92,24,0,68,24
32226,5,41,12,0,29,12
32226,4,22,7,0,15,7
32226,3,7,2,0,5,2
32226,2,2,1,0,1,1
28705,10,2,1,0,1,1
28705,9,9,4,0,5,4
28705,8,40,14,0,26,14
28705,7,61,23,0,38,23
28705,6,74,21,0,53,21
28705,5,29,15,0,14,15
28705,4,23,11,0,12,11
28705,3,9,5,0,4,5
28705,2,3,2,0,1,2
250780,10,13,1,0,12,1
250780,9,14,1,0,13,1
250780,8,71,8,0,63,8
250780,7,88,5,0,83,5
250780,6,49,5,0,44,5
250780,4,6,1,0,5,1
249821,9,15,5,0,10,5
249821,8,88,10,0,78,10
249821,7,73,9,0,64,9
249821,6,40,6,0,34,6
249821,5,16,2,0,14,2
249821,4,7,6,0,1,6
249821,2,1,1,0,0,1
6979,9,4,1,0,3,1
6979,8,12,5,0,7,5
6979,7,51,23,0,28,23
6979,6,104,29,0,75,29
6979,5,41,9,0,32,9
6979,4,24,9,0,15,9
6979,3,12,5,0,7,5
85000,10,18,9,0,9,9
85000,9,26,10,0,16,10
85000,8,86,25,0,61,25
85000,7,56,24,0,32,24
85000,6,46,14,0,32,14
85000,5,10,4,0,6,4
85000,4,8,3,0,5,3
4123,8,18,8,0,10,8
4123,7,35,10,0,25,10
4123,6,93,27,0,66,27
4123,5,41,11,0,30,11
4123,4,34,12,0,22,12
4123,3,17,6,0,11,6
4123,2,5,5,0,0,5
3534,10,15,2,0,13,2
3534,9,37,9,0,28,9
3534,8,54,19,0,35,19
3534,7,56,10,0,46,10
3534,6,56,11,0,45,11
3534,5,20,2,0,18,2
3534,4,7,2,0,5,2
3534,3,2,1,0,1,1
3534,2,2,1,0,1,1
3534,1,2,1,0,1,1
35400,10,13,6,0,7,6
35400,9,25,8,0,17,8
35400,8,100,35,0,65,35
35400,7,59,20,0,39,20
35400,6,33,14,0,19,14
35400,5,11,7,0,4,7
35400,4,6,3,0,3,3
35400,3,3,2,0,1,2
35400,1,1,1,0,0,1
57073,10,21,12,1,9,11
57073,9,30,16,0,14,16
57073,8,72,20,0,52,20
57073,7,64,21,0,43,21
57073,6,36,15,0,21,15
57073,5,19,6,0,13,6
57073,4,7,3,0,4,3
205127,10,9,5,0,4,5
205127,9,30,3,0,27,3
205127,8,106,16,0,90,16
205127,7,57,8,0,49,8
205127,6,30,5,0,25,5
205127,5,13,3,0,10,3
205127,4,2,1,0,1,1
205127,2,2,1,0,1,1
205127,1,3,1,0,2,1
243358,10,14,5,1,9,4
243358,9,22,9,0,13,9
243358,8,90,20,1,70,19
243358,7,77,12,0,65,12
243358,6,34,7,0,27,7
243358,4,4,2,0,2,2
243358,3,3,2,0,1,2
194062,10,13,5,0,8,5
194062,9,23,7,2,16,5
194062,8,63,12,0,51,12
194062,7,67,8,1,59,7
194062,6,45,12,0,33,12
194062,5,21,5,1,16,4
194062,4,16,6,0,10,6
2235,9,5,1,0,4,1
2235,8,17,6,0,11,6
2235,7,48,17,0,31,17
2235,6,97,31,0,66,31
2235,5,51,21,0,30,21
2235,4,17,8,0,9,8
2235,3,7,4,0,3,4
2235,2,6,2,0,4,2
2235,1,3,2,0,1,2
63743,9,8,3,0,5,3
63743,8,38,19,0,19,19
63743,7,74,24,0,50,24
63743,6,71,20,0,51,20
63743,5,28,7,0,21,7
63743,4,12,3,0,9,3
63743,3,11,5,0,6,5
63743,2,4,2,0,2,2
63743,1,1,1,0,0,1
449,10,5,2,0,3,2
449,9,4,2,0,2,2
449,8,29,11,0,18,11
449,7,58,23,0,35,23
449,6,92,37,0,55,37
449,5,33,14,0,19,14
449,4,18,8,0,10,8
449,3,8,4,0,4,4
449,2,1,1,0,0,1
449,1,3,2,0,1,2
1958,10,1,1,0,0,1
1958,8,17,6,0,11,6
1958,7,33,11,0,22,11
1958,6,80,17,0,63,17
1958,5,43,8,0,35,8
1958,4,34,11,0,23,11
1958,3,23,8,0,15,8
1958,2,11,8,0,3,8
1958,1,8,3,0,5,3
242343,10,9,2,0,7,2
242343,9,21,8,1,13,7
242343,8,64,9,0,55,9
242343,7,62,7,0,55,7
242343,6,61,6,1,55,5
242343,5,24,4,0,20,4
2146,10,1,1,0,0,1
2146,9,4,4,0,0,4
2146,8,24,7,0,17,7
2146,7,49,12,0,37,12
2146,6,75,22,0,53,22
2146,5,58,18,0,40,18
2146,4,24,6,0,18,6
2146,3,6,1,0,5,1
2146,2,9,6,0,3,6
98122,9,9,4,0,5,4
98122,8,29,6,0,23,6
98122,7,62,14,0,48,14
98122,6,96,20,0,76,20
98122,5,30,3,0,27,3
98122,4,14,4,0,10,4
91050,10,4,3,0,1,3
91050,8,37,14,0,23,14
91050,7,58,15,0,43,15
91050,6,87,23,1,64,22
91050,5,32,12,1,20,11
91050,4,17,7,0,10,7
91050,3,8,3,1,5,2
91050,2,2,1,0,1,1
91050,1,2,2,0,0,2
11760,9,3,1,0,2,1
11760,8,17,4,0,13,4
11760,7,37,11,0,26,11
11760,6,86,29,0,57,29
11760,5,57,17,0,40,17
11760,4,34,15,0,19,15
11760,3,10,1,0,9,1
11760,2,5,2,0,3,2
158973,10,23,12,0,11,12
158973,9,20,4,0,16,4
158973,8,58,11,0,47,11
158973,7,59,14,1,45,13
158973,6,53,14,2,39,12
158973,5,16,8,1,8,7
158973,4,10,5,0,5,5
158973,3,8,2,1,6,1
158973,2,4,3,1,1,2
104,10,6,1,0,5,1
104,9,21,9,0,12,9
104,8,76,31,0,45,31
104,7,64,25,0,39,25
104,6,55,17,0,38,17
104,5,18,6,0,12,6
104,4,9,1,0,8,1
5332,10,8,4,0,4,4
5332,9,9,5,0,4,5
5332,8,18,6,0,12,6
5332,7,50,15,0,35,15
5332,6,87,27,0,60,27
5332,5,52,18,0,34,18
5332,4,19,6,0,13,6
5332,3,7,2,0,5,2
161537,10,2,1,0,1,1
161537,9,4,2,0,2,2
161537,8,38,11,0,27,11
161537,7,71,17,0,54,17
161537,6,73,11,0,62,11
161537,5,35,12,0,23,12
161537,4,21,7,0,14,7
161537,2,4,2,0,2,2
10815,10,5,2,0,3,2
10815,9,8,3,0,5,3
10815,8,22,5,0,17,5
10815,7,21,8,0,13,8
10815,6,47,16,0,31,16
10815,5,34,12,0,22,12
10815,4,40,14,0,26,14
10815,3,27,10,0,17,10
10815,2,29,12,0,17,12
10815,1,17,6,0,11,6
158168,10,9,6,0,3,6
158168,9,9,2,0,7,2
158168,8,70,16,0,54,16
158168,7,68,11,0,57,11
158168,6,63,7,0,56,7
158168,5,17,2,0,15,2
158168,4,9,2,0,7,2
158168,3,3,1,0,2,1
158168,2,1,1,0,0,1
158168,1,1,1,0,0,1
107148,10,23,5,0,18,5
107148,9,28,5,0,23,5
107148,8,78,7,0,71,7
107148,7,60,6,0,54,6
107148,6,36,5,0,31,5
107148,5,16,3,0,13,3
107148,1,2,1,0,1,1
495,8,18,7,0,11,7
495,7,36,14,0,22,14
495,6,85,15,0,70,15
495,5,61,19,0,42,19
495,4,28,12,0,16,12
495,3,12,2,0,10,2
495,2,7,3,0,4,3
239951,10,13,3,0,10,3
239951,9,12,5,0,7,5
239951,8,35,2,0,33,2
239951,7,55,5,0,50,5
239951,6,72,4,0,68,4
239951,5,33,5,0,28,5
239951,4,16,3,0,13,3
239951,3,8,3,0,5,3
239951,2,4,1,0,3,1
239951,1,2,1,0,1,1
1970,9,5,2,0,3,2
1970,8,17,5,0,12,5
1970,7,46,13,0,33,13
1970,6,89,36,0,53,36
1970,5,52,19,0,33,19
1970,4,29,10,0,19,10
1970,2,3,3,0,0,3
24002,10,6,3,0,3,3
24002,9,8,4,0,4,4
24002,8,20,7,0,13,7
24002,7,37,15,0,22,15
24002,6,76,28,0,48,28
24002,5,46,18,0,28,18
24002,4,29,13,0,16,13
24002,3,17,5,0,12,5
24002,2,9,6,0,3,6
147363,9,20,5,0,15,5
147363,8,63,10,0,53,10
147363,7,59,10,0,49,10
147363,6,59,8,0,51,8
147363,5,15,2,0,13,2
147363,4,10,1,0,9,1
147363,2,4,2,0,2,2
244505,9,20,5,0,15,5
244505,8,54,10,0,44,10
244505,7,74,14,0,60,14
244505,6,64,9,0,55,9
244505,5,15,5,0,10,5
244505,4,9,2,0,7,2
10715,7,15,4,0,11,4
10715,6,24,7,0,17,7
10715,5,52,11,0,41,11
10715,4,43,3,0,40,3
10715,3,44,10,0,34,10
10715,2,40,18,0,22,18
10715,1,25,10,0,15,10
18121,10,6,1,0,5,1
18121,9,12,2,0,10,2
18121,8,36,9,0,27,9
18121,7,59,19,0,40,19
18121,6,67,29,0,38,29
18121,5,32,12,0,20,12
18121,4,28,13,0,15,13
18121,3,9,4,0,5,4
223740,10,18,6,2,12,4
223740,9,32,14,2,18,12
223740,8,82,15,2,67,13
223740,7,46,10,0,36,10
223740,6,37,3,0,34,3
223740,5,12,3,0,9,3
223740,4,13,5,0,8,5
223740,3,6,2,1,4,1
223740,1,2,1,0,1,1
4328,9,4,2,0,2,2
4328,8,18,4,0,14,4
4328,7,47,18,0,29,18
4328,6,106,28,0,78,28
4328,5,41,8,0,33,8
4328,4,18,7,0,11,7
4328,3,12,3,0,9,3
7092,10,13,7,0,6,7
7092,9,35,22,0,13,22
7092,8,74,33,0,41,33
7092,7,66,19,0,47,19
7092,6,42,6,0,36,6
7092,5,14,4,0,10,4
7092,4,5,1,0,4,1
193486,10,4,1,0,3,1
193486,9,26,13,1,13,12
193486,8,102,32,4,70,28
193486,7,61,16,1,45,15
193486,6,41,9,1,32,8
193486,5,11,3,0,8,3
193486,4,2,1,0,1,1
193486,3,2,1,1,1,0
2579,10,18,4,0,14,4
2579,9,24,4,0,20,4
2579,8,76,19,0,57,19
2579,7,71,11,0,60,11
2579,6,43,6,0,37,6
2579,5,6,1,0,5,1
2579,4,5,2,0,3,2
2579,2,2,2,0,0,2
2579,1,2,1,0,1,1
169141,10,92,51,4,41,47
169141,9,63,22,1,41,21
169141,8,44,17,0,27,17
169141,7,18,5,0,13,5
169141,6,11,3,0,8,3
169141,5,5,2,0,3,2
169141,4,4,2,0,2,2
169141,3,7,5,0,2,5
169141,2,2,1,0,1,1
169141,1,3,2,0,1,2
137931,9,1,1,0,0,1
137931,8,13,3,0,10,3
137931,7,36,5,0,31,5
137931,6,103,14,0,89,14
137931,5,53,6,0,47,6
137931,4,24,4,0,20,4
137931,3,11,3,0,8,3
137931,1,5,1,0,4,1
144382,10,1,1,0,0,1
144382,9,4,3,0,1,3
144382,8,45,12,0,33,12
144382,7,75,15,0,60,15
144382,6,71,17,0,54,17
144382,5,26,3,0,23,3
144382,4,16,5,0,11,5
144382,2,3,2,0,1,2
144382,1,1,1,0,0,1
204466,9,9,3,0,6,3
204466,8,35,8,0,27,8
204466,7,42,6,0,36,6
204466,6,96,9,1,87,8
204466,5,29,2,0,27,2
204466,4,21,5,0,16,5
204466,3,8,3,1,5,2
204466,2,4,1,0,3,1
226213,10,6,2,0,4,2
226213,9,25,7,0,18,7
226213,8,87,12,0,75,12
226213,7,69,15,0,54,15
226213,6,44,8,0,36,8
226213,5,14,4,0,10,4
226213,4,3,2,0,1,2
226213,2,3,1,0,2,1
209530,9,17,3,0,14,3
209530,8,36,3,0,33,3
209530,7,65,4,0,61,4
209530,6,68,9,0,59,9
209530,5,25,1,0,24,1
209530,4,13,1,0,12,1
209530,3,4,1,0,3,1
14634,10,23,11,0,12,11
14634,9,39,20,0,19,20
14634,8,73,32,0,41,32
14634,7,47,11,0,36,11
14634,6,47,17,0,30,17
14634,5,9,1,0,8,1
14634,4,5,4,0,1,4
14634,3,3,2,0,1,2
14634,2,2,1,0,1,1
5504,10,8,4,0,4,4
5504,9,20,6,0,14,6
5504,8,38,16,0,22,16
5504,7,60,13,0,47,13
5504,6,71,9,0,62,9
5504,5,28,4,0,24,4
5504,4,18,7,0,11,7
5504,3,4,1,0,3,1
5504,2,2,1,0,1,1
32253,10,2,1,0,1,1
32253,9,6,1,0,5,1
32253,8,22,13,0,9,13
32253,7,34,11,0,23,11
32253,6,87,29,0,58,29
32253,5,38,17,0,21,17
32253,4,27,7,0,20,7
32253,3,20,7,0,13,7
32253,2,13,6,0,7,6
12488,10,2,2,0,0,2
12488,9,23,9,0,14,9
12488,8,62,21,0,41,21
12488,7,57,16,0,41,16
12488,6,55,22,0,33,22
12488,5,30,9,0,21,9
12488,4,13,2,0,11,2
12488,3,5,2,0,3,2
12488,2,1,1,0,0,1
12488,1,1,1,0,0,1
19876,10,2,1,0,1,1
19876,8,11,4,0,7,4
19876,7,30,7,0,23,7
19876,6,93,23,0,70,23
19876,5,59,19,0,40,19
19876,4,34,17,0,17,17
19876,3,15,12,0,3,12
19876,2,4,3,0,1,3
28047,10,4,2,0,2,2
28047,9,3,2,0,1,2
28047,8,15,4,0,11,4
28047,7,32,15,0,17,15
28047,6,63,21,0,42,21
28047,5,40,12,0,28,12
28047,4,49,16,0,33,16
28047,3,24,12,0,12,12
28047,2,11,3,0,8,3
28047,1,8,3,0,5,3
191364,9,5,2,0,3,2
191364,8,17,2,0,15,2
191364,7,49,10,0,39,10
191364,6,82,20,0,62,20
191364,5,48,14,0,34,14
191364,4,23,7,0,16,7
191364,3,14,5,0,9,5
191364,2,7,2,0,5,2
15111,10,2,1,0,1,1
15111,9,1,1,0,0,1
15111,8,13,5,0,8,5
15111,7,21,6,0,15,6
15111,6,81,16,0,65,16
15111,5,61,12,0,49,12
15111,4,35,9,0,26,9
15111,3,23,13,0,10,13
15111,2,7,3,0,4,3
15111,1,5,4,0,1,4
5680,10,12,4,0,8,4
5680,9,18,12,0,6,12
5680,8,65,25,0,40,25
5680,7,84,28,0,56,28
5680,6,47,14,0,33,14
5680,5,15,3,0,12,3
5680,4,8,1,0,7,1
29078,9,10,5,0,5,5
29078,8,38,10,0,28,10
29078,7,54,16,0,38,16
29078,6,71,21,0,50,21
29078,5,39,13,0,26,13
29078,4,18,7,0,11,7
29078,3,11,5,0,6,5
29078,2,3,2,0,1,2
12829,8,11,5,0,6,5
12829,7,26,12,0,14,12
12829,6,99,30,0,69,30
12829,5,65,23,0,42,23
12829,4,27,11,0,16,11
12829,3,10,5,0,5,5
12829,2,7,1,0,6,1
101718,9,6,2,0,4,2
101718,8,11,4,0,7,4
101718,7,39,5,0,34,5
101718,6,86,14,0,72,14
101718,5,38,9,0,29,9
101718,4,35,12,0,23,12
101718,3,15,6,0,9,6
101718,2,11,3,0,8,3
101718,1,5,5,0,0,5
81542,10,3,1,0,2,1
81542,8,41,10,0,31,10
81542,7,36,9,0,27,9
81542,6,91,17,0,74,17
81542,5,37,5,0,32,5
81542,4,17,6,0,11,6
81542,3,13,4,0,9,4
66116,9,5,3,0,2,3
66116,8,37,13,0,24,13
66116,7,63,14,0,49,14
66116,6,79,16,0,63,16
66116,5,37,8,0,29,8
66116,4,17,4,0,13,4
66116,3,5,3,0,2,3
66116,2,3,1,0,2,1
4023,8,23,3,0,20,3
4023,7,37,8,0,29,8
4023,6,69,16,0,53,16
4023,5,44,14,0,30,14
4023,4,40,15,0,25,15
4023,3,17,7,0,10,7
4023,2,13,9,0,4,9
44558,8,39,9,0,30,9
44558,7,47,19,0,28,19
44558,6,91,25,0,66,25
44558,5,39,12,0,27,12
44558,4,17,8,0,9,8
44558,3,9,2,0,7,2
44558,2,3,2,0,1,2
103814,9,8,1,0,7,1
103814,8,34,9,0,25,9
103814,7,82,10,0,72,10
103814,6,77,14,0,63,14
103814,5,27,4,0,23,4
103814,4,14,1,0,13,1
6558,10,2,2,0,0,2
6558,9,7,5,0,2,5
6558,8,27,15,0,12,15
6558,7,61,28,0,33,28
6558,6,85,31,0,54,31
6558,5,36,12,0,24,12
6558,4,25,7,0,18,7
6558,3,5,1,0,4,1
62343,8,20,11,0,9,11
62343,7,55,19,0,36,19
62343,6,94,34,0,60,34
62343,5,46,16,0,30,16
62343,4,19,5,0,14,5
62343,3,9,5,0,4,5
62343,2,2,1,0,1,1
62343,1,3,2,0,1,2
178940,10,9,2,0,7,2
178940,9,21,7,0,14,7
178940,8,77,19,1,58,18
178940,7,70,18,2,52,16
178940,6,55,14,0,41,14
178940,5,13,4,0,9,4
895,10,19,8,0,11,8
895,9,23,6,0,17,6
895,8,55,21,0,34,21
895,7,44,19,0,25,19
895,6,58,28,0,30,28
895,5,32,15,0,17,15
895,4,10,3,0,7,3
895,2,3,2,0,1,2
219430,10,7,1,0,6,1
219430,8,37,5,0,32,5
219430,7,58,7,0,51,7
219430,6,77,10,0,67,10
219430,5,32,4,0,28,4
219430,4,19,4,0,15,4
219430,3,6,3,0,3,3
219430,2,1,1,0,0,1
181819,10,65,20,3,45,17
181819,9,75,18,5,57,13
181819,8,59,13,1,46,12
181819,7,22,2,0,20,2
181819,6,15,1,1,14,0
181819,5,11,7,1,4,6
181819,4,3,1,0,2,1
160853,10,2,1,0,1,1
160853,9,5,1,0,4,1
160853,8,47,12,2,35,10
160853,7,76,14,2,62,12
160853,6,67,8,0,59,8
160853,5,36,7,0,29,7
160853,4,11,4,0,7,4
160853,3,3,2,0,1,2
213149,10,5,1,0,4,1
213149,9,18,3,0,15,3
213149,8,76,13,0,63,13
213149,7,71,8,0,63,8
213149,6,57,8,0,49,8
213149,5,13,4,0,9,4
1891,10,7,2,0,5,2
1891,9,8,1,0,7,1
1891,8,34,11,0,23,11
1891,7,46,12,0,34,12
1891,6,65,24,0,41,24
1891,5,45,11,0,34,11
1891,4,23,8,0,15,8
1891,3,13,6,0,7,6
1891,2,5,1,0,4,1
1891,1,1,1,0,0,1
224125,10,12,1,0,11,1
224125,9,11,2,0,9,2
224125,8,75,13,1,62,12
224125,7,70,12,1,58,11
224125,6,50,10,0,40,10
224125,5,16,3,0,13,3
224125,4,6,2,0,4,2
224125,2,5,1,0,4,1
155157,10,8,2,0,6,2
155157,8,23,8,1,15,7
155157,7,30,3,0,27,3
155157,6,75,12,0,63,12
155157,5,40,4,0,36,4
155157,4,20,5,0,15,5
155157,3,17,3,0,14,3
155157,2,20,7,0,13,7
155157,1,3,1,0,2,1
35599,9,6,2,0,4,2
35599,8,52,12,0,40,12
35599,7,67,21,0,46,21
35599,6,69,16,0,53,16
35599,5,26,6,0,20,6
35599,4,13,1,0,12,1
35599,3,7,3,0,4,3
35599,2,3,2,0,1,2
4769,10,11,3,0,8,3
4769,9,21,10,0,11,10
4769,8,58,23,0,35,23
4769,7,69,17,0,52,17
4769,6,46,14,0,32,14
4769,5,21,10,0,11,10
4769,4,12,8,0,4,8
4769,3,6,4,0,2,4
4769,1,2,1,0,1,1
19578,10,3,1,0,2,1
19578,9,2,1,0,1,1
19578,8,11,3,0,8,3
19578,7,29,5,0,24,5
19578,6,71,20,0,51,20
19578,5,62,11,0,51,11
19578,4,39,10,0,29,10
19578,3,19,6,0,13,6
19578,2,5,2,0,3,2
19578,1,6,1,0,5,1
149746,10,6,2,0,4,2
149746,9,6,2,0,4,2
149746,8,41,9,0,32,9
149746,7,44,11,0,33,11
149746,6,73,16,0,57,16
149746,5,42,10,0,32,10
149746,4,22,10,0,12,10
149746,3,4,1,0,3,1
149746,2,6,2,0,4,2
149746,1,3,2,0,1,2
230358,9,7,1,0,6,1
230358,8,36,5,0,31,5
230358,7,74,9,0,65,9
230358,6,85,8,0,77,8
230358,5,26,2,0,24,2
230358,4,10,2,0,8,2
230358,3,2,1,0,1,1
32002,10,15,3,0,12,3
32002,9,32,12,1,20,11
32002,8,88,26,2,62,24
32002,7,53,10,0,43,10
32002,6,40,10,0,30,10
32002,5,6,4,0,2,4
32002,4,4,3,0,1,3
32002,3,5,2,0,3,2
32002,2,2,2,0,0,2
32002,1,2,1,0,1,1
37794,10,3,1,0,2,1
37794,9,10,6,0,4,6
37794,8,43,11,0,32,11
37794,7,48,16,0,32,16
37794,6,81,14,0,67,14
37794,5,36,12,0,24,12
37794,4,17,8,0,9,8
37794,3,8,1,0,7,1
18747,10,5,3,0,2,3
18747,9,16,8,0,8,8
18747,8,54,14,0,40,14
18747,7,75,19,0,56,19
18747,6,41,15,0,26,15
18747,5,24,11,0,13,11
18747,4,16,6,0,10,6
18747,3,5,4,0,1,4
18747,2,4,4,0,0,4
18747,1,7,6,0,1,6
235344,10,3,1,0,2,1
235344,9,25,4,0,21,4
235344,8,116,24,4,92,20
235344,7,44,10,0,34,10
235344,6,40,11,1,29,10
235344,5,10,4,0,6,4
235344,4,5,1,0,4,1
171356,10,14,6,1,8,5
171356,9,25,4,0,21,4
171356,8,67,17,3,50,14
171356,7,65,14,6,51,8
171356,6,57,17,2,40,15
171356,5,10,1,0,9,1
171356,4,5,1,0,4,1
171356,3,3,1,0,2,1
6817,10,43,17,0,26,17
6817,9,26,12,0,14,12
6817,8,56,17,0,39,17
6817,7,61,15,0,46,15
6817,6,33,5,0,28,5
6817,5,10,3,0,7,3
6817,4,9,3,0,6,3
6817,2,4,3,0,1,3
218,10,1,1,0,0,1
218,8,18,6,0,12,6
218,7,51,15,0,36,15
218,6,79,26,0,53,26
218,5,56,18,0,38,18
218,4,27,9,0,18,9
218,3,9,3,0,6,3
218,2,3,1,0,2,1
203624,10,2,1,0,1,1
203624,9,6,1,0,5,1
203624,8,46,9,0,37,9
203624,7,62,14,0,48,14
203624,6,72,14,0,58,14
203624,5,24,2,0,22,2
203624,4,13,2,0,11,2
203624,3,16,3,0,13,3
203624,1,4,1,0,3,1
38918,8,21,4,0,17,4
38918,7,59,10,0,49,10
38918,6,110,12,0,98,12
38918,5,34,9,0,25,9
38918,4,12,2,0,10,2
38918,3,7,1,0,6,1
490,10,56,53,0,3,53
490,9,43,39,0,4,39
490,8,46,32,0,14,32
490,7,37,11,0,26,11
490,6,35,13,0,22,13
490,5,12,1,0,11,1
490,4,3,2,0,1,2
490,3,5,2,0,3,2
490,1,4,3,0,1,3
40941,10,5,3,0,2,3
40941,9,17,3,0,14,3
40941,8,40,13,0,27,13
40941,7,63,16,0,47,16
40941,6,67,14,0,53,14
40941,5,29,6,0,23,6
40941,4,16,3,0,13,3
40941,3,6,1,0,5,1
40941,2,2,1,0,1,1
24000,7,24,6,0,18,6
24000,6,66,9,0,57,9
24000,5,55,5,0,50,5
24000,4,46,7,0,39,7
24000,3,21,3,0,18,3
24000,2,17,2,0,15,2
24000,1,6,2,0,4,2
160044,10,22,3,0,19,3
160044,9,24,3,0,21,3
160044,8,61,9,0,52,9
160044,7,55,5,0,50,5
160044,6,43,6,0,37,6
160044,5,12,2,0,10,2
160044,4,18,6,0,12,6
160044,1,5,2,0,3,2
642,10,3,1,0,2,1
642,9,8,3,0,5,3
642,8,34,12,0,22,12
642,7,55,14,0,41,14
642,6,62,20,0,42,20
642,5,56,14,0,42,14
642,4,16,5,0,11,5
642,3,6,2,0,4,2
642,2,6,4,0,2,4
9200,9,8,4,0,4,4
9200,8,28,11,0,17,11
9200,7,65,25,0,40,25
9200,6,71,28,0,43,28
9200,5,27,13,0,14,13
9200,4,27,14,0,13,14
9200,3,10,4,0,6,4
9200,2,6,4,0,2,4
9200,1,1,1,0,0,1
174093,10,12,6,0,6,6
174093,9,16,12,0,4,12
174093,8,49,12,0,37,12
174093,7,50,10,0,40,10
174093,6,73,12,0,61,12
174093,5,20,5,0,15,5
174093,4,16,2,0,14,2
174093,3,8,3,0,5,3
174093,1,1,1,0,0,1
11865,10,12,4,0,8,4
11865,9,14,5,0,9,5
11865,8,53,9,0,44,9
11865,7,62,12,0,50,12
11865,6,64,12,0,52,12
11865,5,21,5,0,16,5
11865,4,8,2,0,6,2
11865,3,10,6,0,4,6
2980,8,9,3,0,6,3
2980,7,15,4,0,11,4
2980,6,36,9,0,27,9
2980,5,59,13,0,46,13
2980,4,56,16,0,40,16
2980,3,38,15,0,23,15
2980,2,24,11,0,13,11
66837,10,42,16,0,26,16
66837,9,63,9,0,54,9
66837,8,80,30,2,50,28
66837,7,38,13,1,25,12
66837,6,14,6,0,8,6
66837,5,4,3,0,1,3
66837,4,2,2,0,0,2
1821,10,28,12,0,16,12
1821,9,46,13,0,33,13
1821,8,95,26,0,69,26
1821,7,43,13,0,30,13
1821,6,22,7,0,15,7
1821,5,7,3,0,4,3
1821,2,1,1,0,0,1
145086,10,6,1,0,5,1
145086,8,38,9,0,29,9
145086,7,63,14,0,49,14
145086,6,89,13,0,76,13
145086,5,21,6,0,15,6
145086,4,18,6,0,12,6
145086,3,5,4,0,1,4
116948,10,13,9,0,4,9
116948,9,9,4,1,5,3
116948,8,23,7,0,16,7
116948,7,39,9,0,30,9
116948,6,59,9,0,50,9
116948,5,59,13,1,46,12
116948,4,32,10,1,22,9
116948,3,5,2,0,3,2
116948,2,6,2,0,4,2
4331,10,6,3,0,3,3
4331,9,3,1,0,2,1
4331,8,25,3,0,22,3
4331,7,56,13,0,43,13
4331,6,94,23,0,71,23
4331,5,33,9,0,24,9
4331,4,17,4,0,13,4
4331,3,5,2,0,3,2
4331,2,6,1,0,5,1
41875,9,9,3,0,6,3
41875,8,48,11,0,37,11
41875,7,73,17,0,56,17
41875,6,76,13,0,63,13
41875,5,26,4,0,22,4
41875,4,9,1,0,8,1
41875,1,1,1,0,0,1
21469,9,2,1,0,1,1
21469,8,31,17,0,14,17
21469,7,82,20,0,62,20
21469,6,89,20,0,69,20
21469,5,23,6,0,17,6
21469,4,7,1,0,6,1
21469,3,8,2,0,6,2
21469,2,2,1,0,1,1
22303,10,29,15,0,14,15
22303,9,25,12,0,13,12
22303,8,60,28,0,32,28
22303,7,58,23,0,35,23
22303,6,45,19,0,26,19
22303,5,13,5,0,8,5
22303,4,2,1,0,1,1
22303,3,8,4,0,4,4
205308,10,4,2,0,2,2
205308,9,9,2,0,7,2
205308,8,51,10,0,41,10
205308,7,94,12,0,82,12
205308,6,60,5,0,55,5
205308,5,19,1,0,18,1
205308,4,7,2,0,5,2
66855,10,34,14,0,20,14
66855,9,49,20,0,29,20
66855,8,97,30,0,67,30
66855,7,33,9,0,24,9
66855,6,19,7,0,12,7
66855,4,1,1,0,0,1
66855,3,4,1,0,3,1
66855,2,2,2,0,0,2
1094,7,8,2,0,6,2
1094,6,27,6,0,21,6
1094,5,35,13,0,22,13
1094,4,38,15,0,23,15
1094,3,36,11,0,25,11
1094,2,44,22,0,22,22
1094,1,50,28,0,22,28
175763,10,5,2,0,3,2
175763,9,7,1,0,6,1
175763,8,45,9,0,36,9
175763,7,50,7,0,43,7
175763,6,74,6,0,68,6
175763,5,39,4,0,35,4
175763,4,17,4,0,13,4
175763,2,2,2,0,0,2
8983,9,2,2,0,0,2
8983,8,5,1,0,4,1
8983,7,19,3,0,16,3
8983,6,54,11,0,43,11
8983,5,60,12,0,48,12
8983,4,54,10,0,44,10
8983,3,26,10,0,16,10
8983,2,22,7,0,15,7
8983,1,2,1,0,1,1
175088,10,5,1,0,4,1
175088,9,14,4,0,10,4
175088,8,52,11,0,41,11
175088,7,78,18,0,60,18
175088,6,72,18,0,54,18
175088,5,14,3,0,11,3
175088,4,6,3,0,3,3
175088,1,1,1,0,0,1
140163,10,11,3,0,8,3
140163,9,16,3,0,13,3
140163,8,40,11,3,29,8
140163,7,46,15,1,31,14
140163,6,61,11,0,50,11
140163,5,30,8,0,22,8
140163,4,24,11,0,13,11
140163,3,9,2,0,7,2
140163,2,3,1,0,2,1
140163,1,4,1,0,3,1
158130,10,17,4,0,13,4
158130,9,27,3,0,24,3
158130,8,71,9,1,62,8
158130,7,82,12,0,70,12
158130,6,36,7,0,29,7
158130,5,6,1,0,5,1
158130,3,1,1,0,0,1
158130,2,1,1,0,0,1
42560,10,13,7,0,6,7
42560,9,17,7,0,10,7
42560,8,74,30,0,44,30
42560,7,62,15,0,47,15
42560,6,37,12,0,25,12
42560,5,21,12,0,9,12
42560,4,15,7,0,8,7
42560,3,5,3,0,2,3
6250,8,17,2,0,15,2
6250,7,39,10,0,29,10
6250,6,96,22,0,74,22
6250,5,43,11,0,32,11
6250,4,24,6,0,18,6
6250,3,11,6,0,5,6
6250,1,2,2,0,0,2
8495,10,12,7,0,5,7
8495,9,21,9,0,12,9
8495,8,46,15,0,31,15
8495,7,54,11,0,43,11
8495,6,58,12,0,46,12
8495,5,16,4,0,12,4
8495,4,11,4,0,7,4
8495,3,14,8,0,6,8
8495,2,7,3,0,4,3
8495,1,5,4,0,1,4
179280,10,7,1,0,6,1
179280,8,27,5,0,22,5
179280,7,48,3,0,45,3
179280,6,77,10,0,67,10
179280,5,43,3,0,40,3
179280,4,23,7,0,16,7
179280,3,8,2,0,6,2
179280,1,3,1,0,2,1
234120,9,13,5,0,8,5
234120,8,34,8,0,26,8
234120,7,56,15,0,41,15
234120,6,74,11,0,63,11
234120,5,29,4,0,25,4
234120,4,14,3,0,11,3
234120,3,9,2,0,7,2
234120,2,8,5,0,3,5
234120,1,4,1,0,3,1
1371,10,5,3,0,2,3
1371,9,7,3,0,4,3
1371,8,41,13,0,28,13
1371,7,69,19,0,50,19
1371,6,76,24,0,52,24
1371,5,28,9,0,19,9
1371,4,15,8,0,7,8
1371,3,2,1,0,1,1
1371,2,1,1,0,0,1
15311,10,3,1,0,2,1
15311,8,19,6,0,13,6
15311,7,44,8,0,36,8
15311,6,84,14,0,70,14
15311,5,43,5,0,38,5
15311,4,29,4,0,25,4
15311,3,13,3,0,10,3
235591,10,9,1,0,8,1
235591,9,20,5,0,15,5
235591,8,62,10,0,52,10
235591,7,44,4,0,40,4
235591,6,20,9,0,11,9
235591,5,11,1,0,10,1
235591,4,7,3,0,4,3
235591,3,2,2,0,0,2
235591,2,2,2,0,0,2
920,10,3,1,0,2,1
920,9,8,2,0,6,2
920,8,28,4,0,24,4
920,7,55,12,0,43,12
920,6,84,23,0,61,23
920,5,38,9,0,29,9
920,4,20,4,0,16,4
920,3,6,1,0,5,1
242569,10,4,1,0,3,1
242569,9,9,1,0,8,1
242569,8,55,4,0,51,4
242569,7,78,6,0,72,6
242569,6,67,11,0,56,11
242569,5,19,3,0,16,3
170223,10,11,4,0,7,4
170223,9,19,7,0,12,7
170223,8,53,13,2,40,11
170223,7,58,9,2,49,7
170223,6,53,12,3,41,9
170223,5,19,4,0,15,4
170223,4,17,5,1,12,4
170223,3,5,2,0,3,2
170223,2,5,3,0,2,3
170223,1,4,1,0,3,1
2156,9,2,1,0,1,1
2156,8,16,6,0,10,6
2156,7,24,11,0,13,11
2156,6,72,25,0,47,25
2156,5,63,20,0,43,20
2156,4,37,20,0,17,20
2156,3,17,9,0,8,9
2156,2,7,5,0,2,5
2156,1,5,2,0,3,2
33071,8,15,5,0,10,5
33071,7,37,9,0,28,9
33071,6,61,14,0,47,14
33071,5,38,6,0,32,6
33071,4,21,5,0,16,5
33071,3,7,1,0,6,1
33071,2,5,2,0,3,2
3658,10,4,1,0,3,1
3658,9,3,1,0,2,1
3658,8,8,3,0,5,3
3658,7,46,12,0,34,12
3658,6,99,28,0,71,28
3658,5,51,18,0,33,18
3658,4,21,4,0,17,4
3658,3,10,4,0,6,4
1628,10,2,2,0,0,2
1628,8,16,9,0,7,9
1628,7,42,17,0,25,17
1628,6,78,22,0,56,22
1628,5,48,17,0,31,17
1628,4,29,11,0,18,11
1628,3,16,7,0,9,7
1628,1,3,2,0,1,2
4279,8,18,1,0,17,1
4279,7,33,3,0,30,3
4279,6,62,6,0,56,6
4279,5,53,5,0,48,5
4279,4,37,9,0,28,9
4279,3,18,6,0,12,6
4279,2,12,4,0,8,4
4279,1,5,1,0,4,1
19048,8,19,6,0,13,6
19048,7,60,24,0,36,24
19048,6,96,31,0,65,31
19048,5,44,21,0,23,21
19048,4,10,5,0,5,5
19048,3,6,4,0,2,4
19048,2,6,2,0,4,2
33665,10,28,8,0,20,8
33665,9,57,19,0,38,19
33665,8,104,24,0,80,24
33665,7,31,10,0,21,10
33665,6,13,4,0,9,4
33665,5,4,2,0,2,2
33665,4,2,1,0,1,1
33665,3,1,1,0,0,1
33665,2,1,1,0,0,1
158918,9,2,1,0,1,1
158918,7,32,9,0,23,9
158918,6,87,14,2,73,12
158918,5,62,17,0,45,17
158918,4,34,7,0,27,7
158918,3,12,1,0,11,1
158918,2,6,1,0,5,1
99770,10,2,1,0,1,1
99770,8,23,5,0,18,5
99770,7,59,11,0,48,11
99770,6,91,20,0,71,20
99770,5,32,8,0,24,8
99770,4,22,5,0,17,5
99770,2,3,1,0,2,1
3313,9,1,1,0,0,1
3313,8,25,12,0,13,12
3313,7,49,18,0,31,18
3313,6,93,33,0,60,33
3313,5,46,13,0,33,13
3313,4,17,6,0,11,6
3313,3,9,5,0,4,5
151275,10,7,2,0,5,2
151275,9,16,3,0,13,3
151275,8,57,16,2,41,14
151275,7,79,18,2,61,16
151275,6,56,11,0,45,11
151275,5,18,3,0,15,3
151275,4,7,3,0,4,3
151275,3,2,1,0,1,1
151275,1,1,1,0,0,1
198611,8,39,9,0,30,9
198611,7,64,8,0,56,8
198611,6,82,9,0,73,9
198611,5,23,6,0,17,6
198611,4,12,2,0,10,2
198611,3,10,1,0,9,1
198611,1,2,2,0,0,2
5772,10,3,2,0,1,2
5772,9,12,5,0,7,5
5772,8,46,19,0,27,19
5772,7,68,20,0,48,20
5772,6,73,26,0,47,26
5772,5,22,6,0,16,6
5772,4,14,8,0,6,8
5772,3,5,2,0,3,2
1794,10,14,3,0,11,3
1794,9,16,5,0,11,5
1794,8,46,13,0,33,13
1794,7,55,8,0,47,8
1794,6,56,3,0,53,3
1794,5,32,11,0,21,11
1794,4,12,2,0,10,2
1794,3,7,2,0,5,2
218314,10,2,1,0,1,1
218314,9,8,1,0,7,1
218314,8,28,3,0,25,3
218314,7,53,9,0,44,9
218314,6,81,10,0,71,10
218314,5,30,3,0,27,3
218314,4,23,6,0,17,6
218314,3,13,4,0,9,4
218314,1,2,1,0,1,1
3119,10,8,5,0,3,5
3119,9,19,3,0,16,3
3119,8,45,9,0,36,9
3119,7,85,15,0,70,15
3119,6,51,8,0,43,8
3119,5,17,3,0,14,3
23656,9,3,2,0,1,2
23656,8,11,6,0,5,6
23656,7,30,13,0,17,13
23656,6,78,23,0,55,23
23656,5,53,14,0,39,14
23656,4,42,11,0,31,11
23656,3,18,3,0,15,3
23656,2,2,1,0,1,1
37000,10,1,1,0,0,1
37000,9,3,1,0,2,1
37000,7,27,3,0,24,3
37000,6,53,13,0,40,13
37000,5,59,10,0,49,10
37000,4,37,8,0,29,8
37000,3,20,7,0,13,7
37000,2,18,7,0,11,7
37000,1,6,2,0,4,2
18746,10,13,3,0,10,3
18746,9,45,14,0,31,14
18746,8,95,15,0,80,15
18746,7,62,15,0,47,15
18746,6,17,3,0,14,3
18746,5,8,2,0,6,2
18746,4,2,1,0,1,1
200359,9,10,1,0,9,1
200359,8,47,6,2,41,4
200359,7,63,14,1,49,13
200359,6,64,14,1,50,13
200359,5,28,1,0,27,1
200359,4,11,6,0,5,6
200359,3,10,7,0,3,7
200359,2,4,2,0,2,2
216482,9,2,1,0,1,1
216482,8,20,5,0,15,5
216482,7,69,6,0,63,6
216482,6,95,15,0,80,15
216482,5,39,10,0,29,10
216482,4,10,2,0,8,2
216482,3,5,1,0,4,1
145493,10,22,14,2,8,12
145493,9,28,11,3,17,8
145493,8,63,17,2,46,15
145493,7,43,17,2,26,15
145493,6,40,6,1,34,5
145493,5,23,6,0,17,6
145493,4,16,4,0,12,4
145493,3,4,2,1,2,1
145493,2,1,1,0,0,1
145493,1,2,1,0,1,1
233896,10,53,13,2,40,11
233896,9,46,6,0,40,6
233896,8,65,13,3,52,10
233896,7,34,8,0,26,8
233896,6,16,1,0,15,1
233896,5,6,2,1,4,1
233896,4,5,2,0,3,2
233896,3,7,3,0,4,3
233896,2,6,2,0,4,2
233896,1,6,2,1,4,1
2800,10,15,8,0,7,8
2800,9,21,8,0,13,8
2800,8,75,30,0,45,30
2800,7,67,23,0,44,23
2800,6,46,12,0,34,12
2800,5,12,3,0,9,3
2800,4,4,1,0,3,1
2800,3,1,1,0,0,1
180816,10,13,1,0,12,1
180816,9,12,4,0,8,4
180816,8,37,8,0,29,8
180816,7,51,8,0,43,8
180816,6,76,10,0,66,10
180816,5,35,4,0,31,4
180816,2,6,2,0,4,2
35524,9,2,1,0,1,1
35524,8,12,3,0,9,3
35524,7,33,8,0,25,8
35524,6,74,22,0,52,22
35524,5,43,18,0,25,18
35524,4,36,11,0,25,11
35524,3,24,12,0,12,12
35524,2,13,3,0,10,3
35524,1,5,3,0,2,3
227029,10,6,2,0,4,2
227029,9,9,5,0,4,5
227029,8,38,9,0,29,9
227029,7,74,11,0,63,11
227029,6,65,13,0,52,13
227029,5,23,7,0,16,7
227029,4,7,1,0,6,1
227029,3,4,2,0,2,2
227029,2,5,3,0,2,3
97093,9,1,1,0,0,1
97093,8,23,7,0,16,7
97093,7,65,9,0,56,9
97093,6,85,16,0,69,16
97093,5,38,5,0,33,5
97093,4,17,5,0,12,5
97093,3,6,2,0,4,2
97093,2,7,2,0,5,2
161383,9,8,5,0,3,5
161383,8,22,3,0,19,3
161383,7,51,7,0,44,7
161383,6,95,22,2,73,20
161383,5,47,9,0,38,9
161383,4,11,5,0,6,5
161383,3,2,1,0,1,1
141035,9,2,1,0,1,1
141035,8,15,2,0,13,2
141035,7,37,6,0,31,6
141035,6,67,18,0,49,18
141035,5,45,6,0,39,6
141035,4,33,9,0,24,9
141035,3,25,7,0,18,7
141035,2,10,2,0,8,2
141035,1,7,1,0,6,1
85800,10,4,2,0,2,2
85800,9,6,1,0,5,1
85800,8,50,19,0,31,19
85800,7,69,14,0,55,14
85800,6,82,19,0,63,19
85800,5,26,8,0,18,8
85800,4,6,3,0,3,3
1522,9,5,3,0,2,3
1522,7,33,9,0,24,9
1522,6,86,23,0,63,23
1522,5,57,21,0,36,21
1522,4,34,13,0,21,13
1522,3,9,2,0,7,2
1522,2,5,2,0,3,2
1522,1,2,2,0,0,2
6982,8,16,8,0,8,8
6982,7,34,16,0,18,16
6982,6,95,29,0,66,29
6982,5,53,21,0,32,21
6982,4,26,8,0,18,8
6982,3,12,4,0,8,4
6982,2,3,1,0,2,1
2833,9,3,1,0,2,1
2833,8,14,4,0,10,4
2833,7,41,4,0,37,4
2833,6,87,17,0,70,17
2833,5,51,11,0,40,11
2833,4,24,3,0,21,3
2833,3,6,1,0,5,1
2833,2,8,1,0,7,1
2833,1,5,3,0,2,3
1407,9,1,1,0,0,1
1407,8,12,4,0,8,4
1407,7,30,10,0,20,10
1407,6,86,16,0,70,16
1407,5,61,16,0,45,16
1407,4,31,12,0,19,12
1407,3,17,2,0,15,2
1407,2,2,2,0,0,2
203655,8,47,8,0,39,8
203655,6,73,4,0,69,4
203655,5,25,1,0,24,1
191073,9,9,2,0,7,2
191073,8,41,5,0,36,5
191073,7,59,3,0,56,3
191073,6,85,10,0,75,10
191073,5,18,2,0,16,2
191073,4,12,1,0,11,1
191073,3,8,1,0,7,1
191073,2,2,1,0,1,1
226519,10,7,1,0,6,1
226519,9,14,2,0,12,2
226519,8,61,9,0,52,9
226519,7,89,9,0,80,9
226519,6,45,6,0,39,6
226519,5,15,1,0,14,1
226519,4,4,1,0,3,1
226519,1,5,1,0,4,1
8521,10,64,33,0,31,33
8521,9,54,20,0,34,20
8521,8,64,26,0,38,26
8521,7,23,6,0,17,6
8521,6,21,6,0,15,6
8521,5,7,1,0,6,1
8521,4,1,1,0,0,1
8521,3,1,1,0,0,1
8521,2,3,1,0,2,1
32,9,6,3,0,3,3
32,8,21,5,0,16,5
32,7,55,11,0,44,11
32,6,89,16,0,73,16
32,5,45,16,0,29,16
32,4,14,4,0,10,4
32,3,5,1,0,4,1
32,2,3,3,0,0,3
148036,10,2,1,0,1,1
148036,8,27,8,0,19,8
148036,7,56,13,0,43,13
148036,6,90,24,0,66,24
148036,5,32,6,0,26,6
148036,4,20,4,0,16,4
148036,3,8,1,0,7,1
148036,2,2,1,0,1,1
515,10,6,1,0,5,1
515,9,24,8,0,16,8
515,8,55,21,0,34,21
515,7,71,27,0,44,27
515,6,43,17,0,26,17
515,5,31,13,0,18,13
515,4,8,6,0,2,6
515,3,2,1,0,1,1
515,1,1,1,0,0,1
180785,8,21,3,0,18,3
180785,7,52,9,0,43,9
180785,6,94,16,0,78,16
180785,5,43,8,0,35,8
180785,4,16,6,1,10,5
180785,3,10,2,1,8,1
199357,10,14,4,1,10,3
199357,9,25,7,1,18,6
199357,8,44,8,1,36,7
199357,7,60,13,1,47,12
199357,6,50,12,0,38,12
199357,5,21,3,0,18,3
199357,4,17,5,0,12,5
199357,3,5,1,0,4,1
199357,2,4,1,0,3,1
21373,10,21,7,0,14,7
21373,9,35,6,0,29,6
21373,8,94,15,0,79,15
21373,7,59,8,0,51,8
21373,6,22,6,0,16,6
21373,5,6,2,0,4,2
21373,4,3,1,0,2,1
21373,2,1,1,0,0,1
2995,10,2,1,0,1,1
2995,9,13,3,0,10,3
2995,8,39,18,0,21,18
2995,7,47,21,0,26,21
2995,6,76,29,0,47,29
2995,5,36,11,0,25,11
2995,4,19,9,0,10,9
2995,3,3,1,0,2,1
2995,2,5,2,0,3,2
244994,10,2,1,0,1,1
244994,8,38,4,0,34,4
244994,7,69,10,0,59,10
244994,6,82,13,0,69,13
244994,5,23,3,0,20,3
244994,4,15,5,0,10,5
244994,3,4,3,0,1,3
207310,10,9,3,0,6,3
207310,8,36,4,0,32,4
207310,7,50,14,1,36,13
207310,6,54,10,2,44,8
207310,5,39,2,0,37,2
207310,4,24,3,1,21,2
207310,3,16,4,0,12,4
207310,2,5,2,0,3,2
207310,1,3,1,0,2,1
2154,10,9,2,0,7,2
2154,9,28,11,0,17,11
2154,8,63,13,0,50,13
2154,7,68,17,0,51,17
2154,6,52,10,0,42,10
2154,5,13,3,0,10,3
2154,4,6,3,0,3,3
158837,10,9,1,0,8,1
158837,9,23,5,0,18,5
158837,8,47,14,0,33,14
158837,7,66,10,0,56,10
158837,6,64,14,0,50,14
158837,5,19,3,0,16,3
158837,4,8,1,0,7,1
66125,10,4,1,0,3,1
66125,9,17,4,0,13,4
66125,8,54,5,0,49,5
66125,7,58,5,0,53,5
66125,6,65,4,0,61,4
66125,5,25,1,0,24,1
66125,3,5,2,0,3,2
142364,9,6,4,0,2,4
142364,8,31,10,0,21,10
142364,7,66,17,0,49,17
142364,6,86,19,0,67,19
142364,5,29,9,0,20,9
142364,4,13,3,0,10,3
142364,3,3,1,0,2,1
142364,2,4,1,0,3,1
142364,1,1,1,0,0,1
3627,10,20,10,0,10,10
3627,9,14,5,0,9,5
3627,8,31,9,0,22,9
3627,7,46,12,0,34,12
3627,6,61,17,0,44,17
3627,5,27,11,0,16,11
3627,4,17,5,0,12,5
3627,3,10,5,0,5,5
3627,2,10,7,0,3,7
3627,1,4,1,0,3,1
194298,10,12,5,0,7,5
194298,9,22,6,1,16,5
194298,8,46,13,2,33,11
194298,7,62,7,0,55,7
194298,6,59,12,3,47,9
194298,5,19,5,0,14,5
194298,4,12,1,0,11,1
194298,3,6,1,0,5,1
5369,10,27,10,0,17,10
5369,9,24,7,0,17,7
5369,8,56,17,0,39,17
5369,7,65,16,0,49,16
5369,6,40,10,0,30,10
5369,5,16,5,0,11,5
5369,4,6,3,0,3,3
5369,3,2,1,0,1,1
5369,1,2,2,0,0,2
14054,10,4,2,0,2,2
14054,9,4,2,0,2,2
14054,8,34,16,0,18,16
14054,7,74,34,0,40,34
14054,6,79,33,0,46,33
14054,5,32,13,0,19,13
14054,4,5,3,0,2,3
14054,3,5,1,0,4,1
14054,2,2,1,0,1,1
203759,10,12,5,0,7,5
203759,9,21,6,0,15,6
203759,8,77,21,4,56,17
203759,7,54,9,1,45,8
203759,6,43,10,2,33,8
203759,5,13,3,0,10,3
203759,4,7,1,0,6,1
203759,3,7,3,0,4,3
203759,1,5,4,0,1,4
129735,10,6,3,0,3,3
129735,9,6,1,0,5,1
129735,8,30,9,0,21,9
129735,7,43,13,0,30,13
129735,6,83,21,0,62,21
129735,5,40,9,0,31,9
129735,4,14,5,0,9,5
129735,3,4,2,0,2,2
129735,2,9,7,0,2,7
129735,1,5,1,0,4,1
36241,9,10,6,0,4,6
36241,8,26,8,0,18,8
36241,7,59,23,0,36,23
36241,6,91,38,0,53,38
36241,5,32,12,0,20,12
36241,4,11,5,0,6,5
36241,3,4,4,0,0,4
36241,2,4,2,0,2,2
36241,1,1,1,0,0,1
1916,8,14,2,0,12,2
1916,7,35,11,0,24,11
1916,6,92,25,0,67,25
1916,5,66,15,0,51,15
1916,4,21,10,0,11,10
1916,3,10,1,0,9,1
1916,2,1,1,0,0,1
46530,10,10,1,0,9,1
46530,9,9,1,0,8,1
46530,8,40,8,0,32,8
46530,7,39,5,0,34,5
46530,6,68,10,1,58,9
46530,5,35,3,0,32,3
46530,4,21,4,0,17,4
46530,3,9,2,0,7,2
46530,2,6,2,0,4,2
182626,10,10,3,0,7,3
182626,9,32,5,1,27,4
182626,8,55,7,0,48,7
182626,7,58,9,0,49,9
182626,6,49,9,0,40,9
182626,5,16,4,0,12,4
182626,4,8,2,0,6,2
182626,3,9,5,0,4,5
142556,10,11,1,0,10,1
142556,9,13,2,0,11,2
142556,8,34,4,0,30,4
142556,7,69,15,0,54,15
142556,6,78,14,0,64,14
142556,5,22,2,0,20,2
142556,4,7,1,0,6,1
142556,3,3,2,0,1,2
753,10,4,1,0,3,1
753,9,14,5,0,9,5
753,8,37,16,0,21,16
753,7,67,20,0,47,20
753,6,60,15,0,45,15
753,5,33,10,0,23,10
753,3,9,6,0,3,6
753,2,4,1,0,3,1
753,1,2,2,0,0,2
6614,8,12,2,0,10,2
6614,7,22,3,0,19,3
6614,6,55,7,0,48,7
6614,5,51,11,0,40,11
6614,4,53,7,0,46,7
6614,3,25,10,0,15,10
6614,2,12,4,0,8,4
41123,9,5,1,0,4,1
41123,8,17,2,0,15,2
41123,7,54,17,0,37,17
41123,6,98,25,0,73,25
41123,5,38,12,0,26,12
41123,4,18,2,0,16,2
41123,2,4,2,0,2,2
473,9,7,3,0,4,3
473,8,46,10,0,36,10
473,7,82,22,0,60,22
473,6,65,18,0,47,18
473,5,19,6,0,13,6
473,4,14,4,0,10,4
473,2,1,1,0,0,1
12282,10,6,3,0,3,3
12282,9,19,5,0,14,5
12282,8,72,26,0,46,26
12282,7,63,17,0,46,17
12282,6,47,15,0,32,15
12282,5,15,5,0,10,5
12282,4,11,4,0,7,4
12282,3,4,3,0,1,3
12282,2,3,2,0,1,2
2256,10,4,2,0,2,2
2256,9,5,3,0,2,3
2256,8,34,19,0,15,19
2256,7,53,17,0,36,17
2256,6,77,21,0,56,21
2256,5,43,7,0,36,7
2256,4,19,7,0,12,7
2256,3,4,3,0,1,3
109252,9,2,1,0,1,1
109252,8,12,2,0,10,2
109252,7,36,7,0,29,7
109252,6,73,17,3,56,14
109252,5,59,16,3,43,13
109252,4,31,14,0,17,14
109252,3,14,5,0,9,5
109252,2,7,5,3,2,2
109252,1,2,2,0,0,2
182077,8,7,1,0,6,1
182077,7,28,2,0,26,2
182077,6,90,11,0,79,11
182077,5,42,5,0,37,5
182077,4,33,8,0,25,8
182077,3,20,4,0,16,4
182077,2,13,3,0,10,3
242722,10,76,14,0,62,14
242722,9,75,17,0,58,17
242722,8,62,5,0,57,5
242722,7,12,1,0,11,1
242722,6,9,4,0,5,4
242722,5,1,1,0,0,1
242722,3,2,1,0,1,1
242722,1,2,1,0,1,1
6460,10,2,1,0,1,1
6460,8,28,11,0,17,11
6460,7,33,13,0,20,13
6460,6,92,31,0,61,31
6460,5,36,13,0,23,13
6460,4,20,7,0,13,7
6460,3,11,5,0,6,5
6460,2,9,5,0,4,5
6460,1,5,2,0,3,2
118293,9,7,1,0,6,1
118293,8,45,4,0,41,4
118293,7,71,8,0,63,8
118293,6,72,11,0,61,11
118293,5,25,2,0,23,2
118293,4,12,2,0,10,2
118293,3,2,1,0,1,1
247342,10,19,8,0,11,8
247342,9,40,14,2,26,12
247342,8,87,13,2,74,11
247342,7,57,6,0,51,6
247342,6,22,1,0,21,1
247342,5,4,1,0,3,1
247342,4,7,2,0,5,2
247342,3,4,2,0,2,2
1352,9,5,2,0,3,2
1352,8,26,8,0,18,8
1352,7,59,9,0,50,9
1352,6,74,11,0,63,11
1352,5,41,9,0,32,9
1352,4,17,3,0,14,3
1352,2,4,1,0,3,1
170225,9,25,9,0,16,9
170225,8,90,24,2,66,22
170225,7,55,13,0,42,13
170225,6,35,10,0,25,10
170225,5,8,2,0,6,2
170225,4,10,4,0,6,4
170225,3,8,2,0,6,2
170225,2,3,1,0,2,1
258041,10,6,2,0,4,2
258041,9,18,4,0,14,4
258041,8,62,6,0,56,6
258041,7,84,14,0,70,14
258041,6,49,6,0,43,6
258041,5,10,4,0,6,4
258041,4,5,1,0,4,1
258041,3,3,2,0,1,2
258041,2,2,2,0,0,2
161762,8,22,7,0,15,7
161762,7,64,8,0,56,8
161762,6,88,20,0,68,20
161762,5,31,3,0,28,3
161762,4,17,1,0,16,1
161762,3,6,3,0,3,3
161762,2,5,1,0,4,1
161762,1,1,1,0,0,1
30952,7,49,6,0,43,6
30952,6,70,7,0,63,7
30952,5,53,2,0,51,2
30952,4,20,2,0,18,2
30952,3,19,2,0,17,2
30952,1,2,1,0,1,1
138614,10,9,7,1,2,6
138614,9,18,9,1,9,8
138614,8,48,7,1,41,6
138614,7,62,18,1,44,17
138614,6,61,11,1,50,10
138614,5,20,5,0,15,5
138614,4,11,2,0,9,2
138614,3,7,4,1,3,3
138614,2,2,1,0,1,1
144743,10,27,11,2,16,9
144743,9,34,9,1,25,8
144743,8,74,20,4,54,16
144743,7,49,15,1,34,14
144743,6,33,9,1,24,8
144743,5,12,3,1,9,2
144743,4,6,3,1,3,2
144743,3,1,1,0,0,1
144743,2,1,1,1,0,0
224907,10,8,1,0,7,1
224907,9,6,1,0,5,1
224907,8,34,5,0,29,5
224907,7,70,11,0,59,11
224907,6,79,9,0,70,9
224907,5,21,4,0,17,4
224907,3,9,3,0,6,3
224907,2,4,1,0,3,1
6994,10,1,1,0,0,1
6994,8,14,3,0,11,3
6994,7,29,2,0,27,2
6994,6,76,13,0,63,13
6994,5,53,9,0,44,9
6994,4,35,8,0,27,8
6994,3,18,6,0,12,6
6994,2,4,2,0,2,2
6994,1,5,1,0,4,1
20966,9,4,1,0,3,1
20966,8,12,7,0,5,7
20966,7,45,14,0,31,14
20966,6,99,34,0,65,34
20966,5,42,18,0,24,18
20966,4,23,7,0,16,7
20966,3,9,5,0,4,5
20966,2,1,1,0,0,1
20966,1,3,2,0,1,2
129091,9,14,3,1,11,2
129091,8,32,12,2,20,10
129091,7,65,12,6,53,6
129091,6,81,10,0,71,10
129091,5,21,6,1,15,5
127561,10,21,3,0,18,3
127561,8,61,10,0,51,10
127561,7,66,8,0,58,8
127561,6,38,6,0,32,6
127561,5,18,3,0,15,3
127561,4,4,2,0,2,2
127561,3,4,2,0,2,2
127561,2,3,2,0,1,2
1072,9,13,2,0,11,2
1072,8,40,9,0,31,9
1072,7,81,9,0,72,9
1072,6,70,11,0,59,11
1072,5,19,5,0,14,5
1072,4,8,2,0,6,2
1072,3,3,1,0,2,1
388,9,3,1,0,2,1
388,8,19,5,0,14,5
388,7,41,8,0,33,8
388,6,79,20,0,59,20
388,5,59,16,0,43,16
388,4,26,6,0,20,6
388,3,9,5,0,4,5
388,2,2,1,0,1,1
63758,10,12,6,0,6,6
63758,9,29,13,0,16,13
63758,8,93,34,0,59,34
63758,7,63,19,0,44,19
63758,6,28,12,0,16,12
63758,5,9,4,0,5,4
63758,3,1,1,0,0,1
63758,1,1,1,0,0,1
581,9,7,2,0,5,2
581,8,21,7,0,14,7
581,7,59,19,0,40,19
581,6,80,26,0,54,26
581,5,37,10,0,27,10
581,4,20,5,0,15,5
581,3,6,3,0,3,3
581,2,5,2,0,3,2
581,1,3,1,0,2,1
3725,8,17,6,0,11,6
3725,7,34,12,0,22,12
3725,6,84,25,0,59,25
3725,5,68,31,0,37,31
3725,4,22,7,0,15,7
3725,3,9,3,0,6,3
3725,2,2,1,0,1,1
145475,9,16,3,0,13,3
145475,8,48,8,0,40,8
145475,7,68,16,0,52,16
145475,6,76,10,0,66,10
145475,5,16,1,0,15,1
145475,3,3,1,0,2,1
101929,10,33,9,0,24,9
101929,9,50,19,0,31,19
101929,8,68,16,0,52,16
101929,7,39,9,0,30,9
101929,6,31,9,1,22,8
101929,5,5,1,0,4,1
101929,4,7,6,0,1,6
101929,2,3,1,0,2,1
73650,8,41,10,0,31,10
73650,7,62,14,0,48,14
73650,6,94,21,0,73,21
73650,5,18,9,0,9,9
73650,4,14,7,0,7,7
73650,3,4,1,0,3,1
30287,9,2,1,0,1,1
30287,8,21,8,0,13,8
30287,7,55,15,0,40,15
30287,6,85,12,0,73,12
30287,5,40,8,0,32,8
30287,4,25,9,0,16,9
30287,3,6,1,0,5,1
2201,10,19,6,0,13,6
2201,9,7,5,0,2,5
2201,8,26,11,0,15,11
2201,7,29,9,0,20,9
2201,6,57,17,0,40,17
2201,5,40,12,0,28,12
2201,4,29,7,0,22,7
2201,3,17,7,0,10,7
2201,2,9,3,0,6,3
2201,1,5,1,0,4,1
222887,10,12,1,0,11,1
222887,9,24,3,0,21,3
222887,8,63,10,0,53,10
222887,7,71,6,0,65,6
222887,6,35,6,0,29,6
222887,5,19,3,0,16,3
222887,4,11,1,0,10,1
197439,10,7,4,0,3,4
197439,9,29,8,0,21,8
197439,8,97,28,0,69,28
197439,7,51,9,0,42,9
197439,6,36,9,0,27,9
197439,5,11,3,0,8,3
197439,3,1,1,0,0,1
234711,10,8,2,0,6,2
234711,9,16,3,0,13,3
234711,8,81,13,0,68,13
234711,7,76,11,0,65,11
234711,6,38,5,0,33,5
234711,5,13,4,0,9,4
234711,3,3,1,0,2,1
9388,8,15,2,0,13,2
9388,7,31,9,0,22,9
9388,6,91,26,0,65,26
9388,5,51,6,0,45,6
9388,4,28,9,0,19,9
9388,3,9,7,0,2,7
9388,2,7,1,0,6,1
9388,1,5,3,0,2,3
8160,8,23,7,0,16,7
8160,7,54,12,0,42,12
8160,6,76,17,0,59,17
8160,5,37,9,0,28,9
8160,4,19,7,0,12,7
8160,3,9,1,0,8,1
8160,2,8,4,0,4,4
154498,10,8,1,0,7,1
154498,9,6,1,1,5,0
154498,8,35,14,0,21,14
154498,7,60,13,0,47,13
154498,6,73,11,2,62,9
154498,5,31,5,1,26,4
154498,4,10,3,1,7,2
154498,3,7,1,0,6,1
154498,2,4,3,0,1,3
154498,1,3,1,0,2,1
181328,9,5,2,0,3,2
181328,8,34,6,0,28,6
181328,7,89,17,0,72,17
181328,6,76,9,0,67,9
181328,5,26,8,0,18,8
181328,4,4,1,0,3,1
181328,3,3,1,0,2,1
57759,10,1,1,0,0,1
57759,9,4,1,0,3,1
57759,8,40,12,0,28,12
57759,7,76,28,0,48,28
57759,6,71,18,0,53,18
57759,5,32,9,0,23,9
57759,4,7,4,0,3,4
57759,3,1,1,0,0,1
57759,2,4,4,0,0,4
5177,10,3,1,0,2,1
5177,9,8,3,0,5,3
5177,8,20,4,0,16,4
5177,7,45,5,0,40,5
5177,6,80,13,0,67,13
5177,5,41,9,0,32,9
5177,4,19,5,0,14,5
5177,3,17,7,0,10,7
5177,2,4,3,0,1,3
150811,10,21,13,3,8,10
150811,9,7,4,0,3,4
150811,8,21,5,0,16,5
150811,7,20,3,0,17,3
150811,6,42,12,1,30,11
150811,5,30,6,2,24,4
150811,4,39,14,0,25,14
150811,3,22,9,2,13,7
150811,2,19,7,1,12,6
150811,1,16,8,0,8,8
150605,8,25,9,0,16,9
150605,7,48,5,0,43,5
150605,6,81,13,0,68,13
150605,5,36,8,0,28,8
150605,4,27,7,0,20,7
150605,3,10,2,0,8,2
150605,2,4,2,0,2,2
4962,10,9,5,0,4,5
4962,9,6,2,0,4,2
4962,8,17,9,0,8,9
4962,7,27,9,0,18,9
4962,6,80,26,0,54,26
4962,5,47,20,0,27,20
4962,4,31,11,0,20,11
4962,3,12,4,0,8,4
4962,2,7,1,0,6,1
150930,10,5,1,0,4,1
150930,8,30,10,0,20,10
150930,7,51,5,0,46,5
150930,6,92,16,0,76,16
150930,5,39,5,0,34,5
150930,4,13,3,0,10,3
150930,3,4,1,0,3,1
2667,10,14,9,0,5,9
2667,9,23,10,0,13,10
2667,8,47,25,0,22,25
2667,7,60,18,0,42,18
2667,6,54,15,0,39,15
2667,5,23,8,0,15,8
2667,4,13,6,0,7,6
2667,3,2,1,0,1,1
4062,9,3,1,0,2,1
4062,7,20,5,0,15,5
4062,6,61,15,0,46,15
4062,5,61,15,0,46,15
4062,4,41,9,0,32,9
4062,3,22,8,0,14,8
4062,2,12,7,0,5,7
4062,1,4,3,0,1,3
244141,10,4,2,0,2,2
244141,9,7,3,0,4,3
244141,8,92,13,0,79,13
244141,7,62,8,0,54,8
244141,6,51,11,0,40,11
244141,4,9,4,0,5,4
244141,3,5,1,0,4,1
127994,10,6,1,0,5,1
127994,9,4,1,0,3,1
127994,8,23,7,0,16,7
127994,7,39,7,0,32,7
127994,6,73,17,0,56,17
127994,5,47,9,2,38,7
127994,4,24,3,1,21,2
127994,3,11,5,0,6,5
127994,2,8,4,0,4,4
127994,1,2,1,0,1,1
102690,10,5,2,0,3,2
102690,9,13,5,0,8,5
102690,8,50,12,0,38,12
102690,7,59,10,2,49,8
102690,6,72,11,1,61,10
102690,5,18,3,0,15,3
102690,4,14,3,0,11,3
102690,3,3,1,0,2,1
102690,2,2,1,0,1,1
170437,10,8,4,0,4,4
170437,9,15,6,0,9,6
170437,8,31,5,0,26,5
170437,7,45,8,1,37,7
170437,6,75,9,0,66,9
170437,5,37,8,0,29,8
170437,4,15,3,0,12,3
170437,3,8,1,0,7,1
144567,10,17,5,0,12,5
144567,9,31,12,0,19,12
144567,8,83,19,0,64,19
144567,7,47,9,0,38,9
144567,6,36,9,0,27,9
144567,5,8,5,0,3,5
144567,4,7,3,0,4,3
144567,3,6,1,0,5,1
623,10,9,4,0,5,4
623,9,18,9,0,9,9
623,8,57,20,0,37,20
623,7,65,17,0,48,17
623,6,50,9,0,41,9
623,5,24,6,0,18,6
623,4,8,5,0,3,5
623,3,3,2,0,1,2
623,2,2,2,0,0,2
11883,7,40,8,0,32,8
11883,6,67,18,0,49,18
11883,5,48,6,0,42,6
11883,4,35,14,0,21,14
11883,3,20,7,0,13,7
11883,2,6,1,0,5,1
803,10,3,1,0,2,1
803,8,16,5,0,11,5
803,7,33,13,0,20,13
803,6,89,32,0,57,32
803,5,54,14,0,40,14
803,4,24,9,0,15,9
803,3,10,6,0,4,6
803,2,3,1,0,2,1
228580,10,10,1,0,9,1
228580,9,27,9,2,18,7
228580,8,81,20,1,61,19
228580,7,56,14,5,42,9
228580,6,38,8,1,30,7
228580,5,17,4,0,13,4
228580,4,4,2,0,2,2
228580,3,3,1,0,2,1
41054,9,5,1,0,4,1
41054,8,32,9,0,23,9
41054,7,48,9,0,39,9
41054,6,69,13,0,56,13
41054,5,46,10,0,36,10
41054,4,23,4,0,19,4
41054,2,4,1,0,3,1
102940,10,4,1,0,3,1
102940,9,3,1,0,2,1
102940,8,16,5,0,11,5
102940,7,46,9,0,37,9
102940,6,85,22,0,63,22
102940,5,44,15,0,29,15
102940,4,22,4,0,18,4
102940,3,7,4,0,3,4
102940,1,3,1,0,2,1
8957,10,9,4,0,5,4
8957,9,21,2,0,19,2
8957,8,30,8,0,22,8
8957,7,60,13,0,47,13
8957,6,75,20,0,55,20
8957,5,26,7,0,19,7
8957,4,10,3,0,7,3
8957,3,4,1,0,3,1
229453,9,7,1,0,6,1
229453,8,42,7,0,35,7
229453,7,62,9,0,53,9
229453,6,71,12,0,59,12
229453,5,35,8,0,27,8
229453,4,9,2,0,7,2
229453,3,4,1,0,3,1
29140,9,8,3,0,5,3
29140,8,47,15,0,32,15
29140,7,72,22,0,50,22
29140,6,75,24,0,51,24
29140,5,25,8,0,17,8
29140,4,3,2,0,1,2
29140,3,2,1,0,1,1
29736,10,2,1,0,1,1
29736,8,14,5,0,9,5
29736,7,47,14,0,33,14
29736,6,86,28,0,58,28
29736,5,39,8,0,31,8
29736,4,27,9,0,18,9
29736,3,12,7,0,5,7
29736,2,7,4,0,3,4
29736,1,1,1,0,0,1
180975,10,6,2,0,4,2
180975,8,33,6,0,27,6
180975,7,38,10,1,28,9
180975,6,63,10,4,53,6
180975,5,41,11,2,30,9
180975,4,19,2,0,17,2
180975,3,15,7,0,8,7
180975,2,6,4,0,2,4
180975,1,10,6,2,4,4
1722,10,2,1,0,1,1
1722,9,3,3,0,0,3
1722,8,24,8,0,16,8
1722,7,57,23,0,34,23
1722,6,94,23,0,71,23
1722,5,37,10,0,27,10
1722,4,12,3,0,9,3
1722,3,5,3,0,2,3
1722,1,1,1,0,0,1
30216,10,14,5,0,9,5
30216,9,25,7,0,18,7
30216,8,67,22,0,45,22
30216,7,60,17,0,43,17
30216,6,32,8,0,24,8
30216,5,17,5,0,12,5
30216,4,15,5,0,10,5
30216,3,1,1,0,0,1
30216,2,2,2,0,0,2
30216,1,2,2,0,0,2
229598,9,18,2,0,16,2
229598,8,44,4,0,40,4
229598,7,74,7,0,67,7
229598,6,57,14,0,43,14
229598,5,22,5,0,17,5
229598,4,7,1,0,6,1
229598,3,3,1,0,2,1
15393,8,5,4,0,1,4
15393,7,12,2,0,10,2
15393,6,24,7,0,17,7
15393,5,38,9,0,29,9
15393,4,51,14,0,37,14
15393,3,48,14,0,34,14
15393,2,35,7,0,28,7
15393,1,21,5,0,16,5
1362,10,1,1,0,0,1
1362,9,4,2,0,2,2
1362,8,15,5,0,10,5
1362,7,21,6,0,15,6
1362,6,66,13,0,53,13
1362,5,42,8,0,34,8
1362,4,43,12,0,31,12
1362,3,17,5,0,12,5
1362,2,20,7,0,13,7
1362,1,5,4,0,1,4
94891,8,12,2,0,10,2
94891,7,28,1,0,27,1
94891,6,80,13,0,67,13
94891,5,64,10,0,54,10
94891,4,28,8,0,20,8
94891,3,11,2,0,9,2
94891,2,8,4,0,4,4
94891,1,1,1,0,0,1
459,10,5,1,0,4,1
459,9,14,6,0,8,6
459,8,59,16,0,43,16
459,7,70,26,0,44,26
459,6,58,21,0,37,21
459,5,19,6,0,13,6
459,4,7,3,0,4,3
26047,9,4,2,0,2,2
26047,8,31,11,0,20,11
26047,7,47,17,0,30,17
26047,6,77,24,0,53,24
26047,5,43,8,0,35,8
26047,4,13,4,0,9,4
26047,3,10,4,0,6,4
26047,2,5,3,0,2,3
26047,1,1,1,0,0,1
139131,10,36,5,1,31,4
139131,9,56,10,0,46,10
139131,8,86,15,3,71,12
139131,7,31,5,0,26,5
139131,6,16,2,0,14,2
867,10,1,1,0,0,1
867,9,6,3,0,3,3
867,8,37,12,0,25,12
867,7,77,19,0,58,19
867,6,70,15,0,55,15
867,5,32,13,0,19,13
867,4,10,4,0,6,4
174260,10,14,1,0,13,1
174260,9,23,3,0,20,3
174260,8,53,11,0,42,11
174260,7,53,7,0,46,7
174260,6,50,6,0,44,6
174260,5,14,3,0,11,3
174260,4,12,1,0,11,1
174260,3,10,3,0,7,3
85204,10,32,10,0,22,10
85204,9,42,10,0,32,10
85204,8,78,13,0,65,13
85204,7,43,7,0,36,7
85204,6,18,5,0,13,5
85204,5,15,4,0,11,4
85204,3,3,1,0,2,1
85204,2,1,1,0,0,1
67361,10,10,3,0,7,3
67361,9,6,4,0,2,4
67361,8,52,15,0,37,15
67361,7,52,16,0,36,16
67361,6,68,25,0,43,25
67361,5,24,7,0,17,7
67361,4,10,2,0,8,2
67361,3,5,4,0,1,4
67361,2,7,4,0,3,4
103339,10,22,8,0,14,8
103339,9,44,15,0,29,15
103339,8,115,30,0,85,30
103339,7,34,9,0,25,9
103339,6,12,4,0,8,4
103339,3,1,1,0,0,1
13597,10,11,4,0,7,4
13597,9,15,5,0,10,5
13597,8,44,17,0,27,17
13597,7,54,19,0,35,19
13597,6,54,18,0,36,18
13597,5,31,11,0,20,11
13597,4,14,5,0,9,5
13597,3,5,2,0,3,2
13597,2,4,1,0,3,1
232303,9,5,1,0,4,1
232303,8,59,18,0,41,18
232303,7,87,23,0,64,23
232303,6,50,13,0,37,13
232303,5,24,5,0,19,5
232303,3,3,2,0,1,2
165346,10,41,27,3,14,24
165346,9,37,10,2,27,8
165346,8,49,12,3,37,9
165346,7,32,6,1,26,5
165346,6,49,10,2,39,8
165346,5,8,2,0,6,2
165346,4,14,1,0,13,1
165004,10,24,5,0,19,5
165004,9,37,11,0,26,11
165004,8,80,8,0,72,8
165004,7,53,6,0,47,6
165004,6,33,9,0,24,9
165004,5,5,2,0,3,2
166776,10,45,13,1,32,12
166776,9,51,12,1,39,11
166776,8,60,10,0,50,10
166776,7,34,4,0,30,4
166776,6,27,2,1,25,1
166776,5,8,2,0,6,2
166776,3,2,1,0,1,1
245710,10,8,1,0,7,1
245710,9,10,2,0,8,2
245710,8,27,5,0,22,5
245710,7,52,4,0,48,4
245710,6,62,8,0,54,8
245710,5,35,2,0,33,2
245710,4,24,4,0,20,4
245710,2,3,1,0,2,1
4004,9,3,3,0,0,3
4004,8,2,1,0,1,1
4004,7,9,4,0,5,4
4004,6,35,12,0,23,12
4004,5,44,11,0,33,11
4004,4,57,22,0,35,22
4004,3,39,22,0,17,22
4004,2,34,12,0,22,12
4004,1,9,5,0,4,5
4329,8,5,3,0,2,3
4329,7,30,7,0,23,7
4329,6,107,22,0,85,22
4329,5,52,22,0,30,22
4329,4,24,5,0,19,5
4329,3,11,3,0,8,3
4329,2,2,2,0,0,2
3034,10,18,4,0,14,4
3034,9,5,3,0,2,3
3034,8,19,8,0,11,8
3034,7,37,8,0,29,8
3034,6,76,19,0,57,19
3034,5,43,8,0,35,8
3034,4,20,7,0,13,7
3034,3,10,2,0,8,2
3034,2,4,2,0,2,2
3034,1,2,1,0,1,1
14441,10,4,1,0,3,1
14441,8,23,10,0,13,10
14441,7,41,20,0,21,20
14441,6,67,15,0,52,15
14441,5,47,15,0,32,15
14441,4,30,5,0,25,5
14441,3,7,3,0,4,3
14441,2,6,3,0,3,3
2881,10,2,1,0,1,1
2881,9,7,4,0,3,4
2881,8,45,13,0,32,13
2881,7,54,12,0,42,12
2881,6,59,15,0,44,15
2881,5,34,11,0,23,11
2881,4,18,11,0,7,11
2881,3,8,5,0,3,5
2881,2,6,4,0,2,4
206859,10,7,3,0,4,3
206859,9,23,4,0,19,4
206859,8,60,14,0,46,14
206859,7,65,12,0,53,12
206859,6,47,8,1,39,7
206859,5,12,1,0,11,1
206859,4,12,5,0,7,5
206859,3,4,2,0,2,2
206859,2,3,1,0,2,1
39045,10,5,1,0,4,1
39045,9,5,3,0,2,3
39045,8,45,14,0,31,14
39045,7,64,19,0,45,19
39045,6,65,18,0,47,18
39045,5,22,8,0,14,8
39045,4,18,10,0,8,10
39045,3,8,2,0,6,2
68260,10,9,3,0,6,3
68260,9,26,11,0,15,11
68260,8,87,29,0,58,29
68260,7,65,19,0,46,19
68260,6,29,7,0,22,7
68260,5,10,3,0,7,3
68260,4,4,3,0,1,3
68260,3,3,2,0,1,2
172896,9,18,8,0,10,8
172896,8,58,14,2,44,12
172896,7,68,7,0,61,7
172896,6,55,7,0,48,7
172896,5,15,2,0,13,2
172896,4,3,2,0,1,2
172896,3,4,3,0,1,3
38287,9,3,1,0,2,1
38287,8,17,5,0,12,5
38287,7,53,22,0,31,22
38287,6,78,20,0,58,20
38287,5,41,14,0,27,14
38287,4,18,6,0,12,6
38287,3,17,10,0,7,10
38287,2,5,3,0,2,3
12168,10,5,4,0,1,4
12168,8,18,7,0,11,7
12168,7,32,10,0,22,10
12168,6,77,22,0,55,22
12168,5,57,18,0,39,18
12168,4,29,13,0,16,13
12168,3,9,3,0,6,3
12168,2,2,2,0,0,2
12168,1,2,1,0,1,1
244794,10,4,1,0,3,1
244794,9,4,1,0,3,1
244794,8,43,6,0,37,6
244794,7,63,10,0,53,10
244794,6,79,18,0,61,18
244794,5,27,5,0,22,5
244794,4,10,1,0,9,1
244794,3,5,2,0,3,2
185021,10,3,1,0,2,1
185021,9,10,3,0,7,3
185021,8,63,16,1,47,15
185021,7,67,10,0,57,10
185021,6,63,12,1,51,11
185021,5,17,3,0,14,3
185021,4,8,2,0,6,2
42980,9,5,1,0,4,1
42980,8,19,6,0,13,6
42980,7,48,12,0,36,12
42980,6,69,15,0,54,15
42980,5,38,10,0,28,10
42980,4,20,7,0,13,7
42980,3,16,8,0,8,8
42980,2,16,8,0,8,8
3676,9,2,1,0,1,1
3676,8,11,5,0,6,5
3676,7,28,12,0,16,12
3676,6,61,15,0,46,15
3676,5,57,19,0,38,19
3676,4,39,14,0,25,14
3676,3,15,4,0,11,4
3676,2,13,5,0,8,5
3676,1,4,1,0,3,1
26961,9,3,1,0,2,1
26961,8,46,20,0,26,20
26961,7,61,22,0,39,22
26961,6,70,31,0,39,31
26961,5,22,11,0,11,11
26961,4,17,7,1,10,6
26961,3,9,2,0,7,2
26961,2,5,1,0,4,1
204615,10,1,1,0,0,1
204615,8,43,8,0,35,8
204615,7,65,11,0,54,11
204615,6,71,8,0,63,8
204615,5,27,4,0,23,4
204615,4,12,2,0,10,2
204615,3,11,1,0,10,1
92644,9,13,3,0,10,3
92644,8,60,9,0,51,9
92644,7,70,14,0,56,14
92644,6,60,4,0,56,4
92644,5,10,1,0,9,1
92644,4,9,1,0,8,1
618,10,13,4,0,9,4
618,9,13,7,0,6,7
618,8,23,7,0,16,7
618,7,50,13,0,37,13
618,6,58,18,0,40,18
618,5,33,10,0,23,10
618,4,17,8,0,9,8
618,3,18,10,0,8,10
618,2,6,2,0,4,2
618,1,2,1,0,1,1
6203,10,26,10,0,16,10
6203,9,32,8,0,24,8
6203,8,85,23,0,62,23
6203,7,45,8,0,37,8
6203,6,23,7,0,16,7
6203,5,12,4,0,8,4
6203,4,5,1,0,4,1
6203,3,1,1,0,0,1
6203,1,2,1,0,1,1
54372,9,3,1,0,2,1
54372,8,30,13,0,17,13
54372,7,70,15,0,55,15
54372,6,69,31,0,38,31
54372,5,31,16,0,15,16
54372,4,18,9,0,9,9
54372,3,6,3,0,3,3
162351,10,18,2,0,16,2
162351,9,29,3,0,26,3
162351,8,67,8,2,59,6
162351,7,65,13,1,52,12
162351,6,33,4,0,29,4
162351,4,4,1,0,3,1
162351,2,1,1,0,0,1
162351,1,3,1,0,2,1
41291,8,24,6,0,18,6
41291,7,61,8,0,53,8
41291,6,77,10,0,67,10
41291,5,36,4,0,32,4
41291,4,21,1,0,20,1
41291,3,7,1,0,6,1
176980,10,4,2,0,2,2
176980,9,16,6,1,10,5
176980,8,76,27,1,49,26
176980,7,63,15,0,48,15
176980,6,49,11,0,38,11
176980,4,11,6,0,5,6
176980,1,1,1,0,0,1
1312,10,4,2,0,2,2
1312,9,5,3,0,2,3
1312,8,28,8,0,20,8
1312,7,54,17,0,37,17
1312,6,74,20,0,54,20
1312,5,31,12,0,19,12
1312,4,24,8,0,16,8
1312,3,10,3,0,7,3
1312,2,3,2,0,1,2
8689,8,2,1,0,1,1
8689,7,6,2,0,4,2
8689,6,12,5,0,7,5
8689,5,33,8,0,25,8
8689,4,39,10,0,29,10
8689,3,40,13,0,27,13
8689,2,37,17,0,20,17
8689,1,64,41,0,23,41
1314,9,3,1,0,2,1
1314,8,26,7,0,19,7
1314,7,39,13,0,26,13
1314,6,84,27,0,57,27
1314,5,39,17,0,22,17
1314,4,23,10,0,13,10
1314,3,11,5,0,6,5
1314,1,3,1,0,2,1
192827,9,4,1,0,3,1
192827,8,30,3,0,27,3
192827,7,68,9,0,59,9
192827,6,91,14,1,77,13
192827,5,21,4,1,17,3
192827,4,15,4,1,11,3
192827,2,2,1,0,1,1
27609,9,5,2,0,3,2
27609,8,28,12,0,16,12
27609,7,44,21,1,23,20
27609,6,96,29,1,67,28
27609,5,34,18,0,16,18
27609,4,14,3,0,11,3
27609,3,8,6,0,2,6
27609,2,1,1,0,0,1
198,9,5,1,0,4,1
198,8,20,8,0,12,8
198,7,52,17,0,35,17
198,6,87,32,0,55,32
198,5,38,8,0,30,8
198,4,20,9,0,11,9
198,3,8,3,0,5,3
37362,8,22,6,0,16,6
37362,7,72,19,0,53,19
37362,6,88,18,0,70,18
37362,5,30,5,0,25,5
37362,4,11,3,0,8,3
37362,3,1,1,0,0,1
32989,10,51,20,0,31,20
32989,9,69,12,0,57,12
32989,8,69,21,0,48,21
32989,7,24,3,0,21,3
32989,6,10,3,0,7,3
32989,5,6,1,0,5,1
32989,4,1,1,0,0,1
32989,3,1,1,0,0,1
215471,9,27,7,0,20,7
215471,8,91,14,0,77,14
215471,7,62,10,0,52,10
215471,6,35,10,0,25,10
140101,10,8,1,0,7,1
140101,9,6,3,1,3,2
140101,8,33,10,0,23,10
140101,7,57,7,0,50,7
140101,6,80,10,0,70,10
140101,5,26,5,0,21,5
140101,4,15,5,1,10,4
140101,3,3,2,0,1,2
140101,2,4,2,0,2,2
1837,8,13,7,0,6,7
1837,7,18,6,0,12,6
1837,6,53,10,0,43,10
1837,5,62,17,0,45,17
1837,4,45,8,0,37,8
1837,3,20,7,0,13,7
1837,2,12,5,0,7,5
1837,1,6,2,0,4,2
112210,10,8,1,0,7,1
112210,9,7,1,0,6,1
112210,8,17,7,0,10,7
112210,7,56,6,0,50,6
112210,6,60,10,0,50,10
112210,5,37,4,0,33,4
112210,4,19,3,0,16,3
112210,3,18,4,0,14,4
87893,8,25,5,0,20,5
87893,7,45,10,0,35,10
87893,6,101,17,0,84,17
87893,5,35,10,0,25,10
87893,4,11,2,0,9,2
87893,3,6,3,0,3,3
87893,2,3,2,0,1,2
155495,10,4,1,0,3,1
155495,9,6,1,0,5,1
155495,8,44,17,0,27,17
155495,7,75,19,0,56,19
155495,6,70,13,0,57,13
155495,5,20,5,0,15,5
155495,4,8,1,0,7,1
129368,9,3,1,0,2,1
129368,8,5,1,0,4,1
129368,7,26,5,0,21,5
129368,6,61,7,0,54,7
129368,5,57,11,0,46,11
129368,4,43,11,0,32,11
129368,3,22,2,0,20,2
129368,2,8,1,0,7,1
129368,1,3,1,0,2,1
20078,10,7,3,0,4,3
20078,9,17,5,0,12,5
20078,8,99,26,0,73,26
20078,7,65,24,0,41,24
20078,6,33,9,0,24,9
20078,5,5,5,0,0,5
20078,4,5,1,0,4,1
20078,3,1,1,0,0,1
27948,9,4,3,0,1,3
27948,8,17,9,0,8,9
27948,7,47,10,0,37,10
27948,6,83,17,0,66,17
27948,5,48,13,0,35,13
27948,4,23,4,0,19,4
27948,3,10,4,0,6,4
10213,8,6,1,0,5,1
10213,7,16,6,0,10,6
10213,6,55,13,0,42,13
10213,5,63,19,0,44,19
10213,4,48,15,0,33,15
10213,3,27,11,0,16,11
10213,2,12,5,0,7,5
10213,1,5,2,0,3,2
2901,10,4,1,0,3,1
2901,8,8,4,0,4,4
2901,7,29,11,0,18,11
2901,6,59,13,0,46,13
2901,5,49,17,0,32,17
2901,4,47,14,0,33,14
2901,3,15,5,0,10,5
2901,2,14,5,0,9,5
2901,1,5,2,0,3,2
2421,9,3,1,0,2,1
2421,8,9,2,0,7,2
2421,7,26,5,0,21,5
2421,6,62,16,0,46,16
2421,5,55,11,0,44,11
2421,4,48,11,0,37,11
2421,3,21,6,0,15,6
2421,2,6,2,0,4,2
2421,1,1,1,0,0,1
112192,10,4,1,0,3,1
112192,9,12,3,0,9,3
112192,8,37,8,0,29,8
112192,7,80,15,0,65,15
112192,6,73,13,0,60,13
112192,5,22,4,0,18,4
112192,3,1,1,0,0,1
27574,10,11,6,1,5,5
27574,9,10,2,0,8,2
27574,8,29,6,0,23,6
27574,7,62,18,2,44,16
27574,6,67,17,0,50,17
27574,5,29,7,1,22,6
27574,4,14,4,1,10,3
27574,3,7,1,0,6,1
27574,2,2,1,0,1,1
577,10,3,1,0,2,1
577,9,6,3,0,3,3
577,8,27,15,0,12,15
577,7,38,13,0,25,13
577,6,72,21,0,51,21
577,5,58,15,0,43,15
577,4,19,8,0,11,8
577,3,6,4,0,2,4
122313,9,1,1,0,0,1
122313,8,22,6,0,16,6
122313,7,68,7,0,61,7
122313,6,81,14,0,67,14
122313,5,30,8,0,22,8
122313,4,14,4,0,10,4
122313,3,7,2,0,5,2
122313,2,5,3,0,2,3
122313,1,2,2,0,0,2
2249,10,7,2,0,5,2
2249,9,9,4,0,5,4
2249,8,18,5,0,13,5
2249,7,40,21,0,19,21
2249,6,79,28,0,51,28
2249,5,44,14,0,30,14
2249,4,27,13,0,14,13
2249,3,3,3,0,0,3
2249,2,4,3,0,1,3
2778,10,6,1,0,5,1
2778,9,3,1,0,2,1
2778,8,23,7,0,16,7
2778,7,55,14,0,41,14
2778,6,78,27,0,51,27
2778,5,45,10,0,35,10
2778,4,14,3,0,11,3
2778,3,5,4,0,1,4
2778,2,2,2,0,0,2
18580,10,4,2,0,2,2
18580,9,8,6,0,2,6
18580,8,17,4,0,13,4
18580,7,44,20,0,24,20
18580,6,69,26,0,43,26
18580,5,46,12,0,34,12
18580,4,22,8,0,14,8
18580,3,10,6,0,4,6
18580,2,11,5,0,6,5
85245,8,32,10,0,22,10
85245,7,47,14,0,33,14
85245,6,87,19,0,68,19
85245,5,38,7,0,31,7
85245,4,11,6,0,5,6
85245,3,6,1,0,5,1
85245,2,2,1,0,1,1
1073,9,4,1,0,3,1
1073,8,5,3,0,2,3
1073,7,14,2,0,12,2
1073,6,61,10,0,51,10
1073,5,66,18,0,48,18
1073,4,46,10,0,36,10
1073,3,18,3,0,15,3
1073,2,12,3,0,9,3
1073,1,5,3,0,2,3
32471,10,5,1,0,4,1
32471,9,9,1,0,8,1
32471,8,25,4,0,21,4
32471,7,24,3,0,21,3
32471,6,63,3,0,60,3
32471,5,55,3,0,52,3
32471,4,21,3,0,18,3
32471,3,14,1,0,13,1
32471,2,12,1,0,11,1
32471,1,3,1,0,2,1
164775,9,9,4,0,5,4
164775,8,36,7,1,29,6
164775,7,49,10,4,39,6
164775,6,78,18,2,60,16
164775,5,25,8,0,17,8
164775,4,19,5,2,14,3
164775,3,9,3,0,6,3
164775,2,4,1,0,3,1
164775,1,1,1,0,0,1
19484,10,3,1,0,2,1
19484,8,15,2,0,13,2
19484,7,22,1,0,21,1
19484,6,74,10,0,64,10
19484,5,56,6,0,50,6
19484,4,32,5,0,27,5
19484,3,16,2,0,14,2
19484,2,7,2,0,5,2
19484,1,3,1,0,2,1
73472,9,7,4,0,3,4
73472,8,36,11,0,25,11
73472,7,50,11,2,39,9
73472,6,72,15,1,57,14
73472,5,30,10,0,20,10
73472,4,19,8,0,11,8
73472,3,6,4,0,2,4
73472,2,7,3,0,4,3
73472,1,2,1,0,1,1
257058,10,2,1,0,1,1
257058,9,8,2,0,6,2
257058,8,78,7,0,71,7
257058,7,80,9,0,71,9
257058,6,46,9,0,37,9
257058,5,10,2,0,8,2
257058,4,8,2,0,6,2
36480,10,12,5,0,7,5
36480,9,9,4,0,5,4
36480,8,45,12,0,33,12
36480,7,59,16,0,43,16
36480,6,54,17,0,37,17
36480,5,21,7,0,14,7
36480,4,16,7,0,9,7
36480,3,8,5,0,3,5
36480,2,5,2,0,3,2
36480,1,1,1,0,0,1
32969,9,4,1,0,3,1
32969,8,18,6,0,12,6
32969,7,49,11,0,38,11
32969,6,70,22,0,48,22
32969,5,35,9,0,26,9
32969,4,24,6,0,18,6
32969,3,14,4,0,10,4
32969,2,10,3,0,7,3
32969,1,5,2,0,3,2
181867,10,4,1,0,3,1
181867,9,6,1,0,5,1
181867,8,36,3,0,33,3
181867,7,85,19,0,66,19
181867,6,71,18,0,53,18
181867,5,19,4,0,15,4
181867,4,7,1,0,6,1
191579,10,17,2,0,15,2
191579,9,19,2,0,17,2
191579,8,67,6,0,61,6
191579,7,64,8,0,56,8
191579,6,44,8,0,36,8
191579,4,4,1,0,3,1
191579,3,3,1,0,2,1
191579,2,1,1,0,0,1
191579,1,2,1,0,1,1
31512,9,7,3,0,4,3
31512,8,23,5,0,18,5
31512,7,44,15,0,29,15
31512,6,57,19,0,38,19
31512,5,34,15,0,19,15
31512,4,41,18,0,23,18
31512,3,16,8,0,8,8
31512,2,7,4,0,3,4
31512,1,1,1,0,0,1
32409,8,18,4,0,14,4
32409,7,41,2,0,39,2
32409,6,70,7,0,63,7
32409,5,38,6,0,32,6
32409,4,30,1,0,29,1
32409,3,13,2,0,11,2
32409,2,6,2,0,4,2
32409,1,5,2,0,3,2
4085,10,4,3,0,1,3
4085,9,8,4,0,4,4
4085,8,42,19,0,23,19
4085,7,68,30,0,38,30
4085,6,66,28,0,38,28
4085,5,28,13,0,15,13
4085,4,12,6,0,6,6
4085,3,2,1,0,1,1
4085,2,1,1,0,0,1
188181,10,3,1,0,2,1
188181,9,5,3,0,2,3
188181,8,46,8,1,38,7
188181,7,69,16,2,53,14
188181,6,62,10,1,52,9
188181,5,26,8,0,18,8
188181,4,13,4,0,9,4
188181,3,4,2,0,2,2
39872,9,5,2,0,3,2
39872,8,21,9,0,12,9
39872,7,33,10,0,23,10
39872,6,78,19,0,59,19
39872,5,48,15,0,33,15
39872,4,33,5,0,28,5
39872,3,7,3,0,4,3
39872,2,3,1,0,2,1
38904,10,4,1,0,3,1
38904,9,7,2,0,5,2
38904,8,39,8,0,31,8
38904,7,63,18,0,45,18
38904,6,77,28,0,49,28
38904,5,27,8,0,19,8
38904,4,9,1,0,8,1
6711,10,1,1,0,0,1
6711,6,34,9,0,25,9
6711,5,80,17,0,63,17
6711,4,56,18,0,38,18
6711,3,31,13,0,18,13
6711,2,11,4,0,7,4
6711,1,10,2,0,8,2
179217,10,4,1,0,3,1
179217,9,9,1,0,8,1
179217,8,32,2,0,30,2
179217,7,59,9,0,50,9
179217,6,78,11,0,67,11
179217,5,27,2,0,25,2
179217,4,14,3,0,11,3
158882,10,5,1,0,4,1
158882,9,5,1,0,4,1
158882,8,29,10,0,19,10
158882,7,60,23,0,37,23
158882,6,78,21,0,57,21
158882,5,37,13,0,24,13
158882,4,10,2,0,8,2
158882,3,4,1,0,3,1
205078,9,14,2,0,12,2
205078,8,42,9,0,33,9
205078,7,57,13,0,44,13
205078,6,61,11,0,50,11
205078,5,23,6,0,17,6
205078,4,8,1,0,7,1
205078,3,12,5,0,7,5
205078,2,5,3,0,2,3
77076,9,3,2,0,1,2
77076,8,18,4,0,14,4
77076,7,37,6,0,31,6
77076,6,88,19,0,69,19
77076,5,39,8,0,31,8
77076,4,15,2,0,13,2
77076,3,5,2,0,3,2
37982,10,7,4,0,3,4
37982,9,10,7,0,3,7
37982,8,28,10,0,18,10
37982,7,58,22,0,36,22
37982,6,74,20,0,54,20
37982,5,30,6,0,24,6
37982,4,12,5,0,7,5
37982,3,7,4,0,3,4
37982,2,3,3,0,0,3
124622,10,6,4,0,2,4
124622,9,19,7,0,12,7
124622,8,84,27,0,57,27
124622,7,77,24,0,53,24
124622,6,32,9,0,23,9
124622,5,9,3,0,6,3
124622,3,1,1,0,0,1
27789,8,21,1,0,20,1
27789,7,48,12,0,36,12
27789,6,83,22,0,61,22
27789,5,31,8,0,23,8
27789,4,17,9,0,8,9
27789,3,15,9,0,6,9
27789,1,2,1,0,1,1
256874,10,27,9,0,18,9
256874,9,54,9,0,45,9
256874,8,94,15,0,79,15
256874,7,31,3,0,28,3
256874,6,14,2,0,12,2
256874,4,4,1,0,3,1
166532,8,10,1,0,9,1
166532,7,37,8,0,29,8
166532,6,88,24,0,64,24
166532,5,57,10,0,47,10
166532,4,21,5,0,16,5
166532,3,10,2,0,8,2
166532,2,1,1,0,0,1
166532,1,1,1,0,0,1
217547,10,6,1,0,5,1
217547,9,9,2,0,7,2
217547,8,27,10,1,17,9
217547,7,57,10,0,47,10
217547,6,77,14,1,63,13
217547,5,33,9,0,24,9
217547,4,13,4,0,9,4
217547,3,3,1,0,2,1
217547,2,2,2,1,0,1
217547,1,2,1,0,1,1
6549,10,5,2,0,3,2
6549,9,3,2,0,1,2
6549,8,7,3,0,4,3
6549,7,13,9,0,4,9
6549,6,29,18,0,11,18
6549,5,32,16,0,16,16
6549,4,56,29,0,27,29
6549,3,40,19,0,21,19
6549,2,29,11,0,18,11
6549,1,15,4,0,11,4
76207,10,10,5,0,5,5
76207,9,16,7,0,9,7
76207,8,46,14,0,32,14
76207,7,62,17,0,45,17
76207,6,49,14,0,35,14
76207,5,28,12,0,16,12
76207,4,11,6,0,5,6
76207,3,3,2,0,1,2
76207,2,4,2,0,2,2
239826,9,8,3,0,5,3
239826,8,44,11,0,33,11
239826,7,68,10,0,58,10
239826,6,73,15,0,58,15
239826,5,20,2,0,18,2
239826,4,8,2,0,6,2
239826,3,4,1,0,3,1
239826,2,2,1,0,1,1
239826,1,2,1,0,1,1
32260,8,3,1,0,2,1
32260,7,23,10,0,13,10
32260,6,43,8,0,35,8
32260,5,45,11,0,34,11
32260,4,43,12,1,31,11
32260,3,28,11,0,17,11
32260,2,26,9,0,17,9
32260,1,14,3,0,11,3
256065,10,9,3,0,6,3
256065,9,21,4,0,17,4
256065,8,62,5,0,57,5
256065,7,77,17,0,60,17
256065,6,42,4,0,38,4
256065,4,4,1,0,3,1
6202,10,9,4,0,5,4
6202,9,19,6,0,13,6
6202,8,62,22,0,40,22
6202,7,56,10,0,46,10
6202,6,47,10,0,37,10
6202,5,22,5,0,17,5
6202,4,6,3,0,3,3
6202,3,2,1,0,1,1
6202,2,5,3,0,2,3
6202,1,1,1,0,0,1
18485,10,12,6,0,6,6
18485,9,41,12,0,29,12
18485,8,105,32,0,73,32
18485,7,43,9,0,34,9
18485,6,16,6,0,10,6
18485,5,4,2,0,2,2
18485,4,3,2,0,1,2
18485,3,3,1,0,2,1
3294,8,16,1,0,15,1
3294,7,32,1,0,31,1
3294,6,69,7,0,62,7
3294,5,49,5,0,44,5
3294,4,32,4,0,28,4
3294,3,14,4,0,10,4
3294,2,11,2,0,9,2
33924,10,9,7,0,2,7
33924,9,32,11,0,21,11
33924,8,84,20,0,64,20
33924,7,52,15,0,37,15
33924,6,34,9,0,25,9
33924,5,5,2,0,3,2
33924,4,6,1,0,5,1
33924,3,4,2,0,2,2
33924,2,2,1,0,1,1
56320,10,7,4,0,3,4
56320,9,15,6,0,9,6
56320,8,60,19,0,41,19
56320,7,62,21,0,41,21
56320,6,50,14,0,36,14
56320,5,21,12,0,9,12
56320,4,8,3,0,5,3
56320,2,3,1,0,2,1
181325,9,10,1,0,9,1
181325,8,41,6,0,35,6
181325,7,78,11,0,67,11
181325,6,70,11,0,59,11
181325,5,18,3,0,15,3
181325,4,4,1,0,3,1
181325,3,2,1,0,1,1
181325,2,2,1,0,1,1
226588,10,20,11,0,9,11
226588,9,46,18,2,28,16
226588,8,58,15,1,43,14
226588,7,50,9,0,41,9
226588,6,33,10,0,23,10
226588,5,10,4,0,6,4
226588,4,7,5,0,2,5
226588,3,3,2,0,1,2
13875,10,4,1,0,3,1
13875,9,5,3,0,2,3
13875,8,22,10,0,12,10
13875,7,52,12,0,40,12
13875,6,102,29,0,73,29
13875,5,29,4,0,25,4
13875,4,13,2,0,11,2
13875,3,2,1,0,1,1
2447,10,17,9,0,8,9
2447,9,31,11,0,20,11
2447,8,56,14,0,42,14
2447,7,49,11,0,38,11
2447,6,44,11,0,33,11
2447,5,20,4,0,16,4
2447,4,6,2,0,4,2
2447,3,2,1,0,1,1
88406,9,25,10,0,15,10
88406,8,67,30,0,37,30
88406,7,81,25,0,56,25
88406,6,41,14,0,27,14
88406,5,7,4,0,3,4
88406,3,3,1,0,2,1
88406,1,1,1,0,0,1
194923,10,67,28,2,39,26
194923,9,63,22,4,41,18
194923,8,54,14,1,40,13
194923,7,31,5,0,26,5
194923,6,10,5,0,5,5
194923,5,2,1,0,1,1
3625,10,5,2,0,3,2
3625,9,7,2,0,5,2
3625,8,19,5,0,14,5
3625,7,36,11,0,25,11
3625,6,81,28,0,53,28
3625,5,43,12,0,31,12
3625,4,30,13,0,17,13
3625,2,4,3,0,1,3
1205,10,1,1,0,0,1
1205,8,15,6,0,9,6
1205,7,45,8,0,37,8
1205,6,86,13,0,73,13
1205,5,38,7,0,31,7
1205,4,15,4,0,11,4
1205,3,6,1,0,5,1
162114,10,2,1,0,1,1
162114,9,4,2,0,2,2
162114,8,27,8,0,19,8
162114,7,80,15,0,65,15
162114,6,86,15,0,71,15
162114,5,20,4,0,16,4
162114,4,7,2,0,5,2
162114,3,2,1,0,1,1
2396,10,4,1,0,3,1
2396,9,14,6,0,8,6
2396,8,51,11,0,40,11
2396,7,71,17,0,54,17
2396,6,48,10,0,38,10
2396,5,18,4,0,14,4
2396,4,11,4,0,7,4
2396,3,5,2,0,3,2
2396,2,4,2,0,2,2
2396,1,2,1,0,1,1
77034,9,6,3,0,3,3
77034,8,24,8,0,16,8
77034,7,55,10,0,45,10
77034,6,71,18,0,53,18
77034,5,33,12,0,21,12
77034,4,22,3,0,19,3
77034,3,9,1,0,8,1
77034,2,4,2,0,2,2
142889,10,15,3,0,12,3
142889,9,31,10,0,21,10
142889,8,107,30,0,77,30
142889,7,40,8,0,32,8
142889,6,30,10,0,20,10
142889,5,1,1,0,0,1
142889,4,1,1,0,0,1
184372,10,6,1,0,5,1
184372,9,12,2,0,10,2
184372,8,35,6,0,29,6
184372,7,70,8,0,62,8
184372,6,68,9,0,59,9
184372,4,12,1,0,11,1
102144,10,18,4,0,14,4
102144,9,25,4,0,21,4
102144,8,71,7,0,64,7
102144,7,48,8,0,40,8
102144,6,46,11,0,35,11
102144,5,14,5,0,9,5
102144,3,2,1,0,1,1
2409,9,5,2,0,3,2
2409,8,16,2,0,14,2
2409,7,35,11,0,24,11
2409,6,70,22,0,48,22
2409,5,46,8,0,38,8
2409,4,19,5,0,14,5
2409,3,12,5,0,7,5
2409,2,5,1,0,4,1
2080,10,9,4,0,5,4
2080,9,5,4,0,1,4
2080,8,25,8,0,17,8
2080,7,53,17,0,36,17
2080,6,50,17,0,33,17
2080,5,39,11,0,28,11
2080,4,25,9,0,16,9
2080,3,13,7,0,6,7
2080,2,6,3,0,3,3
2080,1,2,1,0,1,1
173291,8,29,3,0,26,3
173291,7,54,4,0,50,4
173291,6,87,10,0,77,10
173291,5,35,4,0,31,4
173291,4,13,3,0,10,3
173291,3,5,3,0,2,3
4839,10,8,3,0,5,3
4839,9,11,4,0,7,4
4839,8,42,18,0,24,18
4839,7,59,16,0,43,16
4839,6,69,17,0,52,17
4839,5,27,6,0,21,6
4839,3,3,2,0,1,2
170537,10,8,2,0,6,2
170537,9,9,2,0,7,2
170537,8,43,9,1,34,8
170537,7,75,7,2,68,5
170537,6,60,10,1,50,9
170537,5,22,5,0,17,5
170537,4,8,2,0,6,2
170537,3,2,2,0,0,2
39914,9,5,1,0,4,1
39914,8,21,7,0,14,7
39914,7,47,18,0,29,18
39914,6,69,25,0,44,25
39914,5,38,14,0,24,14
39914,4,18,9,0,9,9
39914,3,10,2,0,8,2
39914,2,11,5,0,6,5
184704,10,10,2,0,8,2
184704,9,15,4,0,11,4
184704,8,55,13,0,42,13
184704,7,55,14,0,41,14
184704,6,55,9,0,46,9
184704,5,23,4,0,19,4
184704,4,6,1,0,5,1
184704,2,1,1,0,0,1
184704,1,2,1,0,1,1
27490,9,5,1,0,4,1
27490,8,36,8,0,28,8
27490,7,74,20,0,54,20
27490,6,78,24,0,54,24
27490,5,16,3,0,13,3
27490,4,13,6,0,7,6
27490,3,3,1,0,2,1
1738,9,10,3,0,7,3
1738,8,33,13,0,20,13
1738,7,55,17,0,38,17
1738,6,57,27,0,30,27
1738,5,38,11,0,27,11
1738,4,16,8,0,8,8
1738,3,7,3,0,4,3
1738,2,3,1,0,2,1
1738,1,4,4,0,0,4
104063,10,4,1,0,3,1
104063,9,3,1,0,2,1
104063,8,18,4,0,14,4
104063,7,38,10,0,28,10
104063,6,94,27,1,67,26
104063,5,38,10,0,28,10
104063,4,21,7,0,14,7
104063,3,8,4,0,4,4
3851,10,14,6,0,8,6
3851,9,14,5,0,9,5
3851,8,29,12,0,17,12
3851,7,42,12,0,30,12
3851,6,63,17,0,46,17
3851,5,30,6,0,24,6
3851,4,12,5,0,7,5
3851,3,19,7,0,12,7
3851,1,3,1,0,2,1
487,10,9,6,0,3,6
487,9,7,3,0,4,3
487,8,19,6,0,13,6
487,7,43,8,0,35,8
487,6,77,13,0,64,13
487,5,34,5,0,29,5
487,4,19,6,0,13,6
487,3,11,2,0,9,2
487,2,7,2,0,5,2
209538,10,3,1,0,2,1
209538,9,5,1,0,4,1
209538,8,28,5,0,23,5
209538,7,41,4,0,37,4
209538,6,72,11,1,61,10
209538,5,28,3,0,25,3
209538,4,25,7,1,18,6
209538,3,15,7,0,8,7
209538,1,4,1,0,3,1
109215,10,8,3,1,5,2
109215,9,12,4,1,8,3
109215,8,27,7,2,20,5
109215,7,44,14,2,30,12
109215,6,60,9,1,51,8
109215,5,30,9,3,21,6
109215,4,22,6,2,16,4
109215,3,13,6,0,7,6
109215,2,7,1,0,6,1
109215,1,3,1,0,2,1
98529,8,27,5,0,22,5
98529,7,51,24,0,27,24
98529,6,94,36,0,58,36
98529,5,33,8,0,25,8
98529,4,9,1,0,8,1
98529,3,6,4,0,2,4
98529,2,3,2,0,1,2
10183,10,15,7,0,8,7
10183,9,22,13,0,9,13
10183,8,72,26,0,46,26
10183,7,72,26,0,46,26
10183,6,27,12,0,15,12
39324,8,17,2,0,15,2
39324,7,40,4,0,36,4
39324,6,64,11,0,53,11
39324,5,48,9,0,39,9
39324,4,33,11,0,22,11
39324,3,9,2,0,7,2
39324,2,5,1,0,4,1
39324,1,1,1,0,0,1
30878,10,3,1,0,2,1
30878,9,10,5,0,5,5
30878,8,49,17,0,32,17
30878,7,63,19,0,44,19
30878,6,64,22,0,42,22
30878,5,23,13,0,10,13
30878,4,10,6,0,4,6
30878,3,4,1,0,3,1
119881,10,78,32,0,46,32
119881,9,48,14,0,34,14
119881,8,30,6,0,24,6
119881,7,19,4,1,15,3
119881,6,14,4,0,10,4
119881,5,7,1,0,6,1
119881,4,6,2,0,4,2
119881,3,2,1,0,1,1
119881,2,1,1,0,0,1
119881,1,21,11,0,10,11
153905,10,2,1,0,1,1
153905,9,12,3,0,9,3
153905,8,56,7,1,49,6
153905,7,62,13,1,49,12
153905,6,66,15,0,51,15
153905,5,15,3,0,12,3
153905,4,9,2,0,7,2
153905,2,4,1,0,3,1
119899,9,7,1,0,6,1
119899,8,29,6,1,23,5
119899,7,75,20,3,55,17
119899,6,81,15,1,66,14
119899,5,17,3,0,14,3
119899,4,13,5,0,8,5
87120,10,3,2,0,1,2
87120,9,7,1,0,6,1
87120,8,44,8,0,36,8
87120,7,69,10,0,59,10
87120,6,60,13,0,47,13
87120,5,27,4,0,23,4
87120,4,11,3,0,8,3
87120,2,2,2,0,0,2
257380,10,6,1,0,5,1
257380,9,6,2,0,4,2
257380,8,66,9,0,57,9
257380,7,92,18,0,74,18
257380,6,42,5,0,37,5
257380,5,7,1,0,6,1
257380,2,2,1,0,1,1
43365,9,5,1,0,4,1
43365,8,57,15,1,42,14
43365,7,73,16,1,57,15
43365,6,58,22,0,36,22
43365,5,14,9,0,5,9
43365,4,7,1,0,6,1
43365,3,7,3,0,4,3
25314,10,3,2,0,1,2
25314,9,10,3,0,7,3
25314,8,38,18,0,20,18
25314,7,70,24,0,46,24
25314,6,75,29,0,46,29
25314,5,22,9,0,13,9
25314,4,7,4,0,3,4
25314,3,1,1,0,0,1
5021,10,8,3,0,5,3
5021,9,6,3,0,3,3
5021,8,37,12,0,25,12
5021,7,46,11,0,35,11
5021,6,62,17,0,45,17
5021,5,32,6,0,26,6
5021,4,19,5,0,14,5
5021,3,10,5,0,5,5
5021,2,3,2,0,1,2
5021,1,3,3,0,0,3
2817,7,9,4,0,5,4
2817,6,74,16,0,58,16
2817,5,67,21,0,46,21
2817,4,43,15,0,28,15
2817,3,16,10,0,6,10
2817,2,9,5,0,4,5
68083,10,4,1,0,3,1
68083,9,4,1,0,3,1
68083,8,14,3,0,11,3
68083,7,35,6,0,29,6
68083,6,94,29,0,65,29
68083,5,42,10,0,32,10
68083,4,17,6,0,11,6
68083,3,11,4,0,7,4
68083,2,4,1,0,3,1
3183,9,11,5,0,6,5
3183,8,25,8,0,17,8
3183,7,50,14,0,36,14
3183,6,77,20,0,57,20
3183,5,32,15,0,17,15
3183,4,16,8,0,8,8
3183,3,7,6,0,1,6
3183,2,4,2,0,2,2
3183,1,2,1,0,1,1
220926,9,3,1,0,2,1
220926,8,34,4,0,30,4
220926,7,69,14,0,55,14
220926,6,59,3,0,56,3
220926,5,25,1,0,24,1
220926,4,21,3,0,18,3
220926,3,11,4,0,7,4
220926,2,3,2,0,1,2
85652,10,16,3,0,13,3
85652,9,28,7,0,21,7
85652,8,72,16,0,56,16
85652,7,49,9,0,40,9
85652,6,30,8,0,22,8
85652,5,15,3,0,12,3
85652,4,7,3,0,4,3
85652,3,2,1,0,1,1
85652,2,5,2,0,3,2
186475,10,8,4,0,4,4
186475,9,7,1,0,6,1
186475,8,32,2,0,30,2
186475,7,60,12,0,48,12
186475,6,68,10,0,58,10
186475,5,29,2,0,27,2
186475,4,14,5,0,9,5
186475,3,5,1,0,4,1
186475,1,1,1,0,0,1
181122,10,8,5,0,3,5
181122,9,13,6,0,7,6
181122,8,70,14,0,56,14
181122,7,67,9,0,58,9
181122,6,46,11,0,35,11
181122,5,7,1,0,6,1
181122,4,11,1,0,10,1
60035,10,2,1,0,1,1
60035,9,7,2,0,5,2
60035,8,18,5,0,13,5
60035,7,57,19,0,38,19
60035,6,76,21,0,55,21
60035,5,33,9,0,24,9
60035,4,19,7,0,12,7
60035,3,6,1,0,5,1
60035,2,7,3,0,4,3
9666,8,8,4,0,4,4
9666,7,20,4,0,16,4
9666,6,49,12,0,37,12
9666,5,49,17,0,32,17
9666,4,41,19,0,22,19
9666,3,30,13,0,17,13
9666,2,17,10,0,7,10
9666,1,11,7,0,4,7
235365,10,15,1,0,14,1
235365,9,17,2,0,15,2
235365,8,38,9,0,29,9
235365,7,74,7,0,67,7
235365,6,55,6,0,49,6
235365,5,18,1,0,17,1
235365,4,4,1,0,3,1
235365,2,2,2,0,0,2
2613,10,6,1,0,5,1
2613,9,15,7,0,8,7
2613,8,38,20,0,18,20
2613,7,55,24,0,31,24
2613,6,65,23,0,42,23
2613,5,30,12,0,18,12
2613,4,9,6,0,3,6
2613,3,5,3,0,2,3
2613,2,2,2,0,0,2
1326,8,5,1,0,4,1
1326,7,14,5,0,9,5
1326,6,78,25,0,53,25
1326,5,54,14,0,40,14
1326,4,35,13,0,22,13
1326,3,26,8,0,18,8
1326,2,10,4,0,6,4
26747,10,1,1,0,0,1
26747,9,4,2,0,2,2
26747,8,24,13,0,11,13
26747,7,52,17,0,35,17
26747,6,77,33,0,44,33
26747,5,43,15,0,28,15
26747,4,14,8,0,6,8
26747,3,6,4,0,2,4
26747,2,2,1,0,1,1
26747,1,2,1,0,1,1
257966,9,12,2,0,10,2
257966,8,61,10,0,51,10
257966,7,62,10,0,52,10
257966,6,60,13,0,47,13
257966,5,17,2,0,15,2
257966,4,10,5,0,5,5
257966,3,5,2,0,3,2
130729,8,18,3,0,15,3
130729,7,54,7,0,47,7
130729,6,84,8,0,76,8
130729,5,39,4,0,35,4
130729,4,14,6,0,8,6
130729,2,3,1,0,2,1
14042,9,4,1,0,3,1
14042,8,21,8,0,13,8
14042,7,57,5,0,52,5
14042,6,92,16,0,76,16
14042,5,36,5,0,31,5
14042,4,11,2,0,9,2
14042,1,1,1,0,0,1
220155,10,12,5,1,7,4
220155,9,20,5,0,15,5
220155,8,70,11,2,59,9
220155,7,65,9,0,56,9
220155,6,43,10,1,33,9
220155,5,10,2,0,8,2
220155,4,3,1,0,2,1
6187,9,5,1,0,4,1
6187,8,22,2,0,20,2
6187,7,33,4,0,29,4
6187,6,65,10,0,55,10
6187,5,46,14,0,32,14
6187,4,25,5,0,20,5
6187,3,16,6,0,10,6
6187,2,6,4,0,2,4
221643,8,14,3,0,11,3
221643,7,36,10,1,26,9
221643,6,81,13,1,68,12
221643,5,59,13,2,46,11
221643,4,14,4,2,10,2
221643,3,13,2,0,11,2
23908,9,6,3,0,3,3
23908,8,18,5,0,13,5
23908,7,53,15,0,38,15
23908,6,73,24,0,49,24
23908,5,40,14,0,26,14
23908,4,22,10,0,12,10
23908,3,10,2,0,8,2
23908,2,3,2,0,1,2
82216,9,3,1,0,2,1
82216,8,17,4,0,13,4
82216,7,32,6,0,26,6
82216,6,63,9,0,54,9
82216,5,49,11,0,38,11
82216,4,33,4,0,29,4
82216,3,11,3,0,8,3
82216,2,12,3,0,9,3
81850,9,5,2,0,3,2
81850,8,33,6,0,27,6
81850,7,58,9,0,49,9
81850,6,79,9,0,70,9
81850,5,30,4,0,26,4
81850,3,2,1,0,1,1
81850,2,1,1,0,0,1
2464,10,13,9,0,4,9
2464,9,21,8,0,13,8
2464,8,46,18,0,28,18
2464,7,62,21,0,41,21
2464,6,40,10,0,30,10
2464,5,21,6,0,15,6
2464,4,11,5,0,6,5
2464,3,6,5,0,1,5
2464,2,2,1,0,1,1
2464,1,2,1,0,1,1
154499,9,7,2,0,5,2
154499,8,31,7,0,24,7
154499,7,54,9,0,45,9
154499,6,80,18,0,62,18
154499,5,20,5,0,15,5
154499,4,21,5,0,16,5
154499,3,6,2,0,4,2
154499,2,5,3,0,2,3
232979,10,5,3,0,2,3
232979,9,16,4,0,12,4
232979,8,74,14,0,60,14
232979,7,61,8,0,53,8
232979,6,43,4,0,39,4
232979,5,12,1,0,11,1
232979,4,8,1,0,7,1
232979,2,4,2,0,2,2
9354,10,13,5,0,8,5
9354,9,9,1,0,8,1
9354,8,35,4,0,31,4
9354,7,55,2,0,53,2
9354,6,63,9,0,54,9
9354,5,24,1,0,23,1
9354,4,11,1,0,10,1
9354,2,7,1,0,6,1
9354,1,3,1,0,2,1
34639,10,12,6,0,6,6
34639,9,17,11,0,6,11
34639,8,73,25,0,48,25
34639,7,57,20,0,37,20
34639,6,47,19,0,28,19
34639,5,7,7,0,0,7
34639,4,8,4,0,4,4
34639,2,2,1,0,1,1
86177,10,9,3,0,6,3
86177,9,22,5,0,17,5
86177,8,71,24,0,47,24
86177,7,61,14,0,47,14
86177,6,42,17,0,25,17
86177,5,10,3,0,7,3
86177,4,4,3,0,1,3
86177,3,2,2,0,0,2
86177,2,3,1,0,2,1
20790,9,3,2,0,1,2
20790,8,8,2,0,6,2
20790,7,27,8,0,19,8
20790,6,72,19,0,53,19
20790,5,53,17,0,36,17
20790,4,32,11,0,21,11
20790,3,16,7,0,9,7
20790,2,10,3,0,7,3
247104,10,26,4,0,22,4
247104,9,67,19,0,48,19
247104,8,80,23,0,57,23
247104,7,30,2,0,28,2
247104,6,18,3,0,15,3
247104,5,3,1,0,2,1
39328,10,30,10,0,20,10
39328,9,61,21,0,40,21
39328,8,80,23,0,57,23
39328,7,28,6,0,22,6
39328,6,14,3,0,11,3
39328,5,5,3,0,2,3
39328,4,1,1,0,0,1
179448,10,29,4,0,25,4
179448,9,44,2,0,42,2
179448,8,74,7,0,67,7
179448,7,58,4,0,54,4
179448,6,14,1,0,13,1
179448,5,3,1,0,2,1
5585,10,4,3,0,1,3
5585,8,12,3,0,9,3
5585,7,21,5,0,16,5
5585,6,70,17,0,53,17
5585,5,53,9,0,44,9
5585,4,31,11,0,20,11
5585,3,22,10,0,12,10
5585,2,7,1,0,6,1
168882,9,5,2,0,3,2
168882,8,25,6,0,19,6
168882,7,44,7,0,37,7
168882,6,78,12,0,66,12
168882,5,33,3,0,30,3
168882,4,23,5,0,18,5
168882,3,5,1,0,4,1
83092,10,5,1,0,4,1
83092,9,6,2,0,4,2
83092,8,24,6,0,18,6
83092,7,61,12,0,49,12
83092,6,77,16,0,61,16
83092,5,38,7,0,31,7
83092,4,8,3,0,5,3
5447,10,3,1,0,2,1
5447,8,23,3,0,20,3
5447,7,34,6,0,28,6
5447,6,62,12,0,50,12
5447,5,39,8,0,31,8
5447,4,25,4,0,21,4
5447,3,13,3,0,10,3
5447,2,8,1,0,7,1
190333,10,16,6,0,10,6
190333,9,21,4,0,17,4
190333,8,63,11,4,52,7
190333,7,58,10,1,48,9
190333,6,40,6,3,34,3
190333,5,18,4,0,14,4
220700,10,8,3,0,5,3
220700,9,8,3,0,5,3
220700,8,35,9,0,26,9
220700,7,57,15,0,42,15
220700,6,70,12,0,58,12
220700,5,26,4,0,22,4
220700,4,12,1,0,11,1
220700,3,3,2,0,1,2
220700,2,3,1,0,2,1
40638,10,6,1,0,5,1
40638,9,8,1,0,7,1
40638,8,37,9,0,28,9
40638,7,43,9,0,34,9
40638,6,73,20,0,53,20
40638,5,31,8,0,23,8
40638,4,17,6,0,11,6
40638,3,6,1,0,5,1
2957,8,12,2,0,10,2
2957,7,32,9,0,23,9
2957,6,60,8,0,52,8
2957,5,41,10,0,31,10
2957,4,38,12,0,26,12
2957,3,18,8,0,10,8
2957,2,12,5,0,7,5
2957,1,6,3,0,3,3
30239,8,10,3,0,7,3
30239,7,37,10,0,27,10
30239,6,74,13,0,61,13
30239,5,56,10,0,46,10
30239,4,26,6,0,20,6
30239,3,9,1,0,8,1
30239,2,9,5,0,4,5
193083,8,29,2,0,27,2
193083,7,74,13,0,61,13
193083,6,77,10,0,67,10
193083,5,17,4,0,13,4
193083,4,15,3,0,12,3
227422,10,9,2,0,7,2
227422,9,6,1,0,5,1
227422,8,32,3,0,29,3
227422,7,49,7,0,42,7
227422,6,79,11,0,68,11
227422,5,22,2,0,20,2
227422,4,16,3,0,13,3
227422,3,5,1,0,4,1
8284,10,7,3,0,4,3
8284,9,10,5,0,5,5
8284,8,50,16,0,34,16
8284,7,61,17,0,44,17
8284,6,58,10,0,48,10
8284,5,21,8,0,13,8
8284,4,12,3,0,9,3
8284,3,4,1,0,3,1
153625,9,16,6,0,10,6
153625,8,71,14,0,57,14
153625,7,73,18,0,55,18
153625,6,48,6,0,42,6
153625,5,8,2,0,6,2
153625,4,2,1,0,1,1
168232,10,3,1,0,2,1
168232,9,7,1,0,6,1
168232,8,44,15,1,29,14
168232,7,69,15,0,54,15
168232,6,71,23,1,48,22
168232,5,18,6,0,12,6
168232,4,5,3,0,2,3
168232,3,3,3,0,0,3
197061,9,9,2,0,7,2
197061,8,34,10,0,24,10
197061,7,63,8,0,55,8
197061,6,72,14,0,58,14
197061,5,23,3,0,20,3
197061,4,11,2,0,9,2
197061,3,7,1,0,6,1
446,10,4,3,0,1,3
446,9,5,2,0,3,2
446,8,15,8,0,7,8
446,7,21,7,0,14,7
446,6,96,29,0,67,29
446,5,43,11,0,32,11
446,4,27,8,0,19,8
446,3,7,2,0,5,2
446,2,4,2,0,2,2
113,9,9,1,0,8,1
113,8,41,13,0,28,13
113,7,78,24,0,54,24
113,6,61,12,0,49,12
113,5,22,8,0,14,8
113,4,9,5,0,4,5
113,3,2,1,0,1,1
113,1,1,1,0,0,1
1304,10,4,1,0,3,1
1304,9,7,3,0,4,3
1304,8,16,8,0,8,8
1304,7,47,17,0,30,17
1304,6,64,18,0,46,18
1304,5,32,16,0,16,16
1304,4,31,16,0,15,16
1304,3,13,6,0,7,6
1304,2,6,1,0,5,1
2792,8,11,5,0,6,5
2792,7,28,8,0,20,8
2792,6,79,20,0,59,20
2792,5,52,11,0,41,11
2792,4,27,5,0,22,5
2792,3,14,3,0,11,3
2792,2,6,1,0,5,1
2792,1,3,3,0,0,3
166081,8,12,4,0,8,4
166081,7,31,7,0,24,7
166081,6,52,6,1,46,5
166081,5,40,4,0,36,4
166081,4,44,7,0,37,7
166081,3,19,6,0,13,6
166081,2,14,5,0,9,5
166081,1,4,4,0,0,4
133747,10,13,1,0,12,1
133747,9,15,2,0,13,2
133747,8,44,7,0,37,7
133747,7,57,7,0,50,7
133747,6,64,3,0,61,3
133747,5,12,2,0,10,2
133747,4,7,2,0,5,2
133747,2,4,1,0,3,1
6800,10,1,1,0,0,1
6800,8,7,1,0,6,1
6800,7,34,7,0,27,7
6800,6,68,21,0,47,21
6800,5,59,11,0,48,11
6800,4,17,4,0,13,4
6800,3,24,7,0,17,7
6800,2,7,3,0,4,3
6800,1,4,1,0,3,1
137744,9,11,2,0,9,2
137744,8,43,14,1,29,13
137744,7,54,14,0,40,14
137744,6,74,16,0,58,16
137744,5,24,4,0,20,4
137744,4,8,2,0,6,2
137744,3,3,1,0,2,1
137744,2,1,1,0,0,1
3966,9,8,3,0,5,3
3966,8,30,6,0,24,6
3966,7,38,4,0,34,4
3966,6,90,20,0,70,20
3966,5,34,4,0,30,4
3966,4,12,1,0,11,1
3966,3,3,1,0,2,1
3966,2,3,2,0,1,2
1844,10,3,2,0,1,2
1844,9,9,1,0,8,1
1844,8,26,11,0,15,11
1844,7,66,17,0,49,17
1844,6,69,19,0,50,19
1844,5,37,9,0,28,9
1844,4,10,4,0,6,4
12623,9,1,1,0,0,1
12623,8,8,4,0,4,4
12623,7,31,5,0,26,5
12623,6,65,23,0,42,23
12623,5,55,13,0,42,13
12623,4,35,14,0,21,14
12623,3,15,7,0,8,7
12623,2,9,4,0,5,4
12623,1,3,1,0,2,1
154633,7,34,6,0,28,6
154633,6,74,7,0,67,7
154633,5,53,3,0,50,3
154633,4,24,3,0,21,3
154633,3,6,1,0,5,1
558,9,3,2,0,1,2
558,8,31,5,0,26,5
558,7,54,12,0,42,12
558,6,76,17,0,59,17
558,5,31,6,0,25,6
558,4,14,4,0,10,4
558,3,5,4,0,1,4
558,2,2,2,0,0,2
96026,10,36,8,1,28,7
96026,9,64,11,0,53,11
96026,8,71,23,0,48,23
96026,7,26,9,0,17,9
96026,6,13,6,0,7,6
96026,5,3,3,0,0,3
96026,3,4,3,0,1,3
37305,10,6,2,0,4,2
37305,9,5,3,0,2,3
37305,8,6,3,0,3,3
37305,7,15,6,0,9,6
37305,6,65,21,0,44,21
37305,5,37,11,0,26,11
37305,4,41,15,0,26,15
37305,3,22,9,0,13,9
37305,2,12,6,0,6,6
37305,1,12,4,0,8,4
230315,10,8,3,0,5,3
230315,8,73,12,0,61,12
230315,7,55,5,0,50,5
230315,6,44,8,0,36,8
230315,5,19,3,0,16,3
230315,4,6,2,0,4,2
230315,2,3,1,0,2,1
230315,1,1,1,0,0,1
65556,10,1,1,0,0,1
65556,9,4,3,0,1,3
65556,8,14,4,0,10,4
65556,7,40,9,0,31,9
65556,6,75,20,0,55,20
65556,5,35,16,0,19,16
65556,4,26,11,0,15,11
65556,3,20,6,0,14,6
65556,2,4,1,0,3,1
65556,1,2,1,0,1,1
536,10,4,1,0,3,1
536,9,10,5,0,5,5
536,8,39,12,0,27,12
536,7,63,19,0,44,19
536,6,60,11,0,49,11
536,5,27,4,0,23,4
536,4,16,5,0,11,5
536,1,1,1,0,0,1
32143,10,9,1,0,8,1
32143,9,13,2,0,11,2
32143,8,30,3,0,27,3
32143,7,42,9,0,33,9
32143,6,72,15,0,57,15
32143,5,35,11,0,24,11
32143,4,11,3,0,8,3
32143,3,5,2,0,3,2
32143,2,2,1,0,1,1
32143,1,2,1,0,1,1
258451,10,3,1,0,2,1
258451,8,46,11,0,35,11
258451,7,70,7,0,63,7
258451,6,65,5,0,60,5
258451,5,18,2,0,16,2
258451,3,4,2,0,2,2
3090,10,1,1,0,0,1
3090,9,4,2,0,2,2
3090,8,9,5,0,4,5
3090,7,21,5,0,16,5
3090,6,76,24,0,52,24
3090,5,55,19,0,36,19
3090,4,31,9,0,22,9
3090,3,18,4,0,14,4
3090,2,5,3,0,2,3
4724,10,3,1,0,2,1
4724,9,4,1,0,3,1
4724,7,4,1,0,3,1
4724,6,18,5,0,13,5
4724,5,20,4,0,16,4
4724,4,28,5,0,23,5
4724,3,36,9,0,27,9
4724,2,56,24,0,32,24
4724,1,41,19,0,22,19
416,10,6,2,0,4,2
416,9,6,3,0,3,3
416,8,23,8,0,15,8
416,7,44,16,0,28,16
416,6,79,21,0,58,21
416,5,33,9,0,24,9
416,4,21,8,0,13,8
416,3,6,3,0,3,3
416,1,1,1,0,0,1
147104,9,11,2,0,9,2
147104,8,56,8,0,48,8
147104,7,52,9,0,43,9
147104,6,65,8,0,57,8
147104,5,23,2,0,21,2
147104,3,8,4,0,4,4
264220,10,112,33,5,79,28
264220,9,27,4,0,23,4
264220,8,21,6,2,15,4
264220,7,10,4,0,6,4
264220,5,4,2,1,2,1
264220,2,6,2,0,4,2
264220,1,34,22,0,12,22
178153,10,11,2,0,9,2
178153,9,13,5,1,8,4
178153,8,41,12,1,29,11
178153,7,65,11,1,54,10
178153,6,59,6,1,53,5
178153,5,16,2,0,14,2
178153,4,8,3,0,5,3
178153,3,5,1,0,4,1
178153,1,2,1,1,1,0
220784,9,6,1,0,5,1
220784,8,37,6,0,31,6
220784,7,57,7,0,50,7
220784,6,76,8,0,68,8
220784,5,29,4,0,25,4
220784,4,11,1,0,10,1
192349,9,6,2,0,4,2
192349,8,20,2,0,18,2
192349,7,42,6,0,36,6
192349,6,79,17,0,62,17
192349,5,34,6,0,28,6
192349,4,20,3,0,17,3
192349,3,12,4,0,8,4
192349,2,5,1,0,4,1
192349,1,4,3,0,1,3
308,10,8,3,0,5,3
308,9,14,3,0,11,3
308,8,53,8,0,45,8
308,7,73,16,0,57,16
308,6,50,11,0,39,11
308,5,15,2,0,13,2
308,4,3,1,0,2,1
308,3,4,1,0,3,1
165586,8,24,3,0,21,3
165586,7,56,5,0,51,5
165586,6,82,10,0,72,10
165586,5,30,4,0,26,4
165586,4,14,3,0,11,3
165586,3,8,4,0,4,4
165586,2,2,1,0,1,1
165586,1,2,1,0,1,1
189056,8,31,3,0,28,3
189056,7,54,9,0,45,9
189056,6,86,11,0,75,11
189056,5,24,3,0,21,3
189056,4,13,3,0,10,3
134626,9,3,1,0,2,1
134626,8,32,9,0,23,9
134626,7,69,6,0,63,6
134626,6,72,6,0,66,6
134626,5,27,4,0,23,4
134626,4,11,2,0,9,2
23311,9,5,1,0,4,1
23311,8,27,13,0,14,13
23311,7,57,23,0,34,23
23311,6,89,36,0,53,36
23311,5,29,12,0,17,12
23311,4,7,4,0,3,4
23311,2,3,3,0,0,3
144988,10,14,5,1,9,4
144988,9,11,2,0,9,2
144988,8,55,11,0,44,11
144988,7,69,5,0,64,5
144988,6,44,7,1,37,6
144988,5,17,2,0,15,2
144988,4,5,1,0,4,1
144988,3,3,2,0,1,2
137872,10,9,5,0,4,5
137872,9,17,3,0,14,3
137872,8,47,12,1,35,11
137872,7,57,12,0,45,12
137872,6,51,16,1,35,15
137872,5,26,11,1,15,10
137872,4,6,2,0,4,2
137872,3,5,1,1,4,0
137872,1,1,1,0,0,1
87200,10,7,2,0,5,2
87200,9,6,1,0,5,1
87200,8,56,20,3,36,17
87200,7,64,15,2,49,13
87200,6,43,17,0,26,17
87200,5,26,10,0,16,10
87200,4,11,4,0,7,4
87200,3,7,4,0,3,4
2003,8,12,5,0,7,5
2003,7,45,10,0,35,10
2003,6,81,16,0,65,16
2003,5,49,10,0,39,10
2003,4,18,6,0,12,6
2003,3,10,2,0,8,2
2003,2,2,1,0,1,1
163175,9,21,1,0,20,1
163175,8,63,11,3,52,8
163175,7,51,13,0,38,13
163175,6,53,10,0,43,10
163175,5,12,2,0,10,2
163175,4,4,1,0,3,1
163175,3,7,5,1,2,4
231,10,9,4,0,5,4
231,9,4,3,0,1,3
231,8,21,11,0,10,11
231,7,38,9,0,29,9
231,6,55,19,0,36,19
231,5,41,16,0,25,16
231,4,24,10,0,14,10
231,3,13,5,0,8,5
231,2,9,3,0,6,3
231,1,6,3,0,3,3
1449,10,9,2,0,7,2
1449,9,9,3,0,6,3
1449,8,39,9,0,30,9
1449,7,63,11,0,52,11
1449,6,49,11,0,38,11
1449,5,26,3,0,23,3
1449,4,13,4,0,9,4
1449,3,6,2,0,4,2
1449,2,5,2,0,3,2
1449,1,1,1,0,0,1
637,10,13,9,0,4,9
637,9,24,14,0,10,14
637,8,50,22,0,28,22
637,7,43,16,0,27,16
637,6,45,19,0,26,19
637,5,23,9,0,14,9
637,4,14,5,0,9,5
637,3,6,2,0,4,2
637,2,2,1,0,1,1
162865,10,11,4,0,7,4
162865,9,31,7,0,24,7
162865,8,78,24,2,54,22
162865,7,42,9,0,33,9
162865,6,35,7,1,28,6
162865,5,14,2,0,12,2
162865,4,3,2,0,1,2
162865,2,3,1,0,2,1
112381,10,5,2,0,3,2
112381,9,6,3,0,3,3
112381,8,52,25,0,27,25
112381,7,60,17,0,43,17
112381,6,63,19,0,44,19
112381,5,19,5,0,14,5
112381,4,9,4,0,5,4
112381,3,4,3,0,1,3
5511,10,18,5,0,13,5
5511,9,22,6,0,16,6
5511,8,79,15,0,64,15
5511,7,47,7,0,40,7
5511,6,38,3,0,35,3
5511,5,9,1,0,8,1
5511,4,3,2,0,1,2
31145,8,2,1,0,1,1
31145,7,6,1,0,5,1
31145,6,33,7,0,26,7
31145,5,51,10,0,41,10
31145,4,48,10,0,38,10
31145,3,43,12,0,31,12
31145,2,22,7,0,15,7
31145,1,14,6,0,8,6
11412,9,3,1,0,2,1
11412,8,19,8,0,11,8
11412,7,38,16,0,22,16
11412,6,97,31,0,66,31
11412,5,36,18,0,18,18
11412,4,18,8,0,10,8
11412,3,6,4,0,2,4
11412,2,1,1,0,0,1
11412,1,2,1,0,1,1
7400,10,1,1,0,0,1
7400,8,13,6,0,7,6
7400,7,17,8,0,9,8
7400,6,68,21,0,47,21
7400,5,57,15,0,42,15
7400,4,41,16,0,25,16
7400,3,18,4,0,14,4
7400,2,5,3,0,2,3
1901,10,7,3,0,4,3
1901,9,9,4,0,5,4
1901,8,37,10,0,27,10
1901,7,57,16,0,41,16
1901,6,63,14,0,49,14
1901,5,32,13,0,19,13
1901,4,6,2,0,4,2
1901,3,5,3,0,2,3
1901,2,1,1,0,0,1
1901,1,2,1,0,1,1
26946,10,8,2,0,6,2
26946,9,16,3,0,13,3
26946,8,57,11,0,46,11
26946,7,68,9,0,59,9
26946,6,42,5,0,37,5
26946,5,21,2,0,19,2
229427,10,32,9,0,23,9
229427,9,51,7,0,44,7
229427,8,66,11,0,55,11
229427,7,48,7,0,41,7
229427,6,13,6,0,7,6
229427,5,8,1,0,7,1
229427,2,1,1,0,0,1
10196,9,2,1,0,1,1
10196,8,12,7,0,5,7
10196,7,34,10,0,24,10
10196,6,77,26,0,51,26
10196,5,46,15,0,31,15
10196,4,25,12,0,13,12
10196,3,12,1,0,11,1
10196,2,9,5,0,4,5
4255,10,6,1,0,5,1
4255,9,12,5,0,7,5
4255,8,44,18,0,26,18
4255,7,70,16,0,54,16
4255,6,60,19,0,41,19
4255,5,19,8,0,11,8
4255,4,6,3,0,3,3
2979,9,2,2,0,0,2
2979,8,4,1,0,3,1
2979,7,13,7,0,6,7
2979,6,19,5,0,14,5
2979,5,46,13,0,33,13
2979,4,50,14,0,36,14
2979,3,41,17,0,24,17
2979,2,27,15,0,12,15
2979,1,16,6,0,10,6
15548,8,17,5,0,12,5
15548,7,46,15,0,31,15
15548,6,72,11,0,61,11
15548,5,45,5,0,40,5
15548,4,14,4,0,10,4
15548,3,11,4,0,7,4
15548,2,4,1,0,3,1
2740,8,5,1,0,4,1
2740,7,15,2,0,13,2
2740,6,58,11,0,47,11
2740,5,46,11,0,35,11
2740,4,51,9,0,42,9
2740,3,27,9,0,18,9
2740,2,14,6,0,8,6
2740,1,2,1,0,1,1
216856,9,16,3,0,13,3
216856,8,60,7,0,53,7
216856,7,84,9,0,75,9
216856,6,38,2,0,36,2
216856,5,14,3,0,11,3
257668,9,21,3,0,18,3
257668,8,91,10,0,81,10
257668,7,70,9,0,61,9
257668,6,25,3,0,22,3
257668,5,8,2,0,6,2
257668,4,3,1,0,2,1
214989,10,12,5,0,7,5
214989,9,11,1,0,10,1
214989,8,52,9,0,43,9
214989,7,71,12,3,59,9
214989,6,45,8,1,37,7
214989,5,14,2,0,12,2
214989,4,9,2,0,7,2
214989,3,3,1,0,2,1
160608,9,10,3,0,7,3
160608,8,22,5,0,17,5
160608,7,37,4,0,33,4
160608,6,68,4,0,64,4
160608,5,39,4,0,35,4
160608,4,17,2,0,15,2
160608,3,16,10,0,6,10
160608,2,5,1,0,4,1
160608,1,5,3,0,2,3
7576,10,3,2,0,1,2
7576,9,6,4,0,2,4
7576,8,33,13,0,20,13
7576,7,51,22,0,29,22
7576,6,77,34,0,43,34
7576,5,32,14,0,18,14
7576,4,14,5,0,9,5
1566,10,7,1,0,6,1
1566,9,10,2,0,8,2
1566,8,39,17,0,22,17
1566,7,49,10,0,39,10
1566,6,62,15,0,47,15
1566,5,32,8,0,24,8
1566,4,12,4,0,8,4
1566,3,5,1,0,4,1
1566,2,2,2,0,0,2
1566,1,1,1,0,0,1
35556,9,2,1,0,1,1
35556,8,16,3,0,13,3
35556,7,33,6,0,27,6
35556,6,98,17,0,81,17
35556,5,45,1,0,44,1
35556,4,14,2,0,12,2
35556,3,5,3,0,2,3
35556,2,5,1,0,4,1
35556,1,1,1,0,0,1
40550,10,15,1,0,14,1
40550,9,14,4,0,10,4
40550,8,37,8,0,29,8
40550,7,57,12,0,45,12
40550,6,50,11,0,39,11
40550,5,21,3,0,18,3
40550,3,12,3,0,9,3
30741,8,9,4,0,5,4
30741,7,43,15,0,28,15
30741,6,77,31,0,46,31
30741,5,39,14,0,25,14
30741,4,27,10,0,17,10
30741,3,17,11,0,6,11
30741,2,5,4,0,1,4
30741,1,1,1,0,0,1
4479,10,5,1,0,4,1
4479,9,9,4,0,5,4
4479,8,21,6,0,15,6
4479,7,26,7,0,19,7
4479,6,63,13,0,50,13
4479,5,48,11,0,37,11
4479,4,31,9,0,22,9
4479,3,12,8,0,4,8
4479,2,3,1,0,2,1
4479,1,1,1,0,0,1
221366,10,15,2,0,13,2
221366,9,21,2,0,19,2
221366,8,50,1,0,49,1
221366,7,61,3,0,58,3
221366,6,41,2,0,39,2
221366,4,10,4,0,6,4
221366,1,2,1,0,1,1
131121,10,3,1,0,2,1
131121,9,4,2,0,2,2
131121,8,47,10,1,37,9
131121,7,65,16,1,49,15
131121,6,60,17,1,43,16
131121,5,21,4,0,17,4
131121,4,15,8,0,7,8
131121,3,3,1,0,2,1
131121,2,1,1,0,0,1
8497,9,1,1,0,0,1
8497,8,13,6,0,7,6
8497,7,30,7,0,23,7
8497,6,72,23,0,49,23
8497,5,53,18,0,35,18
8497,4,25,9,0,16,9
8497,3,18,10,0,8,10
8497,2,3,1,0,2,1
7307,9,13,9,0,4,9
7307,8,11,6,0,5,6
7307,7,31,19,0,12,19
7307,6,68,40,0,28,40
7307,5,52,17,0,35,17
7307,4,29,14,0,15,14
7307,3,9,3,0,6,3
7307,2,3,2,0,1,2
4091,10,8,4,0,4,4
4091,9,15,5,0,10,5
4091,8,36,17,0,19,17
4091,7,47,10,0,37,10
4091,6,58,14,0,44,14
4091,5,23,8,0,15,8
4091,4,14,2,0,12,2
4091,3,8,2,0,6,2
4091,2,4,2,0,2,2
4091,1,5,1,0,4,1
23181,9,4,1,0,3,1
23181,8,15,1,0,14,1
23181,7,22,3,0,19,3
23181,6,60,13,0,47,13
23181,5,43,5,0,38,5
23181,4,34,10,0,24,10
23181,3,19,3,0,16,3
23181,2,12,5,0,7,5
23181,1,7,4,0,3,4
136284,8,28,5,0,23,5
136284,7,72,7,0,65,7
136284,6,75,10,0,65,10
136284,5,17,1,0,16,1
136284,4,15,3,0,12,3
41612,10,3,2,0,1,2
41612,9,17,10,0,7,10
41612,8,52,16,0,36,16
41612,7,62,16,0,46,16
41612,6,50,12,0,38,12
41612,5,19,9,0,10,9
41612,4,9,6,0,3,6
41612,3,2,2,0,0,2
41612,2,3,1,0,2,1
158356,9,6,2,0,4,2
158356,8,34,5,0,29,5
158356,7,79,9,0,70,9
158356,6,64,7,0,57,7
158356,5,21,1,0,20,1
158356,4,9,1,0,8,1
158356,2,1,1,0,0,1
24998,8,17,6,0,11,6
24998,7,29,9,0,20,9
24998,6,83,19,0,64,19
24998,5,46,17,0,29,17
24998,4,24,3,0,21,3
24998,3,8,6,0,2,6
24998,2,5,2,0,3,2
24998,1,2,2,0,0,2
183420,10,10,5,0,5,5
183420,9,6,1,0,5,1
183420,8,57,17,0,40,17
183420,7,64,13,0,51,13
183420,6,56,12,0,44,12
183420,5,15,3,0,12,3
183420,4,5,2,0,3,2
183420,3,2,1,0,1,1
183420,2,5,1,0,4,1
133671,10,5,2,0,3,2
133671,9,8,1,0,7,1
133671,8,32,3,0,29,3
133671,7,44,11,0,33,11
133671,6,66,20,0,46,20
133671,5,25,10,0,15,10
133671,4,25,13,0,12,13
133671,3,10,2,0,8,2
133671,2,3,3,0,0,3
2353,9,9,3,0,6,3
2353,8,43,17,0,26,17
2353,7,42,11,0,31,11
2353,6,73,32,0,41,32
2353,5,36,12,0,24,12
2353,4,10,8,0,2,8
2353,3,3,2,0,1,2
4421,9,3,2,0,1,2
4421,8,33,14,0,19,14
4421,7,62,22,0,40,22
4421,6,64,27,0,37,27
4421,5,30,9,0,21,9
4421,4,14,4,0,10,4
4421,3,7,1,0,6,1
4421,2,3,1,0,2,1
256390,9,5,3,0,2,3
256390,8,31,5,0,26,5
256390,7,54,7,0,47,7
256390,6,72,11,0,61,11
256390,5,31,5,0,26,5
256390,4,9,2,0,7,2
256390,3,6,3,0,3,3
256390,2,6,2,0,4,2
7270,10,2,1,0,1,1
7270,9,7,4,0,3,4
7270,8,12,5,0,7,5
7270,7,31,6,0,25,6
7270,6,80,24,0,56,24
7270,5,46,12,0,34,12
7270,4,23,9,0,14,9
7270,3,10,6,0,4,6
7270,2,7,5,0,2,5
7270,1,1,1,0,0,1
32154,9,2,1,0,1,1
32154,8,15,8,0,7,8
32154,7,33,7,0,26,7
32154,6,74,17,0,57,17
32154,5,47,11,0,36,11
32154,4,36,8,0,28,8
32154,3,8,3,0,5,3
32154,2,3,1,0,2,1
20090,8,20,3,0,17,3
20090,7,36,12,0,24,12
20090,6,82,17,0,65,17
20090,5,41,12,0,29,12
20090,4,27,6,0,21,6
20090,3,8,1,0,7,1
20090,2,2,1,0,1,1
188164,10,25,11,0,14,11
188164,9,63,15,0,48,15
188164,8,78,12,0,66,12
188164,7,27,10,1,17,9
188164,6,16,4,1,12,3
188164,5,4,2,0,2,2
188164,2,1,1,0,0,1
223950,10,9,3,0,6,3
223950,9,9,2,0,7,2
223950,8,58,16,2,42,14
223950,7,77,13,2,64,11
223950,6,38,9,1,29,8
223950,5,12,3,1,9,2
223950,4,8,3,1,5,2
223950,3,4,1,0,3,1
122327,8,25,9,0,16,9
122327,7,57,16,0,41,16
122327,6,69,16,0,53,16
122327,5,38,10,0,28,10
122327,4,16,4,0,12,4
122327,3,7,2,0,5,2
122327,2,2,1,0,1,1
65582,8,20,1,0,19,1
65582,7,57,11,0,46,11
65582,6,71,7,0,64,7
65582,5,33,1,0,32,1
65582,4,16,5,0,11,5
65582,3,7,3,0,4,3
65582,2,2,2,0,0,2
5985,10,56,29,0,27,29
5985,9,20,7,1,13,6
5985,8,26,13,0,13,13
5985,7,41,22,1,19,21
5985,6,21,9,0,12,9
5985,5,23,9,0,14,9
5985,4,8,6,0,2,6
5985,3,3,1,0,2,1
5985,1,19,15,0,4,15
211,9,8,2,0,6,2
211,8,39,15,0,24,15
211,7,47,19,0,28,19
211,6,58,14,0,44,14
211,5,35,7,0,28,7
211,4,18,6,0,12,6
211,3,5,1,0,4,1
211,2,2,2,0,0,2
172235,9,7,2,0,5,2
172235,8,22,2,1,20,1
172235,7,53,5,1,48,4
172235,6,63,9,1,54,8
172235,5,41,10,1,31,9
172235,4,11,2,0,9,2
172235,3,13,5,0,8,5
172235,1,1,1,0,0,1
49435,10,3,1,0,2,1
49435,8,17,4,0,13,4
49435,7,37,12,0,25,12
49435,6,74,18,0,56,18
49435,5,40,5,0,35,5
49435,4,24,6,0,18,6
49435,3,10,3,0,7,3
49435,2,8,2,0,6,2
49435,1,2,1,0,1,1
39210,10,2,1,0,1,1
39210,9,7,3,0,4,3
39210,8,27,7,0,20,7
39210,7,63,16,0,47,16
39210,6,77,24,0,53,24
39210,5,26,6,0,20,6
39210,4,13,7,0,6,7
39210,3,1,1,0,0,1
172994,10,11,2,0,9,2
172994,9,18,4,0,14,4
172994,8,59,12,0,47,12
172994,7,70,7,0,63,7
172994,6,42,6,0,36,6
172994,4,4,1,0,3,1
42688,9,4,1,0,3,1
42688,8,21,7,0,14,7
42688,7,58,29,0,29,29
42688,6,75,22,0,53,22
42688,5,33,9,0,24,9
42688,4,12,3,0,9,3
42688,3,5,2,0,3,2
42688,1,2,1,0,1,1
129615,9,14,6,0,8,6
129615,8,37,5,0,32,5
129615,7,68,12,0,56,12
129615,6,50,7,0,43,7
129615,5,26,4,0,22,4
129615,4,13,2,0,11,2
129615,3,6,2,0,4,2
129615,2,1,1,0,0,1
10789,10,15,6,0,9,6
10789,9,20,11,0,9,11
10789,8,38,11,0,27,11
10789,7,46,14,0,32,14
10789,6,57,23,0,34,23
10789,5,21,8,0,13,8
10789,4,11,5,0,6,5
10789,3,3,1,0,2,1
10789,2,4,1,0,3,1
10789,1,2,1,0,1,1
67285,8,29,11,0,18,11
67285,7,78,23,0,55,23
67285,6,72,22,0,50,22
67285,5,22,11,0,11,11
67285,4,7,4,0,3,4
67285,2,2,1,0,1,1
163576,10,4,2,0,2,2
163576,9,2,1,0,1,1
163576,8,22,3,0,19,3
163576,7,27,2,0,25,2
163576,6,59,8,0,51,8
163576,5,51,6,0,45,6
163576,4,27,11,0,16,11
163576,3,15,4,0,11,4
163576,2,8,1,0,7,1
163576,1,2,1,0,1,1
46745,8,7,3,0,4,3
46745,7,20,5,0,15,5
46745,6,63,16,0,47,16
46745,5,58,12,0,46,12
46745,4,46,13,0,33,13
46745,3,12,3,0,9,3
46745,2,7,2,0,5,2
199223,10,13,7,0,6,7
199223,9,13,4,0,9,4
199223,8,77,18,1,59,17
199223,7,60,9,0,51,9
199223,6,46,4,0,42,4
257733,10,9,1,0,8,1
257733,9,6,1,0,5,1
257733,8,55,10,0,45,10
257733,7,69,8,0,61,8
257733,6,55,9,0,46,9
257733,5,16,3,0,13,3
257733,3,2,1,0,1,1
3945,10,5,2,0,3,2
3945,8,31,10,0,21,10
3945,7,46,21,0,25,21
3945,6,66,25,0,41,25
3945,5,35,9,0,26,9
3945,4,24,9,0,15,9
3945,1,1,1,0,0,1
222821,10,3,2,0,1,2
222821,9,16,5,0,11,5
222821,8,66,21,1,45,20
222821,7,71,22,3,49,19
222821,6,40,8,0,32,8
222821,5,12,4,0,8,4
222821,4,6,1,0,5,1
222821,3,1,1,0,0,1
222821,2,1,1,0,0,1
25182,10,2,1,0,1,1
25182,9,6,2,0,4,2
25182,8,32,16,0,16,16
25182,7,70,23,0,47,23
25182,6,71,29,0,42,29
25182,5,25,11,0,14,11
25182,4,7,5,0,2,5
25182,2,2,1,0,1,1
214988,10,18,5,0,13,5
214988,9,37,9,1,28,8
214988,8,87,11,1,76,10
214988,7,44,6,0,38,6
214988,6,23,6,0,17,6
214988,5,5,3,0,2,3
214988,4,1,1,0,0,1
214988,1,1,1,0,0,1
13676,9,6,2,0,4,2
13676,8,27,7,0,20,7
13676,7,55,10,0,45,10
13676,6,55,14,0,41,14
13676,5,30,9,0,21,9
13676,4,20,6,0,14,6
13676,3,12,7,0,5,7
13676,2,7,4,0,3,4
13676,1,2,2,0,0,2
41095,8,14,2,0,12,2
41095,7,29,6,0,23,6
41095,6,71,17,0,54,17
41095,5,47,11,0,36,11
41095,4,22,2,0,20,2
41095,3,17,2,0,15,2
41095,2,8,1,0,7,1
41095,1,4,1,0,3,1
170430,8,19,3,1,16,2
170430,7,54,15,0,39,15
170430,6,75,14,2,61,12
170430,5,37,6,0,31,6
170430,4,22,5,0,17,5
170430,3,5,1,0,4,1
170430,2,4,1,0,3,1
474,10,8,3,0,5,3
474,9,4,2,0,2,2
474,8,22,7,0,15,7
474,7,53,22,0,31,22
474,6,71,16,0,55,16
474,5,34,11,0,23,11
474,4,12,5,0,7,5
474,3,6,3,0,3,3
474,2,3,1,0,2,1
474,1,4,3,0,1,3
178688,10,7,2,1,5,1
178688,9,11,4,1,7,3
178688,8,59,11,2,48,9
178688,7,65,6,0,59,6
178688,6,52,9,2,43,7
178688,3,5,3,0,2,3
178688,2,1,1,0,0,1
5699,10,5,1,0,4,1
5699,9,17,4,0,13,4
5699,8,51,17,0,34,17
5699,7,58,16,0,42,16
5699,6,59,12,0,47,12
5699,5,15,5,0,10,5
5699,3,3,3,0,0,3
53103,9,2,1,0,1,1
53103,8,11,3,0,8,3
53103,7,25,3,0,22,3
53103,6,32,6,0,26,6
53103,5,14,5,0,9,5
53103,4,7,2,0,5,2
13493,9,8,3,0,5,3
13493,8,20,5,0,15,5
13493,7,41,13,0,28,13
13493,6,73,23,0,50,23
13493,5,35,8,0,27,8
13493,4,22,10,0,12,10
13493,3,7,3,0,4,3
13493,2,5,1,0,4,1
1823,10,21,6,0,15,6
1823,9,16,6,0,10,6
1823,8,48,12,0,36,12
1823,7,53,13,0,40,13
1823,6,46,12,0,34,12
1823,5,20,5,0,15,5
1823,4,6,4,0,2,4
1823,3,2,1,0,1,1
1823,2,3,1,0,2,1
5357,10,11,5,0,6,5
5357,9,22,7,0,15,7
5357,8,65,19,0,46,19
5357,7,63,19,0,44,19
5357,6,36,17,0,19,17
5357,5,14,7,0,7,7
5357,4,4,2,0,2,2
5357,3,1,1,0,0,1
159910,10,3,1,0,2,1
159910,9,7,5,0,2,5
159910,8,71,19,0,52,19
159910,7,58,23,0,35,23
159910,6,57,14,0,43,14
159910,5,11,2,0,9,2
159910,3,4,3,0,1,3
19508,8,6,2,0,4,2
19508,7,25,2,0,23,2
19508,6,66,11,0,55,11
19508,5,42,7,0,35,7
19508,4,40,11,0,29,11
19508,3,24,11,0,13,11
19508,2,8,4,0,4,4
19508,1,3,1,0,2,1
55315,9,3,2,0,1,2
55315,8,16,3,0,13,3
55315,7,54,9,0,45,9
55315,6,74,8,0,66,8
55315,5,41,11,0,30,11
55315,4,22,3,0,19,3
55315,3,3,1,0,2,1
5468,8,8,4,0,4,4
5468,7,24,6,0,18,6
5468,6,63,18,0,45,18
5468,5,62,21,0,41,21
5468,4,32,13,0,19,13
5468,3,16,7,0,9,7
5468,2,10,6,0,4,6
226562,10,10,4,0,6,4
226562,9,9,3,0,6,3
226562,8,40,6,0,34,6
226562,7,71,14,0,57,14
226562,6,42,6,0,36,6
226562,5,21,4,0,17,4
226562,4,5,1,0,4,1
226562,3,11,5,1,6,4
226562,2,5,2,0,3,2
226562,1,2,1,0,1,1
206471,9,6,1,0,5,1
206471,8,47,10,0,37,10
206471,7,62,9,0,53,9
206471,6,71,14,0,57,14
206471,5,16,2,0,14,2
206471,3,3,1,0,2,1
206471,2,1,1,0,0,1
241025,8,34,5,0,29,5
241025,7,67,2,0,65,2
241025,6,69,7,0,62,7
241025,5,21,1,0,20,1
241025,4,12,3,0,9,3
241025,3,2,1,0,1,1
429,8,14,5,0,9,5
429,7,52,15,0,37,15
429,6,75,14,0,61,14
429,5,40,6,0,34,6
429,4,19,8,0,11,8
429,3,8,3,0,5,3
429,1,1,1,0,0,1
38227,8,10,1,0,9,1
38227,7,37,4,0,33,4
38227,6,81,19,0,62,19
38227,5,30,9,0,21,9
38227,4,25,9,0,16,9
38227,3,12,1,0,11,1
38227,2,11,3,0,8,3
231966,10,25,7,0,18,7
231966,9,12,4,0,8,4
231966,8,30,2,0,28,2
231966,7,40,3,0,37,3
231966,6,41,5,0,36,5
231966,5,21,2,0,19,2
231966,4,15,3,0,12,3
231966,3,22,5,0,17,5
231966,2,7,2,0,5,2
231966,1,3,1,0,2,1
4352,10,3,1,0,2,1
4352,9,3,1,0,2,1
4352,8,23,7,0,16,7
4352,7,40,15,0,25,15
4352,6,68,21,0,47,21
4352,5,46,14,0,32,14
4352,4,16,5,0,11,5
4352,3,12,5,0,7,5
8860,8,4,3,0,1,3
8860,7,16,8,0,8,8
8860,6,75,18,0,57,18
8860,5,56,13,0,43,13
8860,4,38,11,0,27,11
8860,3,10,2,0,8,2
8860,2,10,3,0,7,3
3248,10,7,3,0,4,3
3248,9,13,4,0,9,4
3248,8,27,7,0,20,7
3248,7,49,21,0,28,21
3248,6,68,18,0,50,18
3248,5,29,5,0,24,5
3248,4,16,2,0,14,2
3248,3,3,2,0,1,2
132019,10,7,2,0,5,2
132019,9,33,12,0,21,12
132019,8,89,31,0,58,31
132019,7,60,21,0,39,21
132019,6,15,3,0,12,3
132019,4,1,1,0,0,1
132019,3,1,1,0,0,1
28436,8,32,3,0,29,3
28436,7,68,5,0,63,5
28436,6,80,4,0,76,4
28436,5,19,2,0,17,2
28436,4,9,5,0,4,5
28436,3,3,3,0,0,3
28436,2,2,1,0,1,1
144499,9,5,2,0,3,2
144499,8,24,5,0,19,5
144499,7,60,18,0,42,18
144499,6,74,12,0,62,12
144499,5,20,3,0,17,3
144499,4,22,4,0,18,4
144499,3,8,3,0,5,3
3992,10,24,16,0,8,16
3992,9,33,15,0,18,15
3992,8,63,23,0,40,23
3992,7,36,15,0,21,15
3992,6,33,13,0,20,13
3992,5,9,3,0,6,3
3992,4,7,3,0,4,3
3992,3,3,3,0,0,3
3992,2,6,5,0,1,5
3992,1,1,1,0,0,1
1833,10,7,2,0,5,2
1833,9,4,1,0,3,1
1833,8,16,4,0,12,4
1833,7,32,12,0,20,12
1833,6,67,16,0,51,16
1833,5,41,9,0,32,9
1833,4,30,13,0,17,13
1833,3,11,3,0,8,3
1833,2,6,2,0,4,2
12956,9,4,1,0,3,1
12956,8,9,5,0,4,5
12956,7,33,4,0,29,4
12956,6,72,9,0,63,9
12956,5,58,3,0,55,3
12956,4,28,5,0,23,5
12956,3,7,3,0,4,3
12956,2,5,1,0,4,1
17859,9,10,1,0,9,1
17859,8,37,8,0,29,8
17859,7,50,7,0,43,7
17859,6,57,11,0,46,11
17859,5,33,10,0,23,10
17859,4,16,1,0,15,1
17859,3,7,1,0,6,1
195373,8,16,4,0,12,4
195373,7,53,7,1,46,6
195373,6,92,16,2,76,14
195373,5,28,6,0,22,6
195373,4,17,6,1,11,5
195373,3,3,2,1,1,1
17382,10,6,2,0,4,2
17382,9,9,3,0,6,3
17382,8,32,11,0,21,11
17382,7,53,15,0,38,15
17382,6,69,22,0,47,22
17382,5,21,8,0,13,8
17382,4,9,5,0,4,5
17382,3,9,5,0,4,5
17382,2,6,3,0,3,3
234468,8,30,6,0,24,6
234468,7,79,15,0,64,15
234468,6,66,4,0,62,4
234468,5,29,7,0,22,7
234468,4,7,2,0,5,2
102681,10,9,1,0,8,1
102681,9,15,2,0,13,2
102681,8,35,9,0,26,9
102681,7,57,10,0,47,10
102681,6,58,5,0,53,5
102681,5,26,3,0,23,3
102681,4,9,3,0,6,3
102681,3,5,1,0,4,1
17204,9,5,2,0,3,2
17204,8,25,20,0,5,20
17204,7,64,27,0,37,27
17204,6,76,32,0,44,32
17204,5,26,15,0,11,15
17204,4,14,4,0,10,4
17204,3,5,2,0,3,2
2970,10,1,1,0,0,1
2970,8,12,6,0,6,6
2970,7,40,15,0,25,15
2970,6,73,18,0,55,18
2970,5,42,13,0,29,13
2970,4,28,7,0,21,7
2970,3,11,5,0,6,5
2970,2,3,3,0,0,3
2970,1,2,1,0,1,1
20077,10,6,4,0,2,4
20077,9,13,7,0,6,7
20077,8,60,22,0,38,22
20077,7,62,17,0,45,17
20077,6,45,15,0,30,15
20077,5,12,5,0,7,5
20077,4,8,5,0,3,5
20077,3,4,2,0,2,2
20077,2,3,2,0,1,2
2857,10,7,2,0,5,2
2857,9,13,3,0,10,3
2857,8,18,3,0,15,3
2857,7,54,14,0,40,14
2857,6,61,10,0,51,10
2857,5,24,2,0,22,2
2857,4,19,6,0,13,6
2857,1,8,6,0,2,6
5677,10,17,10,0,7,10
5677,9,21,13,0,8,13
5677,8,48,23,0,25,23
5677,7,64,26,0,38,26
5677,6,43,18,0,25,18
5677,5,14,4,0,10,4
5677,4,5,2,0,3,2
2812,9,3,2,0,1,2
2812,8,18,8,0,10,8
2812,7,44,12,0,32,12
2812,6,69,28,0,41,28
2812,5,48,18,0,30,18
2812,4,16,4,0,12,4
2812,3,6,2,0,4,2
2812,2,6,4,0,2,4
32016,10,3,2,0,1,2
32016,8,8,4,0,4,4
32016,7,42,23,0,19,23
32016,6,76,29,0,47,29
32016,5,50,18,0,32,18
32016,4,23,11,0,12,11
32016,3,8,5,0,3,5
32016,2,4,2,0,2,2
181393,10,11,4,0,7,4
181393,9,19,6,1,13,5
181393,8,57,18,3,39,15
181393,7,57,8,1,49,7
181393,6,43,5,1,38,4
181393,5,18,3,0,15,3
181393,4,4,1,0,3,1
2520,10,7,1,0,6,1
2520,9,13,3,0,10,3
2520,8,46,7,0,39,7
2520,7,59,15,0,44,15
2520,6,56,17,0,39,17
2520,5,23,1,0,22,1
2520,4,7,2,0,5,2
2520,3,2,1,0,1,1
2520,1,1,1,0,0,1
155822,10,5,1,0,4,1
155822,8,21,5,0,16,5
155822,7,54,7,0,47,7
155822,6,69,6,0,63,6
155822,5,40,9,0,31,9
155822,4,17,4,0,13,4
155822,3,4,1,0,3,1
155822,1,1,1,0,0,1
820,10,12,5,0,7,5
820,9,13,8,0,5,8
820,8,55,23,0,32,23
820,7,57,26,0,31,26
820,6,49,11,0,38,11
820,5,15,4,0,11,4
820,4,9,5,0,4,5
42617,9,4,1,0,3,1
42617,8,30,12,0,18,12
42617,7,42,23,0,19,23
42617,6,63,19,0,44,19
42617,5,38,16,0,22,16
42617,4,23,14,0,9,14
42617,3,7,4,0,3,4
42617,2,4,1,0,3,1
42617,1,1,1,0,0,1
17533,10,15,3,0,12,3
17533,9,14,2,0,12,2
17533,8,42,12,0,30,12
17533,7,49,7,0,42,7
17533,6,57,11,0,46,11
17533,5,24,8,0,16,8
17533,2,2,1,0,1,1
215616,10,19,5,0,14,5
215616,9,33,5,0,28,5
215616,8,70,11,0,59,11
215616,7,62,10,0,52,10
215616,6,22,4,0,18,4
215616,5,5,1,0,4,1
702,10,4,4,0,0,4
702,9,7,4,0,3,4
702,8,19,3,0,16,3
702,7,35,13,0,22,13
702,6,78,21,0,57,21
702,5,38,14,0,24,14
702,4,21,4,0,17,4
702,3,11,5,0,6,5
3705,9,3,2,0,1,2
3705,8,23,6,0,17,6
3705,7,42,9,0,33,9
3705,6,73,22,0,51,22
3705,5,39,13,0,26,13
3705,4,24,6,0,18,6
3705,3,4,1,0,3,1
3705,2,4,1,0,3,1
142401,10,5,2,1,3,1
142401,8,43,9,1,34,8
142401,7,50,10,0,40,10
142401,6,61,14,1,47,13
142401,5,34,5,0,29,5
142401,4,7,3,0,4,3
142401,3,6,3,1,3,2
66088,10,2,1,0,1,1
66088,8,20,7,0,13,7
66088,7,47,9,0,38,9
66088,6,89,13,0,76,13
66088,5,34,7,0,27,7
66088,4,13,1,0,12,1
66088,3,4,1,0,3,1
119622,10,3,1,0,2,1
119622,8,23,7,0,16,7
119622,7,45,9,0,36,9
119622,6,53,11,0,42,11
119622,5,24,7,0,17,7
119622,4,26,5,0,21,5
119622,3,15,6,1,9,5
119622,2,8,2,0,6,2
119622,1,14,5,0,9,5
166280,10,10,2,0,8,2
166280,9,4,1,0,3,1
166280,8,43,5,0,38,5
166280,7,56,6,0,50,6
166280,6,66,7,1,59,6
166280,5,26,6,0,20,6
166280,3,4,2,0,2,2
2521,10,3,2,0,1,2
2521,9,4,2,0,2,2
2521,8,22,11,0,11,11
2521,7,46,15,0,31,15
2521,6,82,31,0,51,31
2521,5,40,15,0,25,15
2521,4,13,6,0,7,6
2521,2,2,2,0,0,2
2866,10,1,1,0,0,1
2866,8,20,4,0,16,4
2866,7,31,9,0,22,9
2866,6,64,16,0,48,16
2866,5,46,17,0,29,17
2866,4,23,4,0,19,4
2866,3,14,7,0,7,7
2866,2,8,4,0,4,4
2866,1,6,1,0,5,1
148759,9,12,2,0,10,2
148759,8,42,5,0,37,5
148759,7,42,5,0,37,5
148759,6,59,8,0,51,8
148759,5,25,3,0,22,3
148759,4,15,3,0,12,3
148759,3,7,1,0,6,1
148759,2,3,1,0,2,1
148759,1,3,1,0,2,1
234521,10,26,5,0,21,5
234521,9,57,5,0,52,5
234521,8,69,15,0,54,15
234521,7,34,8,0,26,8
234521,6,16,3,0,13,3
234521,5,2,1,0,1,1
234521,4,3,1,0,2,1
234521,3,3,1,0,2,1
234521,2,1,1,0,0,1
234521,1,3,3,0,0,3
165595,10,9,4,0,5,4
165595,9,26,8,0,18,8
165595,8,71,19,0,52,19
165595,7,66,15,0,51,15
165595,6,32,12,0,20,12
165595,5,4,2,0,2,2
165595,3,1,1,0,0,1
28018,9,3,1,0,2,1
28018,8,10,1,0,9,1
28018,7,16,2,0,14,2
28018,6,73,12,0,61,12
28018,5,36,5,0,31,5
28018,4,43,7,0,36,7
28018,3,14,3,0,11,3
28018,2,14,4,0,10,4
28018,1,4,2,0,2,2
212346,10,83,11,3,72,8
212346,9,68,4,1,64,3
212346,8,35,4,0,31,4
212346,6,7,2,0,5,2
212346,4,3,1,0,2,1
212346,1,5,1,0,4,1
256067,10,4,1,0,3,1
256067,9,18,2,0,16,2
256067,8,79,9,0,70,9
256067,7,67,10,0,57,10
256067,6,35,3,0,32,3
256067,5,6,1,0,5,1
256067,4,2,1,0,1,1
116981,9,5,3,0,2,3
116981,8,22,1,0,21,1
116981,7,44,8,0,36,8
116981,6,89,19,0,70,19
116981,5,27,7,0,20,7
116981,4,19,4,0,15,4
116981,3,4,1,0,3,1
9346,10,1,1,0,0,1
9346,9,10,5,0,5,5
9346,8,27,8,0,19,8
9346,7,60,19,0,41,19
9346,6,78,24,0,54,24
9346,5,22,2,0,20,2
9346,4,9,3,0,6,3
9346,3,3,1,0,2,1
9346,2,2,1,0,1,1
9346,1,1,1,0,0,1
169743,10,6,1,0,5,1
169743,9,6,1,0,5,1
169743,8,20,6,0,14,6
169743,7,55,7,0,48,7
169743,6,72,12,0,60,12
169743,5,26,5,0,21,5
169743,4,8,1,0,7,1
169743,3,13,2,0,11,2
169743,1,2,1,0,1,1
127129,8,22,8,0,14,8
127129,7,38,5,0,33,5
127129,6,70,16,0,54,16
127129,5,36,7,0,29,7
127129,4,17,4,0,13,4
127129,3,19,5,0,14,5
127129,2,5,3,0,2,3
428,9,6,2,0,4,2
428,8,12,2,0,10,2
428,7,47,13,0,34,13
428,6,83,19,0,64,19
428,5,32,3,0,29,3
428,4,21,9,0,12,9
428,3,6,3,0,3,3
428,2,4,1,0,3,1
189351,10,14,5,1,9,4
189351,9,24,5,0,19,5
189351,8,41,6,0,35,6
189351,7,32,3,0,29,3
189351,6,49,7,1,42,6
189351,5,16,1,0,15,1
189351,4,15,4,0,11,4
189351,3,12,5,0,7,5
189351,2,4,1,0,3,1
189351,1,5,2,0,3,2
33759,10,6,1,0,5,1
33759,9,28,9,0,19,9
33759,8,65,22,0,43,22
33759,7,48,8,0,40,8
33759,6,34,9,0,25,9
33759,5,14,5,0,9,5
33759,4,11,6,0,5,6
33759,2,2,1,0,1,1
33759,1,1,1,0,0,1
1422,10,2,2,0,0,2
1422,9,1,1,0,0,1
1422,8,6,5,0,1,5
1422,7,13,4,0,9,4
1422,6,24,6,0,18,6
1422,5,35,12,0,23,12
1422,4,36,8,0,28,8
1422,3,26,12,0,14,12
1422,2,38,18,0,20,18
1422,1,31,24,0,7,24
40759,9,3,1,0,2,1
40759,8,37,7,0,30,7
40759,7,61,7,0,54,7
40759,6,78,12,0,66,12
40759,5,21,4,0,17,4
40759,4,8,1,0,7,1
8816,8,6,2,0,4,2
8816,7,32,15,0,17,15
8816,6,98,35,0,63,35
8816,5,44,15,0,29,15
8816,4,19,10,0,9,10
8816,3,10,4,0,6,4
8816,2,2,1,0,1,1
122913,10,21,8,0,13,8
122913,9,24,7,0,17,7
122913,8,64,14,0,50,14
122913,7,50,14,0,36,14
122913,6,35,12,0,23,12
122913,4,8,4,0,4,4
122913,3,1,1,0,0,1
17451,10,4,1,0,3,1
17451,9,2,2,0,0,2
17451,8,8,2,0,6,2
17451,7,12,1,0,11,1
17451,6,36,12,0,24,12
17451,5,52,17,0,35,17
17451,4,40,15,0,25,15
17451,3,22,8,0,14,8
17451,2,27,15,0,12,15
17451,1,9,7,0,2,7
219101,10,16,5,0,11,5
219101,9,46,14,0,32,14
219101,8,110,21,3,89,18
219101,7,25,8,0,17,8
219101,6,10,5,0,5,5
219101,5,3,1,0,2,1
219101,4,1,1,0,0,1
219101,3,1,1,0,0,1
2344,9,6,2,0,4,2
2344,8,30,10,0,20,10
2344,7,57,17,0,40,17
2344,6,68,17,0,51,17
2344,5,30,9,0,21,9
2344,4,14,7,0,7,7
2344,3,7,3,0,4,3
99078,10,7,2,1,5,1
99078,9,18,8,3,10,5
99078,8,57,22,0,35,22
99078,7,48,16,2,32,14
99078,6,39,11,0,28,11
99078,5,18,11,1,7,10
99078,4,16,6,0,10,6
99078,3,3,1,0,2,1
99078,2,6,3,0,3,3
139,10,3,2,0,1,2
139,9,7,1,0,6,1
139,8,32,10,0,22,10
139,7,38,17,0,21,17
139,6,61,22,0,39,22
139,5,35,14,0,21,14
139,4,16,3,0,13,3
139,3,12,4,0,8,4
139,2,6,3,0,3,3
139,1,1,1,0,0,1
154939,10,12,2,0,10,2
154939,9,25,7,1,18,6
154939,8,52,13,3,39,10
154939,7,48,7,0,41,7
154939,6,36,3,0,33,3
154939,5,10,3,0,7,3
154939,4,8,2,0,6,2
154939,3,9,5,1,4,4
154939,2,3,2,0,1,2
154939,1,8,3,0,5,3
199047,10,4,3,0,1,3
199047,9,9,3,0,6,3
199047,8,61,15,2,46,13
199047,7,72,13,1,59,12
199047,6,44,5,0,39,5
199047,5,11,3,0,8,3
199047,4,4,2,0,2,2
199047,3,4,1,0,3,1
199047,2,1,1,0,0,1
2766,10,2,1,0,1,1
2766,9,6,3,0,3,3
2766,8,12,4,0,8,4
2766,7,17,5,0,12,5
2766,6,51,14,0,37,14
2766,5,56,8,0,48,8
2766,4,39,11,0,28,11
2766,3,16,5,0,11,5
2766,2,9,6,0,3,6
1235,10,2,1,0,1,1
1235,8,11,4,0,7,4
1235,7,40,12,0,28,12
1235,6,77,26,0,51,26
1235,5,41,7,0,34,7
1235,4,22,8,0,14,8
1235,3,9,5,0,4,5
1235,2,8,4,0,4,4
1773,10,2,1,0,1,1
1773,9,6,3,0,3,3
1773,8,17,5,0,12,5
1773,7,42,16,0,26,16
1773,6,76,35,0,41,35
1773,5,42,13,0,29,13
1773,4,12,2,0,10,2
1773,3,9,5,0,4,5
1773,1,3,1,0,2,1
22604,9,14,3,0,11,3
22604,8,50,19,0,31,19
22604,7,45,12,0,33,12
22604,6,45,14,0,31,14
22604,5,26,9,0,17,9
22604,4,10,5,0,5,5
22604,3,9,5,0,4,5
22604,2,6,3,0,3,3
22604,1,2,1,0,1,1
5607,9,2,1,0,1,1
5607,8,18,6,0,12,6
5607,7,59,20,0,39,20
5607,6,72,28,0,44,28
5607,5,30,11,0,19,11
5607,4,21,7,0,14,7
5607,3,6,2,0,4,2
130006,10,14,3,0,11,3
130006,9,17,2,0,15,2
130006,8,65,10,0,55,10
130006,7,76,10,0,66,10
130006,6,28,5,0,23,5
130006,5,8,4,0,4,4
130006,4,3,1,0,2,1
1447,10,35,14,0,21,14
1447,9,46,20,0,26,20
1447,8,67,22,0,45,22
1447,7,28,9,0,19,9
1447,6,19,8,0,11,8
1447,5,5,2,0,3,2
1447,4,6,4,0,2,4
1447,1,4,1,0,3,1
39019,10,9,3,0,6,3
39019,9,39,13,0,26,13
39019,8,95,29,0,66,29
39019,7,39,9,0,30,9
39019,6,20,5,0,15,5
39019,5,4,3,0,1,3
39019,4,5,2,0,3,2
158100,10,5,1,0,4,1
158100,9,9,2,0,7,2
158100,8,33,5,0,28,5
158100,7,70,5,0,65,5
158100,6,79,11,0,68,11
158100,4,2,1,0,1,1
158978,10,7,1,0,6,1
158978,8,28,4,0,24,4
158978,7,45,1,0,44,1
158978,6,69,13,0,56,13
158978,5,29,3,0,26,3
158978,4,16,2,0,14,2
158978,3,6,1,0,5,1
158978,2,6,3,0,3,3
144865,9,3,1,0,2,1
144865,8,12,2,0,10,2
144865,7,37,5,0,32,5
144865,6,82,24,0,58,24
144865,5,35,8,0,27,8
144865,4,21,6,0,15,6
144865,3,12,1,0,11,1
144865,2,7,1,0,6,1
137140,8,28,8,0,20,8
137140,7,45,7,0,38,7
137140,6,87,16,0,71,16
137140,5,29,5,0,24,5
137140,4,13,5,0,8,5
137140,3,3,1,0,2,1
180543,10,31,12,0,19,12
180543,9,48,12,1,36,11
180543,8,60,16,2,44,14
180543,7,43,10,0,33,10
180543,6,18,3,0,15,3
180543,5,6,4,0,2,4
118703,10,4,3,0,1,3
118703,9,12,2,0,10,2
118703,8,46,17,0,29,17
118703,7,74,19,0,55,19
118703,6,46,20,0,26,20
118703,5,23,9,0,14,9
118703,4,2,1,0,1,1
118703,3,2,1,0,1,1
40503,10,2,1,0,1,1
40503,8,3,2,0,1,2
40503,7,24,9,0,15,9
40503,6,81,28,0,53,28
40503,5,51,13,0,38,13
40503,4,23,4,0,19,4
40503,3,20,7,0,13,7
40503,2,6,1,0,5,1
12642,9,5,1,0,4,1
12642,8,11,2,0,9,2
12642,7,21,7,0,14,7
12642,6,45,15,0,30,15
12642,5,54,20,0,34,20
12642,4,41,17,0,24,17
12642,3,16,10,0,6,10
12642,2,9,4,0,5,4
12642,1,8,5,0,3,5
152952,10,3,2,0,1,2
152952,9,4,2,0,2,2
152952,8,35,5,0,30,5
152952,7,61,11,0,50,11
152952,6,62,15,0,47,15
152952,5,23,7,0,16,7
152952,4,15,6,0,9,6
152952,3,5,2,0,3,2
230430,10,11,2,0,9,2
230430,9,18,2,0,16,2
230430,8,44,7,0,37,7
230430,7,60,12,0,48,12
230430,6,40,5,0,35,5
230430,5,20,7,0,13,7
230430,4,4,2,0,2,2
230430,3,7,2,0,5,2
197451,9,4,2,0,2,2
197451,8,20,1,0,19,1
197451,7,34,8,1,26,7
197451,6,57,11,1,46,10
197451,5,34,8,3,26,5
197451,4,22,3,1,19,2
197451,3,10,4,0,6,4
197451,2,10,5,2,5,3
197451,1,15,9,2,6,7
40667,10,4,2,0,2,2
40667,9,4,1,0,3,1
40667,8,37,12,0,25,12
40667,7,30,9,0,21,9
40667,6,77,30,0,47,30
40667,5,36,14,0,22,14
40667,4,13,4,0,9,4
40667,3,7,1,0,6,1
2693,10,1,1,0,0,1
2693,8,5,4,0,1,4
2693,7,23,8,0,15,8
2693,6,64,19,0,45,19
2693,5,55,9,0,46,9
2693,4,45,17,0,28,17
2693,3,11,3,0,8,3
2693,2,4,4,0,0,4
109801,8,30,4,0,26,4
109801,7,44,14,0,30,14
109801,6,73,16,0,57,16
109801,5,28,5,0,23,5
109801,4,12,1,0,11,1
109801,3,6,3,0,3,3
207117,10,9,1,0,8,1
207117,9,15,4,0,11,4
207117,8,26,3,0,23,3
207117,7,55,5,0,50,5
207117,6,55,10,5,45,5
207117,5,24,9,2,15,7
207117,4,11,2,1,9,1
207117,3,10,4,0,6,4
207117,2,4,1,0,3,1
55158,10,4,2,0,2,2
55158,9,11,3,0,8,3
55158,8,45,15,0,30,15
55158,7,38,8,0,30,8
55158,6,56,12,0,44,12
55158,5,26,8,0,18,8
55158,4,21,6,0,15,6
55158,3,7,2,0,5,2
55158,2,2,1,0,1,1
2738,9,3,3,0,0,3
2738,8,3,1,0,2,1
2738,7,23,8,0,15,8
2738,6,81,17,0,64,17
2738,5,42,12,0,30,12
2738,4,34,12,0,22,12
2738,3,17,7,0,10,7
2738,2,5,1,0,4,1
17922,8,39,1,0,38,1
17922,7,69,9,0,60,9
17922,6,67,7,0,60,7
17922,5,18,2,0,16,2
17922,4,4,1,0,3,1
17922,3,1,1,0,0,1
175224,10,2,1,0,1,1
175224,9,7,1,0,6,1
175224,8,19,6,0,13,6
175224,7,43,11,0,32,11
175224,6,59,12,0,47,12
175224,5,40,7,0,33,7
175224,4,23,6,0,17,6
175224,3,12,3,0,9,3
175224,2,5,3,0,2,3
7182,8,15,4,0,11,4
7182,7,45,17,0,28,17
7182,6,71,23,0,48,23
7182,5,38,13,0,25,13
7182,4,23,13,0,10,13
7182,3,7,5,0,2,5
7182,2,5,3,0,2,3
7182,1,1,1,0,0,1
202982,10,16,5,0,11,5
202982,9,22,5,0,17,5
202982,8,58,10,0,48,10
202982,7,45,5,0,40,5
202982,6,39,7,0,32,7
202982,5,16,5,0,11,5
202982,3,2,1,0,1,1
202982,2,6,5,0,1,5
202982,1,1,1,0,0,1
3352,8,8,4,0,4,4
3352,7,21,6,0,15,6
3352,6,76,21,0,55,21
3352,5,43,17,0,26,17
3352,4,34,12,0,22,12
3352,3,17,6,0,11,6
3352,2,9,4,0,5,4
4587,8,5,2,0,3,2
4587,7,23,3,0,20,3
4587,6,41,4,0,37,4
4587,5,38,2,0,36,2
4587,4,45,10,0,35,10
4587,3,29,6,0,23,6
4587,2,20,6,0,14,6
4587,1,7,2,0,5,2
123408,10,17,4,0,13,4
123408,9,25,2,1,23,1
123408,8,39,14,3,25,11
123408,7,35,8,0,27,8
123408,6,37,10,3,27,7
123408,5,18,2,1,16,1
123408,4,10,5,1,5,4
123408,3,12,5,0,7,5
123408,2,7,5,0,2,5
123408,1,9,4,2,5,2
209136,10,9,4,2,5,2
209136,9,23,8,0,15,8
209136,8,92,28,0,64,28
209136,7,48,6,0,42,6
209136,6,25,6,1,19,5
209136,5,8,3,0,5,3
209136,1,1,1,0,0,1
23049,8,14,1,0,13,1
23049,7,23,6,0,17,6
23049,6,62,24,0,38,24
23049,5,54,10,0,44,10
23049,4,32,6,0,26,6
23049,3,11,3,0,8,3
23049,2,10,3,0,7,3
34659,10,8,3,0,5,3
34659,9,25,6,0,19,6
34659,8,74,13,0,61,13
34659,7,53,15,0,38,15
34659,6,33,13,0,20,13
34659,5,9,3,0,6,3
34659,4,2,1,0,1,1
34659,3,2,1,0,1,1
256669,10,6,2,0,4,2
256669,9,16,3,0,13,3
256669,8,83,18,0,65,18
256669,7,48,9,0,39,9
256669,6,39,6,0,33,6
256669,5,8,2,0,6,2
256669,4,8,2,0,6,2
67148,10,8,1,0,7,1
67148,9,13,6,0,7,6
67148,8,45,6,0,39,6
67148,7,64,10,0,54,10
67148,6,53,9,0,44,9
67148,5,8,3,0,5,3
67148,4,7,1,0,6,1
67148,3,3,1,0,2,1
67148,1,3,1,0,2,1
8003,10,12,4,0,8,4
8003,9,16,4,0,12,4
8003,8,36,10,0,26,10
8003,7,60,12,0,48,12
8003,6,47,11,0,36,11
8003,5,15,5,0,10,5
8003,4,12,2,0,10,2
8003,3,2,2,0,0,2
8003,2,1,1,0,0,1
8003,1,8,2,0,6,2
7601,10,1,1,0,0,1
7601,6,15,4,0,11,4
7601,5,26,4,0,22,4
7601,4,53,8,0,45,8
7601,3,38,11,0,27,11
7601,2,48,18,0,30,18
7601,1,23,13,0,10,13
39932,10,12,4,0,8,4
39932,9,17,3,0,14,3
39932,8,87,25,0,62,25
39932,7,60,15,0,45,15
39932,6,18,9,0,9,9
39932,5,10,8,0,2,8
39932,4,3,1,0,2,1
39932,3,2,1,0,1,1
50862,8,26,6,0,20,6
50862,7,47,11,0,36,11
50862,6,77,14,0,63,14
50862,5,30,10,0,20,10
50862,4,13,5,0,8,5
50862,3,8,3,0,5,3
2878,8,5,1,0,4,1
2878,7,14,6,0,8,6
2878,6,41,9,0,32,9
2878,5,46,12,0,34,12
2878,4,45,12,0,33,12
2878,3,25,10,0,15,10
2878,2,20,9,0,11,9
2878,1,13,4,0,9,4
192984,10,18,13,2,5,11
192984,9,15,6,0,9,6
192984,8,29,8,0,21,8
192984,7,34,5,1,29,4
192984,6,49,6,0,43,6
192984,5,15,1,0,14,1
192984,4,13,2,0,11,2
192984,3,13,3,0,10,3
192984,2,10,2,0,8,2
192984,1,13,5,0,8,5
24051,10,2,1,0,1,1
24051,9,4,3,0,1,3
24051,8,31,13,0,18,13
24051,7,50,22,0,28,22
24051,6,67,23,0,44,23
24051,5,23,10,0,13,10
24051,4,19,10,0,9,10
24051,3,9,7,0,2,7
24051,2,3,2,0,1,2
153991,10,4,2,0,2,2
153991,9,11,3,0,8,3
153991,8,65,10,1,55,9
153991,7,59,18,1,41,17
153991,6,42,8,0,34,8
153991,5,18,4,0,14,4
153991,4,8,1,0,7,1
153991,1,1,1,1,0,0
1378,8,17,7,0,10,7
1378,7,36,4,0,32,4
1378,6,83,15,0,68,15
1378,5,32,7,0,25,7
1378,4,21,11,0,10,11
1378,3,15,4,0,11,4
159003,10,13,1,0,12,1
159003,8,22,1,0,21,1
159003,7,28,7,0,21,7
159003,6,63,6,0,57,6
159003,5,34,8,0,26,8
159003,4,17,2,0,15,2
159003,2,7,1,0,6,1
159003,1,7,5,2,2,3
2119,10,3,1,0,2,1
2119,9,6,2,0,4,2
2119,8,17,2,0,15,2
2119,7,37,14,0,23,14
2119,6,67,14,0,53,14
2119,5,45,14,0,31,14
2119,4,17,8,0,9,8
2119,3,10,6,0,4,6
2119,2,6,3,0,3,3
20040,8,11,3,0,8,3
20040,7,16,4,0,12,4
20040,6,61,14,0,47,14
20040,5,65,17,0,48,17
20040,4,29,8,0,21,8
20040,3,17,7,0,10,7
20040,2,4,3,0,1,3
20040,1,4,2,0,2,2
28452,10,18,9,0,9,9
28452,9,41,17,0,24,17
28452,8,72,26,0,46,26
28452,7,40,13,0,27,13
28452,6,24,10,0,14,10
28452,5,8,4,0,4,4
28452,4,3,2,0,1,2
28452,3,2,2,0,0,2
185104,10,5,1,0,4,1
185104,8,16,1,0,15,1
185104,7,31,2,0,29,2
185104,6,70,8,0,62,8
185104,5,50,4,0,46,4
185104,4,15,1,0,14,1
185104,3,11,2,0,9,2
185104,2,4,2,0,2,2
185104,1,6,1,0,5,1
93563,10,6,3,0,3,3
93563,8,16,3,0,13,3
93563,7,48,9,0,39,9
93563,6,73,14,0,59,14
93563,5,26,7,0,19,7
93563,4,22,9,0,13,9
93563,3,8,2,0,6,2
93563,2,6,3,0,3,3
169275,10,13,1,0,12,1
169275,9,25,4,0,21,4
169275,8,67,7,1,60,6
169275,7,54,8,0,46,8
169275,6,37,5,0,32,5
169275,5,7,1,0,6,1
169275,2,2,1,0,1,1
169275,1,1,1,0,0,1
169475,10,16,9,1,7,8
169475,9,18,6,1,12,5
169475,8,62,16,1,46,15
169475,7,61,10,1,51,9
169475,6,34,8,0,26,8
169475,5,9,1,0,8,1
169475,4,3,1,0,2,1
69318,9,5,1,0,4,1
69318,8,24,2,0,22,2
69318,7,46,7,0,39,7
69318,6,80,24,0,56,24
69318,5,26,9,0,17,9
69318,4,10,5,0,5,5
69318,3,7,2,0,5,2
69318,2,7,5,0,2,5
69318,1,2,1,0,1,1
182260,10,8,1,0,7,1
182260,9,13,3,0,10,3
182260,8,62,24,0,38,24
182260,7,60,17,0,43,17
182260,6,45,14,0,31,14
182260,5,12,2,0,10,2
182260,4,6,3,0,3,3
182260,2,1,1,0,0,1
140172,10,7,5,0,2,5
140172,9,5,1,0,4,1
140172,8,26,9,0,17,9
140172,7,49,7,0,42,7
140172,6,54,10,0,44,10
140172,5,40,6,0,34,6
140172,4,17,4,0,13,4
140172,3,8,3,0,5,3
540,10,2,1,0,1,1
540,8,24,10,0,14,10
540,7,58,19,0,39,19
540,6,79,12,0,67,12
540,5,28,3,0,25,3
540,4,7,3,0,4,3
540,3,6,1,0,5,1
38429,10,11,7,0,4,7
38429,9,19,5,0,14,5
38429,8,66,14,0,52,14
38429,7,51,21,0,30,21
38429,6,50,13,0,37,13
38429,5,6,1,0,5,1
38429,4,3,2,0,1,2
38429,3,2,1,0,1,1
223674,10,7,3,0,4,3
223674,9,8,3,0,5,3
223674,8,31,7,0,24,7
223674,7,46,11,3,35,8
223674,6,59,10,1,49,9
223674,5,25,4,0,21,4
223674,3,8,1,0,7,1
223674,1,2,1,0,1,1
117992,10,2,1,0,1,1
117992,8,14,3,0,11,3
117992,7,38,7,0,31,7
117992,6,80,15,0,65,15
117992,5,41,4,0,37,4
117992,4,23,3,0,20,3
117992,3,4,1,0,3,1
117992,2,3,2,0,1,2
117992,1,2,1,0,1,1
185154,10,3,1,0,2,1
185154,8,12,2,1,10,1
185154,7,21,4,0,17,4
185154,6,60,6,2,54,4
185154,5,32,10,1,22,9
185154,4,29,8,1,21,7
185154,3,29,6,0,23,6
185154,2,12,3,1,9,2
185154,1,10,8,2,2,6
2457,10,6,2,0,4,2
2457,9,7,3,0,4,3
2457,8,22,9,0,13,9
2457,7,29,8,0,21,8
2457,6,78,27,0,51,27
2457,5,34,8,0,26,8
2457,4,22,9,0,13,9
2457,3,6,1,0,5,1
2457,2,3,1,0,2,1
141725,9,4,1,0,3,1
141725,8,16,1,0,15,1
141725,7,37,13,0,24,13
141725,6,72,17,0,55,17
141725,5,32,5,1,27,4
141725,4,22,9,0,13,9
141725,3,13,5,0,8,5
141725,2,6,4,0,2,4
141725,1,3,2,0,1,2
1698,10,4,1,0,3,1
1698,9,2,1,0,1,1
1698,8,20,11,0,9,11
1698,7,26,11,0,15,11
1698,6,76,17,0,59,17
1698,5,41,9,0,32,9
1698,4,19,2,0,17,2
1698,3,13,5,0,8,5
1698,2,4,3,0,1,3
1698,1,3,2,0,1,2
213882,10,5,1,0,4,1
213882,9,10,3,0,7,3
213882,8,60,12,0,48,12
213882,7,79,13,0,66,13
213882,6,35,10,0,25,10
213882,5,15,1,0,14,1
4367,8,4,2,0,2,2
4367,7,9,2,0,7,2
4367,6,30,4,0,26,4
4367,5,32,7,0,25,7
4367,4,31,7,0,24,7
4367,3,22,9,0,13,9
4367,2,47,19,0,28,19
4367,1,31,18,0,13,18
136249,8,6,1,0,5,1
136249,7,23,2,0,21,2
136249,6,71,12,0,59,12
136249,5,33,7,0,26,7
136249,4,29,8,0,21,8
136249,3,22,5,0,17,5
136249,2,14,4,0,10,4
136249,1,5,2,0,3,2
1543,9,10,3,0,7,3
1543,8,25,7,0,18,7
1543,7,36,8,0,28,8
1543,6,70,15,0,55,15
1543,5,39,11,0,28,11
1543,4,11,2,0,9,2
1543,3,7,1,0,6,1
1543,2,1,1,0,0,1
1543,1,3,1,0,2,1
166569,10,5,1,0,4,1
166569,9,9,4,0,5,4
166569,8,48,10,1,38,9
166569,7,59,10,0,49,10
166569,6,52,12,1,40,11
166569,5,14,3,0,11,3
166569,4,11,2,0,9,2
166569,3,6,2,0,4,2
3170,10,6,1,0,5,1
3170,9,7,3,0,4,3
3170,8,34,7,0,27,7
3170,7,68,19,0,49,19
3170,6,54,18,0,36,18
3170,5,17,4,0,13,4
3170,4,10,1,0,9,1
3170,3,5,2,0,3,2
3170,2,1,1,0,0,1
3170,1,5,1,0,4,1
134559,10,1,1,0,0,1
134559,9,6,1,0,5,1
134559,8,29,6,2,23,4
134559,7,38,8,1,30,7
134559,6,65,11,2,54,9
134559,5,34,4,2,30,2
134559,4,21,4,1,17,3
134559,3,8,5,0,3,5
134559,2,5,1,1,4,0
247436,10,9,2,0,7,2
247436,9,13,2,0,11,2
247436,8,57,9,0,48,9
247436,7,60,3,0,57,3
247436,6,57,6,0,51,6
247436,5,10,2,0,8,2
247436,4,3,2,0,1,2
247436,3,1,1,0,0,1
23995,10,17,6,0,11,6
23995,9,32,19,0,13,19
23995,8,77,25,0,52,25
23995,7,39,13,0,26,13
23995,6,31,10,0,21,10
23995,5,8,4,0,4,4
23995,3,2,1,0,1,1
993,10,1,1,0,0,1
993,9,7,1,0,6,1
993,8,27,9,0,18,9
993,7,68,22,0,46,22
993,6,58,20,0,38,20
993,5,29,11,0,18,11
993,4,10,4,0,6,4
993,3,6,3,0,3,3
17991,10,26,7,0,19,7
17991,9,28,5,0,23,5
17991,8,43,9,0,34,9
17991,7,30,5,0,25,5
17991,6,39,6,0,33,6
17991,5,19,6,0,13,6
17991,4,11,2,0,9,2
17991,3,5,1,0,4,1
17991,2,3,3,0,0,3
17991,1,3,1,0,2,1
104234,9,4,1,0,3,1
104234,8,20,1,0,19,1
104234,7,30,7,0,23,7
104234,6,66,14,0,52,14
104234,5,38,8,0,30,8
104234,4,34,5,0,29,5
104234,3,10,3,0,7,3
104234,2,5,1,0,4,1
1460,9,2,2,0,0,2
1460,8,18,5,0,13,5
1460,7,32,11,0,21,11
1460,6,67,24,0,43,24
1460,5,51,8,0,43,8
1460,4,25,9,0,16,9
1460,3,9,4,0,5,4
98960,10,2,1,0,1,1
98960,8,30,8,0,22,8
98960,7,32,11,0,21,11
98960,6,64,15,0,49,15
98960,5,24,5,0,19,5
98960,4,16,4,0,12,4
98960,3,13,4,0,9,4
98960,2,9,4,0,5,4
98960,1,9,3,0,6,3
195456,8,16,1,0,15,1
195456,7,47,6,0,41,6
195456,6,83,14,2,69,12
195456,5,33,6,0,27,6
195456,4,16,6,2,10,4
195456,2,4,2,0,2,2
26147,8,24,7,0,17,7
26147,7,61,17,0,44,17
26147,6,71,17,0,54,17
26147,5,18,2,0,16,2
26147,4,15,4,0,11,4
26147,3,6,1,0,5,1
2412,10,4,1,0,3,1
2412,9,5,1,0,4,1
2412,8,23,8,0,15,8
2412,7,48,17,0,31,17
2412,6,72,18,0,54,18
2412,5,31,5,0,26,5
2412,4,14,6,0,8,6
2412,3,7,5,0,2,5
2412,2,2,1,0,1,1
74233,9,3,1,0,2,1
74233,8,28,4,0,24,4
74233,7,48,15,0,33,15
74233,6,75,21,0,54,21
74233,5,28,8,0,20,8
74233,4,9,3,0,6,3
74233,3,9,2,0,7,2
74233,2,3,1,0,2,1
167828,10,3,1,0,2,1
167828,8,60,14,0,46,14
167828,7,79,13,2,66,11
167828,6,37,7,0,30,7
167828,5,7,2,0,5,2
167828,4,10,2,0,8,2
38355,9,8,1,0,7,1
38355,8,20,4,0,16,4
38355,7,30,4,0,26,4
38355,6,70,16,0,54,16
38355,5,46,11,0,35,11
38355,4,19,3,0,16,3
38355,3,8,1,0,7,1
38355,2,2,1,0,1,1
158883,10,8,1,0,7,1
158883,9,7,1,0,6,1
158883,8,31,7,1,24,6
158883,7,48,11,2,37,9
158883,6,67,14,5,53,9
158883,5,25,8,0,17,8
158883,4,13,4,0,9,4
158883,3,4,4,2,0,2
158883,2,2,1,1,1,0
107464,8,10,1,0,9,1
107464,7,26,3,0,23,3
107464,6,85,12,0,73,12
107464,5,49,9,0,40,9
107464,4,14,3,0,11,3
107464,3,9,3,0,6,3
11274,10,8,1,0,7,1
11274,9,14,2,0,12,2
11274,8,83,20,0,63,20
11274,7,65,17,0,48,17
11274,6,24,10,0,14,10
11274,5,9,3,0,6,3
11274,4,2,2,0,0,2
11274,3,1,1,0,0,1
103714,10,2,1,0,1,1
103714,9,6,3,0,3,3
103714,8,21,5,0,16,5
103714,7,39,4,0,35,4
103714,6,49,13,0,36,13
103714,5,35,7,0,28,7
103714,4,19,4,0,15,4
103714,3,22,11,0,11,11
103714,2,7,3,0,4,3
103714,1,6,4,0,2,4
3758,10,1,1,0,0,1
3758,9,5,2,0,3,2
3758,8,15,6,0,9,6
3758,7,26,10,0,16,10
3758,6,52,6,0,46,6
3758,5,42,11,0,31,11
3758,4,42,11,0,31,11
3758,3,9,4,0,5,4
3758,2,12,6,0,6,6
204602,10,57,14,1,43,13
204602,9,25,7,1,18,6
204602,8,56,18,1,38,17
204602,7,26,3,1,23,2
204602,6,18,4,1,14,3
204602,5,12,2,0,10,2
204602,3,4,1,0,3,1
204602,2,2,1,0,1,1
204602,1,3,1,1,2,0
10140,9,6,3,0,3,3
10140,8,15,7,0,8,7
10140,7,36,9,0,27,9
10140,6,74,11,0,63,11
10140,5,43,11,0,32,11
10140,4,20,6,0,14,6
10140,3,7,2,0,5,2
10140,2,5,3,0,2,3
289,10,6,2,0,4,2
289,9,15,9,0,6,9
289,8,42,12,0,30,12
289,7,45,17,0,28,17
289,6,60,22,0,38,22
289,5,15,6,0,9,6
289,4,17,9,0,8,9
289,3,3,2,0,1,2
289,2,2,1,0,1,1
289,1,1,1,0,0,1
1470,10,3,1,0,2,1
1470,8,22,9,0,13,9
1470,7,37,9,0,28,9
1470,6,75,22,0,53,22
1470,5,25,2,0,23,2
1470,4,23,5,0,18,5
1470,3,11,2,0,9,2
1470,2,5,4,0,1,4
1470,1,2,2,0,0,2
22721,8,22,9,0,13,9
22721,7,41,16,0,25,16
22721,6,83,28,0,55,28
22721,5,28,8,0,20,8
22721,4,13,8,0,5,8
22721,3,10,5,0,5,5
22721,2,7,2,0,5,2
90050,10,3,1,0,2,1
90050,9,8,6,0,2,6
90050,8,22,6,0,16,6
90050,7,45,10,0,35,10
90050,6,68,17,0,51,17
90050,5,27,13,0,14,13
90050,4,16,7,0,9,7
90050,3,10,4,0,6,4
90050,2,4,3,0,1,3
90050,1,3,1,0,2,1
445,9,2,1,0,1,1
445,8,13,4,0,9,4
445,7,36,13,0,23,13
445,6,77,20,0,57,20
445,5,46,10,0,36,10
445,4,25,5,0,20,5
177698,9,3,1,0,2,1
177698,8,23,5,1,18,4
177698,7,36,9,1,27,8
177698,6,75,10,2,65,8
177698,5,33,8,3,25,5
177698,4,17,2,1,15,1
177698,3,11,2,1,9,1
177698,2,7,2,0,5,2
28574,8,22,5,0,17,5
28574,7,46,5,0,41,5
28574,6,59,3,0,56,3
28574,5,34,2,0,32,2
28574,4,15,3,0,12,3
28574,3,12,1,0,11,1
158791,10,3,1,0,2,1
158791,9,9,3,0,6,3
158791,8,19,2,0,17,2
158791,7,55,8,0,47,8
158791,6,72,10,0,62,10
158791,5,28,8,0,20,8
158791,4,11,5,0,6,5
158791,3,6,1,0,5,1
158791,2,2,1,0,1,1
34152,9,11,5,0,6,5
34152,8,47,14,0,33,14
34152,7,35,7,0,28,7
34152,6,41,14,0,27,14
34152,5,26,7,0,19,7
34152,4,26,9,0,17,9
4086,10,9,3,0,6,3
4086,9,21,9,0,12,9
4086,8,50,12,0,38,12
4086,7,51,21,0,30,21
4086,6,40,5,0,35,5
4086,5,26,5,0,21,5
4086,4,5,3,0,2,3
4086,2,1,1,0,0,1
602,10,7,1,0,6,1
602,9,14,1,0,13,1
602,8,32,8,0,24,8
602,7,61,8,0,53,8
602,6,48,9,0,39,9
602,5,18,2,0,16,2
602,4,16,2,0,14,2
602,3,4,1,0,3,1
602,2,4,2,0,2,2
1875,9,3,1,0,2,1
1875,8,18,8,0,10,8
1875,7,28,9,0,19,9
1875,6,69,19,0,50,19
1875,5,52,18,0,34,18
1875,4,22,10,0,12,10
1875,3,11,5,0,6,5
1875,2,2,2,0,0,2
1875,1,1,1,0,0,1
38897,10,3,1,0,2,1
38897,8,17,3,0,14,3
38897,7,26,5,0,21,5
38897,6,71,15,0,56,15
38897,5,39,10,0,29,10
38897,4,27,8,0,19,8
38897,3,17,4,0,13,4
184866,10,8,1,0,7,1
184866,9,26,8,0,18,8
184866,8,69,21,0,48,21
184866,7,57,12,0,45,12
184866,6,34,10,0,24,10
184866,5,11,6,0,5,6
184866,4,1,1,0,0,1
20881,9,5,1,0,4,1
20881,8,20,6,0,14,6
20881,7,33,14,0,19,14
20881,6,63,27,0,36,27
20881,5,41,16,0,25,16
20881,4,27,7,0,20,7
20881,3,10,7,0,3,7
20881,2,4,3,0,1,3
206266,10,12,2,0,10,2
206266,9,18,4,0,14,4
206266,8,62,12,2,50,10
206266,7,46,6,0,40,6
206266,6,30,2,0,28,2
206266,5,20,6,0,14,6
206266,4,7,3,1,4,2
206266,3,6,1,0,5,1
206266,2,3,2,0,1,2
23521,8,16,8,0,8,8
23521,7,39,9,0,30,9
23521,6,79,23,0,56,23
23521,5,33,12,0,21,12
23521,4,18,3,0,15,3
23521,3,7,3,0,4,3
23521,2,6,5,0,1,5
23521,1,3,2,0,1,2
1771,10,2,1,0,1,1
1771,9,2,1,0,1,1
1771,8,8,4,0,4,4
1771,7,19,3,0,16,3
1771,6,60,18,0,42,18
1771,5,56,15,0,41,15
1771,4,32,12,0,20,12
1771,3,13,6,0,7,6
1771,2,9,5,0,4,5
1771,1,4,1,0,3,1
120580,9,2,2,0,0,2
120580,8,12,4,0,8,4
120580,7,47,13,0,34,13
120580,6,75,20,0,55,20
120580,5,34,9,0,25,9
120580,4,20,4,0,16,4
120580,3,8,3,0,5,3
120580,2,3,2,0,1,2
1161,9,9,5,0,4,5
1161,8,15,5,0,10,5
1161,7,42,13,0,29,13
1161,6,71,24,0,47,24
1161,5,41,10,0,31,10
1161,4,13,7,0,6,7
1161,3,9,4,0,5,4
173800,8,10,3,0,7,3
173800,7,35,2,1,33,1
173800,6,76,17,2,59,15
173800,5,51,15,1,36,14
173800,4,19,3,0,16,3
173800,3,7,1,0,6,1
173800,2,1,1,0,0,1
173875,10,5,1,0,4,1
173875,8,22,1,0,21,1
173875,7,32,5,0,27,5
173875,6,53,7,0,46,7
173875,5,45,3,0,42,3
173875,4,22,8,0,14,8
173875,3,8,1,0,7,1
173875,1,4,1,0,3,1
747,10,4,2,0,2,2
747,9,16,10,0,6,10
747,8,50,19,0,31,19
747,7,66,19,0,47,19
747,6,41,12,0,29,12
747,5,18,3,0,15,3
747,4,6,1,0,5,1
747,3,1,1,0,0,1
747,2,2,1,0,1,1
2937,10,2,1,0,1,1
2937,8,11,5,0,6,5
2937,7,39,11,0,28,11
2937,6,66,18,0,48,18
2937,5,46,8,0,38,8
2937,4,20,6,0,14,6
2937,3,11,5,0,6,5
2937,2,6,3,0,3,3
2937,1,2,1,0,1,1
40949,10,1,1,0,0,1
40949,9,6,2,0,4,2
40949,8,18,2,0,16,2
40949,7,56,9,0,47,9
40949,6,68,15,0,53,15
40949,5,26,7,0,19,7
40949,4,18,4,0,14,4
40949,3,9,4,0,5,4
220547,10,13,7,0,6,7
220547,9,10,3,0,7,3
220547,8,33,4,1,29,3
220547,7,46,6,0,40,6
220547,6,54,6,0,48,6
220547,5,16,5,0,11,5
220547,4,13,3,0,10,3
220547,3,10,2,0,8,2
220547,2,8,1,0,7,1
220547,1,2,1,0,1,1
195484,9,14,4,0,10,4
195484,8,44,8,0,36,8
195484,7,60,14,0,46,14
195484,6,52,9,0,43,9
195484,5,16,1,0,15,1
195484,4,11,4,0,7,4
195484,3,2,1,0,1,1
195484,2,2,1,0,1,1
1796,10,3,3,0,0,3
1796,9,20,12,0,8,12
1796,8,72,24,0,48,24
1796,7,57,17,0,40,17
1796,6,34,17,0,17,17
1796,5,7,3,0,4,3
1796,4,5,3,0,2,3
1796,2,2,2,0,0,2
1796,1,4,1,0,3,1
254110,10,4,1,0,3,1
254110,9,13,3,0,10,3
254110,8,67,16,1,51,15
254110,7,66,10,1,56,9
254110,6,37,8,0,29,8
254110,5,9,1,0,8,1
254110,4,5,2,0,3,2
254110,2,1,1,0,0,1
6930,10,11,2,0,9,2
6930,9,33,8,0,25,8
6930,8,89,26,0,63,26
6930,7,48,8,0,40,8
6930,6,17,4,0,13,4
6930,5,4,3,0,1,3
6930,4,3,3,0,0,3
59161,8,24,1,0,23,1
59161,7,49,7,0,42,7
59161,6,76,11,0,65,11
59161,5,29,3,0,26,3
59161,4,11,4,0,7,4
486,10,2,1,0,1,1
486,9,4,1,0,3,1
486,8,10,7,0,3,7
486,7,33,11,0,22,11
486,6,73,32,0,41,32
486,5,49,23,0,26,23
486,4,26,11,0,15,11
486,3,7,2,0,5,2
2307,9,6,2,0,4,2
2307,8,18,2,0,16,2
2307,7,36,10,0,26,10
2307,6,78,25,0,53,25
2307,5,32,10,0,22,10
2307,4,15,4,0,11,4
2307,3,10,3,0,7,3
2307,2,7,3,0,4,3
2307,1,1,1,0,0,1
29017,10,2,1,0,1,1
29017,9,13,3,0,10,3
29017,8,45,13,0,32,13
29017,7,58,22,0,36,22
29017,6,60,16,0,44,16
29017,5,18,7,0,11,7
29017,4,5,2,0,3,2
29017,3,3,1,0,2,1
34334,10,2,1,0,1,1
34334,9,15,6,0,9,6
34334,8,53,20,0,33,20
34334,7,72,24,0,48,24
34334,6,40,11,0,29,11
34334,5,14,4,0,10,4
34334,4,2,1,0,1,1
34334,3,6,5,0,1,5
203719,10,23,1,0,22,1
203719,9,23,2,0,21,2
203719,8,67,5,0,62,5
203719,7,49,4,0,45,4
203719,6,22,2,0,20,2
203719,5,12,1,0,11,1
203719,4,3,1,0,2,1
203719,3,3,1,0,2,1
203719,1,1,1,0,0,1
266083,9,11,1,0,10,1
266083,8,53,9,0,44,9
266083,7,72,8,0,64,8
266083,6,44,5,0,39,5
266083,5,17,2,0,15,2
266083,4,9,1,0,8,1
266083,2,4,1,0,3,1
22359,10,31,7,0,24,7
22359,9,44,9,0,35,9
22359,8,47,11,0,36,11
22359,7,45,9,0,36,9
22359,6,19,3,0,16,3
22359,5,11,4,0,7,4
22359,3,4,1,0,3,1
22359,2,1,1,0,0,1
22359,1,1,1,0,0,1
225885,10,26,8,2,18,6
225885,9,39,16,3,23,13
225885,8,71,13,2,58,11
225885,7,40,18,2,22,16
225885,6,20,7,0,13,7
225885,5,3,1,0,2,1
225885,3,1,1,1,0,0
225885,1,3,1,0,2,1
7803,10,1,1,0,0,1
7803,9,3,2,0,1,2
7803,8,6,1,0,5,1
7803,7,20,3,0,17,3
7803,6,58,17,0,41,17
7803,5,56,17,0,39,17
7803,4,36,19,0,17,19
7803,3,14,3,0,11,3
7803,2,4,2,0,2,2
7803,1,6,1,0,5,1
142085,10,8,2,0,6,2
142085,9,17,4,0,13,4
142085,8,58,20,1,38,19
142085,7,56,17,2,39,15
142085,6,37,14,1,23,13
142085,5,15,4,0,11,4
142085,4,6,1,0,5,1
142085,3,4,2,0,2,2
142085,2,1,1,0,0,1
142085,1,2,1,0,1,1
176146,10,9,7,0,2,7
176146,9,46,15,0,31,15
176146,8,75,19,0,56,19
176146,7,38,11,0,27,11
176146,6,19,12,0,7,12
176146,5,8,5,0,3,5
176146,4,3,2,0,1,2
176146,3,5,5,0,0,5
176146,2,1,1,0,0,1
155322,10,3,1,0,2,1
155322,9,6,2,0,4,2
155322,8,34,7,0,27,7
155322,7,48,11,0,37,11
155322,6,71,14,0,57,14
155322,5,23,4,0,19,4
155322,4,14,3,0,11,3
155322,3,6,1,0,5,1
175510,10,5,1,0,4,1
175510,9,5,4,1,1,3
175510,8,26,7,1,19,6
175510,7,58,22,1,36,21
175510,6,65,20,3,45,17
175510,5,30,9,1,21,8
175510,4,10,1,0,9,1
175510,3,4,1,1,3,0
175510,2,1,1,0,0,1
149910,10,33,14,0,19,14
149910,9,36,7,0,29,7
149910,8,43,10,0,33,10
149910,7,50,6,0,44,6
149910,6,28,8,0,20,8
149910,5,8,3,0,5,3
149910,4,5,3,0,2,3
698,8,9,3,0,6,3
698,7,13,5,0,8,5
698,6,35,12,0,23,12
698,5,44,13,0,31,13
698,4,43,17,0,26,17
698,3,34,17,0,17,17
698,2,19,12,0,7,12
510,8,8,2,0,6,2
510,7,39,13,0,26,13
510,6,80,15,0,65,15
510,5,47,11,0,36,11
510,4,17,7,0,10,7
510,3,7,3,0,4,3
510,1,2,1,0,1,1
160903,10,29,12,0,17,12
160903,9,55,11,0,44,11
160903,8,67,15,0,52,15
160903,7,27,9,0,18,9
160903,6,9,3,0,6,3
160903,5,5,5,0,0,5
160903,4,4,1,0,3,1
160903,3,4,3,0,1,3
160903,2,1,1,0,0,1
160903,1,3,3,0,0,3
843,10,3,1,0,2,1
843,9,10,3,0,7,3
843,8,30,11,0,19,11
843,7,44,14,0,30,14
843,6,76,12,0,64,12
843,5,21,4,0,17,4
843,4,11,2,0,9,2
843,3,6,3,0,3,3
843,2,3,1,0,2,1
229240,9,3,1,0,2,1
229240,8,33,6,0,27,6
229240,7,58,11,0,47,11
229240,6,72,16,0,56,16
229240,5,24,4,0,20,4
229240,4,8,2,0,6,2
229240,2,3,1,0,2,1
119464,10,4,2,0,2,2
119464,9,4,1,0,3,1
119464,8,40,12,0,28,12
119464,7,59,10,0,49,10
119464,6,67,9,0,58,9
119464,5,18,5,0,13,5
119464,4,7,2,0,5,2
119464,3,5,1,0,4,1
67486,10,4,2,0,2,2
67486,8,15,3,0,12,3
67486,7,27,5,0,22,5
67486,6,61,15,0,46,15
67486,5,42,9,0,33,9
67486,4,21,5,0,16,5
67486,3,18,8,0,10,8
67486,2,12,8,0,4,8
3954,10,7,3,0,4,3
3954,9,3,2,0,1,2
3954,8,17,3,0,14,3
3954,7,31,13,0,18,13
3954,6,66,21,0,45,21
3954,5,36,14,0,22,14
3954,4,23,6,0,17,6
3954,3,16,6,0,10,6
3954,2,5,1,0,4,1
101682,10,21,7,0,14,7
101682,9,53,9,0,44,9
101682,8,80,15,0,65,15
101682,7,28,6,0,22,6
101682,6,13,6,0,7,6
101682,5,4,1,0,3,1
101682,3,2,2,0,0,2
101682,2,1,1,0,0,1
187777,10,9,3,0,6,3
187777,9,29,6,2,23,4
187777,8,42,13,2,29,11
187777,7,44,5,1,39,4
187777,6,34,10,2,24,8
187777,5,18,4,0,14,4
187777,4,12,2,0,10,2
187777,3,7,4,1,3,3
187777,2,6,6,0,0,6
187777,1,3,2,0,1,2
6226,10,3,2,0,1,2
6226,9,10,3,0,7,3
6226,8,53,23,0,30,23
6226,7,71,14,0,57,14
6226,6,40,16,0,24,16
6226,5,16,5,0,11,5
6226,3,4,1,0,3,1
39994,10,4,3,0,1,3
39994,9,5,2,0,3,2
39994,8,24,5,0,19,5
39994,7,50,10,0,40,10
39994,6,59,10,0,49,10
39994,5,25,4,0,21,4
39994,4,24,5,0,19,5
39994,3,8,3,0,5,3
39994,1,3,1,0,2,1
257769,9,22,3,0,19,3
257769,8,64,13,0,51,13
257769,7,66,11,0,55,11
257769,6,30,7,0,23,7
257769,5,11,4,0,7,4
1519,10,13,5,0,8,5
1519,9,13,3,0,10,3
1519,8,47,9,0,38,9
1519,7,44,6,0,38,6
1519,6,52,16,0,36,16
1519,5,13,4,0,9,4
1519,4,12,3,0,9,3
1519,3,5,2,0,3,2
1519,2,1,1,0,0,1
1519,1,3,2,0,1,2
94396,10,14,2,0,12,2
94396,9,31,9,0,22,9
94396,8,79,22,0,57,22
94396,7,37,13,0,24,13
94396,6,23,14,0,9,14
94396,5,7,4,0,3,4
94396,4,5,2,0,3,2
94396,3,5,3,0,2,3
94396,2,1,1,0,0,1
94396,1,1,1,0,0,1
9794,10,4,3,0,1,3
9794,8,17,5,0,12,5
9794,7,33,10,0,23,10
9794,6,66,14,0,52,14
9794,5,48,11,0,37,11
9794,4,19,6,0,13,6
9794,3,11,4,0,7,4
9794,2,3,1,0,2,1
9794,1,1,1,0,0,1
256623,9,18,6,0,12,6
256623,8,64,17,0,47,17
256623,7,50,7,0,43,7
256623,6,43,4,0,39,4
256623,5,10,3,0,7,3
256623,3,3,2,0,1,2
107173,10,3,2,0,1,2
107173,9,5,3,0,2,3
107173,8,19,4,0,15,4
107173,7,45,13,0,32,13
107173,6,72,12,0,60,12
107173,5,27,5,0,22,5
107173,4,14,6,0,8,6
107173,3,7,3,0,4,3
107173,2,7,4,0,3,4
865,10,10,4,0,6,4
865,9,9,3,0,6,3
865,8,17,5,0,12,5
865,7,37,17,0,20,17
865,6,62,24,0,38,24
865,5,41,12,0,29,12
865,4,17,8,0,9,8
865,3,8,4,0,4,4
865,2,2,2,0,0,2
246759,9,7,2,1,5,1
246759,8,25,3,0,22,3
246759,7,53,6,0,47,6
246759,6,55,9,0,46,9
246759,5,26,6,0,20,6
246759,4,15,5,0,10,5
246759,3,12,5,0,7,5
246759,2,3,1,0,2,1
2581,8,11,3,0,8,3
2581,7,27,11,0,16,11
2581,6,54,17,0,37,17
2581,5,62,16,0,46,16
2581,4,29,16,0,13,16
2581,3,14,4,0,10,4
2581,1,2,2,0,0,2
37184,9,11,1,0,10,1
37184,8,41,8,0,33,8
37184,7,53,8,0,45,8
37184,6,53,10,0,43,10
37184,5,19,5,0,14,5
37184,4,10,3,0,7,3
37184,1,2,1,0,1,1
143782,10,5,3,0,2,3
143782,9,14,4,0,10,4
143782,8,57,14,0,43,14
143782,7,69,20,0,49,20
143782,6,40,9,0,31,9
143782,5,11,3,0,8,3
143782,4,3,2,0,1,2
143782,3,1,1,0,0,1
143782,1,2,1,0,1,1
196379,8,16,4,0,12,4
196379,7,37,3,1,34,2
196379,6,66,8,0,58,8
196379,5,30,6,0,24,6
196379,4,26,8,1,18,7
196379,3,13,1,0,12,1
196379,2,10,3,0,7,3
196379,1,3,1,0,2,1
4643,10,7,2,0,5,2
4643,9,13,4,0,9,4
4643,8,33,17,0,16,17
4643,7,60,30,0,30,30
4643,6,62,18,0,44,18
4643,5,13,1,0,12,1
4643,4,12,2,0,10,2
4643,3,2,2,0,0,2
2192,10,5,2,0,3,2
2192,9,6,3,0,3,3
2192,8,22,7,0,15,7
2192,7,50,16,0,34,16
2192,6,79,25,0,54,25
2192,5,25,7,0,18,7
2192,4,12,2,0,10,2
2192,3,3,2,0,1,2
69105,10,3,1,0,2,1
69105,8,20,5,0,15,5
69105,7,32,5,0,27,5
69105,6,84,14,0,70,14
69105,5,44,4,0,40,4
69105,4,10,4,0,6,4
69105,3,4,1,0,3,1
150690,8,14,4,0,10,4
150690,7,19,3,0,16,3
150690,6,57,10,1,47,9
150690,5,45,7,1,38,6
150690,4,33,10,1,23,9
150690,3,21,6,1,15,5
150690,2,10,3,1,7,2
9464,10,5,1,0,4,1
9464,8,6,2,0,4,2
9464,7,8,2,0,6,2
9464,6,49,13,0,36,13
9464,5,53,11,0,42,11
9464,4,36,6,0,30,6
9464,3,23,10,0,13,10
9464,2,22,11,0,11,11
9464,1,1,1,0,0,1
1356,9,7,1,0,6,1
1356,8,27,7,0,20,7
1356,7,41,10,0,31,10
1356,6,75,12,0,63,12
1356,5,29,5,0,24,5
1356,4,16,8,0,8,8
13928,10,1,1,0,0,1
13928,9,2,1,0,1,1
13928,8,18,4,0,14,4
13928,7,43,17,0,26,17
13928,6,72,19,0,53,19
13928,5,37,9,0,28,9
13928,4,21,7,0,14,7
13928,3,7,2,0,5,2
13928,2,2,1,0,1,1
217020,10,9,3,0,6,3
217020,9,8,4,0,4,4
217020,8,52,10,0,42,10
217020,7,71,15,1,56,14
217020,6,44,4,0,40,4
217020,5,14,2,0,12,2
217020,4,4,1,0,3,1
217020,3,2,1,0,1,1
399,8,6,1,0,5,1
399,7,8,3,0,5,3
399,6,39,10,0,29,10
399,5,32,4,0,28,4
399,4,47,18,0,29,18
399,3,35,15,0,20,15
399,2,24,14,0,10,14
399,1,11,5,0,6,5
1709,10,6,3,0,3,3
1709,9,8,2,0,6,2
1709,8,26,11,0,15,11
1709,7,52,14,0,38,14
1709,6,64,15,0,49,15
1709,5,29,7,0,22,7
1709,4,12,5,0,7,5
1709,3,5,1,0,4,1
223726,9,9,3,0,6,3
223726,8,39,7,0,32,7
223726,7,55,8,0,47,8
223726,6,63,11,0,52,11
223726,5,20,2,0,18,2
223726,4,13,5,0,8,5
146035,10,1,1,0,0,1
146035,9,8,4,0,4,4
146035,8,42,20,0,22,20
146035,7,62,27,0,35,27
146035,6,60,15,0,45,15
146035,5,17,5,0,12,5
146035,4,11,2,0,9,2
796,10,8,3,0,5,3
796,9,18,12,0,6,12
796,8,29,7,0,22,7
796,7,38,16,0,22,16
796,6,62,10,0,52,10
796,5,27,4,0,23,4
796,4,13,6,0,7,6
796,3,4,2,0,2,2
796,2,2,2,0,0,2
796,1,1,1,0,0,1
1145,10,13,6,0,7,6
1145,9,24,13,0,11,13
1145,8,36,13,0,23,13
1145,7,41,13,0,28,13
1145,6,45,14,0,31,14
1145,5,24,9,0,15,9
1145,4,10,7,0,3,7
1145,3,6,3,0,3,3
1145,1,2,2,0,0,2
193193,10,4,2,0,2,2
193193,9,6,5,1,1,4
193193,8,19,3,1,16,2
193193,7,54,8,3,46,5
193193,6,74,13,3,61,10
193193,5,31,6,0,25,6
193193,4,6,1,0,5,1
193193,3,5,1,0,4,1
11695,10,4,1,0,3,1
11695,9,6,3,0,3,3
11695,8,29,12,0,17,12
11695,7,48,21,0,27,21
11695,6,63,31,0,32,31
11695,5,23,7,0,16,7
11695,4,14,8,0,6,8
11695,3,8,7,0,1,7
11695,2,2,1,0,1,1
11695,1,5,4,0,1,4
129951,10,9,1,0,8,1
129951,9,13,1,0,12,1
129951,8,26,1,0,25,1
129951,7,50,5,0,45,5
129951,6,54,11,1,43,10
129951,5,24,3,0,21,3
129951,4,13,2,0,11,2
129951,3,9,1,0,8,1
129951,1,1,1,0,0,1
172007,8,15,1,0,14,1
172007,7,29,7,0,22,7
172007,6,60,7,1,53,6
172007,5,36,5,0,31,5
172007,4,32,4,0,28,4
172007,3,13,4,0,9,4
172007,2,5,1,0,4,1
172007,1,2,1,0,1,1
69356,8,21,3,0,18,3
69356,7,28,4,0,24,4
69356,6,74,8,0,66,8
69356,5,36,6,0,30,6
69356,4,21,9,0,12,9
69356,3,12,3,0,9,3
69356,2,5,3,0,2,3
69356,1,4,1,0,3,1
144789,8,29,3,0,26,3
144789,7,59,8,0,51,8
144789,6,84,7,0,77,7
144789,5,13,3,0,10,3
144789,4,5,2,0,3,2
5233,10,5,2,0,3,2
5233,9,15,4,0,11,4
5233,8,55,15,0,40,15
5233,7,64,12,0,52,12
5233,6,41,16,0,25,16
5233,5,14,3,0,11,3
5233,4,4,3,0,1,3
5233,3,2,2,0,0,2
5233,2,2,1,0,1,1
3182,9,2,1,0,1,1
3182,8,13,4,0,9,4
3182,7,43,9,0,34,9
3182,6,80,25,0,55,25
3182,5,36,5,0,31,5
3182,4,16,4,0,12,4
3182,3,8,3,0,5,3
3182,2,4,3,0,1,3
153480,10,2,1,0,1,1
153480,9,7,4,0,3,4
153480,8,41,15,0,26,15
153480,7,66,19,0,47,19
153480,6,51,14,0,37,14
153480,5,24,8,0,16,8
153480,4,6,2,0,4,2
153480,3,5,2,0,3,2
16184,7,34,10,0,24,10
16184,6,82,33,0,49,33
16184,5,41,15,0,26,15
16184,4,22,7,0,15,7
16184,3,11,4,0,7,4
16184,1,2,2,0,0,2
47462,9,7,2,0,5,2
47462,8,28,7,0,21,7
47462,7,30,6,0,24,6
47462,6,51,7,0,44,7
47462,5,35,9,0,26,9
47462,4,17,7,0,10,7
47462,3,15,6,0,9,6
47462,2,12,3,0,9,3
47462,1,3,1,0,2,1
158812,9,8,3,0,5,3
158812,8,44,11,1,33,10
158812,7,56,11,0,45,11
158812,6,55,12,0,43,12
158812,5,27,6,0,21,6
158812,4,5,1,0,4,1
148494,10,5,1,0,4,1
148494,9,6,2,0,4,2
148494,8,19,4,0,15,4
148494,7,24,1,0,23,1
148494,6,75,9,0,66,9
148494,5,46,9,0,37,9
148494,4,15,2,0,13,2
148494,3,7,2,0,5,2
148494,2,2,1,0,1,1
9804,10,7,4,0,3,4
9804,9,14,6,0,8,6
9804,8,65,25,0,40,25
9804,7,56,16,0,40,16
9804,6,31,10,0,21,10
9804,5,14,6,0,8,6
9804,4,7,6,0,1,6
9804,3,5,3,0,2,3
27968,10,8,4,0,4,4
27968,9,38,13,0,25,13
27968,8,77,28,0,49,28
27968,7,44,12,0,32,12
27968,6,18,7,0,11,7
27968,5,9,2,0,7,2
27968,4,6,3,0,3,3
128114,10,4,3,0,1,3
128114,8,29,4,0,25,4
128114,7,49,12,0,37,12
128114,6,68,18,0,50,18
128114,5,24,3,0,21,3
128114,4,16,12,0,4,12
128114,3,3,3,0,0,3
128114,2,3,3,0,0,3
128114,1,1,1,0,0,1
140524,10,9,4,0,5,4
140524,9,15,6,0,9,6
140524,8,48,8,1,40,7
140524,7,44,8,1,36,7
140524,6,41,11,1,30,10
140524,5,25,8,0,17,8
140524,4,7,2,0,5,2
140524,3,6,1,0,5,1
140524,1,3,2,0,1,2
103061,10,6,2,0,4,2
103061,9,15,5,0,10,5
103061,8,54,16,0,38,16
103061,7,48,13,0,35,13
103061,6,55,10,0,45,10
103061,5,18,6,0,12,6
103061,4,6,1,0,5,1
187515,8,18,5,0,13,5
187515,7,51,12,0,39,12
187515,6,63,11,0,52,11
187515,5,34,11,0,23,11
187515,4,20,9,0,11,9
187515,3,7,1,0,6,1
187515,2,3,2,0,1,2
193512,10,22,4,0,18,4
193512,9,41,8,0,33,8
193512,8,79,19,0,60,19
193512,7,40,3,0,37,3
193512,5,1,1,0,0,1
4671,9,10,2,0,8,2
4671,8,23,5,0,18,5
4671,7,38,10,0,28,10
4671,6,61,11,0,50,11
4671,5,39,9,0,30,9
4671,4,11,7,0,4,7
4671,3,7,3,0,4,3
4671,2,6,5,0,1,5
7584,10,4,2,0,2,2
7584,9,8,3,0,5,3
7584,8,8,4,0,4,4
7584,7,14,6,0,8,6
7584,6,37,17,0,20,17
7584,5,33,11,0,22,11
7584,4,40,16,0,24,16
7584,3,24,10,0,14,10
7584,2,22,12,0,10,12
7584,1,11,3,0,8,3
20761,9,5,1,0,4,1
20761,8,27,5,0,22,5
20761,7,68,9,0,59,9
20761,6,75,10,0,65,10
20761,5,13,1,0,12,1
20761,3,8,2,0,6,2
20761,2,2,1,0,1,1
86415,9,7,2,0,5,2
86415,8,42,9,0,33,9
86415,7,65,19,0,46,19
86415,6,57,13,0,44,13
86415,5,16,6,0,10,6
86415,4,9,3,0,6,3
28238,9,1,1,0,0,1
28238,8,14,5,0,9,5
28238,7,40,22,0,18,22
28238,6,56,14,0,42,14
28238,5,53,14,0,39,14
28238,4,20,8,0,12,8
28238,3,12,7,0,5,7
66797,10,1,1,0,0,1
66797,8,15,2,0,13,2
66797,7,52,11,0,41,11
66797,6,85,17,0,68,17
66797,5,29,6,0,23,6
66797,4,9,1,0,8,1
66797,3,3,1,0,2,1
13271,8,6,3,0,3,3
13271,7,22,9,0,13,9
13271,6,59,17,0,42,17
13271,5,37,11,0,26,11
13271,4,36,10,0,26,10
13271,3,22,6,0,16,6
13271,2,14,4,0,10,4
13271,1,3,2,0,1,2
21947,10,15,4,0,11,4
21947,9,18,4,0,14,4
21947,8,75,18,0,57,18
21947,7,52,12,0,40,12
21947,6,33,14,0,19,14
21947,4,1,1,0,0,1
21947,3,1,1,0,0,1
21947,1,1,1,0,0,1
220628,8,43,5,0,38,5
220628,7,58,5,0,53,5
220628,6,54,3,0,51,3
220628,5,22,1,0,21,1
220628,4,7,1,0,6,1
2446,8,6,3,0,3,3
2446,7,24,11,0,13,11
2446,6,51,15,0,36,15
2446,5,61,24,0,37,24
2446,4,34,17,0,17,17
2446,3,14,6,0,8,6
2446,2,7,6,0,1,6
2211,10,3,2,0,1,2
2211,9,8,4,0,4,4
2211,8,32,14,0,18,14
2211,7,72,26,0,46,26
2211,6,52,16,0,36,16
2211,5,24,10,0,14,10
2211,4,4,2,0,2,2
2211,3,2,1,0,1,1
2211,2,2,1,0,1,1
104633,10,1,1,0,0,1
104633,8,11,2,0,9,2
104633,7,45,9,0,36,9
104633,6,63,16,0,47,16
104633,5,29,7,0,22,7
104633,4,31,6,0,25,6
104633,3,13,3,0,10,3
104633,2,2,1,0,1,1
258466,9,6,1,0,5,1
258466,8,29,3,0,26,3
258466,7,65,11,0,54,11
258466,6,67,9,0,58,9
258466,5,20,2,0,18,2
258466,4,11,2,0,9,2
172969,10,12,1,0,11,1
172969,9,21,2,0,19,2
172969,8,63,10,1,53,9
172969,7,64,7,0,57,7
172969,6,29,7,0,22,7
172969,3,2,1,0,1,1
172969,1,1,1,0,0,1
210342,8,37,4,0,33,4
210342,7,80,17,0,63,17
210342,6,56,6,0,50,6
210342,5,12,3,0,9,3
210342,4,5,2,0,3,2
210342,3,2,1,0,1,1
34255,8,14,1,0,13,1
34255,7,35,10,0,25,10
34255,6,81,15,0,66,15
34255,5,39,5,0,34,5
34255,4,21,4,0,17,4
111999,10,4,1,0,3,1
111999,9,6,2,0,4,2
111999,8,18,1,0,17,1
111999,7,43,3,0,40,3
111999,6,68,10,0,58,10
111999,5,29,4,0,25,4
111999,4,20,2,0,18,2
111999,3,6,3,0,3,3
111999,2,2,2,0,0,2
111999,1,4,1,0,3,1
248861,9,12,2,0,10,2
248861,8,69,8,0,61,8
248861,7,52,13,0,39,13
248861,6,48,12,0,36,12
248861,5,9,1,0,8,1
248861,2,1,1,0,0,1
303,9,7,2,0,5,2
303,8,35,6,0,29,6
303,7,51,13,0,38,13
303,6,65,18,0,47,18
303,5,27,3,0,24,3
303,4,8,2,0,6,2
303,3,3,1,0,2,1
7290,10,29,16,0,13,16
7290,9,39,18,0,21,18
7290,8,53,20,0,33,20
7290,7,38,14,0,24,14
7290,6,19,4,0,15,4
7290,5,11,4,0,7,4
7290,4,3,1,0,2,1
7290,2,4,1,0,3,1
20634,9,8,1,0,7,1
20634,8,13,3,0,10,3
20634,7,24,4,0,20,4
20634,6,59,16,0,43,16
20634,5,43,17,0,26,17
20634,4,26,5,0,21,5
20634,3,12,3,0,9,3
20634,2,10,3,0,7,3
20634,1,4,1,0,3,1
93001,10,7,3,0,4,3
93001,8,24,6,0,18,6
93001,7,42,10,0,32,10
93001,6,72,24,0,48,24
93001,5,33,5,0,28,5
93001,4,10,5,0,5,5
93001,3,4,3,0,1,3
155496,10,14,9,0,5,9
155496,9,27,14,0,13,14
155496,8,93,41,0,52,41
155496,7,37,17,1,20,16
155496,6,25,10,0,15,10
5241,10,4,1,0,3,1
5241,9,4,2,0,2,2
5241,8,19,7,0,12,7
5241,7,49,15,0,34,15
5241,6,71,23,0,48,23
5241,5,30,5,0,25,5
5241,4,16,4,0,12,4
5241,3,4,2,0,2,2
5241,2,3,2,0,1,2
27965,10,3,2,0,1,2
27965,9,10,4,0,6,4
27965,8,70,30,0,40,30
27965,7,73,20,0,53,20
27965,6,24,10,0,14,10
27965,5,12,5,0,7,5
27965,4,6,3,0,3,3
27965,1,2,1,0,1,1
2580,10,20,5,0,15,5
2580,9,24,7,0,17,7
2580,8,58,5,0,53,5
2580,7,50,10,0,40,10
2580,6,33,9,0,24,9
2580,5,9,1,0,8,1
17521,8,7,2,0,5,2
17521,7,25,6,0,19,6
17521,6,72,31,0,41,31
17521,5,40,13,0,27,13
17521,4,19,5,0,14,5
17521,3,18,10,0,8,10
17521,2,11,4,0,7,4
17521,1,1,1,0,0,1
137336,8,9,1,0,8,1
137336,7,28,6,0,22,6
137336,6,52,11,0,41,11
137336,5,25,4,0,21,4
137336,4,23,8,0,15,8
137336,3,25,8,0,17,8
137336,2,19,5,0,14,5
137336,1,14,4,0,10,4
194019,10,5,2,0,3,2
194019,9,10,4,0,6,4
194019,8,45,7,0,38,7
194019,7,55,6,0,49,6
194019,6,64,7,0,57,7
194019,5,11,3,0,8,3
194019,4,6,1,0,5,1
26516,10,4,1,0,3,1
26516,9,8,2,0,6,2
26516,8,22,8,0,14,8
26516,7,26,5,0,21,5
26516,6,51,5,0,46,5
26516,5,30,7,0,23,7
26516,4,32,9,0,23,9
26516,3,14,7,0,7,7
26516,2,10,7,0,3,7
1516,10,5,3,0,2,3
1516,9,7,4,0,3,4
1516,8,21,12,0,9,12
1516,7,26,13,0,13,13
1516,6,55,14,0,41,14
1516,5,48,25,0,23,25
1516,4,23,11,0,12,11
1516,3,6,2,0,4,2
1516,2,8,6,0,2,6
2061,10,6,3,0,3,3
2061,9,4,1,0,3,1
2061,8,25,9,0,16,9
2061,7,34,12,0,22,12
2061,6,60,20,0,40,20
2061,5,31,5,0,26,5
2061,4,24,8,0,16,8
2061,3,8,1,0,7,1
2061,2,5,1,0,4,1
1873,10,4,3,0,1,3
1873,9,9,4,0,5,4
1873,8,18,4,0,14,4
1873,7,39,12,0,27,12
1873,6,45,10,0,35,10
1873,5,40,11,0,29,11
1873,4,21,13,0,8,13
1873,3,14,7,0,7,7
1873,2,7,4,0,3,4
1912,10,2,1,0,1,1
1912,8,37,10,0,27,10
1912,7,50,17,0,33,17
1912,6,62,18,0,44,18
1912,5,23,7,0,16,7
1912,4,8,4,0,4,4
1912,3,7,2,0,5,2
1912,2,3,1,0,2,1
1912,1,1,1,0,0,1
46586,8,16,5,0,11,5
46586,7,18,2,0,16,2
46586,6,63,15,0,48,15
46586,5,46,8,0,38,8
46586,4,29,6,0,23,6
46586,3,12,2,0,10,2
46586,2,9,4,0,5,4
46586,1,5,1,0,4,1
4281,9,3,1,0,2,1
4281,8,13,4,0,9,4
4281,7,27,6,0,21,6
4281,6,72,19,0,53,19
4281,5,52,11,0,41,11
4281,4,18,6,0,12,6
4281,3,7,4,0,3,4
4281,2,4,2,0,2,2
4281,1,2,1,0,1,1
141829,9,4,1,0,3,1
141829,8,27,7,0,20,7
141829,7,38,12,0,26,12
141829,6,67,12,0,55,12
141829,5,28,7,0,21,7
141829,4,20,8,0,12,8
141829,3,7,4,0,3,4
141829,2,4,2,0,2,2
673,9,4,1,0,3,1
673,8,30,11,0,19,11
673,7,61,18,0,43,18
673,6,50,12,0,38,12
673,5,36,12,0,24,12
673,4,11,4,0,7,4
673,3,2,2,0,0,2
673,2,3,3,0,0,3
673,1,1,1,0,0,1
177857,9,13,1,0,12,1
177857,8,37,2,1,35,1
177857,7,48,5,0,43,5
177857,6,50,6,1,44,5
177857,5,23,5,0,18,5
177857,4,13,4,0,9,4
177857,2,3,1,0,2,1
177857,1,1,1,0,0,1
128011,9,15,5,0,10,5
128011,8,47,9,0,38,9
128011,7,54,16,0,38,16
128011,6,46,12,0,34,12
128011,5,21,3,0,18,3
128011,4,10,3,0,7,3
128011,3,3,1,0,2,1
74408,10,12,2,0,10,2
74408,9,16,4,0,12,4
74408,8,46,5,0,41,5
74408,7,56,10,0,46,10
74408,6,38,6,0,32,6
74408,5,15,2,0,13,2
74408,4,8,3,0,5,3
74408,3,2,1,0,1,1
74408,2,1,1,0,0,1
33030,10,2,1,0,1,1
33030,9,4,3,0,1,3
33030,8,26,11,0,15,11
33030,7,46,17,0,29,17
33030,6,78,36,0,42,36
33030,5,28,9,0,19,9
33030,4,8,2,0,6,2
33030,3,5,3,0,2,3
33030,2,2,1,0,1,1
10445,10,8,4,0,4,4
10445,9,8,3,0,5,3
10445,8,34,14,0,20,14
10445,7,37,11,0,26,11
10445,6,43,12,0,31,12
10445,5,33,11,0,22,11
10445,4,16,9,0,7,9
10445,3,14,7,0,7,7
10445,2,6,3,0,3,3
145578,10,4,1,0,3,1
145578,8,16,4,0,12,4
145578,7,32,8,0,24,8
145578,6,74,11,0,63,11
145578,5,47,7,0,40,7
145578,4,14,1,0,13,1
154904,8,15,4,0,11,4
154904,7,32,9,1,23,8
154904,6,85,12,0,73,12
154904,5,41,9,0,32,9
154904,4,17,5,0,12,5
188021,9,4,2,0,2,2
188021,8,23,5,0,18,5
188021,7,62,17,1,45,16
188021,6,57,10,0,47,10
188021,5,34,9,0,25,9
188021,4,11,2,0,9,2
188021,3,4,1,0,3,1
156061,10,7,3,0,4,3
156061,9,9,4,0,5,4
156061,8,38,4,0,34,4
156061,7,48,7,0,41,7
156061,6,50,8,0,42,8
156061,5,14,2,0,12,2
156061,4,20,7,0,13,7
156061,3,8,1,0,7,1
156061,2,3,1,0,2,1
156061,1,1,1,0,0,1
979,10,1,1,0,0,1
979,8,16,6,0,10,6
979,7,41,21,0,20,21
979,6,84,36,0,48,36
979,5,30,13,0,17,13
979,4,19,6,0,13,6
979,2,4,2,0,2,2
979,1,1,1,0,0,1
12237,9,4,2,0,2,2
12237,8,9,3,0,6,3
12237,7,19,3,0,16,3
12237,6,60,11,0,49,11
12237,5,46,6,0,40,6
12237,4,27,6,0,21,6
12237,3,25,5,0,20,5
36634,8,16,2,0,14,2
36634,7,23,6,0,17,6
36634,6,59,15,0,44,15
36634,5,36,6,0,30,6
36634,4,34,10,0,24,10
36634,3,15,4,0,11,4
36634,2,10,7,0,3,7
69130,10,29,9,0,20,9
69130,9,49,10,0,39,10
69130,8,68,12,0,56,12
69130,7,31,8,0,23,8
69130,6,14,9,0,5,9
69130,5,2,1,0,1,1
69130,4,2,1,0,1,1
69130,3,2,2,0,0,2
4207,9,10,5,0,5,5
4207,8,27,12,0,15,12
4207,7,61,18,0,43,18
4207,6,61,22,0,39,22
4207,5,25,7,0,18,7
4207,4,10,4,0,6,4
1687,10,2,1,0,1,1
1687,9,2,1,0,1,1
1687,8,17,10,0,7,10
1687,7,44,10,0,34,10
1687,6,57,15,0,42,15
1687,5,50,9,0,41,9
1687,4,16,7,0,9,7
1687,3,5,3,0,2,3
1687,2,5,3,0,2,3
1237,8,29,18,0,11,18
1237,7,56,24,0,32,24
1237,6,50,19,0,31,19
1237,5,34,13,0,21,13
1237,4,16,7,0,9,7
1237,3,5,5,0,0,5
1237,2,2,1,0,1,1
20952,10,1,1,0,0,1
20952,8,15,4,0,11,4
20952,7,34,8,0,26,8
20952,6,63,10,0,53,10
20952,5,51,8,0,43,8
20952,4,24,7,0,17,7
948,8,11,2,0,9,2
948,7,28,8,0,20,8
948,6,56,14,0,42,14
948,5,41,10,0,31,10
948,4,26,13,0,13,13
948,3,14,5,0,9,5
948,2,14,5,0,9,5
948,1,3,2,0,1,2
9214,8,3,2,0,1,2
9214,7,11,1,0,10,1
9214,6,33,10,0,23,10
9214,5,43,10,0,33,10
9214,4,47,7,0,40,7
9214,3,33,9,0,24,9
9214,2,16,6,0,10,6
9214,1,11,5,0,6,5
10662,10,5,4,0,1,4
10662,9,10,5,0,5,5
10662,8,58,28,0,30,28
10662,7,66,28,0,38,28
10662,6,39,15,0,24,15
10662,5,9,7,0,2,7
10662,4,9,4,0,5,4
10662,3,1,1,0,0,1
23928,9,5,3,0,2,3
23928,8,61,25,0,36,25
23928,7,61,19,0,42,19
23928,6,41,11,0,30,11
23928,5,17,7,0,10,7
23928,4,9,1,0,8,1
23928,2,2,1,0,1,1
23928,1,1,1,0,0,1
16153,8,8,3,0,5,3
16153,7,22,8,0,14,8
16153,6,60,16,0,44,16
16153,5,65,17,0,48,17
16153,4,24,3,0,21,3
127,10,2,1,0,1,1
127,8,16,7,0,9,7
127,7,19,6,0,13,6
127,6,54,17,0,37,17
127,5,49,17,0,32,17
127,4,29,12,0,17,12
127,3,13,6,0,7,6
127,2,8,7,0,1,7
127,1,5,3,0,2,3
34905,8,26,8,0,18,8
34905,7,41,15,0,26,15
34905,6,62,16,0,46,16
34905,5,37,17,0,20,17
34905,4,18,7,0,11,7
34905,3,3,1,0,2,1
34905,2,3,3,0,0,3
49261,8,24,2,0,22,2
49261,7,52,6,0,46,6
49261,6,75,11,0,64,11
49261,5,19,1,0,18,1
49261,4,11,1,0,10,1
49261,3,8,2,0,6,2
49261,2,2,1,0,1,1
1716,10,5,1,0,4,1
1716,9,8,4,0,4,4
1716,8,18,5,0,13,5
1716,7,34,11,0,23,11
1716,6,61,24,0,37,24
1716,5,36,5,0,31,5
1716,4,19,9,0,10,9
1716,3,8,5,0,3,5
1716,2,8,5,0,3,5
5034,10,10,5,0,5,5
5034,9,14,1,0,13,1
5034,8,48,13,0,35,13
5034,7,42,9,0,33,9
5034,6,43,9,0,34,9
5034,5,18,4,0,14,4
5034,4,11,7,0,4,7
5034,3,9,4,0,5,4
5034,1,2,2,0,0,2
130240,9,3,1,0,2,1
130240,8,12,3,0,9,3
130240,7,23,5,0,18,5
130240,6,60,14,0,46,14
130240,5,40,2,0,38,2
130240,4,29,7,0,22,7
130240,3,18,3,0,15,3
130240,2,7,1,0,6,1
130240,1,5,2,0,3,2
65272,10,7,5,0,2,5
65272,9,8,4,0,4,4
65272,8,56,16,0,40,16
65272,7,43,13,0,30,13
65272,6,46,9,0,37,9
65272,5,19,6,0,13,6
65272,4,11,6,0,5,6
65272,3,5,3,0,2,3
153225,8,21,6,0,15,6
153225,7,52,5,0,47,5
153225,6,83,16,0,67,16
153225,5,23,1,0,22,1
153225,4,7,2,0,5,2
207919,10,4,3,0,1,3
207919,9,13,4,0,9,4
207919,8,44,10,0,34,10
207919,7,49,12,0,37,12
207919,6,66,9,0,57,9
207919,5,13,4,0,9,4
207919,4,4,3,0,1,3
207919,3,3,1,0,2,1
671,10,3,2,0,1,2
671,8,28,14,0,14,14
671,7,47,21,0,26,21
671,6,63,20,0,43,20
671,5,34,11,0,23,11
671,4,8,2,0,6,2
671,3,6,2,0,4,2
671,1,2,1,0,1,1
129029,10,3,1,0,2,1
129029,9,6,4,0,2,4
129029,8,29,11,0,18,11
129029,7,42,9,0,33,9
129029,6,77,17,0,60,17
129029,5,23,3,0,20,3
129029,4,8,3,0,5,3
129029,3,6,1,0,5,1
17450,10,3,2,0,1,2
17450,9,8,2,0,6,2
17450,8,26,9,0,17,9
17450,7,55,5,1,50,4
17450,6,59,13,0,46,13
17450,5,22,3,0,19,3
17450,4,14,7,0,7,7
17450,3,9,3,0,6,3
41090,10,5,3,0,2,3
41090,9,19,4,0,15,4
41090,8,70,34,0,36,34
41090,7,49,18,0,31,18
41090,6,43,17,0,26,17
41090,5,7,2,0,5,2
41090,4,3,1,0,2,1
130499,10,8,2,0,6,2
130499,9,13,4,0,9,4
130499,8,33,5,0,28,5
130499,7,53,12,1,41,11
130499,6,55,15,0,40,15
130499,5,16,6,2,10,4
130499,4,9,1,0,8,1
130499,3,7,2,0,5,2
162660,8,22,5,0,17,5
162660,7,29,3,0,26,3
162660,6,66,8,0,58,8
162660,5,43,6,0,37,6
162660,4,18,3,0,15,3
162660,3,7,4,0,3,4
162660,2,3,1,0,2,1
162660,1,1,1,0,0,1
3405,10,1,1,0,0,1
3405,8,14,6,0,8,6
3405,7,29,12,0,17,12
3405,6,94,25,0,69,25
3405,5,28,12,0,16,12
3405,4,20,7,0,13,7
3405,3,8,3,0,5,3
246639,9,14,2,0,12,2
246639,8,51,9,0,42,9
246639,7,56,9,0,47,9
246639,6,53,6,0,47,6
246639,5,12,4,0,8,4
246639,4,8,1,0,7,1
246639,2,3,1,0,2,1
178,9,5,5,0,0,5
178,8,15,8,0,7,8
178,7,36,13,0,23,13
178,6,84,19,0,65,19
178,5,33,8,0,25,8
178,4,14,7,0,7,7
178,2,4,2,0,2,2
178,1,1,1,0,0,1
158970,10,3,1,0,2,1
158970,9,11,4,0,7,4
158970,8,50,12,2,38,10
158970,7,54,13,1,41,12
158970,6,55,8,0,47,8
158970,5,12,5,0,7,5
158970,3,4,2,0,2,2
158970,2,1,1,1,0,0
2252,10,10,5,0,5,5
2252,9,9,6,0,3,6
2252,8,43,19,0,24,19
2252,7,63,30,0,33,30
2252,6,42,12,0,30,12
2252,5,21,12,0,9,12
2252,4,6,3,0,3,3
169697,10,15,2,1,13,1
169697,9,30,10,2,20,8
169697,8,52,13,1,39,12
169697,7,46,9,0,37,9
169697,6,40,6,0,34,6
169697,5,9,2,0,7,2
169697,4,2,1,0,1,1
213503,10,11,4,2,7,2
213503,9,17,8,1,9,7
213503,8,39,9,0,30,9
213503,7,67,11,4,56,7
213503,6,39,9,1,30,8
213503,5,14,2,0,12,2
213503,3,3,1,0,2,1
213503,2,1,1,1,0,0
146188,10,2,1,0,1,1
146188,8,17,3,0,14,3
146188,7,43,11,0,32,11
146188,6,64,10,0,54,10
146188,5,28,3,0,25,3
146188,4,23,8,0,15,8
146188,3,13,5,0,8,5
146188,2,4,2,0,2,2
146188,1,2,2,0,0,2
32968,7,40,9,0,31,9
32968,6,68,7,0,61,7
32968,5,38,8,0,30,8
32968,4,21,4,0,17,4
32968,3,13,4,0,9,4
3226,10,6,2,0,4,2
3226,9,16,7,0,9,7
3226,8,48,19,0,29,19
3226,7,55,19,0,36,19
3226,6,47,18,0,29,18
3226,5,16,7,0,9,7
3226,4,5,3,0,2,3
3226,1,1,1,0,0,1
4779,9,5,3,0,2,3
4779,8,8,1,0,7,1
4779,7,17,7,0,10,7
4779,6,43,12,0,31,12
4779,5,51,6,0,45,6
4779,4,32,15,0,17,15
4779,3,27,13,0,14,13
4779,2,9,3,0,6,3
4779,1,4,3,0,1,3
30393,9,3,1,0,2,1
30393,8,11,2,0,9,2
30393,7,24,3,0,21,3
30393,6,39,15,0,24,15
30393,5,47,13,0,34,13
30393,4,32,8,0,24,8
30393,3,17,7,0,10,7
30393,2,14,6,0,8,6
30393,1,6,3,0,3,3
39710,10,2,1,0,1,1
39710,8,25,6,0,19,6
39710,7,50,16,0,34,16
39710,6,76,29,0,47,29
39710,5,13,3,0,10,3
39710,4,15,6,0,9,6
39710,3,10,4,0,6,4
39710,2,1,1,0,0,1
99630,10,16,8,0,8,8
99630,9,31,8,0,23,8
99630,8,65,15,0,50,15
99630,7,42,13,0,29,13
99630,6,22,9,0,13,9
99630,5,6,2,0,4,2
99630,4,11,3,0,8,3
99630,3,3,2,0,1,2
158548,10,3,1,1,2,0
158548,9,2,1,0,1,1
158548,8,31,11,0,20,11
158548,7,52,10,0,42,10
158548,6,70,13,1,57,12
158548,5,16,4,0,12,4
158548,4,15,5,0,10,5
158548,2,5,3,0,2,3
85340,8,15,1,0,14,1
85340,7,37,9,0,28,9
85340,6,85,24,0,61,24
85340,5,34,9,0,25,9
85340,4,20,5,0,15,5
85340,3,2,2,0,0,2
171620,9,4,2,0,2,2
171620,8,18,4,0,14,4
171620,7,40,11,0,29,11
171620,6,76,12,0,64,12
171620,5,32,8,0,24,8
171620,4,20,4,0,16,4
171620,3,3,2,0,1,2
129165,10,37,14,0,23,14
129165,9,33,6,0,27,6
129165,8,68,13,0,55,13
129165,7,31,7,0,24,7
129165,6,13,1,0,12,1
226146,10,11,3,0,8,3
226146,9,14,1,0,13,1
226146,8,31,3,0,28,3
226146,7,44,10,0,34,10
226146,6,51,15,0,36,15
226146,5,23,6,0,17,6
226146,4,12,3,0,9,3
226146,3,5,2,0,3,2
226146,2,5,1,0,4,1
226146,1,2,1,0,1,1
54395,9,1,1,0,0,1
54395,7,23,5,0,18,5
54395,6,71,9,0,62,9
54395,5,40,8,0,32,8
54395,4,32,6,0,26,6
54395,3,9,3,0,6,3
4922,9,4,3,0,1,3
4922,8,8,5,0,3,5
4922,7,25,12,0,13,12
4922,6,57,20,0,37,20
4922,5,45,9,0,36,9
4922,4,27,5,0,22,5
4922,3,15,4,0,11,4
4922,2,6,3,0,3,3
4922,1,8,4,0,4,4
27363,9,3,2,0,1,2
27363,8,23,6,0,17,6
27363,7,44,10,0,34,10
27363,6,75,14,0,61,14
27363,5,23,8,0,15,8
27363,4,17,6,0,11,6
27363,3,8,4,0,4,4
27363,2,3,1,0,2,1
2348,8,11,2,0,9,2
2348,7,27,8,0,19,8
2348,6,70,18,0,52,18
2348,5,28,4,0,24,4
2348,4,28,12,0,16,12
2348,3,13,5,0,8,5
2348,2,7,2,0,5,2
2348,1,3,2,0,1,2
1217,7,14,2,0,12,2
1217,6,38,3,0,35,3
1217,5,58,6,0,52,6
1217,4,37,6,0,31,6
1217,3,21,7,0,14,7
1217,2,14,2,0,12,2
1217,1,5,1,0,4,1
8996,9,2,1,0,1,1
8996,8,9,3,0,6,3
8996,7,26,10,0,16,10
8996,6,64,16,0,48,16
8996,5,51,6,0,45,6
8996,4,26,6,0,20,6
8996,3,11,3,0,8,3
8833,9,6,2,0,4,2
8833,8,15,3,0,12,3
8833,7,33,10,0,23,10
8833,6,59,19,0,40,19
8833,5,39,16,0,23,16
8833,4,21,11,0,10,11
8833,3,12,6,0,6,6
8833,2,5,3,0,2,3
176564,9,8,1,0,7,1
176564,8,40,8,0,32,8
176564,7,57,3,1,54,2
176564,6,50,6,0,44,6
176564,5,23,5,0,18,5
176564,4,8,1,0,7,1
176564,3,3,2,0,1,2
176564,2,3,1,0,2,1
69587,10,3,1,0,2,1
69587,8,14,6,0,8,6
69587,7,40,5,0,35,5
69587,6,72,11,0,61,11
69587,5,32,4,0,28,4
69587,4,22,8,0,14,8
69587,3,8,3,0,5,3
192619,9,19,4,1,15,3
192619,8,50,9,0,41,9
192619,7,46,13,0,33,13
192619,6,40,9,0,31,9
192619,5,17,3,0,14,3
192619,4,8,1,0,7,1
192619,3,3,1,0,2,1
192619,2,3,1,0,2,1
3765,10,6,3,0,3,3
3765,9,11,4,0,7,4
3765,8,38,11,0,27,11
3765,7,42,12,0,30,12
3765,6,54,18,0,36,18
3765,5,20,3,0,17,3
3765,4,15,5,0,10,5
3765,3,4,1,0,3,1
3765,2,5,1,0,4,1
151251,10,5,1,0,4,1
151251,9,9,3,0,6,3
151251,8,43,6,0,37,6
151251,7,50,10,0,40,10
151251,6,52,8,0,44,8
151251,5,17,4,0,13,4
151251,4,12,3,0,9,3
1178,10,1,1,0,0,1
1178,7,17,5,0,12,5
1178,6,76,15,0,61,15
1178,5,57,4,0,53,4
1178,4,35,9,0,26,9
1178,3,5,1,0,4,1
150533,9,4,1,0,3,1
150533,8,14,2,0,12,2
150533,7,55,10,0,45,10
150533,6,78,16,0,62,16
150533,5,27,4,0,23,4
150533,4,12,5,0,7,5
150533,3,4,2,0,2,2
260,10,1,1,0,0,1
260,9,3,1,0,2,1
260,8,22,9,0,13,9
260,7,30,11,0,19,11
260,6,68,25,0,43,25
260,5,37,13,0,24,13
260,4,13,2,0,11,2
260,3,13,8,0,5,8
260,2,5,3,0,2,3
260,1,3,1,0,2,1
4831,10,11,9,0,2,9
4831,9,14,9,0,5,9
4831,8,34,23,0,11,23
4831,7,51,19,0,32,19
4831,6,46,21,0,25,21
4831,5,29,8,0,21,8
4831,4,7,3,0,4,3
4831,3,2,1,0,1,1
209886,8,24,3,0,21,3
209886,7,47,5,0,42,5
209886,6,90,21,0,69,21
209886,5,16,3,0,13,3
209886,4,10,1,0,9,1
209886,3,5,2,0,3,2
70324,10,4,2,0,2,2
70324,9,4,1,0,3,1
70324,8,43,13,0,30,13
70324,7,45,16,0,29,16
70324,6,50,19,0,31,19
70324,5,24,5,0,19,5
70324,4,14,5,0,9,5
70324,3,6,1,0,5,1
70324,2,4,2,0,2,2
252688,10,17,4,0,13,4
252688,9,31,5,0,26,5
252688,8,64,10,0,54,10
252688,7,55,7,1,48,6
252688,6,21,2,0,19,2
252688,5,6,2,0,4,2
252688,1,1,1,0,0,1
166650,10,19,4,0,15,4
166650,9,9,3,0,6,3
166650,8,27,9,1,18,8
166650,7,36,3,0,33,3
166650,6,51,7,1,44,6
166650,5,14,2,0,12,2
166650,4,16,1,0,15,1
166650,3,14,4,0,10,4
166650,2,7,3,1,4,2
166650,1,2,1,0,1,1
129974,10,20,6,0,14,6
129974,8,50,5,0,45,5
129974,7,43,4,0,39,4
129974,6,34,5,0,29,5
129974,5,13,1,0,12,1
129974,4,4,2,0,2,2
215469,9,6,1,0,5,1
215469,8,15,4,0,11,4
215469,7,53,6,0,47,6
215469,6,66,8,0,58,8
215469,5,37,7,0,30,7
215469,4,13,1,0,12,1
215469,3,2,1,0,1,1
22733,9,5,1,0,4,1
22733,8,18,9,0,9,9
22733,7,30,7,0,23,7
22733,6,77,19,0,58,19
22733,5,33,6,0,27,6
22733,4,17,4,0,13,4
22733,3,5,3,0,2,3
22733,2,4,2,0,2,2
248167,10,4,3,0,1,3
248167,9,12,5,0,7,5
248167,8,59,10,0,49,10
248167,7,54,9,0,45,9
248167,6,39,6,0,33,6
248167,5,16,4,0,12,4
248167,4,9,1,0,8,1
248167,3,2,1,0,1,1
248167,2,1,1,0,0,1
174182,10,25,9,0,16,9
174182,9,14,6,0,8,6
174182,8,50,10,0,40,10
174182,7,40,7,0,33,7
174182,6,32,3,0,29,3
174182,5,18,4,0,14,4
174182,4,10,3,0,7,3
174182,1,1,1,0,0,1
69278,10,11,5,0,6,5
69278,9,18,5,0,13,5
69278,8,75,18,0,57,18
69278,7,52,14,0,38,14
69278,6,29,8,0,21,8
69278,5,5,1,0,4,1
69278,4,1,1,0,0,1
69278,3,3,2,0,1,2
24795,10,1,1,0,0,1
24795,8,17,6,0,11,6
24795,7,45,11,0,34,11
24795,6,47,12,0,35,12
24795,5,31,10,0,21,10
24795,4,27,8,0,19,8
24795,3,12,4,0,8,4
24795,2,8,6,0,2,6
24795,1,5,1,0,4,1
7462,10,2,1,0,1,1
7462,9,4,2,0,2,2
7462,8,9,3,0,6,3
7462,7,23,14,0,9,14
7462,6,42,18,0,24,18
7462,5,49,10,0,39,10
7462,4,39,16,0,23,16
7462,3,17,6,0,11,6
7462,2,7,3,0,4,3
7462,1,2,1,0,1,1
91817,10,2,2,0,0,2
91817,9,5,3,0,2,3
91817,8,31,11,0,20,11
91817,7,69,22,0,47,22
91817,6,59,9,0,50,9
91817,5,14,3,0,11,3
91817,4,12,1,0,11,1
91817,3,2,1,0,1,1
37345,9,2,1,0,1,1
37345,8,13,4,0,9,4
37345,7,42,9,0,33,9
37345,6,72,9,0,63,9
37345,5,29,9,0,20,9
37345,4,14,3,0,11,3
37345,3,4,1,0,3,1
108018,10,67,10,0,57,10
108018,9,42,10,0,32,10
108018,8,40,5,0,35,5
108018,7,17,2,0,15,2
108018,6,17,3,0,14,3
108018,5,9,2,0,7,2
108018,4,1,1,0,0,1
3163,10,2,1,0,1,1
3163,8,32,8,0,24,8
3163,7,55,22,0,33,22
3163,6,65,23,0,42,23
3163,5,23,8,0,15,8
3163,4,12,5,0,7,5
19803,9,6,3,0,3,3
19803,8,31,10,0,21,10
19803,7,53,23,0,30,23
19803,6,63,21,0,42,21
19803,5,23,10,0,13,10
19803,4,12,7,0,5,7
19803,3,2,1,0,1,1
19803,2,1,1,0,0,1
19803,1,1,1,0,0,1
29020,8,13,2,0,11,2
29020,7,32,1,0,31,1
29020,6,73,4,0,69,4
29020,5,38,7,0,31,7
29020,4,23,1,0,22,1
29020,2,3,3,0,0,3
34284,10,1,1,0,0,1
34284,9,7,1,0,6,1
34284,8,29,4,0,25,4
34284,7,59,11,0,48,11
34284,6,59,9,0,50,9
34284,5,25,4,0,21,4
34284,4,9,1,0,8,1
19877,9,4,2,0,2,2
19877,8,13,5,0,8,5
19877,7,29,11,0,18,11
19877,6,79,25,0,54,25
19877,5,32,11,0,21,11
19877,4,18,5,0,13,5
19877,3,6,1,0,5,1
19877,2,8,1,0,7,1
19877,1,2,2,0,0,2
26148,10,7,3,0,4,3
26148,9,18,8,0,10,8
26148,8,61,23,0,38,23
26148,7,52,13,0,39,13
26148,6,36,12,0,24,12
26148,5,10,7,0,3,7
26148,4,4,2,0,2,2
26148,3,4,1,0,3,1
132799,10,7,3,0,4,3
132799,9,10,5,0,5,5
132799,8,36,11,0,25,11
132799,7,50,9,0,41,9
132799,6,43,5,0,38,5
132799,5,24,6,0,18,6
132799,4,12,4,0,8,4
132799,3,9,1,0,8,1
213670,10,14,2,0,12,2
213670,9,19,2,0,17,2
213670,8,46,5,0,41,5
213670,7,57,5,0,52,5
213670,6,30,3,0,27,3
213670,5,15,4,0,11,4
213670,4,8,2,0,6,2
213670,3,1,1,0,0,1
213670,2,4,1,0,3,1
8179,8,15,4,0,11,4
8179,7,46,8,0,38,8
8179,6,63,20,0,43,20
8179,5,32,8,0,24,8
8179,4,21,8,0,13,8
8179,3,10,4,0,6,4
8179,2,5,1,0,4,1
8179,1,1,1,0,0,1
2194,10,4,1,0,3,1
2194,9,5,2,0,3,2
2194,8,14,4,0,10,4
2194,7,40,14,0,26,14
2194,6,68,16,0,52,16
2194,5,42,13,0,29,13
2194,4,12,2,0,10,2
2194,3,6,4,0,2,4
679,10,4,4,0,0,4
679,9,10,3,0,7,3
679,8,27,6,0,21,6
679,7,37,16,0,21,16
679,6,60,19,0,41,19
679,5,29,11,0,18,11
679,4,13,7,0,6,7
679,3,8,5,0,3,5
679,2,5,5,0,0,5
241987,10,15,10,1,5,9
241987,9,41,5,0,36,5
241987,8,85,22,6,63,16
241987,7,28,3,0,25,3
241987,6,18,6,0,12,6
241987,4,3,3,0,0,3
214204,10,7,3,0,4,3
214204,9,16,3,0,13,3
214204,8,41,7,0,34,7
214204,7,63,11,0,52,11
214204,6,47,4,0,43,4
214204,5,12,2,0,10,2
214204,3,4,1,0,3,1
33767,10,5,3,0,2,3
33767,9,22,9,0,13,9
33767,8,51,19,0,32,19
33767,7,67,18,0,49,18
33767,6,30,6,0,24,6
33767,5,10,5,0,5,5
33767,4,7,1,0,6,1
1001,8,2,1,0,1,1
1001,7,20,5,0,15,5
1001,6,68,20,0,48,20
1001,5,37,8,0,29,8
1001,4,32,4,0,28,4
1001,3,19,2,0,17,2
1001,2,10,4,0,6,4
4386,10,3,1,0,2,1
4386,9,11,5,0,6,5
4386,8,32,10,0,22,10
4386,7,44,14,0,30,14
4386,6,59,22,0,37,22
4386,5,30,6,0,24,6
4386,3,6,4,0,2,4
4386,2,3,1,0,2,1
233015,10,13,4,0,9,4
233015,9,19,9,1,10,8
233015,8,55,11,3,44,8
233015,7,43,8,0,35,8
233015,6,35,5,0,30,5
233015,5,14,4,0,10,4
233015,4,10,5,0,5,5
233015,1,1,1,0,0,1
8719,10,16,8,0,8,8
8719,9,28,8,0,20,8
8719,8,56,19,0,37,19
8719,7,45,14,0,31,14
8719,6,30,10,0,20,10
8719,5,11,5,0,6,5
8719,4,4,1,0,3,1
8719,3,3,1,0,2,1
26952,10,12,4,0,8,4
26952,9,19,6,0,13,6
26952,8,27,4,0,23,4
26952,7,37,9,0,28,9
26952,6,47,15,0,32,15
26952,5,28,4,0,24,4
26952,4,10,1,0,9,1
26952,3,9,1,0,8,1
26952,2,3,1,0,2,1
6977,10,2,1,0,1,1
6977,8,7,1,0,6,1
6977,7,23,6,0,17,6
6977,6,66,21,0,45,21
6977,5,55,16,0,39,16
6977,4,27,11,0,16,11
6977,3,8,4,0,4,4
6977,2,5,3,0,2,3
332,9,8,1,0,7,1
332,8,31,8,0,23,8
332,7,49,9,0,40,9
332,6,51,14,0,37,14
332,5,31,5,0,26,5
332,4,13,5,0,8,5
332,3,8,4,0,4,4
186279,10,9,3,0,6,3
186279,9,20,3,0,17,3
186279,8,77,15,0,62,15
186279,7,39,4,0,35,4
186279,6,36,7,0,29,7
2229,9,8,2,0,6,2
2229,8,28,2,0,26,2
2229,7,41,7,0,34,7
2229,6,66,15,0,51,15
2229,5,27,9,0,18,9
2229,4,12,4,0,8,4
2229,3,6,2,0,4,2
2229,2,2,1,0,1,1
220738,10,5,2,0,3,2
220738,8,45,8,0,37,8
220738,7,56,7,0,49,7
220738,6,46,7,0,39,7
220738,5,16,2,0,14,2
197101,10,21,9,0,12,9
197101,9,36,6,0,30,6
197101,8,58,12,0,46,12
197101,7,39,5,0,34,5
197101,6,23,3,0,20,3
197101,5,8,1,0,7,1
197101,4,3,1,0,2,1
197101,3,4,2,0,2,2
1556,8,13,8,0,5,8
1556,7,29,6,0,23,6
1556,6,44,10,0,34,10
1556,5,34,13,0,21,13
1556,4,28,11,0,17,11
1556,3,19,11,0,8,11
1556,2,11,6,0,5,6
1556,1,12,6,0,6,6
193867,10,50,18,0,32,18
193867,9,63,15,0,48,15
193867,8,51,16,0,35,16
193867,7,15,6,0,9,6
193867,6,8,1,0,7,1
193867,5,3,2,0,1,2
193867,3,2,1,0,1,1
173759,10,17,3,0,14,3
173759,9,24,2,1,22,1
173759,8,46,6,1,40,5
173759,7,41,5,0,36,5
173759,6,42,8,1,34,7
173759,5,14,5,1,9,4
173759,4,4,1,0,3,1
173759,2,3,1,0,2,1
4076,9,2,1,0,1,1
4076,8,7,1,0,6,1
4076,7,27,8,0,19,8
4076,6,66,15,0,51,15
4076,5,38,13,0,25,13
4076,4,26,13,0,13,13
4076,3,13,3,0,10,3
4076,2,6,1,0,5,1
4076,1,6,1,0,5,1
11670,9,3,1,0,2,1
11670,8,5,2,0,3,2
11670,7,8,5,0,3,5
11670,6,28,14,0,14,14
11670,5,47,18,0,29,18
11670,4,45,15,0,30,15
11670,3,32,15,0,17,15
43136,9,5,1,0,4,1
43136,8,23,6,0,17,6
43136,7,42,14,0,28,14
43136,6,65,15,0,50,15
43136,5,31,12,0,19,12
43136,4,13,2,0,11,2
43136,3,8,2,0,6,2
134618,10,1,1,0,0,1
134618,8,14,3,0,11,3
134618,7,35,9,0,26,9
134618,6,69,18,0,51,18
134618,5,41,9,0,32,9
134618,4,18,3,0,15,3
134618,3,10,2,0,8,2
134618,2,3,1,0,2,1
215614,10,7,1,0,6,1
215614,9,10,5,1,5,4
215614,8,16,5,1,11,4
215614,7,34,7,0,27,7
215614,6,64,10,1,54,9
215614,5,28,5,0,23,5
215614,4,18,3,0,15,3
215614,3,5,4,0,1,4
215614,2,9,2,0,7,2
170951,8,39,11,1,28,10
170951,7,56,15,0,41,15
170951,6,63,12,0,51,12
170951,5,25,7,1,18,6
170951,3,6,2,0,4,2
29875,10,21,8,0,13,8
29875,9,34,6,0,28,6
29875,8,71,20,0,51,20
29875,7,44,12,0,32,12
29875,6,11,5,0,6,5
29875,5,7,2,0,5,2
29875,3,1,1,0,0,1
29875,1,2,1,0,1,1
19651,10,1,1,0,0,1
19651,9,4,3,0,1,3
19651,8,15,6,0,9,6
19651,7,48,16,0,32,16
19651,6,58,17,0,41,17
19651,5,36,14,0,22,14
19651,4,24,10,0,14,10
19651,2,3,2,0,1,2
62972,10,16,9,0,7,9
62972,9,42,16,0,26,16
62972,8,81,30,0,51,30
62972,7,34,20,0,14,20
62972,6,11,5,0,6,5
62972,5,6,2,0,4,2
191932,10,4,1,0,3,1
191932,8,34,9,1,25,8
191932,7,45,7,0,38,7
191932,6,69,13,3,56,10
191932,5,21,7,0,14,7
191932,4,11,1,0,10,1
191932,3,3,1,0,2,1
17119,9,2,1,0,1,1
17119,8,14,5,0,9,5
17119,7,28,18,0,10,18
17119,6,73,34,0,39,34
17119,5,39,16,0,23,16
17119,4,25,13,0,12,13
17119,3,10,5,0,5,5
17119,2,1,1,0,0,1
223538,9,7,1,0,6,1
223538,8,27,4,0,23,4
223538,7,40,3,0,37,3
223538,6,71,8,0,63,8
223538,5,26,3,0,23,3
223538,4,13,1,0,12,1
104640,10,7,3,0,4,3
104640,9,13,2,0,11,2
104640,8,57,11,0,46,11
104640,7,58,6,0,52,6
104640,6,43,6,0,37,6
104640,5,7,2,0,5,2
104640,4,5,3,0,2,3
22169,9,2,1,0,1,1
22169,8,17,6,0,11,6
22169,7,27,6,0,21,6
22169,6,68,5,0,63,5
22169,5,34,7,0,27,7
22169,4,24,5,0,19,5
22169,3,13,2,0,11,2
22169,2,4,1,0,3,1
22169,1,2,2,0,0,2
93819,9,13,4,0,9,4
93819,8,42,8,0,34,8
93819,7,35,6,0,29,6
93819,6,55,14,0,41,14
93819,5,22,5,0,17,5
93819,4,5,2,0,3,2
93819,3,8,4,0,4,4
148381,9,3,1,0,2,1
148381,8,20,7,0,13,7
148381,7,39,2,0,37,2
148381,6,79,8,0,71,8
148381,5,30,1,0,29,1
148381,4,12,1,0,11,1
12634,10,1,1,0,0,1
12634,9,3,1,0,2,1
12634,8,5,3,0,2,3
12634,7,21,4,0,17,4
12634,6,65,19,0,46,19
12634,5,38,9,0,29,9
12634,4,25,8,0,17,8
12634,3,25,13,0,12,13
12634,2,7,3,0,4,3
12634,1,2,1,0,1,1
178450,9,10,4,0,6,4
178450,8,15,1,0,14,1
178450,7,60,10,0,50,10
178450,6,67,10,1,57,9
178450,5,20,9,0,11,9
178450,4,12,2,0,10,2
178450,3,3,2,0,1,2
178450,1,1,1,0,0,1
209289,9,8,5,0,3,5
209289,8,41,10,0,31,10
209289,7,58,2,0,56,2
209289,6,65,7,0,58,7
169675,9,10,2,0,8,2
169675,8,25,4,0,21,4
169675,7,45,8,0,37,8
169675,6,60,13,0,47,13
169675,5,26,3,0,23,3
169675,4,14,3,0,11,3
169675,3,4,1,0,3,1
2199,9,3,1,0,2,1
2199,8,18,7,0,11,7
2199,7,28,6,0,22,6
2199,6,69,21,0,48,21
2199,5,51,15,0,36,15
2199,4,13,2,0,11,2
2199,3,6,3,0,3,3
200783,7,33,6,0,27,6
200783,6,56,10,0,46,10
200783,5,43,8,0,35,8
200783,4,23,5,0,18,5
200783,3,12,1,0,11,1
200783,2,8,1,1,7,0
127436,9,5,3,0,2,3
127436,8,13,2,0,11,2
127436,7,39,6,0,33,6
127436,6,59,5,0,54,5
127436,5,32,3,0,29,3
127436,4,21,4,0,17,4
127436,3,13,1,0,12,1
127436,2,9,2,0,7,2
22244,9,2,1,0,1,1
22244,8,13,8,0,5,8
22244,7,36,9,0,27,9
22244,6,73,23,0,50,23
22244,5,39,16,0,23,16
22244,4,20,4,0,16,4
22244,3,5,3,0,2,3
22244,2,1,1,0,0,1
133534,10,11,2,0,9,2
133534,9,20,2,0,18,2
133534,8,64,15,0,49,15
133534,7,43,8,0,35,8
133534,6,33,5,0,28,5
133534,5,7,1,0,6,1
133534,4,9,2,0,7,2
133534,3,3,1,0,2,1
163685,9,3,2,0,1,2
163685,8,19,3,2,16,1
163685,7,35,6,1,29,5
163685,6,57,9,2,48,7
163685,5,36,7,2,29,5
163685,4,15,2,1,13,1
163685,3,18,5,0,13,5
163685,1,2,1,0,1,1
37349,9,1,1,0,0,1
37349,8,18,7,0,11,7
37349,7,28,12,0,16,12
37349,6,53,19,0,34,19
37349,5,30,10,0,20,10
37349,4,27,6,0,21,6
37349,3,10,4,0,6,4
37349,2,7,3,0,4,3
37349,1,16,10,0,6,10
27719,8,16,3,0,13,3
27719,7,49,10,0,39,10
27719,6,72,19,0,53,19
27719,5,30,6,0,24,6
27719,4,13,6,0,7,6
27719,3,3,1,0,2,1
280,10,5,2,0,3,2
280,9,14,6,0,8,6
280,8,35,8,0,27,8
280,7,60,17,0,43,17
280,6,52,13,0,39,13
280,5,18,6,0,12,6
280,4,5,2,0,3,2
280,3,2,1,0,1,1
52825,8,34,4,0,30,4
52825,7,55,3,0,52,3
52825,6,59,9,0,50,9
52825,5,22,5,0,17,5
52825,4,9,1,0,8,1
52825,2,3,2,0,1,2
207487,9,9,1,0,8,1
207487,8,39,5,0,34,5
207487,7,62,9,0,53,9
207487,6,54,7,0,47,7
207487,5,18,1,0,17,1
207487,4,7,1,0,6,1
11028,8,2,1,0,1,1
11028,6,19,4,0,15,4
11028,5,32,9,0,23,9
11028,4,44,9,0,35,9
11028,3,36,9,0,27,9
11028,2,28,11,0,17,11
11028,1,21,6,0,15,6
3585,10,2,2,0,0,2
3585,9,3,3,0,0,3
3585,8,12,6,0,6,6
3585,7,25,11,0,14,11
3585,6,60,14,0,46,14
3585,5,42,17,0,25,17
3585,4,25,8,0,17,8
3585,3,15,6,0,9,6
3585,2,5,1,0,4,1
12764,9,5,5,0,0,5
12764,8,37,20,0,17,20
12764,7,65,24,0,41,24
12764,6,58,22,0,36,22
12764,5,21,9,0,12,9
12764,4,4,1,0,3,1
197760,9,11,1,0,10,1
197760,8,26,4,0,22,4
197760,7,63,6,0,57,6
197760,6,61,7,0,54,7
197760,5,16,3,0,13,3
197760,4,5,2,0,3,2
89340,9,5,2,0,3,2
89340,8,3,1,0,2,1
89340,7,11,1,0,10,1
89340,6,49,7,0,42,7
89340,5,57,10,0,47,10
89340,4,32,7,0,25,7
89340,3,20,5,0,15,5
89340,2,9,1,0,8,1
89340,1,5,1,0,4,1
121806,9,5,3,0,2,3
121806,8,28,12,0,16,12
121806,7,38,14,0,24,14
121806,6,72,20,0,52,20
121806,5,32,8,0,24,8
121806,4,12,1,0,11,1
121806,3,1,1,0,0,1
190,8,19,6,0,13,6
190,7,57,11,0,46,11
190,6,65,18,0,47,18
190,5,34,11,0,23,11
190,4,9,3,0,6,3
190,3,6,3,0,3,3
240822,9,3,2,0,1,2
240822,8,22,6,0,16,6
240822,7,55,6,0,49,6
240822,6,73,10,0,63,10
240822,5,25,2,0,23,2
240822,4,10,3,0,7,3
165347,10,47,27,3,20,24
165347,9,24,7,3,17,4
165347,8,26,7,1,19,6
165347,7,28,6,1,22,5
165347,6,47,13,1,34,12
165347,4,9,2,0,7,2
216640,10,4,2,0,2,2
216640,9,14,5,0,9,5
216640,8,58,15,0,43,15
216640,7,66,17,0,49,17
216640,6,32,5,0,27,5
216640,5,15,5,0,10,5
216640,2,1,1,0,0,1
117555,7,27,3,0,24,3
117555,6,76,12,0,64,12
117555,5,38,7,0,31,7
117555,4,22,6,0,16,6
117555,3,13,3,0,10,3
42651,10,8,2,0,6,2
42651,9,13,9,1,4,8
42651,8,57,19,0,38,19
42651,7,50,17,0,33,17
42651,6,40,16,0,24,16
42651,5,17,6,1,11,5
42651,4,4,2,0,2,2
6798,10,4,1,0,3,1
6798,9,4,1,0,3,1
6798,8,10,7,0,3,7
6798,7,14,5,0,9,5
6798,6,49,18,0,31,18
6798,5,51,13,0,38,13
6798,4,28,9,0,19,9
6798,3,17,5,0,12,5
6798,2,9,2,0,7,2
24085,10,9,3,0,6,3
24085,9,10,5,0,5,5
24085,8,34,12,0,22,12
24085,7,55,17,0,38,17
24085,6,45,14,0,31,14
24085,5,20,6,0,14,6
24085,4,11,4,0,7,4
24085,3,4,1,0,3,1
1883,10,11,1,0,10,1
1883,9,17,3,0,14,3
1883,8,61,17,0,44,17
1883,7,59,13,0,46,13
1883,6,27,8,0,19,8
1883,5,10,2,0,8,2
1883,4,5,3,0,2,3
1883,1,2,1,0,1,1
1211,10,1,1,0,0,1
1211,9,2,1,0,1,1
1211,8,6,3,0,3,3
1211,7,31,16,0,15,16
1211,6,70,22,0,48,22
1211,5,46,20,0,26,20
1211,4,19,7,0,12,7
1211,3,10,5,0,5,5
1211,2,3,1,0,2,1
1211,1,2,2,0,0,2
204801,9,25,2,0,23,2
204801,8,78,4,0,74,4
204801,7,49,6,0,43,6
204801,6,24,1,0,23,1
204801,5,7,1,0,6,1
20074,9,7,1,0,6,1
20074,8,25,7,0,18,7
20074,7,47,18,0,29,18
20074,6,76,19,0,57,19
20074,5,19,6,0,13,6
20074,4,8,4,0,4,4
20074,3,5,4,0,1,4
20074,1,2,1,0,1,1
4287,10,6,1,0,5,1
4287,9,8,2,0,6,2
4287,8,27,11,0,16,11
4287,7,56,21,0,35,21
4287,6,53,16,0,37,16
4287,5,24,5,0,19,5
4287,4,9,3,0,6,3
4287,3,7,2,0,5,2
269207,10,7,1,0,6,1
269207,9,24,2,0,22,2
269207,8,89,10,0,79,10
269207,7,47,2,0,45,2
269207,6,25,3,0,22,3
165967,10,41,16,0,25,16
165967,9,53,12,0,41,12
165967,8,66,15,0,51,15
165967,7,18,8,0,10,8
165967,6,7,1,0,6,1
198414,10,18,12,1,6,11
198414,9,35,20,1,15,19
198414,8,70,16,2,54,14
198414,7,36,2,0,34,2
198414,6,20,3,0,17,3
198414,5,5,1,0,4,1
198414,4,3,2,0,1,2
198414,3,3,1,0,2,1
198414,2,1,1,0,0,1
11628,9,6,1,0,5,1
11628,8,14,4,0,10,4
11628,7,23,6,0,17,6
11628,6,37,8,0,29,8
11628,5,55,8,0,47,8
11628,4,29,7,0,22,7
11628,3,16,9,0,7,9
11628,2,6,1,0,5,1
11628,1,3,1,0,2,1
3806,10,7,1,0,6,1
3806,9,2,2,0,0,2
3806,8,12,4,0,8,4
3806,7,36,11,0,25,11
3806,6,68,14,0,54,14
3806,5,41,12,0,29,12
3806,4,15,1,0,14,1
3806,3,6,1,0,5,1
200610,10,3,1,0,2,1
200610,8,20,3,0,17,3
200610,6,64,7,2,57,5
200610,5,27,5,0,22,5
200610,4,24,5,3,19,2
200610,3,15,1,1,14,0
200610,2,8,5,1,3,4
200610,1,1,1,0,0,1
6235,9,3,1,0,2,1
6235,8,12,6,0,6,6
6235,7,21,9,0,12,9
6235,6,82,30,0,52,30
6235,5,29,10,0,19,10
6235,4,20,10,0,10,10
6235,3,15,8,0,7,8
6235,2,4,1,0,3,1
6235,1,3,1,0,2,1
17857,9,25,9,0,16,9
17857,8,76,20,0,56,20
17857,7,44,15,0,29,15
17857,6,27,12,0,15,12
17857,5,5,1,0,4,1
17857,4,4,2,0,2,2
17857,3,3,1,0,2,1
17857,1,1,1,0,0,1
156853,10,7,1,0,6,1
156853,9,4,1,0,3,1
156853,8,32,7,2,25,5
156853,7,52,12,1,40,11
156853,6,60,13,0,47,13
156853,5,15,2,0,13,2
156853,4,10,4,0,6,4
156853,3,5,1,0,4,1
156853,2,4,3,0,1,3
156853,1,1,1,1,0,0
19765,10,9,6,0,3,6
19765,9,27,14,0,13,14
19765,8,60,26,0,34,26
19765,7,37,17,0,20,17
19765,6,34,9,0,25,9
19765,5,12,4,0,8,4
19765,4,5,1,0,4,1
19765,3,4,3,0,1,3
19765,2,2,1,0,1,1
256839,10,37,17,0,20,17
256839,9,40,11,0,29,11
256839,8,78,6,0,72,6
256839,7,24,3,0,21,3
256839,6,9,1,0,8,1
256839,5,3,1,0,2,1
98739,10,4,1,0,3,1
98739,9,12,3,1,9,2
98739,8,42,17,0,25,17
98739,7,35,6,0,29,6
98739,6,56,13,2,43,11
98739,5,16,7,2,9,5
98739,4,15,7,1,8,6
98739,3,7,2,0,5,2
98739,2,1,1,0,0,1
23931,10,3,1,0,2,1
23931,9,4,3,0,1,3
23931,8,33,20,0,13,20
23931,7,48,26,0,22,26
23931,6,73,32,0,41,32
23931,5,16,8,0,8,8
23931,4,6,5,0,1,5
23931,3,7,3,0,4,3
909,10,5,1,0,4,1
909,9,8,4,0,4,4
909,8,41,12,0,29,12
909,7,57,23,0,34,23
909,6,56,21,0,35,21
909,5,14,10,0,4,10
909,4,7,4,0,3,4
909,3,1,1,0,0,1
964,10,4,2,0,2,2
964,9,5,3,0,2,3
964,8,33,11,0,22,11
964,7,36,18,0,18,18
964,6,64,26,0,38,26
964,5,25,9,0,16,9
964,4,15,8,0,7,8
964,3,4,1,0,3,1
964,2,3,2,0,1,2
147206,10,10,4,0,6,4
147206,9,12,4,0,8,4
147206,8,44,10,2,34,8
147206,7,50,9,2,41,7
147206,6,48,14,0,34,14
147206,5,13,3,0,10,3
147206,4,8,3,0,5,3
147206,2,2,2,0,0,2
230590,10,11,5,0,6,5
230590,9,24,8,0,16,8
230590,8,52,17,0,35,17
230590,7,44,10,0,34,10
230590,6,32,14,0,18,14
230590,5,15,2,0,13,2
230590,4,7,1,0,6,1
230590,3,2,1,0,1,1
230590,2,2,1,0,1,1
230590,1,1,1,0,0,1
12188,9,10,8,0,2,8
12188,8,62,29,0,33,29
12188,7,53,24,0,29,24
12188,6,36,14,0,22,14
12188,5,15,4,0,11,4
12188,4,10,4,0,6,4
12188,3,2,2,0,0,2
12188,1,1,1,0,0,1
8,8,24,5,0,19,5
8,7,45,11,0,34,11
8,6,71,21,0,50,21
8,5,34,9,0,25,9
8,4,8,4,0,4,4
8,2,4,3,0,1,3
131241,10,6,2,0,4,2
131241,9,9,4,0,5,4
131241,8,52,14,2,38,12
131241,7,53,8,0,45,8
131241,6,41,4,0,37,4
131241,5,21,3,0,18,3
131241,3,5,1,0,4,1
131241,1,1,1,0,0,1
232041,10,6,1,0,5,1
232041,9,15,6,1,9,5
232041,8,84,19,2,65,17
232041,7,50,8,0,42,8
232041,6,25,5,1,20,4
232041,4,4,2,0,2,2
203042,9,6,1,0,5,1
203042,8,30,5,0,25,5
203042,7,64,5,0,59,5
203042,6,58,9,0,49,9
203042,5,13,1,0,12,1
203042,4,10,3,0,7,3
203042,3,4,1,0,3,1
336,9,3,2,0,1,2
336,8,10,8,0,2,8
336,7,27,10,0,17,10
336,6,54,19,0,35,19
336,5,58,17,0,41,17
336,4,24,11,0,13,11
336,3,9,4,0,5,4
183643,9,6,1,0,5,1
183643,8,34,5,0,29,5
183643,7,61,12,0,49,12
183643,6,62,13,0,49,13
183643,5,15,3,0,12,3
183643,3,3,1,0,2,1
183643,2,2,1,0,1,1
2253,10,2,1,0,1,1
2253,9,3,1,0,2,1
2253,8,6,1,0,5,1
2253,7,22,3,0,19,3
2253,6,58,17,0,41,17
2253,5,42,15,0,27,15
2253,4,31,11,0,20,11
2253,3,10,2,0,8,2
2253,2,12,6,0,6,6
2213,10,5,4,0,1,4
2213,9,5,4,0,1,4
2213,8,36,13,0,23,13
2213,7,27,15,0,12,15
2213,6,64,28,0,36,28
2213,5,31,11,0,20,11
2213,4,14,6,0,8,6
2213,3,5,3,0,2,3
2213,2,2,1,0,1,1
99655,10,5,2,0,3,2
99655,9,9,5,0,4,5
99655,8,41,13,2,28,11
99655,7,49,6,0,43,6
99655,6,50,11,0,39,11
99655,5,16,4,0,12,4
99655,4,12,5,0,7,5
99655,3,6,2,0,4,2
4597,10,2,2,0,0,2
4597,9,5,1,0,4,1
4597,8,15,5,0,10,5
4597,7,20,7,0,13,7
4597,6,45,11,0,34,11
4597,5,39,10,0,29,10
4597,4,25,8,0,17,8
4597,3,21,11,0,10,11
4597,2,13,4,0,9,4
4597,1,4,4,0,0,4
1404,8,22,6,0,16,6
1404,7,52,17,0,35,17
1404,6,61,18,0,43,18
1404,5,35,14,0,21,14
1404,4,11,6,0,5,6
1404,3,5,3,0,2,3
1404,2,1,1,0,0,1
10709,8,4,3,0,1,3
10709,7,8,1,0,7,1
10709,6,28,5,0,23,5
10709,5,48,8,0,40,8
10709,4,54,14,0,40,14
10709,3,33,11,0,22,11
10709,2,11,2,0,9,2
10709,1,3,1,0,2,1
12367,10,11,3,0,8,3
12367,9,6,2,0,4,2
12367,8,32,13,0,19,13
12367,7,53,9,0,44,9
12367,6,45,17,0,28,17
12367,5,22,6,0,16,6
12367,4,11,4,0,7,4
12367,3,6,2,0,4,2
12367,1,2,2,0,0,2
126443,8,13,1,0,12,1
126443,7,23,4,0,19,4
126443,6,70,11,0,59,11
126443,5,38,6,0,32,6
126443,4,23,1,0,22,1
126443,3,14,6,0,8,6
126443,1,1,1,0,0,1
182064,10,3,2,0,1,2
182064,9,8,2,0,6,2
182064,8,16,4,0,12,4
182064,7,47,13,1,34,12
182064,6,64,12,0,52,12
182064,5,34,9,1,25,8
8711,9,11,2,0,9,2
8711,8,32,14,0,18,14
8711,7,66,18,0,48,18
8711,6,44,14,0,30,14
8711,5,19,13,0,6,13
8711,4,7,2,0,5,2
8711,2,1,1,0,0,1
157815,9,5,1,0,4,1
157815,8,13,2,0,11,2
157815,7,43,7,0,36,7
157815,6,62,10,0,52,10
157815,5,40,8,0,32,8
157815,4,17,9,0,8,9
169544,10,15,4,2,11,2
169544,9,8,3,0,5,3
169544,8,35,9,2,26,7
169544,7,54,7,1,47,6
169544,6,40,5,0,35,5
169544,5,17,2,0,15,2
169544,4,8,4,0,4,4
169544,3,6,2,1,4,1
169544,2,4,2,0,2,2
169544,1,2,1,0,1,1
121015,8,22,3,0,19,3
121015,7,42,4,0,38,4
121015,6,74,6,0,68,6
121015,5,27,6,0,21,6
121015,4,16,3,0,13,3
121015,3,4,1,0,3,1
55279,9,5,3,0,2,3
55279,8,17,5,0,12,5
55279,7,33,6,0,27,6
55279,6,44,9,0,35,9
55279,5,36,8,0,28,8
55279,4,23,8,0,15,8
55279,3,15,5,0,10,5
55279,2,7,1,0,6,1
55279,1,6,1,0,5,1
164027,10,3,1,0,2,1
164027,9,6,1,0,5,1
164027,8,41,11,0,30,11
164027,7,63,6,0,57,6
164027,6,51,14,0,37,14
164027,5,11,4,0,7,4
164027,4,11,4,0,7,4
164027,2,1,1,0,0,1
164027,1,2,1,0,1,1
137933,9,2,1,0,1,1
137933,8,29,7,0,22,7
137933,7,64,15,0,49,15
137933,6,59,10,0,49,10
137933,5,24,3,0,21,3
137933,4,6,2,0,4,2
137933,3,3,1,0,2,1
20122,9,3,1,0,2,1
20122,8,19,12,0,7,12
20122,7,39,15,0,24,15
20122,6,74,30,0,44,30
20122,5,30,10,0,20,10
20122,4,12,4,0,8,4
20122,3,10,3,0,7,3
20122,2,2,1,0,1,1
184085,10,1,1,0,0,1
184085,9,5,1,0,4,1
184085,8,37,9,0,28,9
184085,7,49,6,0,43,6
184085,6,64,12,0,52,12
184085,5,17,3,0,14,3
184085,4,12,2,0,10,2
184085,3,4,2,0,2,2
191049,8,15,2,0,13,2
191049,7,33,4,0,29,4
191049,6,66,12,0,54,12
191049,5,36,12,0,24,12
191049,4,20,5,0,15,5
191049,3,13,1,0,12,1
191049,2,4,1,0,3,1
185497,10,8,1,0,7,1
185497,9,6,3,0,3,3
185497,8,19,3,2,16,1
185497,7,35,3,0,32,3
185497,6,52,6,1,46,5
185497,5,24,4,0,20,4
185497,4,16,2,0,14,2
185497,3,12,4,1,8,3
185497,2,5,2,1,3,1
185497,1,11,4,0,7,4
240892,9,12,5,0,7,5
240892,8,41,5,0,36,5
240892,7,56,10,0,46,10
240892,6,43,7,0,36,7
240892,4,12,3,0,9,3
240892,3,7,1,0,6,1
240892,1,1,1,0,0,1
15271,7,54,4,0,50,4
15271,6,55,8,0,47,8
15271,5,36,6,0,30,6
15271,4,18,6,0,12,6
15271,3,3,2,0,1,2
89403,10,2,2,0,0,2
89403,9,4,2,0,2,2
89403,8,23,9,0,14,9
89403,7,51,11,0,40,11
89403,6,66,20,0,46,20
89403,5,29,6,0,23,6
89403,4,6,1,0,5,1
89403,3,6,1,0,5,1
89403,2,1,1,0,0,1
5503,10,5,3,0,2,3
5503,9,9,4,0,5,4
5503,8,20,9,0,11,9
5503,7,38,16,0,22,16
5503,6,54,21,0,33,21
5503,5,34,10,0,24,10
5503,4,19,12,0,7,12
5503,3,7,2,0,5,2
19081,9,10,1,0,9,1
19081,8,23,6,0,17,6
19081,7,53,16,0,37,16
19081,6,65,14,0,51,14
19081,5,22,6,0,16,6
19081,4,11,2,0,9,2
19081,1,1,1,0,0,1
317,10,4,3,0,1,3
317,9,9,1,0,8,1
317,8,30,4,0,26,4
317,7,54,12,0,42,12
317,6,47,10,0,37,10
317,5,26,6,0,20,6
317,4,6,2,0,4,2
317,3,5,2,0,3,2
317,2,7,5,0,2,5
3572,10,3,1,0,2,1
3572,9,8,2,0,6,2
3572,8,31,16,0,15,16
3572,7,52,20,0,32,20
3572,6,64,13,0,51,13
3572,5,23,7,0,16,7
3572,4,7,3,0,4,3
144479,10,40,6,0,34,6
144479,8,41,6,0,35,6
144479,7,20,2,0,18,2
144479,6,24,4,0,20,4
144479,5,11,1,0,10,1
144479,4,4,1,0,3,1
144479,2,4,1,0,3,1
144479,1,5,3,0,2,3
5614,10,13,1,0,12,1
5614,9,25,8,0,17,8
5614,8,58,16,0,42,16
5614,7,40,17,0,23,17
5614,6,30,8,0,22,8
5614,5,10,2,0,8,2
5614,4,6,1,0,5,1
5614,3,4,1,0,3,1
5614,2,2,2,0,0,2
240843,10,16,8,0,8,8
240843,9,21,8,0,13,8
240843,8,54,14,0,40,14
240843,7,43,13,0,30,13
240843,6,37,8,0,29,8
240843,5,8,1,0,7,1
240843,4,3,1,0,2,1
240843,3,5,1,0,4,1
158916,9,3,3,0,0,3
158916,8,12,2,0,10,2
158916,7,50,10,0,40,10
158916,6,71,13,1,58,12
158916,5,37,12,0,25,12
158916,4,9,3,0,6,3
158916,1,1,1,0,0,1
137480,9,5,2,0,3,2
137480,8,32,9,0,23,9
137480,7,61,19,0,42,19
137480,6,70,14,0,56,14
137480,5,10,1,0,9,1
137480,3,2,1,0,1,1
225317,10,10,9,0,1,9
225317,9,18,9,1,9,8
225317,8,57,13,0,44,13
225317,7,35,5,1,30,4
225317,6,41,6,0,35,6
225317,5,17,1,0,16,1
225317,4,6,3,0,3,3
225317,3,4,2,0,2,2
156175,10,15,9,1,6,8
156175,9,45,17,0,28,17
156175,8,64,18,1,46,17
156175,7,25,9,0,16,9
156175,6,25,7,0,18,7
156175,5,6,2,0,4,2
156175,4,2,1,0,1,1
4668,9,3,1,0,2,1
4668,8,17,9,0,8,9
4668,7,49,17,0,32,17
4668,6,71,26,0,45,26
4668,5,30,10,0,20,10
4668,4,11,4,0,7,4
4668,3,4,1,0,3,1
215918,9,3,1,0,2,1
215918,8,15,2,0,13,2
215918,7,34,4,0,30,4
215918,6,81,7,0,74,7
215918,5,31,2,0,29,2
215918,4,15,2,0,13,2
215918,3,4,2,0,2,2
80942,8,13,2,0,11,2
80942,7,34,7,0,27,7
80942,6,58,10,0,48,10
80942,5,44,16,0,28,16
80942,4,16,2,0,14,2
80942,3,11,5,0,6,5
80942,2,8,2,0,6,2
148144,10,12,4,0,8,4
148144,9,5,2,0,3,2
148144,8,26,4,0,22,4
148144,7,52,11,1,41,10
148144,6,50,15,2,35,13
148144,5,21,8,0,13,8
148144,4,12,5,0,7,5
148144,3,4,2,1,2,1
148144,2,5,2,0,3,2
148144,1,1,1,0,0,1
11582,10,12,4,0,8,4
11582,9,10,4,0,6,4
11582,8,48,21,0,27,21
11582,7,48,17,0,31,17
11582,6,45,13,0,32,13
11582,5,13,6,0,7,6
11582,4,6,1,0,5,1
11582,3,4,2,0,2,2
11582,2,2,2,0,0,2
169558,8,17,2,0,15,2
169558,7,30,9,0,21,9
169558,6,52,7,0,45,7
169558,5,38,4,0,34,4
169558,4,19,3,0,16,3
169558,3,15,2,0,13,2
169558,2,9,3,0,6,3
219638,10,5,2,0,3,2
219638,9,12,2,0,10,2
219638,8,21,5,0,16,5
219638,7,69,13,0,56,13
219638,6,48,5,0,43,5
219638,5,13,2,0,11,2
219638,4,14,3,0,11,3
219638,3,4,2,0,2,2
219638,2,1,1,0,0,1
5271,10,1,1,0,0,1
5271,9,4,2,0,2,2
5271,8,18,3,0,15,3
5271,7,35,13,0,22,13
5271,6,72,22,0,50,22
5271,5,31,10,0,21,10
5271,4,18,4,0,14,4
5271,3,6,1,0,5,1
5271,2,3,1,0,2,1
218126,9,12,3,0,9,3
218126,8,47,1,0,46,1
218126,7,47,2,0,45,2
218126,6,58,3,0,55,3
218126,5,13,3,0,10,3
218126,4,7,1,0,6,1
3412,10,4,1,0,3,1
3412,9,11,4,0,7,4
3412,8,80,27,0,53,27
3412,7,51,19,0,32,19
3412,6,28,9,0,19,9
3412,5,8,1,0,7,1
3412,4,5,2,0,3,2
19409,8,8,4,0,4,4
19409,7,19,4,0,15,4
19409,6,38,15,0,23,15
19409,5,38,9,0,29,9
19409,4,44,14,0,30,14
19409,3,22,5,0,17,5
19409,2,13,6,0,7,6
19409,1,4,2,0,2,2
248002,9,8,2,0,6,2
248002,8,50,8,0,42,8
248002,7,47,5,0,42,5
248002,6,53,9,0,44,9
248002,5,14,2,0,12,2
248002,4,7,3,0,4,3
17820,10,6,2,0,4,2
17820,8,11,3,0,8,3
17820,7,16,5,0,11,5
17820,6,49,11,0,38,11
17820,5,43,8,0,35,8
17820,4,29,5,0,24,5
17820,3,17,4,0,13,4
17820,2,9,2,0,7,2
32048,9,6,1,0,5,1
32048,8,22,12,0,10,12
32048,7,51,30,0,21,30
32048,6,69,34,0,35,34
32048,5,22,10,0,12,10
32048,4,5,4,0,1,4
32048,3,4,3,0,1,3
32048,2,6,4,0,2,4
32048,1,1,1,0,0,1
208808,10,8,2,0,6,2
208808,9,11,1,0,10,1
208808,8,31,6,0,25,6
208808,7,49,6,0,43,6
208808,6,56,10,0,46,10
208808,5,17,6,0,11,6
208808,4,8,2,0,6,2
208808,2,1,1,0,0,1
29582,8,5,2,0,3,2
29582,7,17,8,0,9,8
29582,6,57,18,0,39,18
29582,5,48,12,0,36,12
29582,4,33,9,0,24,9
29582,3,17,4,0,13,4
29582,2,5,2,0,3,2
29582,1,3,1,0,2,1
192286,9,8,4,0,4,4
192286,8,27,8,0,19,8
192286,7,51,4,0,47,4
192286,6,58,9,0,49,9
192286,4,11,2,0,9,2
192286,3,7,2,0,5,2
192286,2,3,1,0,2,1
192286,1,2,1,0,1,1
183521,10,5,1,0,4,1
183521,9,3,1,0,2,1
183521,7,20,4,0,16,4
183521,6,55,12,0,43,12
183521,5,35,6,0,29,6
183521,4,26,6,0,20,6
183521,3,12,2,0,10,2
183521,2,7,2,0,5,2
183521,1,6,3,0,3,3
178051,10,6,2,0,4,2
178051,8,20,4,0,16,4
178051,7,23,4,0,19,4
178051,6,63,12,0,51,12
178051,5,37,8,0,29,8
178051,4,18,6,0,12,6
178051,3,7,2,0,5,2
178051,1,3,1,0,2,1
176215,10,1,1,0,0,1
176215,9,3,2,0,1,2
176215,8,27,4,0,23,4
176215,7,51,8,0,43,8
176215,6,64,2,0,62,2
176215,5,18,2,0,16,2
176215,4,14,5,0,9,5
176215,2,3,3,0,0,3
69851,10,14,7,0,7,7
69851,9,20,4,0,16,4
69851,8,72,28,0,44,28
69851,7,49,22,0,27,22
69851,6,25,10,0,15,10
69851,5,6,2,0,4,2
32466,10,4,1,0,3,1
32466,9,3,2,0,1,2
32466,8,26,4,0,22,4
32466,7,36,13,0,23,13
32466,6,57,14,0,43,14
32466,5,36,8,0,28,8
32466,4,16,7,0,9,7
32466,3,3,1,0,2,1
32466,2,6,2,0,4,2
180921,8,35,6,0,29,6
180921,7,66,2,0,64,2
180921,6,58,7,0,51,7
180921,5,12,1,0,11,1
180921,4,5,3,0,2,3
204728,10,47,9,1,38,8
204728,9,61,11,0,50,11
204728,8,49,8,1,41,7
204728,7,13,2,0,11,2
204728,4,1,1,0,0,1
204728,3,1,1,0,0,1
204728,2,1,1,0,0,1
35472,9,5,1,0,4,1
35472,8,25,4,0,21,4
35472,7,56,9,0,47,9
35472,6,55,11,0,44,11
35472,5,20,4,0,16,4
35472,4,11,3,0,8,3
35472,3,9,3,0,6,3
21389,9,3,1,0,2,1
21389,8,7,2,0,5,2
21389,7,14,3,0,11,3
21389,6,27,7,0,20,7
21389,5,41,9,0,32,9
21389,4,49,11,0,38,11
21389,3,9,5,0,4,5
147505,10,5,2,0,3,2
147505,8,34,10,1,24,9
147505,7,41,11,2,30,9
147505,6,61,15,0,46,15
147505,5,17,10,0,7,10
147505,4,14,3,0,11,3
63385,9,6,1,0,5,1
63385,8,31,5,0,26,5
63385,7,53,7,0,46,7
63385,6,57,3,0,54,3
63385,5,23,3,0,20,3
63385,4,8,1,0,7,1
154804,10,7,1,0,6,1
154804,9,15,4,0,11,4
154804,8,42,5,0,37,5
154804,7,50,11,0,39,11
154804,6,45,4,0,41,4
154804,5,18,4,0,14,4
154804,4,7,2,0,5,2
204175,9,6,1,0,5,1
204175,8,27,6,0,21,6
204175,7,45,6,0,39,6
204175,6,69,12,0,57,12
204175,5,29,7,0,22,7
204175,4,7,3,0,4,3
160012,10,19,10,0,9,10
160012,9,19,10,0,9,10
160012,8,38,6,1,32,5
160012,7,47,6,1,41,5
160012,6,35,6,0,29,6
160012,5,12,1,0,11,1
160012,4,9,1,0,8,1
160012,3,4,2,0,2,2
160012,2,3,1,0,2,1
241,9,9,4,0,5,4
241,8,22,11,0,11,11
241,7,44,19,0,25,19
241,6,55,19,0,36,19
241,5,30,7,0,23,7
241,4,15,7,0,8,7
241,3,3,1,0,2,1
241,2,6,4,0,2,4
241,1,2,1,0,1,1
218179,10,4,1,0,3,1
218179,9,11,1,0,10,1
218179,8,33,7,0,26,7
218179,7,48,10,0,38,10
218179,6,55,7,0,48,7
218179,5,24,2,0,22,2
218179,4,8,1,0,7,1
111866,10,7,1,0,6,1
111866,9,5,3,0,2,3
111866,8,24,5,0,19,5
111866,7,35,7,1,28,6
111866,6,64,16,3,48,13
111866,5,23,11,0,12,11
111866,4,12,2,0,10,2
111866,3,11,6,0,5,6
111866,2,4,3,0,1,3
111866,1,1,1,0,0,1
221372,10,7,1,0,6,1
221372,8,37,5,0,32,5
221372,7,60,7,0,53,7
221372,6,49,7,0,42,7
221372,5,14,3,0,11,3
221372,4,8,3,0,5,3
221372,3,3,1,0,2,1
29656,10,4,1,0,3,1
29656,9,7,2,0,5,2
29656,8,46,18,0,28,18
29656,7,41,14,0,27,14
29656,6,47,18,0,29,18
29656,5,23,11,0,12,11
29656,4,8,6,0,2,6
29656,3,7,3,0,4,3
29656,2,2,1,0,1,1
29656,1,1,1,0,0,1
189890,9,7,1,0,6,1
189890,8,22,4,1,18,3
189890,7,25,3,0,22,3
189890,6,69,12,1,57,11
189890,5,39,7,2,32,5
189890,4,12,6,0,6,6
189890,3,5,1,0,4,1
175634,10,1,1,0,0,1
175634,8,6,1,0,5,1
175634,7,37,8,0,29,8
175634,6,78,12,0,66,12
175634,5,41,6,0,35,6
175634,4,17,6,0,11,6
182194,10,3,1,0,2,1
182194,9,4,1,0,3,1
182194,8,14,3,0,11,3
182194,7,48,6,0,42,6
182194,6,61,10,0,51,10
182194,5,27,6,0,21,6
182194,4,12,3,0,9,3
182194,3,14,5,0,9,5
196712,10,45,11,0,34,11
196712,9,54,11,0,43,11
196712,8,42,15,0,27,15
196712,7,22,3,0,19,3
196712,4,3,1,0,2,1
196712,3,5,3,0,2,3
39406,9,4,1,0,3,1
39406,8,34,6,0,28,6
39406,7,41,9,0,32,9
39406,6,67,14,0,53,14
39406,5,24,5,0,19,5
39406,4,11,5,0,6,5
39406,3,4,1,0,3,1
39406,1,1,1,0,0,1
38877,10,18,10,0,8,10
38877,9,42,18,0,24,18
38877,8,63,28,0,35,28
38877,7,32,7,0,25,7
38877,6,23,5,0,18,5
38877,5,4,1,0,3,1
38877,4,4,1,0,3,1
38195,8,16,6,0,10,6
38195,7,45,13,0,32,13
38195,6,77,19,0,58,19
38195,5,32,1,0,31,1
38195,4,12,2,0,10,2
182638,10,4,2,0,2,2
182638,9,10,4,0,6,4
182638,8,32,9,0,23,9
182638,7,51,4,1,47,3
182638,6,52,11,0,41,11
182638,5,17,4,1,13,3
182638,4,13,7,0,6,7
182638,3,5,1,0,4,1
36690,10,2,1,0,1,1
36690,9,4,3,0,1,3
36690,8,20,7,0,13,7
36690,7,28,6,0,22,6
36690,6,57,21,0,36,21
36690,5,31,4,0,27,4
36690,4,20,6,0,14,6
36690,3,13,7,0,6,7
36690,2,8,5,0,3,5
36690,1,3,3,0,0,3
1446,8,5,3,0,2,3
1446,7,13,3,0,10,3
1446,6,16,6,0,10,6
1446,5,43,11,0,32,11
1446,4,39,17,0,22,17
1446,3,33,17,0,16,17
1446,2,27,11,0,16,11
1446,1,10,5,0,5,5
145553,10,3,1,0,2,1
145553,9,3,3,0,0,3
145553,8,32,13,0,19,13
145553,7,42,12,0,30,12
145553,6,59,11,0,48,11
145553,5,21,2,0,19,2
145553,4,11,4,0,7,4
145553,3,11,3,0,8,3
145553,2,4,1,0,3,1
9824,8,2,2,0,0,2
9824,7,17,5,0,12,5
9824,6,70,27,0,43,27
9824,5,48,18,0,30,18
9824,4,34,13,0,21,13
9824,3,9,4,0,5,4
9824,2,5,3,0,2,3
22950,9,8,4,0,4,4
22950,8,32,6,0,26,6
22950,7,41,9,0,32,9
22950,6,51,10,0,41,10
22950,5,19,5,0,14,5
22950,4,17,6,0,11,6
22950,3,8,4,0,4,4
22950,2,4,3,0,1,3
22950,1,2,2,0,0,2
356,9,3,2,0,1,2
356,8,6,2,0,4,2
356,7,23,10,0,13,10
356,6,57,15,0,42,15
356,5,39,8,0,31,8
356,4,38,9,0,29,9
356,3,14,5,0,9,5
356,2,5,4,0,1,4
18794,10,5,2,0,3,2
18794,9,12,2,0,10,2
18794,8,57,7,0,50,7
18794,7,51,7,0,44,7
18794,6,45,6,0,39,6
18794,5,8,3,0,5,3
5900,10,6,2,0,4,2
5900,9,10,2,0,8,2
5900,8,24,10,0,14,10
5900,7,31,13,0,18,13
5900,6,48,13,0,35,13
5900,5,30,11,0,19,11
5900,4,21,7,0,14,7
5900,3,11,4,0,7,4
5900,1,2,1,0,1,1
154343,10,2,1,0,1,1
154343,7,15,4,0,11,4
154343,6,40,6,0,34,6
154343,5,57,6,0,51,6
154343,4,34,9,0,25,9
154343,3,17,2,0,15,2
154343,1,1,1,0,0,1
69136,10,14,4,0,10,4
69136,9,20,9,0,11,9
69136,8,63,17,0,46,17
69136,7,51,15,0,36,15
69136,6,20,4,0,16,4
69136,5,7,3,0,4,3
69136,4,4,3,0,1,3
69136,3,5,3,0,2,3
69136,2,1,1,0,0,1
2258,10,2,1,0,1,1
2258,9,2,2,0,0,2
2258,8,9,2,0,7,2
2258,7,21,6,0,15,6
2258,6,49,12,0,37,12
2258,5,59,16,0,43,16
2258,4,27,8,0,19,8
2258,3,10,4,0,6,4
2258,2,3,2,0,1,2
2258,1,3,3,0,0,3
103191,8,18,4,0,14,4
103191,7,21,4,0,17,4
103191,6,58,18,0,40,18
103191,5,37,7,0,30,7
103191,4,24,4,0,20,4
103191,3,14,7,0,7,7
103191,2,8,5,0,3,5
103191,1,2,1,0,1,1
202443,10,6,1,0,5,1
202443,9,10,3,0,7,3
202443,8,38,7,2,31,5
202443,7,59,8,4,51,4
202443,6,43,9,1,34,8
202443,5,17,7,0,10,7
202443,4,6,3,1,3,2
202443,3,4,4,0,0,4
202443,2,1,1,0,0,1
202443,1,3,2,0,1,2
236304,9,5,1,0,4,1
236304,8,46,8,0,38,8
236304,7,56,10,0,46,10
236304,6,41,5,1,36,4
236304,5,23,6,0,17,6
236304,4,5,1,0,4,1
236304,3,2,1,0,1,1
9092,9,7,5,0,2,5
9092,8,26,10,0,16,10
9092,7,51,13,0,38,13
9092,6,63,15,0,48,15
9092,5,23,7,0,16,7
9092,4,11,2,0,9,2
9092,3,2,1,0,1,1
9092,2,1,1,0,0,1
158917,8,4,2,0,2,2
158917,7,16,1,0,15,1
158917,6,56,7,1,49,6
158917,5,39,4,0,35,4
158917,4,37,8,1,29,7
158917,3,16,7,0,9,7
158917,2,11,2,0,9,2
158917,1,4,2,0,2,2
18905,7,5,4,0,1,4
18905,6,6,1,0,5,1
18905,5,21,7,0,14,7
18905,4,45,14,0,31,14
18905,3,40,11,0,29,11
18905,2,52,18,0,34,18
18905,1,15,3,0,12,3
265736,10,15,4,0,11,4
265736,9,17,1,0,16,1
265736,8,94,20,0,74,20
265736,7,48,5,0,43,5
4975,10,1,1,0,0,1
4975,9,7,4,0,3,4
4975,8,34,15,0,19,15
4975,7,48,19,0,29,19
4975,6,55,23,0,32,23
4975,5,23,8,0,15,8
4975,4,11,4,0,7,4
4975,2,4,4,0,0,4
6642,10,3,1,0,2,1
6642,9,16,7,0,9,7
6642,8,34,12,0,22,12
6642,7,64,14,0,50,14
6642,6,47,9,0,38,9
6642,5,11,3,0,8,3
6642,4,5,3,0,2,3
6642,3,3,1,0,2,1
6642,2,1,1,0,0,1
6642,1,1,1,0,0,1
32688,9,5,1,0,4,1
32688,8,13,2,0,11,2
32688,7,28,4,0,24,4
32688,6,68,9,0,59,9
32688,5,29,9,0,20,9
32688,4,29,10,0,19,10
32688,2,4,3,0,1,3
32688,1,1,1,0,0,1
212662,10,60,9,0,51,9
212662,9,26,2,1,24,1
212662,8,36,5,0,31,5
212662,7,39,5,0,34,5
146880,10,6,1,0,5,1
146880,9,7,1,0,6,1
146880,8,53,14,3,39,11
146880,7,36,7,5,29,2
146880,6,51,10,0,41,10
146880,5,16,5,1,11,4
146880,4,8,1,0,7,1
146880,3,4,1,0,3,1
146880,2,3,1,0,2,1
146880,1,1,1,0,0,1
148764,10,1,1,0,0,1
148764,8,25,5,0,20,5
148764,7,56,9,0,47,9
148764,6,65,14,0,51,14
148764,5,15,1,0,14,1
148764,4,10,1,0,9,1
148764,3,7,2,0,5,2
34843,10,3,1,0,2,1
34843,9,8,6,0,2,6
34843,8,24,12,0,12,12
34843,7,36,9,0,27,9
34843,6,57,22,0,35,22
34843,5,22,7,0,15,7
34843,4,17,8,0,9,8
34843,3,9,3,0,6,3
34843,2,6,3,0,3,3
34843,1,2,1,0,1,1
323,8,28,8,0,20,8
323,7,42,4,0,38,4
323,6,64,14,0,50,14
323,5,26,6,0,20,6
323,4,11,2,0,9,2
323,3,6,2,0,4,2
323,2,5,2,0,3,2
14701,9,10,4,0,6,4
14701,8,28,8,0,20,8
14701,7,56,18,0,38,18
14701,6,45,18,0,27,18
14701,5,21,8,0,13,8
14701,4,7,4,0,3,4
14701,3,8,7,0,1,7
14701,2,4,4,0,0,4
14701,1,1,1,0,0,1
4146,10,3,2,0,1,2
4146,9,6,2,0,4,2
4146,8,22,13,0,9,13
4146,7,41,16,0,25,16
4146,6,71,23,0,48,23
4146,5,25,7,0,18,7
4146,4,10,6,0,4,6
4146,3,4,1,0,3,1
4146,2,2,1,0,1,1
230667,10,28,12,3,16,9
230667,9,13,5,1,8,4
230667,8,30,6,1,24,5
230667,7,34,3,0,31,3
230667,6,46,12,2,34,10
230667,5,19,2,0,17,2
230667,4,10,6,1,4,5
230667,3,3,1,1,2,0
177541,10,9,1,0,8,1
177541,9,6,1,0,5,1
177541,8,35,13,2,22,11
177541,7,53,18,1,35,17
177541,6,48,11,1,37,10
177541,5,19,3,0,16,3
177541,4,4,2,0,2,2
177541,3,6,1,0,5,1
177541,1,1,1,1,0,0
241164,10,9,4,0,5,4
241164,9,6,4,0,2,4
241164,8,46,8,0,38,8
241164,7,74,3,0,71,3
241164,6,33,4,0,29,4
241164,5,10,2,0,8,2
241164,4,5,1,0,4,1
241164,3,1,1,0,0,1
18266,8,16,4,0,12,4
18266,7,41,21,0,20,21
18266,6,80,20,0,60,20
18266,5,24,10,0,14,10
18266,4,13,7,0,6,7
18266,3,4,2,0,2,2
18266,2,4,1,0,3,1
82948,9,8,5,0,3,5
82948,8,22,6,0,16,6
82948,7,39,7,0,32,7
82948,6,64,16,0,48,16
82948,5,25,5,0,20,5
82948,4,18,7,0,11,7
82948,3,5,1,0,4,1
246816,10,8,2,0,6,2
246816,9,15,1,0,14,1
246816,8,70,5,0,65,5
246816,7,53,7,0,46,7
246816,6,30,8,0,22,8
246816,5,3,2,0,1,2
246816,4,2,1,0,1,1
2728,10,18,3,0,15,3
2728,9,13,5,0,8,5
2728,8,16,9,0,7,9
2728,7,35,19,0,16,19
2728,6,59,24,0,35,24
2728,5,32,12,0,20,12
2728,4,9,5,0,4,5
121787,8,12,3,0,9,3
121787,7,42,7,0,35,7
121787,6,61,9,0,52,9
121787,5,33,8,0,25,8
121787,4,13,7,0,6,7
121787,3,10,2,0,8,2
121787,2,7,4,0,3,4
121787,1,3,1,0,2,1
24985,9,2,1,0,1,1
24985,7,12,2,0,10,2
24985,6,29,4,0,25,4
24985,5,26,6,0,20,6
24985,4,36,7,0,29,7
24985,3,20,6,0,14,6
24985,2,21,5,0,16,5
24985,1,6,1,0,5,1
255037,10,13,4,0,9,4
255037,9,14,4,0,10,4
255037,8,35,4,0,31,4
255037,7,45,5,0,40,5
255037,6,44,2,0,42,2
255037,5,13,3,0,10,3
255037,4,10,4,0,6,4
255037,3,4,1,0,3,1
255037,2,6,3,0,3,3
192824,8,27,7,0,20,7
192824,7,51,9,1,42,8
192824,6,60,9,0,51,9
192824,5,27,7,0,20,7
192824,4,7,3,1,4,2
192824,3,3,1,0,2,1
192824,2,2,1,0,1,1
28284,10,24,12,0,12,12
28284,9,40,14,0,26,14
28284,8,62,20,0,42,20
28284,7,31,4,0,27,4
28284,6,18,4,0,14,4
28284,5,4,3,0,1,3
28284,4,3,2,0,1,2
28284,1,2,1,0,1,1
94837,9,3,1,0,2,1
94837,7,25,3,0,22,3
94837,6,79,9,0,70,9
94837,5,37,5,0,32,5
94837,4,12,4,0,8,4
94837,3,3,2,0,1,2
94837,2,4,1,0,3,1
94837,1,2,1,0,1,1
141419,9,15,4,1,11,3
141419,8,45,13,0,32,13
141419,7,56,12,0,44,12
141419,6,51,13,0,38,13
141419,4,3,2,0,1,2
46957,10,4,2,0,2,2
46957,9,1,1,0,0,1
46957,8,15,3,0,12,3
46957,7,28,7,0,21,7
46957,6,64,13,0,51,13
46957,5,38,6,0,32,6
46957,4,23,8,0,15,8
46957,3,9,7,0,2,7
234450,10,7,3,0,4,3
234450,9,22,6,0,16,6
234450,8,68,10,0,58,10
234450,7,50,4,0,46,4
234450,6,23,5,0,18,5
234450,5,6,2,0,4,2
234450,4,5,2,0,3,2
234450,3,2,1,0,1,1
129156,10,7,4,0,3,4
129156,9,36,16,0,20,16
129156,8,83,40,0,43,40
129156,7,36,8,0,28,8
129156,6,17,7,0,10,7
129156,5,4,2,0,2,2
129156,4,1,1,0,0,1
461,10,1,1,0,0,1
461,8,21,7,0,14,7
461,7,55,22,0,33,22
461,6,61,13,0,48,13
461,5,29,5,0,24,5
461,4,11,4,0,7,4
461,3,2,1,0,1,1
218376,10,22,11,0,11,11
218376,9,41,11,0,30,11
218376,8,68,14,1,54,13
218376,7,26,5,0,21,5
218376,6,19,7,0,12,7
218376,5,3,1,0,2,1
218376,4,2,1,0,1,1
218376,3,3,2,0,1,2
93537,9,11,6,0,5,6
93537,8,25,5,0,20,5
93537,7,52,10,0,42,10
93537,6,54,13,0,41,13
93537,5,19,3,0,16,3
93537,4,11,3,0,8,3
93537,2,3,1,0,2,1
2366,10,4,1,0,3,1
2366,9,2,1,0,1,1
2366,8,16,3,0,13,3
2366,7,36,14,0,22,14
2366,6,57,20,0,37,20
2366,5,47,10,0,37,10
2366,4,13,4,0,9,4
2366,3,5,2,0,3,2
105023,10,9,3,0,6,3
105023,9,19,7,0,12,7
105023,8,52,13,0,39,13
105023,7,42,11,0,31,11
105023,6,31,10,0,21,10
105023,5,10,3,0,7,3
105023,4,9,5,0,4,5
105023,3,5,2,0,3,2
105023,2,5,3,0,2,3
105023,1,1,1,0,0,1
33077,10,12,6,0,6,6
33077,9,14,8,0,6,8
33077,8,53,16,0,37,16
33077,7,54,24,0,30,24
33077,6,28,13,0,15,13
33077,5,7,3,0,4,3
33077,4,2,1,0,1,1
33077,3,1,1,0,0,1
33077,2,2,1,0,1,1
33077,1,10,10,0,0,10
2763,9,3,1,0,2,1
2763,8,12,6,0,6,6
2763,7,22,4,0,18,4
2763,6,69,23,0,46,23
2763,5,37,16,0,21,16
2763,4,24,10,0,14,10
2763,3,6,2,0,4,2
1170,7,11,4,0,7,4
1170,6,33,6,0,27,6
1170,5,45,11,0,34,11
1170,4,44,11,0,33,11
1170,3,22,8,0,14,8
1170,2,23,9,0,14,9
1170,1,3,1,0,2,1
72269,10,6,3,0,3,3
72269,9,2,1,0,1,1
72269,8,33,7,0,26,7
72269,7,36,10,0,26,10
72269,6,55,12,0,43,12
72269,5,22,7,0,15,7
72269,4,12,6,0,6,6
172162,8,22,4,0,18,4
172162,7,60,7,0,53,7
172162,6,70,11,0,59,11
172162,5,16,3,0,13,3
172162,3,5,1,0,4,1
50912,8,12,4,0,8,4
50912,7,21,1,0,20,1
50912,6,65,7,0,58,7
50912,5,38,3,0,35,3
50912,4,23,4,0,19,4
50912,3,12,2,0,10,2
50912,2,8,6,0,2,6
6387,9,2,2,0,0,2
6387,8,8,6,0,2,6
6387,7,14,5,0,9,5
6387,6,35,16,0,19,16
6387,5,51,17,0,34,17
6387,4,44,11,0,33,11
6387,3,18,6,0,12,6
6387,2,7,3,0,4,3
6387,1,4,2,0,2,2
3575,10,3,2,0,1,2
3575,9,7,5,0,2,5
3575,8,20,8,0,12,8
3575,7,29,14,0,15,14
3575,6,39,12,0,27,12
3575,5,37,12,0,25,12
3575,4,24,10,0,14,10
3575,3,15,10,0,5,10
3575,2,7,5,0,2,5
3575,1,2,2,0,0,2
78,10,4,2,0,2,2
78,9,14,4,0,10,4
78,8,40,18,0,22,18
78,7,54,9,0,45,9
78,6,45,10,0,35,10
78,5,19,10,0,9,10
78,4,6,1,0,5,1
2180,9,5,4,0,1,4
2180,8,21,7,0,14,7
2180,7,35,13,0,22,13
2180,6,67,16,0,51,16
2180,5,31,11,0,20,11
2180,4,16,11,0,5,11
2180,3,6,3,0,3,3
2180,2,1,1,0,0,1
2180,1,1,1,0,0,1
15721,8,13,7,0,6,7
15721,7,38,4,0,34,4
15721,6,56,14,0,42,14
15721,5,36,10,0,26,10
15721,4,27,7,0,20,7
15721,3,5,2,0,3,2
15721,2,3,1,0,2,1
161995,10,1,1,0,0,1
161995,9,6,1,0,5,1
161995,8,37,9,0,28,9
161995,7,53,8,0,45,8
161995,6,55,8,0,47,8
161995,5,15,1,0,14,1
161995,4,8,2,0,6,2
161995,1,2,1,0,1,1
172158,9,6,3,0,3,3
172158,8,36,6,0,30,6
172158,7,44,5,0,39,5
172158,6,63,13,0,50,13
172158,5,16,1,0,15,1
172158,4,10,5,0,5,5
172158,3,4,1,0,3,1
172158,2,3,1,0,2,1
2324,10,8,6,0,2,6
2324,9,12,5,0,7,5
2324,8,49,29,0,20,29
2324,7,51,18,2,33,16
2324,6,43,12,0,31,12
2324,5,9,4,0,5,4
2324,4,6,4,0,2,4
2324,3,5,4,0,1,4
98046,10,2,1,0,1,1
98046,9,7,2,0,5,2
98046,8,30,8,0,22,8
98046,7,29,3,0,26,3
98046,6,52,7,0,45,7
98046,5,34,7,0,27,7
98046,4,16,3,0,13,3
98046,3,11,2,0,9,2
206169,10,5,1,0,4,1
206169,9,8,2,0,6,2
206169,8,36,15,0,21,15
206169,7,54,11,0,43,11
206169,6,61,10,0,51,10
206169,5,14,1,0,13,1
206169,4,4,1,0,3,1
236484,9,5,3,0,2,3
236484,8,39,9,0,30,9
236484,7,52,11,0,41,11
236484,6,62,4,0,58,4
236484,5,19,2,0,17,2
236484,4,4,1,0,3,1
236484,3,2,1,0,1,1
217099,10,26,6,0,20,6
217099,9,43,10,0,33,10
217099,8,64,7,0,57,7
217099,7,25,4,0,21,4
217099,5,4,1,0,3,1
217099,4,2,1,0,1,1
217099,2,1,1,0,0,1
8320,10,3,2,0,1,2
8320,9,8,5,0,3,5
8320,8,28,7,0,21,7
8320,7,54,18,0,36,18
8320,6,60,23,0,37,23
8320,5,20,7,0,13,7
8320,4,7,1,0,6,1
8320,3,2,1,0,1,1
212376,10,9,4,0,5,4
212376,9,6,4,0,2,4
212376,8,33,8,0,25,8
212376,7,47,11,0,36,11
212376,6,50,6,0,44,6
212376,5,22,4,0,18,4
212376,4,9,2,0,7,2
212376,2,3,2,0,1,2
212376,1,2,1,0,1,1
220193,8,27,7,0,20,7
220193,7,47,8,0,39,8
220193,6,64,9,0,55,9
220193,5,22,6,0,16,6
220193,4,8,4,0,4,4
220193,2,3,2,0,1,2
187976,10,19,3,0,16,3
187976,9,14,10,0,4,10
187976,8,34,9,0,25,9
187976,7,38,6,0,32,6
187976,6,36,6,0,30,6
187976,5,20,2,0,18,2
187976,4,11,4,1,7,3
187976,3,6,3,0,3,3
5243,10,7,4,0,3,4
5243,9,20,10,1,10,9
5243,8,57,26,1,31,25
5243,7,44,18,2,26,16
5243,6,38,12,0,26,12
5243,5,9,1,0,8,1
5243,4,3,2,0,1,2
5243,3,4,2,0,2,2
172206,10,3,1,0,2,1
172206,8,41,8,2,33,6
172206,7,42,6,1,36,5
172206,6,58,8,0,50,8
172206,5,18,2,0,16,2
172206,4,13,4,0,9,4
118215,9,2,1,0,1,1
118215,8,23,8,0,15,8
118215,7,41,7,0,34,7
118215,6,63,13,0,50,13
118215,5,33,9,0,24,9
118215,4,14,1,0,13,1
118215,1,1,1,0,0,1
158851,9,4,1,0,3,1
158851,8,16,3,1,13,2
158851,7,36,7,0,29,7
158851,6,60,6,0,54,6
158851,5,18,4,0,14,4
158851,4,12,2,0,10,2
158851,3,15,3,0,12,3
158851,2,7,1,0,6,1
158851,1,11,3,0,8,3
172837,10,5,2,0,3,2
172837,9,6,1,0,5,1
172837,8,17,3,0,14,3
172837,7,32,4,0,28,4
172837,6,60,12,0,48,12
172837,5,24,7,0,17,7
172837,4,19,6,0,13,6
172837,3,13,5,0,8,5
829,9,2,2,0,0,2
829,8,20,7,0,13,7
829,7,37,11,0,26,11
829,6,52,20,0,32,20
829,5,34,11,0,23,11
829,4,14,7,0,7,7
829,3,13,9,0,4,9
829,2,6,4,0,2,4
829,1,2,1,0,1,1
2688,8,5,3,0,2,3
2688,7,9,6,0,3,6
2688,6,22,7,0,15,7
2688,5,34,5,0,29,5
2688,4,36,15,0,21,15
2688,3,40,17,0,23,17
2688,2,28,21,0,7,21
2688,1,6,3,0,3,3
258389,10,4,1,0,3,1
258389,8,28,2,0,26,2
258389,7,54,11,0,43,11
258389,6,50,11,0,39,11
258389,5,32,7,0,25,7
258389,4,5,1,0,4,1
258389,3,4,1,0,3,1
258389,2,3,1,0,2,1
314,8,20,3,0,17,3
314,7,52,9,0,43,9
314,6,63,9,0,54,9
314,5,28,5,0,23,5
314,4,8,2,0,6,2
314,3,4,3,0,1,3
314,2,2,1,0,1,1
31575,10,8,4,0,4,4
31575,9,20,7,0,13,7
31575,8,41,14,0,27,14
31575,7,44,16,0,28,16
31575,6,33,8,0,25,8
31575,5,15,4,0,11,4
31575,4,12,1,0,11,1
31575,3,6,1,0,5,1
31575,2,2,1,0,1,1
88691,10,5,1,0,4,1
88691,9,1,1,0,0,1
88691,8,11,3,0,8,3
88691,7,18,5,0,13,5
88691,6,54,10,0,44,10
88691,5,34,8,0,26,8
88691,4,25,5,0,20,5
88691,3,19,5,0,14,5
88691,2,11,2,0,9,2
256313,8,47,9,0,38,9
256313,7,56,11,0,45,11
256313,6,41,8,0,33,8
256313,5,13,1,0,12,1
256313,4,6,3,0,3,3
150996,10,10,2,1,8,1
150996,9,9,2,0,7,2
150996,8,39,6,0,33,6
150996,7,56,5,0,51,5
150996,6,36,2,1,34,1
150996,5,21,3,0,18,3
150996,3,3,3,0,0,3
24225,10,5,4,0,1,4
24225,9,19,3,0,16,3
24225,8,31,9,0,22,9
24225,7,42,12,0,30,12
24225,6,40,14,0,26,14
24225,5,18,5,0,13,5
24225,4,15,6,0,9,6
24225,3,6,4,0,2,4
4346,10,5,3,0,2,3
4346,9,13,6,0,7,6
4346,8,46,17,0,29,17
4346,7,62,23,0,39,23
4346,6,35,11,0,24,11
4346,5,11,1,0,10,1
4346,4,5,1,0,4,1
4346,3,2,1,0,1,1
4346,2,2,1,0,1,1
19046,10,2,1,0,1,1
19046,8,11,5,0,6,5
19046,7,26,5,0,21,5
19046,6,68,16,0,52,16
19046,5,44,11,0,33,11
19046,4,16,7,0,9,7
19046,3,7,1,0,6,1
19046,2,6,3,0,3,3
18895,10,9,1,0,8,1
18895,9,4,1,0,3,1
18895,8,12,3,0,9,3
18895,7,18,2,0,16,2
18895,6,50,15,0,35,15
18895,5,32,8,0,24,8
18895,4,26,7,0,19,7
18895,3,14,6,0,8,6
18895,2,12,5,0,7,5
18895,1,5,1,0,4,1
42691,9,4,2,0,2,2
42691,8,9,1,0,8,1
42691,7,22,5,0,17,5
42691,6,59,5,0,54,5
42691,5,32,2,0,30,2
42691,4,22,5,0,17,5
42691,3,22,7,0,15,7
42691,2,7,4,0,3,4
42691,1,2,1,0,1,1
2248,10,1,1,0,0,1
2248,9,3,1,0,2,1
2248,8,26,5,0,21,5
2248,7,36,17,0,19,17
2248,6,73,18,0,55,18
2248,5,27,6,0,21,6
2248,4,11,4,0,7,4
2248,3,5,2,0,3,2
202207,10,4,2,1,2,1
202207,9,11,6,1,5,5
202207,8,41,13,1,28,12
202207,7,51,9,2,42,7
202207,6,48,12,2,36,10
202207,5,18,1,0,17,1
2583,10,4,2,0,2,2
2583,9,15,9,0,6,9
2583,8,56,25,0,31,25
2583,7,63,27,0,36,27
2583,6,32,13,0,19,13
2583,5,5,1,0,4,1
2583,4,3,2,0,1,2
221248,10,25,4,0,21,4
221248,9,33,5,1,28,4
221248,8,63,7,0,56,7
221248,7,49,8,0,41,8
221248,6,11,1,0,10,1
221248,5,1,1,0,0,1
8250,10,3,1,0,2,1
8250,9,8,6,0,2,6
8250,8,22,7,0,15,7
8250,7,50,17,0,33,17
8250,6,61,11,0,50,11
8250,5,25,7,0,18,7
8250,4,9,1,0,8,1
1697,10,3,2,0,1,2
1697,9,2,1,0,1,1
1697,8,15,7,0,8,7
1697,7,29,13,0,16,13
1697,6,66,22,0,44,22
1697,5,44,20,0,24,20
1697,4,14,6,0,8,6
1697,3,6,3,0,3,3
1697,1,1,1,0,0,1
7176,10,5,1,0,4,1
7176,9,16,8,0,8,8
7176,8,50,14,0,36,14
7176,7,53,11,0,42,11
7176,6,31,10,0,21,10
7176,5,16,5,0,11,5
7176,2,3,2,0,1,2
256801,8,27,3,0,24,3
256801,7,50,10,0,40,10
256801,6,49,7,0,42,7
256801,5,22,5,0,17,5
256801,4,12,1,0,11,1
256801,3,4,1,0,3,1
256801,2,8,4,0,4,4
256801,1,3,2,0,1,2
145424,8,40,10,0,30,10
145424,7,58,12,0,46,12
145424,6,54,14,0,40,14
145424,5,13,3,0,10,3
145424,4,7,1,0,6,1
145424,3,2,2,0,0,2
83325,10,32,19,0,13,19
83325,9,37,15,0,22,15
83325,8,54,23,0,31,23
83325,7,28,9,0,19,9
83325,6,22,11,0,11,11
83325,3,2,2,0,0,2
89898,10,1,1,0,0,1
89898,9,7,3,0,4,3
89898,8,19,2,0,17,2
89898,7,27,6,0,21,6
89898,6,60,12,0,48,12
89898,5,33,10,0,23,10
89898,4,20,7,0,13,7
89898,3,8,2,0,6,2
89898,2,4,1,0,3,1
89898,1,2,1,0,1,1
103469,10,14,5,0,9,5
103469,9,18,2,0,16,2
103469,8,42,4,0,38,4
103469,7,40,5,0,35,5
103469,6,40,6,0,34,6
103469,5,20,9,0,11,9
103469,4,5,1,0,4,1
32129,10,1,1,0,0,1
32129,9,19,7,0,12,7
32129,8,54,21,0,33,21
32129,7,56,26,0,30,26
32129,6,34,15,0,19,15
32129,5,10,4,0,6,4
32129,4,4,3,0,1,3
149863,8,32,5,0,27,5
149863,7,42,7,0,35,7
149863,6,64,11,0,53,11
149863,5,24,7,0,17,7
149863,4,9,2,0,7,2
16000,10,7,2,0,5,2
16000,9,28,16,0,12,16
16000,8,69,16,0,53,16
16000,7,49,18,0,31,18
16000,6,14,2,0,12,2
16000,5,8,2,0,6,2
16000,4,1,1,0,0,1
16000,2,3,1,0,2,1
38944,8,22,5,0,17,5
38944,7,55,16,0,39,16
38944,6,75,12,0,63,12
38944,5,20,3,0,17,3
38944,4,5,1,0,4,1
38944,2,1,1,0,0,1
19028,8,12,5,0,7,5
19028,7,39,9,0,30,9
19028,6,58,15,0,43,15
19028,5,30,13,0,17,13
19028,4,20,5,0,15,5
19028,3,10,3,0,7,3
19028,2,7,7,0,0,7
19028,1,3,1,0,2,1
8328,9,5,1,0,4,1
8328,8,17,9,0,8,9
8328,7,29,14,0,15,14
8328,6,68,25,0,43,25
8328,5,41,13,0,28,13
8328,4,17,6,0,11,6
8328,1,1,1,0,0,1
38950,8,13,2,0,11,2
38950,7,13,2,0,11,2
38950,6,65,13,0,52,13
38950,5,36,5,0,31,5
38950,4,38,10,0,28,10
38950,3,11,4,0,7,4
38950,2,3,1,0,2,1
13714,9,2,1,0,1,1
13714,8,10,3,0,7,3
13714,7,20,5,0,15,5
13714,6,52,17,0,35,17
13714,5,44,14,0,30,14
13714,4,30,17,0,13,17
13714,3,15,6,0,9,6
13714,2,3,2,0,1,2
13714,1,4,3,0,1,3
93540,10,2,1,0,1,1
93540,9,4,2,0,2,2
93540,8,25,11,0,14,11
93540,7,48,10,0,38,10
93540,6,54,10,0,44,10
93540,5,27,6,0,21,6
93540,4,17,9,0,8,9
93540,1,1,1,0,0,1
4205,10,30,9,0,21,9
4205,9,31,10,0,21,10
4205,8,59,11,0,48,11
4205,7,31,11,0,20,11
4205,6,22,3,0,19,3
4205,5,6,1,0,5,1
4205,3,1,1,0,0,1
2853,10,8,5,0,3,5
2853,9,17,4,0,13,4
2853,8,37,17,0,20,17
2853,7,50,16,0,34,16
2853,6,39,15,0,24,15
2853,5,21,5,0,16,5
2853,4,3,1,0,2,1
2853,3,3,1,0,2,1
2853,2,3,1,0,2,1
315,8,8,4,0,4,4
315,7,42,13,0,29,13
315,6,78,19,0,59,19
315,5,28,8,0,20,8
315,4,13,4,0,9,4
315,3,8,4,0,4,4
195981,10,5,1,0,4,1
195981,9,16,4,1,12,3
195981,8,33,11,1,22,10
195981,7,57,6,0,51,6
195981,6,49,11,1,38,10
108705,9,3,1,0,2,1
108705,8,27,9,0,18,9
108705,7,45,4,0,41,4
108705,6,66,5,0,61,5
108705,5,28,9,0,19,9
159470,9,6,2,0,4,2
159470,8,26,5,0,21,5
159470,7,62,17,0,45,17
159470,6,55,10,0,45,10
159470,5,16,4,0,12,4
159470,4,9,5,0,4,5
159470,3,3,1,0,2,1
6617,10,2,1,0,1,1
6617,9,6,2,0,4,2
6617,8,25,3,0,22,3
6617,7,44,10,0,34,10
6617,6,55,8,0,47,8
6617,5,29,7,0,22,7
6617,4,10,2,0,8,2
6617,3,8,3,0,5,3
6617,2,2,2,0,0,2
112445,9,10,3,0,7,3
112445,8,33,9,1,24,8
112445,7,27,1,0,26,1
112445,6,44,10,2,34,8
112445,5,26,8,1,18,7
112445,4,10,6,4,4,2
112445,3,15,8,3,7,5
112445,2,9,2,1,7,1
112445,1,5,2,0,3,2
133835,10,6,2,0,4,2
133835,9,8,1,0,7,1
133835,8,48,18,0,30,18
133835,7,46,13,1,33,12
133835,6,37,12,0,25,12
133835,5,17,5,0,12,5
133835,4,9,5,0,4,5
133835,3,7,4,0,3,4
133835,2,3,2,0,1,2
1336,8,6,1,0,5,1
1336,7,37,6,0,31,6
1336,6,62,10,0,52,10
1336,5,40,11,0,29,11
1336,4,27,5,0,22,5
1336,3,7,3,0,4,3
7935,10,44,13,0,31,13
7935,9,41,11,0,30,11
7935,8,62,14,0,48,14
7935,7,21,5,0,16,5
7935,6,7,2,0,5,2
142584,9,6,1,0,5,1
142584,8,18,5,1,13,4
142584,7,34,7,2,27,5
142584,6,48,10,2,38,8
142584,5,30,8,1,22,7
142584,4,20,5,1,15,4
142584,3,10,5,0,5,5
142584,2,11,4,1,7,3
142584,1,1,1,0,0,1
6284,9,2,2,0,0,2
6284,8,5,3,0,2,3
6284,7,8,3,0,5,3
6284,6,41,6,0,35,6
6284,5,50,10,0,40,10
6284,4,36,7,0,29,7
6284,3,20,7,0,13,7
6284,2,16,4,0,12,4
181495,10,15,2,0,13,2
181495,9,31,10,0,21,10
181495,8,73,9,1,64,8
181495,7,33,5,0,28,5
181495,6,19,6,0,13,6
181495,5,6,2,0,4,2
181495,3,2,1,0,1,1
182385,10,1,1,0,0,1
182385,8,37,11,0,26,11
182385,7,54,8,0,46,8
182385,6,58,17,0,41,17
182385,5,22,8,0,14,8
182385,4,2,1,0,1,1
182385,2,1,1,0,0,1
182385,1,2,2,0,0,2
40962,8,21,8,0,13,8
40962,7,34,8,0,26,8
40962,6,71,12,0,59,12
40962,5,35,11,0,24,11
40962,3,6,2,0,4,2
40962,1,3,1,0,2,1
232318,10,16,7,2,9,5
232318,9,16,4,0,12,4
232318,8,56,14,3,42,11
232318,7,51,4,0,47,4
232318,6,26,3,0,23,3
232318,5,6,1,0,5,1
232318,1,4,2,0,2,2
1570,10,3,3,0,0,3
1570,9,4,2,0,2,2
1570,8,10,6,0,4,6
1570,7,26,9,0,17,9
1570,6,67,20,0,47,20
1570,5,39,16,0,23,16
1570,4,16,6,0,10,6
1570,3,10,6,0,4,6
1570,2,5,1,0,4,1
145975,10,11,3,0,8,3
145975,9,34,7,0,27,7
145975,8,74,23,0,51,23
145975,7,38,10,0,28,10
145975,6,14,2,0,12,2
145975,5,5,1,0,4,1
145975,4,1,1,0,0,1
145975,3,2,2,0,0,2
16191,8,14,2,0,12,2
16191,7,23,1,0,22,1
16191,6,51,5,0,46,5
16191,5,46,8,0,38,8
16191,4,19,3,0,16,3
16191,3,12,2,0,10,2
16191,2,8,1,0,7,1
181120,10,7,1,0,6,1
181120,9,7,1,0,6,1
181120,8,35,8,0,27,8
181120,7,53,7,0,46,7
181120,6,51,8,1,43,7
181120,5,18,5,0,13,5
181120,4,4,1,0,3,1
181120,3,4,2,0,2,2
27674,8,14,5,0,9,5
27674,7,28,7,0,21,7
27674,6,58,20,0,38,20
27674,5,37,12,0,25,12
27674,4,28,10,0,18,10
27674,3,8,1,0,7,1
27674,2,4,1,0,3,1
17003,7,2,1,0,1,1
17003,6,13,4,0,9,4
17003,5,20,7,0,13,7
17003,4,51,27,0,24,27
17003,3,41,12,0,29,12
17003,2,23,11,0,12,11
232420,9,7,3,0,4,3
232420,8,22,3,0,19,3
232420,7,37,4,0,33,4
232420,6,58,9,0,49,9
232420,5,29,4,0,25,4
232420,4,18,2,0,16,2
232420,3,5,1,0,4,1
232420,2,3,1,0,2,1
9801,9,2,1,0,1,1
9801,8,24,13,0,11,13
9801,7,33,7,0,26,7
9801,6,62,15,0,47,15
9801,5,25,3,0,22,3
9801,4,18,9,0,9,9
9801,3,12,8,0,4,8
29351,10,8,1,0,7,1
29351,9,11,4,0,7,4
29351,8,26,2,0,24,2
29351,7,34,6,0,28,6
29351,6,49,10,0,39,10
29351,5,23,7,0,16,7
29351,4,21,2,0,19,2
29351,3,3,1,0,2,1
29351,2,4,2,0,2,2
204879,9,2,1,0,1,1
204879,8,43,4,0,39,4
204879,7,53,9,0,44,9
204879,6,59,9,0,50,9
204879,5,14,1,0,13,1
204879,3,1,1,0,0,1
204879,2,1,1,0,0,1
174518,10,11,3,0,8,3
174518,8,54,2,0,52,2
174518,7,58,6,0,52,6
174518,6,28,4,0,24,4
61902,9,3,1,0,2,1
61902,8,11,1,0,10,1
61902,7,34,5,0,29,5
61902,6,62,9,0,53,9
61902,5,31,5,0,26,5
61902,4,18,4,0,14,4
61902,3,10,4,0,6,4
61902,2,7,3,0,4,3
9473,10,5,1,0,4,1
9473,9,2,1,0,1,1
9473,8,9,4,0,5,4
9473,7,45,5,0,40,5
9473,6,63,23,0,40,23
9473,5,29,12,0,17,12
9473,4,16,10,0,6,10
9473,2,2,2,0,0,2
31542,10,6,2,0,4,2
31542,9,22,9,0,13,9
31542,8,44,5,0,39,5
31542,7,34,7,0,27,7
31542,6,31,7,0,24,7
31542,5,22,11,0,11,11
31542,4,10,3,0,7,3
31542,3,6,4,0,2,4
31542,2,2,1,0,1,1
31542,1,3,2,0,1,2
180193,10,2,1,0,1,1
180193,9,8,4,0,4,4
180193,8,57,10,0,47,10
180193,7,44,10,0,34,10
180193,6,55,9,0,46,9
180193,5,8,3,0,5,3
180193,3,1,1,0,0,1
180193,1,2,1,0,1,1
2942,8,12,4,0,8,4
2942,7,25,4,0,21,4
2942,6,51,20,0,31,20
2942,5,46,13,0,33,13
2942,4,23,10,0,13,10
2942,3,9,2,0,7,2
2942,2,5,3,0,2,3
2942,1,1,1,0,0,1
148975,9,7,3,0,4,3
148975,8,28,7,0,21,7
148975,7,53,13,0,40,13
148975,6,67,16,0,51,16
148975,5,17,3,0,14,3
148975,3,4,2,0,2,2
113853,10,3,1,0,2,1
113853,9,10,7,0,3,7
113853,8,29,9,0,20,9
113853,7,43,18,0,25,18
113853,6,44,13,0,31,13
113853,5,27,6,0,21,6
113853,4,17,5,0,12,5
113853,3,5,2,0,3,2
1524,9,2,1,0,1,1
1524,8,7,2,0,5,2
1524,7,34,8,0,26,8
1524,6,56,17,0,39,17
1524,5,37,9,0,28,9
1524,4,25,10,0,15,10
1524,3,10,3,0,7,3
1524,2,7,3,0,4,3
1524,1,1,1,0,0,1
99358,10,33,10,0,23,10
99358,9,62,16,0,46,16
99358,8,63,14,0,49,14
99358,7,13,3,0,10,3
99358,6,4,1,0,3,1
99358,5,3,1,0,2,1
194233,10,11,1,0,10,1
194233,9,10,3,0,7,3
194233,8,45,10,0,35,10
194233,7,44,8,0,36,8
194233,6,50,6,0,44,6
194233,5,10,4,0,6,4
194233,4,8,1,0,7,1
194233,3,3,1,0,2,1
168512,9,10,2,0,8,2
168512,8,29,5,0,24,5
168512,7,48,6,0,42,6
168512,6,48,6,0,42,6
168512,5,16,5,0,11,5
168512,4,14,6,0,8,6
168512,3,10,3,0,7,3
4009,10,3,1,0,2,1
4009,9,5,3,0,2,3
4009,8,23,11,0,12,11
4009,7,55,13,0,42,13
4009,6,59,25,0,34,25
4009,5,29,11,0,18,11
4009,4,5,3,0,2,3
4009,2,1,1,0,0,1
169795,10,5,2,0,3,2
169795,9,12,7,0,5,7
169795,8,30,2,0,28,2
169795,7,38,7,0,31,7
169795,6,44,10,0,34,10
169795,5,23,3,0,20,3
169795,4,10,5,0,5,5
169795,3,10,6,0,4,6
169795,2,7,2,0,5,2
132148,10,14,3,0,11,3
132148,9,36,12,0,24,12
132148,8,74,14,0,60,14
132148,7,30,7,0,23,7
132148,6,15,8,0,7,8
132148,5,5,3,0,2,3
132148,4,4,3,0,1,3
132148,1,1,1,0,0,1
1924,8,17,5,0,12,5
1924,7,41,11,0,30,11
1924,6,50,16,0,34,16
1924,5,49,9,0,40,9
1924,4,13,6,0,7,6
1924,3,5,1,0,4,1
35812,9,5,1,0,4,1
35812,8,17,4,0,13,4
35812,7,38,8,0,30,8
35812,6,70,11,0,59,11
35812,5,25,4,0,21,4
35812,4,16,5,0,11,5
35812,3,5,3,0,2,3
35812,2,1,1,0,0,1
145599,10,20,8,1,12,7
145599,9,19,5,1,14,4
145599,8,41,13,1,28,12
145599,7,39,7,0,32,7
145599,6,32,3,0,29,3
145599,5,12,2,0,10,2
145599,4,8,2,1,6,1
145599,1,7,5,2,2,3
13359,8,23,9,0,14,9
13359,7,52,19,0,33,19
13359,6,61,27,0,34,27
13359,5,28,20,0,8,20
13359,4,8,5,0,3,5
13359,3,3,3,0,0,3
13359,1,1,1,0,0,1
43168,10,6,1,0,5,1
43168,8,12,2,0,10,2
43168,7,28,4,0,24,4
43168,6,75,17,0,58,17
43168,5,35,5,0,30,5
43168,4,12,4,0,8,4
43168,3,6,2,0,4,2
43168,2,3,3,0,0,3
65313,10,7,2,0,5,2
65313,9,22,7,0,15,7
65313,8,57,19,0,38,19
65313,7,49,11,0,38,11
65313,6,26,6,0,20,6
65313,5,7,3,0,4,3
65313,4,6,3,0,3,3
65313,3,2,1,0,1,1
65313,2,2,1,0,1,1
22684,10,3,1,0,2,1
22684,9,6,2,0,4,2
22684,8,29,8,0,21,8
22684,7,47,8,0,39,8
22684,6,57,12,0,45,12
22684,5,21,5,0,16,5
22684,4,7,1,0,6,1
22684,3,7,4,0,3,4
221233,9,7,2,0,5,2
221233,8,29,6,0,23,6
221233,7,55,11,0,44,11
221233,6,61,18,0,43,18
221233,5,19,4,0,15,4
221233,4,3,1,0,2,1
221233,3,3,1,0,2,1
221233,2,2,2,0,0,2
3794,10,4,1,0,3,1
3794,9,9,4,0,5,4
3794,8,26,5,0,21,5
3794,7,29,6,0,23,6
3794,6,54,13,0,41,13
3794,5,29,8,0,21,8
3794,4,15,2,0,13,2
3794,3,7,5,0,2,5
3794,2,4,1,0,3,1
3794,1,2,1,0,1,1
14953,9,4,3,0,1,3
14953,8,16,5,0,11,5
14953,7,32,4,0,28,4
14953,6,62,15,0,47,15
14953,5,31,5,0,26,5
14953,4,12,2,0,10,2
14953,3,9,2,0,7,2
14953,2,10,5,0,5,5
14953,1,4,2,0,2,2
26459,10,17,5,0,12,5
26459,9,20,6,0,14,6
26459,8,51,14,0,37,14
26459,7,39,12,0,27,12
26459,6,28,5,0,23,5
26459,5,12,4,0,8,4
26459,4,5,3,0,2,3
26459,3,3,1,0,2,1
26459,2,4,3,0,1,3
2372,10,3,3,0,0,3
2372,9,1,1,0,0,1
2372,8,13,2,0,11,2
2372,7,30,8,0,22,8
2372,6,51,13,0,38,13
2372,5,44,9,0,35,9
2372,4,19,4,0,15,4
2372,3,11,4,0,7,4
2372,2,6,1,0,5,1
30370,8,17,4,0,13,4
30370,7,38,13,0,25,13
30370,6,58,20,0,38,20
30370,5,32,14,0,18,14
30370,4,10,5,0,5,5
30370,3,13,6,0,7,6
30370,2,5,1,0,4,1
30370,1,3,3,0,0,3
6841,10,3,1,0,2,1
6841,9,5,1,0,4,1
6841,8,19,10,0,9,10
6841,7,44,21,0,23,21
6841,6,64,23,0,41,23
6841,5,24,11,0,13,11
6841,4,12,8,0,4,8
6841,3,6,1,0,5,1
6841,2,2,1,0,1,1
147889,8,20,2,0,18,2
147889,7,42,5,0,37,5
147889,6,65,9,0,56,9
147889,5,26,4,0,22,4
147889,3,3,1,0,2,1
15121,10,2,1,0,1,1
15121,9,3,1,0,2,1
15121,8,10,3,0,7,3
15121,7,26,5,0,21,5
15121,6,58,12,0,46,12
15121,5,44,15,0,29,15
15121,4,22,8,0,14,8
15121,3,11,2,0,9,2
15121,2,2,1,0,1,1
128218,10,8,5,0,3,5
128218,9,11,5,0,6,5
128218,8,55,7,0,48,7
128218,7,43,6,0,37,6
128218,6,37,3,0,34,3
128218,5,7,1,0,6,1
128218,4,7,1,0,6,1
128218,2,2,1,0,1,1
128218,1,3,2,0,1,2
1510,10,13,7,0,6,7
1510,9,3,1,0,2,1
1510,8,7,4,0,3,4
1510,7,8,2,0,6,2
1510,6,30,10,0,20,10
1510,5,29,12,0,17,12
1510,4,43,12,0,31,12
1510,3,24,10,0,14,10
1510,2,14,8,0,6,8
1510,1,8,5,0,3,5
7483,9,11,5,0,6,5
7483,8,36,10,0,26,10
7483,7,37,8,0,29,8
7483,6,65,13,0,52,13
7483,5,22,5,0,17,5
7483,4,7,2,0,5,2
158268,9,6,2,0,4,2
158268,8,24,5,0,19,5
158268,7,29,3,0,26,3
158268,6,42,6,0,36,6
158268,5,27,6,0,21,6
158268,4,24,6,0,18,6
158268,3,11,1,0,10,1
158268,2,9,3,0,6,3
158268,1,4,3,0,1,3
154125,10,5,1,0,4,1
154125,9,12,3,0,9,3
154125,8,33,8,0,25,8
154125,7,74,13,0,61,13
154125,6,37,7,0,30,7
154125,5,14,3,0,11,3
189160,10,3,1,0,2,1
189160,9,4,1,0,3,1
189160,8,16,2,0,14,2
189160,7,49,10,0,39,10
189160,6,55,12,0,43,12
189160,5,31,4,0,27,4
189160,4,17,1,0,16,1
189160,3,4,4,0,0,4
189160,2,1,1,0,0,1
19399,10,1,1,0,0,1
19399,9,2,1,0,1,1
19399,8,15,1,0,14,1
19399,7,26,7,0,19,7
19399,6,68,11,0,57,11
19399,5,40,9,0,31,9
19399,4,12,2,0,10,2
19399,3,7,2,0,5,2
19399,2,6,1,0,5,1
244099,10,10,3,0,7,3
244099,9,9,2,0,7,2
244099,8,71,16,3,55,13
244099,7,49,14,2,35,12
244099,6,30,4,0,26,4
244099,5,8,3,0,5,3
244099,3,3,1,0,2,1
188991,10,16,10,1,6,9
188991,9,25,12,2,13,10
188991,8,58,19,2,39,17
188991,7,37,10,0,27,10
188991,6,29,7,1,22,6
188991,5,11,3,0,8,3
17250,8,11,3,0,8,3
17250,7,9,2,0,7,2
17250,6,34,4,0,30,4
17250,5,40,6,0,34,6
17250,4,38,13,0,25,13
17250,3,23,7,0,16,7
17250,2,15,5,0,10,5
17250,1,6,1,0,5,1
107733,10,2,1,0,1,1
107733,9,4,1,0,3,1
107733,8,12,4,0,8,4
107733,7,37,10,0,27,10
107733,6,39,4,0,35,4
107733,5,35,9,0,26,9
107733,4,25,3,0,22,3
107733,3,13,2,0,11,2
107733,2,5,1,0,4,1
107733,1,8,1,0,7,1
83157,10,3,2,0,1,2
83157,9,4,2,0,2,2
83157,8,35,14,0,21,14
83157,7,38,8,0,30,8
83157,6,66,17,0,49,17
83157,5,22,5,0,17,5
83157,4,10,2,0,8,2
83157,1,1,1,0,0,1
13224,9,7,1,0,6,1
13224,8,24,14,0,10,14
13224,7,41,13,0,28,13
13224,6,55,14,0,41,14
13224,5,23,7,0,16,7
13224,4,17,11,0,6,11
13224,3,5,3,0,2,3
13224,2,2,2,0,0,2
13224,1,2,2,0,0,2
5856,10,4,1,0,3,1
5856,8,10,3,0,7,3
5856,7,21,5,0,16,5
5856,6,45,7,0,38,7
5856,5,39,12,0,27,12
5856,4,39,12,0,27,12
5856,3,14,6,0,8,6
5856,2,3,2,0,1,2
5856,1,2,1,0,1,1
190247,10,23,8,0,15,8
190247,9,17,5,0,12,5
190247,8,73,21,3,52,18
190247,7,27,8,0,19,8
190247,6,24,2,0,22,2
190247,5,6,3,0,3,3
190247,3,3,2,0,1,2
190247,1,2,1,0,1,1
39080,9,1,1,0,0,1
39080,8,14,4,0,10,4
39080,7,42,16,0,26,16
39080,6,62,20,0,42,20
39080,5,31,10,0,21,10
39080,4,14,4,0,10,4
39080,3,9,3,0,6,3
39080,2,5,5,0,0,5
21829,9,8,1,0,7,1
21829,8,33,4,0,29,4
21829,7,40,5,0,35,5
21829,6,53,10,0,43,10
21829,5,25,5,0,20,5
21829,4,10,1,0,9,1
21829,3,7,2,0,5,2
83919,10,3,1,0,2,1
83919,8,17,2,0,15,2
83919,7,40,7,0,33,7
83919,6,62,14,0,48,14
83919,5,30,6,0,24,6
83919,4,13,4,0,9,4
83919,3,5,1,0,4,1
198408,10,6,3,0,3,3
198408,9,8,3,0,5,3
198408,8,32,3,0,29,3
198408,7,53,9,0,44,9
198408,6,45,6,0,39,6
198408,5,22,7,0,15,7
198408,4,6,1,0,5,1
198408,3,4,2,0,2,2
198408,1,1,1,0,0,1
104340,10,3,1,0,2,1
104340,9,6,1,0,5,1
104340,8,22,8,0,14,8
104340,7,43,9,0,34,9
104340,6,62,17,0,45,17
104340,5,19,5,0,14,5
104340,4,12,4,0,8,4
104340,3,8,4,0,4,4
104340,2,3,2,0,1,2
245645,10,5,1,0,4,1
245645,8,49,7,0,42,7
245645,7,57,7,0,50,7
245645,6,36,8,0,28,8
245645,5,20,5,0,15,5
71886,10,2,1,0,1,1
71886,9,6,2,0,4,2
71886,8,36,8,0,28,8
71886,7,49,10,0,39,10
71886,6,64,8,0,56,8
71886,5,13,1,0,12,1
71886,2,1,1,0,0,1
75828,10,10,1,0,9,1
75828,9,18,6,0,12,6
75828,8,48,12,0,36,12
75828,7,36,11,0,25,11
75828,6,40,12,0,28,12
75828,5,16,5,0,11,5
75828,4,3,1,0,2,1
75828,3,5,3,0,2,3
2090,10,2,2,0,0,2
2090,9,6,1,0,5,1
2090,8,39,11,0,28,11
2090,7,65,13,0,52,13
2090,6,47,11,0,36,11
2090,5,13,2,0,11,2
2090,3,2,1,0,1,1
162738,9,2,1,0,1,1
162738,8,25,6,0,19,6
162738,7,48,8,0,40,8
162738,6,74,12,0,62,12
162738,5,17,1,0,16,1
162738,4,6,1,0,5,1
164205,9,8,3,0,5,3
164205,8,38,6,0,32,6
164205,7,46,9,0,37,9
164205,6,57,11,0,46,11
164205,5,19,8,0,11,8
164205,4,4,1,0,3,1
164205,3,2,1,0,1,1
6837,9,4,1,0,3,1
6837,8,8,4,0,4,4
6837,7,33,11,0,22,11
6837,6,63,19,0,44,19
6837,5,35,7,0,28,7
6837,4,20,4,0,16,4
6837,3,7,3,0,4,3
127438,10,1,1,0,0,1
127438,9,4,2,0,2,2
127438,8,31,10,0,21,10
127438,7,51,9,0,42,9
127438,6,56,5,0,51,5
127438,5,21,2,0,19,2
127438,4,6,2,0,4,2
127438,3,5,1,0,4,1
201037,8,39,15,0,24,15
201037,7,62,12,0,50,12
201037,6,51,11,0,40,11
201037,5,16,4,0,12,4
201037,1,1,1,0,0,1
42702,8,15,1,0,14,1
42702,7,39,2,0,37,2
42702,6,42,4,0,38,4
42702,5,28,2,0,26,2
42702,4,24,2,0,22,2
42702,3,10,2,0,8,2
42702,2,5,1,0,4,1
42702,1,3,1,0,2,1
39095,8,18,2,0,16,2
39095,7,45,10,0,35,10
39095,6,71,3,0,68,3
39095,5,28,5,0,23,5
39095,4,11,4,0,7,4
39095,3,4,3,0,1,3
65936,10,23,7,0,16,7
65936,9,43,9,0,34,9
65936,8,79,25,0,54,25
65936,7,17,7,0,10,7
65936,6,7,2,0,5,2
65936,5,5,1,0,4,1
65936,2,3,1,0,2,1
179794,10,4,1,0,3,1
179794,9,4,1,0,3,1
179794,8,16,3,0,13,3
179794,7,34,5,0,29,5
179794,6,70,10,0,60,10
179794,5,30,4,0,26,4
179794,4,9,4,0,5,4
179794,3,8,4,0,4,4
179794,2,1,1,0,0,1
179794,1,2,2,0,0,2
195179,8,18,2,0,16,2
195179,7,46,3,0,43,3
195179,6,62,14,0,48,14
195179,5,32,4,0,28,4
183150,9,7,3,0,4,3
183150,8,38,10,2,28,8
183150,7,55,6,0,49,6
183150,6,56,4,0,52,4
183150,5,14,4,0,10,4
214996,10,19,7,0,12,7
214996,9,65,21,0,44,21
214996,8,64,10,0,54,10
214996,7,13,3,0,10,3
214996,6,10,2,0,8,2
214996,5,3,1,0,2,1
214996,3,2,1,0,1,1
2919,10,8,5,0,3,5
2919,9,14,4,0,10,4
2919,8,35,14,0,21,14
2919,7,56,19,0,37,19
2919,6,37,19,0,18,19
2919,5,21,8,0,13,8
2919,3,2,1,0,1,1
42132,8,12,3,0,9,3
42132,7,10,3,0,7,3
42132,6,50,15,0,35,15
42132,5,53,15,0,38,15
42132,4,20,7,0,13,7
42132,3,18,11,0,7,11
42132,2,10,3,0,7,3
42132,1,3,1,0,2,1
307,9,2,1,0,1,1
307,8,10,1,0,9,1
307,7,35,12,0,23,12
307,6,49,12,0,37,12
307,5,36,6,0,30,6
307,4,28,11,0,17,11
307,3,10,7,0,3,7
307,2,5,1,0,4,1
307,1,1,1,0,0,1
3771,10,1,1,0,0,1
3771,9,8,6,0,2,6
3771,8,24,7,0,17,7
3771,7,45,8,0,37,8
3771,6,55,18,0,37,18
3771,5,24,10,0,14,10
3771,4,12,8,0,4,8
3771,3,3,2,0,1,2
3771,2,5,3,0,2,3
569,8,12,3,0,9,3
569,7,48,10,0,38,10
569,6,48,7,0,41,7
569,5,40,8,0,32,8
569,4,20,5,0,15,5
569,3,5,1,0,4,1
569,2,2,1,0,1,1
119804,10,3,2,0,1,2
119804,9,3,1,0,2,1
119804,8,43,9,0,34,9
119804,7,67,12,0,55,12
119804,6,42,9,0,33,9
119804,5,11,1,0,10,1
119804,4,3,2,0,1,2
119804,2,1,1,0,0,1
119804,1,1,1,0,0,1
1997,10,10,6,0,4,6
1997,9,8,2,0,6,2
1997,8,38,6,0,32,6
1997,7,53,5,0,48,5
1997,6,34,6,0,28,6
1997,5,17,5,0,12,5
1997,3,7,1,0,6,1
1997,2,2,1,0,1,1
5082,8,23,4,0,19,4
5082,7,38,6,0,32,6
5082,6,70,10,0,60,10
5082,5,20,2,0,18,2
5082,3,7,2,0,5,2
15509,9,3,1,0,2,1
15509,8,16,4,0,12,4
15509,7,31,6,0,25,6
15509,6,51,9,0,42,9
15509,5,44,7,0,37,7
15509,4,14,2,0,12,2
15509,3,13,4,0,9,4
15509,2,4,1,0,3,1
224271,10,16,6,0,10,6
224271,9,10,4,0,6,4
224271,8,24,6,0,18,6
224271,7,39,5,0,34,5
224271,6,48,6,0,42,6
224271,5,21,3,0,18,3
224271,4,7,2,0,5,2
224271,2,3,2,0,1,2
145943,9,2,1,0,1,1
145943,8,10,1,0,9,1
145943,7,20,3,0,17,3
145943,6,62,13,2,49,11
145943,5,40,8,1,32,7
145943,4,20,6,0,14,6
145943,3,12,2,0,10,2
145943,2,10,3,0,7,3
1177,8,13,3,0,10,3
1177,7,39,9,0,30,9
1177,6,70,17,0,53,17
1177,5,33,5,0,28,5
1177,4,13,6,0,7,6
1177,3,7,3,0,4,3
2887,7,12,4,0,8,4
2887,6,58,19,0,39,19
2887,5,42,15,0,27,15
2887,4,30,19,0,11,19
2887,3,22,3,0,19,3
2887,2,10,3,0,7,3
36659,8,23,8,0,15,8
36659,7,45,16,0,29,16
36659,6,65,31,0,34,31
36659,5,30,9,0,21,9
36659,4,7,3,0,4,3
36659,3,3,1,0,2,1
36659,2,3,2,0,1,2
8798,10,9,5,0,4,5
8798,9,11,3,0,8,3
8798,8,42,25,0,17,25
8798,7,55,18,0,37,18
8798,6,45,11,0,34,11
8798,5,7,1,0,6,1
8798,4,6,4,0,2,4
8798,3,2,2,0,0,2
121657,10,9,4,0,5,4
121657,9,17,7,0,10,7
121657,8,57,15,0,42,15
121657,7,47,7,0,40,7
121657,6,29,8,0,21,8
121657,4,7,3,0,4,3
121657,3,3,2,0,1,2
177515,10,17,6,0,11,6
177515,9,31,9,0,22,9
177515,8,73,17,0,56,17
177515,7,24,4,0,20,4
177515,6,19,2,0,17,2
177515,5,8,1,0,7,1
177515,3,1,1,0,0,1
177515,1,2,1,0,1,1
14342,8,12,3,0,9,3
14342,7,22,8,0,14,8
14342,6,57,13,0,44,13
14342,5,35,8,0,27,8
14342,4,27,8,0,19,8
14342,3,11,4,0,7,4
14342,2,6,3,0,3,3
14342,1,2,1,0,1,1
162315,10,9,5,0,4,5
162315,9,11,3,0,8,3
162315,8,54,6,0,48,6
162315,7,53,7,0,46,7
162315,6,32,6,1,26,5
162315,5,13,3,0,10,3
162315,4,3,1,0,2,1
203716,10,4,1,0,3,1
203716,9,6,1,0,5,1
203716,8,26,3,0,23,3
203716,7,43,9,0,34,9
203716,6,57,12,0,45,12
203716,5,18,4,0,14,4
203716,4,9,3,0,6,3
203716,3,6,1,0,5,1
203716,2,6,2,0,4,2
203716,1,1,1,0,0,1
187679,10,19,6,0,13,6
187679,9,23,7,0,16,7
187679,8,63,11,0,52,11
187679,7,33,6,0,27,6
187679,6,25,4,0,21,4
187679,5,7,1,0,6,1
187679,3,3,2,0,1,2
187679,1,1,1,0,0,1
171544,10,4,1,0,3,1
171544,8,63,12,0,51,12
171544,7,48,12,0,36,12
171544,6,31,8,0,23,8
171544,4,4,2,0,2,2
171544,3,6,2,0,4,2
171544,1,1,1,0,0,1
33434,10,25,7,0,18,7
33434,9,58,20,0,38,20
33434,8,56,13,0,43,13
33434,7,24,5,0,19,5
33434,6,9,3,0,6,3
38400,10,14,7,0,7,7
38400,9,13,4,0,9,4
38400,8,27,10,0,17,10
38400,7,32,12,0,20,12
38400,6,40,14,0,26,14
38400,5,23,9,0,14,9
38400,4,11,4,0,7,4
38400,3,10,4,0,6,4
38400,2,4,2,0,2,2
38400,1,2,1,0,1,1
206928,10,1,1,0,0,1
206928,8,21,4,0,17,4
206928,7,48,6,0,42,6
206928,6,60,11,0,49,11
206928,5,27,4,0,23,4
206928,4,11,4,0,7,4
147523,9,5,2,0,3,2
147523,8,11,3,0,8,3
147523,7,28,5,0,23,5
147523,6,51,17,0,34,17
147523,5,37,15,0,22,15
147523,4,16,2,0,14,2
147523,3,20,6,0,14,6
207,10,2,2,0,0,2
207,9,6,4,0,2,4
207,8,25,9,0,16,9
207,7,34,9,0,25,9
207,6,59,13,0,46,13
207,5,18,3,0,15,3
207,4,17,6,0,11,6
207,3,11,2,0,9,2
207,2,3,2,0,1,2
207,1,1,1,0,0,1
4096,9,1,1,0,0,1
4096,8,14,7,0,7,7
4096,7,28,9,0,19,9
4096,6,57,23,0,34,23
4096,5,33,9,0,24,9
4096,4,22,9,0,13,9
4096,3,15,7,0,8,7
4096,1,2,2,0,0,2
8954,10,5,2,0,3,2
8954,9,7,4,0,3,4
8954,8,38,12,0,26,12
8954,7,39,11,0,28,11
8954,6,43,10,0,33,10
8954,5,24,8,0,16,8
8954,4,11,4,0,7,4
8954,3,8,3,0,5,3
8954,2,1,1,0,0,1
35376,9,3,1,0,2,1
35376,8,23,5,0,18,5
35376,7,26,7,0,19,7
35376,6,71,26,0,45,26
35376,5,26,9,0,17,9
35376,4,15,6,0,9,6
35376,3,7,3,0,4,3
35376,2,3,2,0,1,2
35376,1,2,1,0,1,1
83196,10,3,2,0,1,2
83196,9,2,1,0,1,1
83196,8,20,2,0,18,2
83196,7,41,6,0,35,6
83196,6,60,5,0,55,5
83196,5,33,4,0,29,4
83196,4,16,2,0,14,2
230050,10,15,5,0,10,5
230050,9,38,9,2,29,7
230050,8,61,8,1,53,7
230050,7,39,5,1,34,4
230050,6,19,4,0,15,4
115976,9,8,1,0,7,1
115976,8,17,4,1,13,3
115976,7,51,10,1,41,9
115976,6,51,10,2,41,8
115976,5,31,3,0,28,3
115976,4,6,2,0,4,2
116877,10,6,1,0,5,1
116877,9,6,1,0,5,1
116877,8,26,3,0,23,3
116877,7,38,2,0,36,2
116877,6,64,8,0,56,8
116877,5,23,5,0,18,5
116877,3,5,4,0,1,4
116877,1,1,1,0,0,1
170344,8,29,2,0,27,2
170344,7,54,4,0,50,4
170344,6,47,6,0,41,6
170344,5,19,1,0,18,1
170344,4,18,2,0,16,2
362,10,2,2,0,0,2
362,9,2,1,0,1,1
362,8,10,4,0,6,4
362,7,33,9,0,24,9
362,6,65,20,0,45,20
362,5,41,10,0,31,10
362,4,15,9,0,6,9
362,3,4,3,0,1,3
362,1,3,1,0,2,1
181385,10,4,1,0,3,1
181385,9,7,1,0,6,1
181385,8,32,5,0,27,5
181385,7,43,6,0,37,6
181385,6,58,11,0,47,11
181385,5,15,1,0,14,1
181385,4,12,1,0,11,1
159446,10,5,3,0,2,3
159446,9,8,1,0,7,1
159446,8,51,10,0,41,10
159446,7,49,13,0,36,13
159446,6,39,7,0,32,7
159446,5,13,2,0,11,2
159446,4,7,1,0,6,1
205420,9,10,3,0,7,3
205420,8,32,5,0,27,5
205420,7,61,7,0,54,7
205420,6,44,3,0,41,3
205420,5,16,2,0,14,2
205420,4,6,1,0,5,1
205420,3,2,1,0,1,1
64583,9,2,1,0,1,1
64583,8,13,4,0,9,4
64583,7,44,16,0,28,16
64583,6,67,18,0,49,18
64583,5,30,9,0,21,9
64583,4,14,3,0,11,3
64583,3,4,1,0,3,1
21342,8,13,8,0,5,8
21342,7,34,10,0,24,10
21342,6,72,25,0,47,25
21342,5,30,9,0,21,9
21342,4,13,5,0,8,5
21342,3,6,3,0,3,3
21342,2,2,1,0,1,1
21342,1,2,1,0,1,1
10802,10,1,1,0,0,1
10802,9,4,1,0,3,1
10802,8,8,3,0,5,3
10802,7,27,8,0,19,8
10802,6,65,16,0,49,16
10802,5,33,7,0,26,7
10802,4,17,3,0,14,3
10802,3,9,4,0,5,4
10802,2,9,2,0,7,2
10802,1,2,1,0,1,1
106631,9,3,1,0,2,1
106631,8,22,4,0,18,4
106631,7,31,9,0,22,9
106631,6,59,14,0,45,14
106631,5,26,6,0,20,6
106631,4,17,4,0,13,4
106631,3,11,5,0,6,5
106631,2,4,2,0,2,2
36424,10,1,1,0,0,1
36424,9,7,3,0,4,3
36424,8,44,19,0,25,19
36424,7,58,12,0,46,12
36424,6,39,14,0,25,14
36424,5,17,8,0,9,8
36424,4,6,2,0,4,2
36424,3,3,1,0,2,1
40830,8,20,9,0,11,9
40830,7,34,9,0,25,9
40830,6,69,14,0,55,14
40830,5,29,7,0,22,7
40830,4,14,5,0,9,5
40830,3,5,1,0,4,1
2759,10,13,4,0,9,4
2759,9,19,11,0,8,11
2759,8,46,23,0,23,23
2759,7,43,12,0,31,12
2759,6,37,9,0,28,9
2759,5,9,2,0,7,2
2759,2,2,1,0,1,1
216357,10,5,1,0,4,1
216357,9,9,2,0,7,2
216357,8,30,9,1,21,8
216357,7,46,5,0,41,5
216357,6,42,10,3,32,7
216357,5,14,2,0,12,2
216357,4,16,5,0,11,5
216357,3,6,2,0,4,2
216357,2,7,3,0,4,3
16177,9,5,2,0,3,2
16177,8,36,12,0,24,12
16177,7,50,17,0,33,17
16177,6,55,14,0,41,14
16177,5,22,11,0,11,11
16177,4,4,3,0,1,3
4427,10,3,1,0,2,1
4427,8,11,2,0,9,2
4427,7,37,4,0,33,4
4427,6,57,5,0,52,5
4427,5,34,7,0,27,7
4427,4,19,6,0,13,6
4427,3,7,1,0,6,1
4427,2,4,2,0,2,2
17106,9,1,1,0,0,1
17106,8,7,5,0,2,5
17106,7,8,4,0,4,4
17106,6,34,12,0,22,12
17106,5,45,19,0,26,19
17106,4,40,23,0,17,23
17106,3,24,17,0,7,17
17106,2,11,2,0,9,2
17106,1,5,2,0,3,2
166436,10,3,1,0,2,1
166436,8,30,8,0,22,8
166436,7,46,5,0,41,5
166436,6,55,11,0,44,11
166436,5,22,3,0,19,3
166436,4,8,4,0,4,4
166436,3,8,1,0,7,1
1694,9,2,1,0,1,1
1694,8,22,11,0,11,11
1694,7,46,15,0,31,15
1694,6,61,16,0,45,16
1694,5,29,7,0,22,7
1694,4,8,2,0,6,2
2376,10,3,2,0,1,2
2376,9,8,2,0,6,2
2376,8,27,5,0,22,5
2376,7,44,14,0,30,14
2376,6,60,11,0,49,11
2376,5,17,7,0,10,7
2376,4,9,6,0,3,6
2376,3,5,3,0,2,3
2376,1,1,1,0,0,1
1398,8,11,2,0,9,2
1398,7,27,3,0,24,3
1398,6,43,7,0,36,7
1398,5,50,5,0,45,5
1398,4,27,4,0,23,4
1398,3,9,3,0,6,3
1398,2,6,3,0,3,3
1398,1,2,1,0,1,1
31159,8,12,1,0,11,1
31159,7,19,3,0,16,3
31159,6,68,7,0,61,7
31159,5,35,8,0,27,8
31159,4,25,4,0,21,4
31159,3,8,3,0,5,3
31159,2,6,3,0,3,3
166418,10,9,4,0,5,4
166418,9,11,3,1,8,2
166418,8,46,13,3,33,10
166418,7,47,12,3,35,9
166418,6,44,6,1,38,5
166418,5,7,2,0,5,2
166418,4,7,2,0,5,2
166418,3,3,1,0,2,1
99791,10,1,1,0,0,1
99791,9,7,5,0,2,5
99791,8,26,12,2,14,10
99791,7,31,6,0,25,6
99791,6,50,14,2,36,12
99791,5,24,11,2,13,9
99791,4,17,8,1,9,7
99791,3,13,2,0,11,2
99791,2,5,4,1,1,3
99791,1,1,1,0,0,1
7365,10,5,2,0,3,2
7365,9,7,2,0,5,2
7365,8,29,15,0,14,15
7365,7,47,12,0,35,12
7365,6,51,15,0,36,15
7365,5,20,3,0,17,3
7365,4,10,2,0,8,2
7365,3,6,4,0,2,4
104376,8,17,1,0,16,1
104376,7,27,7,0,20,7
104376,6,80,15,0,65,15
104376,5,25,7,0,18,7
104376,4,20,4,0,16,4
29352,10,1,1,0,0,1
29352,7,23,5,0,18,5
29352,6,72,8,0,64,8
29352,5,37,5,0,32,5
29352,4,16,2,0,14,2
29352,3,7,2,0,5,2
29352,2,6,1,0,5,1
111069,10,8,2,0,6,2
111069,9,12,3,0,9,3
111069,8,38,6,0,32,6
111069,7,39,8,0,31,8
111069,6,43,10,0,33,10
111069,5,16,7,0,9,7
111069,4,10,4,0,6,4
111069,3,7,4,0,3,4
111069,2,1,1,0,0,1
28843,10,7,2,0,5,2
28843,9,3,3,0,0,3
28843,8,17,7,0,10,7
28843,7,41,21,0,20,21
28843,6,50,25,0,25,25
28843,5,29,13,0,16,13
28843,4,12,4,0,8,4
28843,3,6,3,0,3,3
28843,2,4,2,0,2,2
28843,1,5,4,0,1,4
37732,8,8,3,0,5,3
37732,7,40,10,0,30,10
37732,6,62,16,0,46,16
37732,5,35,8,0,27,8
37732,4,15,3,0,12,3
37732,3,11,5,0,6,5
37732,2,3,1,0,2,1
6748,9,5,4,0,1,4
6748,8,17,9,0,8,9
6748,7,35,13,0,22,13
6748,6,48,22,0,26,22
6748,5,25,13,0,12,13
6748,4,27,11,0,16,11
6748,3,8,5,0,3,5
6748,2,5,3,0,2,3
6748,1,2,2,0,0,2
2401,10,6,1,0,5,1
2401,9,6,3,0,3,3
2401,8,13,2,0,11,2
2401,7,24,3,0,21,3
2401,6,50,9,0,41,9
2401,5,32,2,0,30,2
2401,4,23,7,0,16,7
2401,3,12,4,0,8,4
2401,2,6,2,0,4,2
76203,9,12,5,0,7,5
76203,8,40,9,0,31,9
76203,7,43,13,0,30,13
76203,6,53,13,0,40,13
76203,5,19,4,0,15,4
13266,10,13,3,0,10,3
13266,9,19,1,0,18,1
13266,8,61,19,0,42,19
13266,7,45,10,0,35,10
13266,6,22,9,0,13,9
13266,5,9,3,0,6,3
13266,4,4,1,0,3,1
134631,8,15,5,0,10,5
134631,7,37,8,0,29,8
134631,6,54,6,0,48,6
134631,5,35,7,0,28,7
134631,4,17,2,0,15,2
134631,3,7,4,0,3,4
134631,2,1,1,0,0,1
206802,9,6,2,0,4,2
206802,8,22,2,0,20,2
206802,7,36,7,0,29,7
206802,6,53,3,0,50,3
206802,5,27,4,0,23,4
206802,4,17,4,0,13,4
24511,10,5,2,0,3,2
24511,9,14,8,0,6,8
24511,8,32,13,0,19,13
24511,7,64,26,0,38,26
24511,6,40,17,0,23,17
24511,5,14,1,0,13,1
24511,4,5,2,0,3,2
69234,10,26,12,0,14,12
69234,9,46,11,0,35,11
69234,8,53,16,0,37,16
69234,7,22,4,0,18,4
69234,6,12,5,0,7,5
69234,5,5,1,0,4,1
69234,4,5,5,0,0,5
69234,3,2,2,0,0,2
69234,1,2,1,0,1,1
8916,9,3,1,0,2,1
8916,8,9,2,0,7,2
8916,7,13,4,0,9,4
8916,6,49,6,0,43,6
8916,5,36,6,0,30,6
8916,4,31,9,0,22,9
8916,3,15,4,0,11,4
8916,2,11,5,0,6,5
8916,1,5,2,0,3,2
146963,10,3,2,0,1,2
146963,9,11,5,0,6,5
146963,8,33,7,1,26,6
146963,7,51,13,1,38,12
146963,6,52,12,0,40,12
146963,5,17,6,0,11,6
148740,8,35,1,0,34,1
148740,7,56,6,0,50,6
148740,6,47,3,0,44,3
148740,5,18,1,0,17,1
148740,4,6,1,0,5,1
148740,2,3,2,0,1,2
148740,1,1,1,0,0,1
30179,9,5,2,0,3,2
30179,8,22,5,0,17,5
30179,7,49,15,0,34,15
30179,6,65,8,0,57,8
30179,5,22,4,0,18,4
30179,4,8,3,0,5,3
217423,9,10,5,0,5,5
217423,8,54,13,1,41,12
217423,7,57,12,2,45,10
217423,6,35,9,2,26,7
217423,5,11,1,0,10,1
217423,4,4,1,0,3,1
217423,2,1,1,0,0,1
10501,10,19,11,0,8,11
10501,9,33,10,0,23,10
10501,8,59,18,0,41,18
10501,7,41,11,0,30,11
10501,6,11,5,0,6,5
10501,5,6,2,0,4,2
10501,4,2,1,0,1,1
10501,3,2,1,0,1,1
10501,2,1,1,0,0,1
146943,10,6,4,0,2,4
146943,9,9,5,0,4,5
146943,8,47,12,0,35,12
146943,7,32,7,0,25,7
146943,6,44,9,0,35,9
146943,5,18,5,0,13,5
146943,4,12,5,0,7,5
146943,3,2,1,0,1,1
8915,8,8,1,0,7,1
8915,7,18,2,0,16,2
8915,6,50,14,0,36,14
8915,5,47,9,0,38,9
8915,4,23,5,0,18,5
8915,3,15,6,0,9,6
8915,2,8,2,0,6,2
8915,1,1,1,0,0,1
5960,10,2,1,0,1,1
5960,8,12,3,0,9,3
5960,7,15,7,0,8,7
5960,6,32,13,0,19,13
5960,5,30,9,0,21,9
5960,4,31,13,0,18,13
5960,3,22,8,0,14,8
5960,2,16,11,0,5,11
5960,1,11,8,0,3,8
241245,10,3,2,0,1,2
241245,9,8,2,0,6,2
241245,8,24,6,0,18,6
241245,7,30,12,0,18,12
241245,6,60,14,0,46,14
241245,5,20,1,0,19,1
241245,4,12,5,0,7,5
241245,3,10,2,0,8,2
87632,10,7,2,0,5,2
87632,9,7,1,0,6,1
87632,8,17,5,0,12,5
87632,7,39,11,0,28,11
87632,6,62,21,0,41,21
87632,5,29,7,0,22,7
87632,4,6,6,0,0,6
87632,3,4,2,0,2,2
3836,10,11,5,0,6,5
3836,9,13,3,0,10,3
3836,8,45,20,0,25,20
3836,7,42,12,0,30,12
3836,6,32,7,0,25,7
3836,5,20,4,0,16,4
3836,4,9,2,0,7,2
535,9,1,1,0,0,1
535,8,8,3,0,5,3
535,7,24,12,0,12,12
535,6,55,18,0,37,18
535,5,38,13,0,25,13
535,4,25,4,0,21,4
535,3,13,6,0,7,6
535,2,4,1,0,3,1
535,1,3,1,0,2,1
14860,10,6,3,0,3,3
14860,9,13,11,0,2,11
14860,8,67,38,0,29,38
14860,7,39,19,0,20,19
14860,6,33,23,0,10,23
14860,5,11,3,0,8,3
14860,4,4,2,0,2,2
35395,10,8,4,0,4,4
35395,9,12,4,0,8,4
35395,8,34,6,0,28,6
35395,7,36,6,0,30,6
35395,6,47,4,0,43,4
35395,5,18,3,0,15,3
35395,4,10,5,0,5,5
35395,2,1,1,0,0,1
35395,1,6,3,1,3,2
256802,8,41,9,0,32,9
256802,7,56,8,0,48,8
256802,6,43,11,0,32,11
256802,5,10,3,0,7,3
256802,4,7,1,0,6,1
256802,2,3,1,0,2,1
76684,10,2,1,0,1,1
76684,9,1,1,0,0,1
76684,8,13,2,0,11,2
76684,7,23,8,0,15,8
76684,6,53,9,0,44,9
76684,5,55,10,0,45,10
76684,4,17,2,0,15,2
76684,3,4,1,0,3,1
76684,2,4,3,0,1,3
128185,10,2,1,0,1,1
128185,9,1,1,0,0,1
128185,8,5,1,0,4,1
128185,7,18,4,0,14,4
128185,6,49,14,0,35,14
128185,5,36,9,0,27,9
128185,4,32,15,0,17,15
128185,3,18,7,0,11,7
128185,2,9,5,0,4,5
27266,10,22,11,0,11,11
27266,9,19,5,0,14,5
27266,8,43,6,0,37,6
27266,7,52,10,0,42,10
27266,6,27,7,0,20,7
27266,5,6,1,0,5,1
3262,8,27,12,0,15,12
3262,7,48,28,0,20,28
3262,6,77,26,0,51,26
3262,5,15,9,0,6,9
3262,4,4,1,0,3,1
3262,3,1,1,0,0,1
228390,10,18,9,0,9,9
228390,9,14,5,0,9,5
228390,8,33,6,0,27,6
228390,7,49,9,0,40,9
228390,6,40,5,0,35,5
228390,5,5,1,0,4,1
228390,4,9,1,0,8,1
8325,10,6,2,0,4,2
8325,9,22,10,0,12,10
8325,8,48,16,0,32,16
8325,7,51,14,0,37,14
8325,6,30,7,0,23,7
8325,5,10,1,0,9,1
8325,3,2,1,0,1,1
8325,1,2,1,0,1,1
241225,10,15,1,0,14,1
241225,9,19,3,0,16,3
241225,8,70,6,0,64,6
241225,7,43,3,0,40,3
241225,6,16,3,0,13,3
241225,5,7,2,0,5,2
241225,2,1,1,0,0,1
218957,10,4,1,0,3,1
218957,9,8,5,0,3,5
218957,8,23,5,0,18,5
218957,7,55,11,0,44,11
218957,6,51,9,0,42,9
218957,5,23,8,0,15,8
20543,8,10,3,0,7,3
20543,7,30,11,0,19,11
20543,6,73,16,0,57,16
20543,5,39,10,0,29,10
20543,4,12,2,0,10,2
20543,3,4,1,0,3,1
20543,2,4,1,0,3,1
4244,10,9,6,0,3,6
4244,9,21,8,0,13,8
4244,8,42,17,0,25,17
4244,7,41,12,0,29,12
4244,6,38,11,0,27,11
4244,5,10,7,0,3,7
4244,4,7,2,0,5,2
4244,3,2,1,0,1,1
4244,2,2,2,0,0,2
8892,10,3,2,0,1,2
8892,8,12,7,0,5,7
8892,7,28,5,0,23,5
8892,6,60,26,0,34,26
8892,5,34,15,0,19,15
8892,4,28,15,0,13,15
8892,3,5,3,0,2,3
8892,2,2,1,0,1,1
2206,8,8,4,0,4,4
2206,7,15,3,0,12,3
2206,6,49,16,0,33,16
2206,5,41,15,0,26,15
2206,4,33,10,0,23,10
2206,3,15,9,0,6,9
2206,2,7,2,0,5,2
2206,1,3,1,0,2,1
29626,10,1,1,0,0,1
29626,8,7,1,0,6,1
29626,7,22,4,0,18,4
29626,6,65,13,0,52,13
29626,5,42,5,0,37,5
29626,4,24,6,0,18,6
29626,2,5,1,0,4,1
199309,10,13,6,0,7,6
199309,9,20,2,1,18,1
199309,8,50,8,1,42,7
199309,7,42,9,0,33,9
199309,6,26,5,0,21,5
199309,5,11,1,0,10,1
199309,4,4,1,0,3,1
199309,3,4,3,0,1,3
199309,1,1,1,0,0,1
2665,10,6,3,0,3,3
2665,9,12,5,0,7,5
2665,8,42,15,0,27,15
2665,7,54,13,0,41,13
2665,6,36,8,0,28,8
2665,5,15,4,0,11,4
2665,4,5,1,0,4,1
2665,3,2,1,0,1,1
23671,10,9,3,0,6,3
23671,8,8,4,0,4,4
23671,7,33,2,0,31,2
23671,6,33,5,0,28,5
23671,5,38,11,0,27,11
23671,4,24,4,0,20,4
23671,3,14,2,0,12,2
23671,2,10,2,0,8,2
23671,1,3,1,0,2,1
124044,8,32,8,2,24,6
124044,7,48,11,0,37,11
124044,6,50,13,1,37,12
124044,5,21,5,1,16,4
124044,4,8,3,0,5,3
124044,3,7,4,0,3,4
124044,2,2,1,0,1,1
124044,1,2,1,0,1,1
4642,10,19,14,0,5,14
4642,9,18,7,0,11,7
4642,8,43,23,0,20,23
4642,7,31,10,0,21,10
4642,6,38,15,0,23,15
4642,5,11,5,0,6,5
4642,4,3,1,0,2,1
4642,3,6,3,0,3,3
4642,1,2,1,0,1,1
1428,8,6,2,0,4,2
1428,7,15,5,0,10,5
1428,6,42,12,0,30,12
1428,5,43,8,0,35,8
1428,4,34,11,0,23,11
1428,3,17,6,0,11,6
1428,2,12,3,0,9,3
7826,10,1,1,0,0,1
7826,8,8,2,0,6,2
7826,7,14,4,0,10,4
7826,6,50,10,0,40,10
7826,5,36,12,0,24,12
7826,4,27,10,0,17,10
7826,3,21,12,0,9,12
7826,2,11,4,0,7,4
7826,1,4,1,0,3,1
11002,10,2,2,0,0,2
11002,8,19,9,0,10,9
11002,7,34,11,0,23,11
11002,6,70,22,0,48,22
11002,5,34,13,0,21,13
11002,3,3,2,0,1,2
91668,10,1,1,0,0,1
91668,8,24,4,0,20,4
91668,7,44,5,0,39,5
91668,6,70,9,0,61,9
91668,5,18,3,0,15,3
91668,4,10,2,0,8,2
91668,3,2,1,0,1,1
194081,10,11,2,0,9,2
194081,9,15,2,0,13,2
194081,8,40,8,0,32,8
194081,7,49,5,0,44,5
194081,6,37,7,0,30,7
194081,5,12,2,0,10,2
194081,4,7,2,0,5,2
343,8,16,3,0,13,3
343,7,49,9,0,40,9
343,6,61,11,0,50,11
343,5,31,2,0,29,2
343,2,1,1,0,0,1
2190,10,1,1,0,0,1
2190,8,13,4,0,9,4
2190,7,20,5,0,15,5
2190,6,41,11,0,30,11
2190,5,48,15,0,33,15
2190,4,26,7,0,19,7
2190,3,14,5,0,9,5
2190,2,6,2,0,4,2
72285,10,3,3,0,0,3
72285,9,4,3,0,1,3
72285,8,46,15,0,31,15
72285,7,45,10,0,35,10
72285,6,49,15,0,34,15
72285,5,18,7,0,11,7
72285,4,4,2,0,2,2
72285,2,2,1,0,1,1
19732,10,3,2,0,1,2
19732,8,14,2,0,12,2
19732,7,29,9,0,20,9
19732,6,57,18,0,39,18
19732,5,29,8,0,21,8
19732,4,21,7,0,14,7
19732,3,10,5,0,5,5
19732,2,5,2,0,3,2
122701,9,6,2,0,4,2
122701,8,36,16,0,20,16
122701,7,40,12,0,28,12
122701,6,48,10,2,38,8
122701,5,22,7,0,15,7
122701,4,12,6,0,6,6
122701,3,4,1,0,3,1
122701,2,2,1,1,1,0
36649,9,3,1,0,2,1
36649,8,26,9,0,17,9
36649,7,30,4,0,26,4
36649,6,59,10,0,49,10
36649,5,21,2,0,19,2
36649,4,10,2,0,8,2
36649,3,10,4,0,6,4
36649,2,6,4,0,2,4
36649,1,5,3,0,2,3
40773,9,1,1,0,0,1
40773,7,45,10,0,35,10
40773,6,54,8,0,46,8
40773,5,29,10,0,19,10
40773,4,13,1,0,12,1
40773,3,7,2,0,5,2
40773,2,1,1,0,0,1
39802,8,10,3,0,7,3
39802,7,31,9,0,22,9
39802,6,72,31,0,41,31
39802,5,28,11,0,17,11
39802,4,25,6,0,19,6
39802,3,5,3,0,2,3
127839,10,7,2,1,5,1
127839,9,9,5,1,4,4
127839,8,36,8,0,28,8
127839,7,44,6,1,38,5
127839,6,43,8,1,35,7
127839,5,20,3,0,17,3
127839,2,3,1,0,2,1
88960,9,2,1,0,1,1
88960,8,23,11,0,12,11
88960,7,25,8,0,17,8
88960,6,48,15,0,33,15
88960,5,39,6,0,33,6
88960,4,20,9,0,11,9
88960,3,7,2,0,5,2
88960,2,7,3,0,4,3
35247,9,4,1,0,3,1
35247,7,34,3,0,31,3
35247,6,50,3,0,47,3
35247,5,36,2,0,34,2
35247,4,21,2,0,19,2
35247,3,11,2,0,9,2
35247,2,4,1,0,3,1
1580,10,1,1,0,0,1
1580,9,1,1,0,0,1
1580,8,13,2,0,11,2
1580,7,32,12,0,20,12
1580,6,49,15,0,34,15
1580,5,38,11,0,27,11
1580,4,26,8,0,18,8
1580,3,9,5,0,4,5
1580,2,2,2,0,0,2
1580,1,1,1,0,0,1
6787,7,4,1,0,3,1
6787,6,28,1,0,27,1
6787,5,46,8,0,38,8
6787,4,40,4,0,36,4
6787,3,32,6,0,26,6
6787,2,14,2,0,12,2
6787,1,3,1,0,2,1
3251,10,2,1,0,1,1
3251,9,1,1,0,0,1
3251,8,20,5,0,15,5
3251,7,34,12,0,22,12
3251,6,56,14,0,42,14
3251,5,37,13,0,24,13
3251,4,14,3,0,11,3
3251,3,4,3,0,1,3
3251,1,3,3,0,0,3
2610,9,7,3,0,4,3
2610,8,37,11,0,26,11
2610,7,62,17,0,45,17
2610,6,50,19,0,31,19
2610,5,13,3,0,10,3
2610,3,2,1,0,1,1
77011,10,3,1,0,2,1
77011,9,3,1,0,2,1
77011,8,48,13,0,35,13
77011,7,55,11,1,44,10
77011,6,39,8,0,31,8
77011,5,13,3,0,10,3
77011,4,5,2,0,3,2
77011,3,4,1,0,3,1
77011,2,2,1,0,1,1
186,10,1,1,0,0,1
186,8,12,5,0,7,5
186,7,25,6,0,19,6
186,6,74,20,0,54,20
186,5,35,5,0,30,5
186,4,12,4,0,8,4
186,3,3,2,0,1,2
186,1,4,3,0,1,3
220598,10,4,2,0,2,2
220598,9,12,3,0,9,3
220598,8,60,15,1,45,14
220598,7,39,6,0,33,6
220598,6,32,6,0,26,6
220598,5,14,4,0,10,4
220598,4,3,1,0,2,1
220598,3,5,2,0,3,2
220598,2,3,2,0,1,2
4236,10,4,1,0,3,1
4236,9,4,2,0,2,2
4236,8,22,9,0,13,9
4236,7,39,12,0,27,12
4236,6,43,17,0,26,17
4236,5,39,11,0,28,11
4236,4,14,5,0,9,5
4236,3,4,2,0,2,2
4236,2,1,1,0,0,1
4236,1,1,1,0,0,1
4228,10,7,3,0,4,3
4228,9,9,4,0,5,4
4228,8,29,14,0,15,14
4228,7,58,24,0,34,24
4228,6,43,11,0,32,11
4228,5,17,3,0,14,3
4228,4,5,1,0,4,1
4228,3,2,2,0,0,2
246938,10,3,1,0,2,1
246938,9,3,1,0,2,1
246938,8,18,2,0,16,2
246938,7,54,13,0,41,13
246938,6,62,7,0,55,7
246938,5,16,2,0,14,2
246938,4,13,1,0,12,1
246938,1,1,1,0,0,1
16142,9,4,1,0,3,1
16142,8,22,14,0,8,14
16142,7,35,13,0,22,13
16142,6,60,17,0,43,17
16142,5,30,12,0,18,12
16142,4,14,6,0,8,6
16142,3,3,2,0,1,2
11886,10,4,2,0,2,2
11886,9,18,7,0,11,7
11886,8,45,18,0,27,18
11886,7,56,18,0,38,18
11886,6,28,13,0,15,13
11886,5,18,9,0,9,9
11886,4,2,2,0,0,2
32678,10,2,1,0,1,1
32678,8,7,2,0,5,2
32678,7,23,2,0,21,2
32678,6,55,12,0,43,12
32678,5,41,7,0,34,7
32678,4,15,5,0,10,5
32678,3,11,3,0,8,3
32678,2,11,2,0,9,2
32678,1,4,3,0,1,3
6810,10,5,3,0,2,3
6810,8,18,2,0,16,2
6810,7,20,4,0,16,4
6810,6,58,14,0,44,14
6810,5,34,7,0,27,7
6810,4,16,6,0,10,6
6810,3,12,1,0,11,1
6810,2,4,3,0,1,3
232078,10,6,1,0,5,1
232078,9,8,2,0,6,2
232078,8,29,4,0,25,4
232078,7,34,4,0,30,4
232078,6,53,10,0,43,10
232078,5,19,2,0,17,2
232078,4,7,1,0,6,1
232078,3,9,2,0,7,2
232078,2,5,2,0,3,2
232078,1,1,1,0,0,1
2072,10,12,2,0,10,2
2072,9,19,9,0,10,9
2072,8,39,17,0,22,17
2072,7,58,21,0,37,21
2072,6,23,8,0,15,8
2072,5,12,3,0,9,3
2072,4,3,1,0,2,1
2072,3,4,3,0,1,3
181956,9,3,1,0,2,1
181956,8,17,4,0,13,4
181956,7,46,10,0,36,10
181956,6,68,11,0,57,11
181956,5,24,5,0,19,5
181956,4,9,2,0,7,2
181956,3,2,1,0,1,1
89976,10,2,1,0,1,1
89976,8,10,4,0,6,4
89976,7,21,5,0,16,5
89976,6,56,10,0,46,10
89976,5,39,9,0,30,9
89976,4,22,6,0,16,6
89976,3,11,1,0,10,1
89976,2,5,1,0,4,1
24996,10,11,5,0,6,5
24996,9,14,9,0,5,9
24996,8,20,9,0,11,9
24996,7,43,16,0,27,16
24996,6,36,9,0,27,9
24996,5,29,6,0,23,6
24996,4,7,4,0,3,4
24996,3,5,2,0,3,2
24996,2,1,1,0,0,1
24996,1,5,5,0,0,5
246701,9,2,1,0,1,1
246701,8,9,1,0,8,1
246701,7,25,4,0,21,4
246701,6,48,6,0,42,6
246701,5,31,4,0,27,4
246701,4,28,6,0,22,6
246701,3,18,5,0,13,5
246701,2,5,1,0,4,1
246701,1,3,1,0,2,1
19329,9,4,1,0,3,1
19329,8,21,10,0,11,10
19329,7,39,12,0,27,12
19329,6,47,28,0,19,28
19329,5,33,13,0,20,13
19329,4,15,9,0,6,9
19329,3,4,2,0,2,2
19329,2,5,3,0,2,3
7089,10,3,1,0,2,1
7089,9,12,5,0,7,5
7089,8,43,16,0,27,16
7089,7,38,8,0,30,8
7089,6,35,9,0,26,9
7089,5,11,3,0,8,3
7089,4,8,3,0,5,3
7089,3,5,4,0,1,4
7089,2,3,1,0,2,1
7089,1,13,6,0,7,6
182352,10,13,4,0,9,4
182352,9,10,2,0,8,2
182352,8,66,10,0,56,10
182352,7,44,4,0,40,4
182352,6,26,7,0,19,7
182352,5,8,2,0,6,2
5953,8,14,6,0,8,6
5953,7,45,21,0,24,21
5953,6,70,20,0,50,20
5953,5,25,7,0,18,7
5953,4,6,2,0,4,2
5953,3,7,3,0,4,3
124290,8,10,3,0,7,3
124290,7,39,11,0,28,11
124290,6,68,17,0,51,17
124290,5,30,4,0,26,4
124290,4,15,4,0,11,4
1329,10,8,4,0,4,4
1329,9,10,4,0,6,4
1329,8,30,10,0,20,10
1329,7,52,14,0,38,14
1329,6,46,17,0,29,17
1329,5,13,1,0,12,1
1329,4,9,3,0,6,3
4780,8,14,6,0,8,6
4780,7,33,10,0,23,10
4780,6,63,11,0,52,11
4780,5,29,6,0,23,6
4780,4,13,3,0,10,3
4780,2,3,2,0,1,2
4780,1,2,1,0,1,1
254976,10,2,1,0,1,1
254976,9,11,3,0,8,3
254976,8,40,10,0,30,10
254976,7,59,14,2,45,12
254976,6,37,6,0,31,6
254976,5,12,1,0,11,1
254976,4,7,1,0,6,1
254976,3,2,1,0,1,1
7109,10,7,1,0,6,1
7109,9,13,4,0,9,4
7109,8,37,15,0,22,15
7109,7,44,16,0,28,16
7109,6,40,8,0,32,8
7109,5,22,10,0,12,10
8784,9,2,1,0,1,1
8784,7,10,2,0,8,2
8784,6,33,7,0,26,7
8784,5,45,13,0,32,13
8784,4,30,9,0,21,9
8784,3,27,17,0,10,17
8784,2,9,5,0,4,5
8784,1,12,3,0,9,3
202254,8,13,1,0,12,1
202254,7,27,8,0,19,8
202254,6,36,3,0,33,3
202254,5,32,7,1,25,6
202254,4,22,6,1,16,5
202254,3,20,7,0,13,7
202254,2,14,7,1,7,6
202254,1,6,1,0,5,1
23375,9,4,1,0,3,1
23375,8,26,11,0,15,11
23375,7,38,14,0,24,14
23375,6,56,18,0,38,18
23375,5,28,6,0,22,6
23375,4,6,3,0,3,3
23375,3,4,4,0,0,4
23375,2,3,2,0,1,2
23375,1,2,1,0,1,1
173075,10,4,1,1,3,0
173075,9,2,1,0,1,1
173075,8,12,4,0,8,4
173075,7,18,4,1,14,3
173075,6,58,10,2,48,8
173075,5,33,3,0,30,3
173075,4,19,4,0,15,4
173075,3,9,2,0,7,2
173075,2,6,3,0,3,3
173075,1,9,3,0,6,3
23550,10,7,4,0,3,4
23550,9,5,2,0,3,2
23550,8,16,6,0,10,6
23550,7,26,4,0,22,4
23550,6,69,29,0,40,29
23550,5,19,9,0,10,9
23550,4,21,10,0,11,10
23550,3,6,2,0,4,2
6504,10,3,2,0,1,2
6504,9,7,2,0,5,2
6504,8,25,6,0,19,6
6504,7,55,13,0,42,13
6504,6,46,7,0,39,7
6504,5,24,5,0,19,5
6504,4,7,3,0,4,3
6504,3,3,2,0,1,2
252693,10,8,1,0,7,1
252693,9,24,5,0,19,5
252693,8,65,7,0,58,7
252693,7,40,6,0,34,6
252693,6,22,3,0,19,3
252693,4,5,3,0,2,3
252693,2,2,1,0,1,1
155633,10,4,1,0,3,1
155633,9,3,1,0,2,1
155633,8,25,7,0,18,7
155633,7,45,9,0,36,9
155633,6,62,10,0,52,10
155633,5,15,3,0,12,3
155633,4,12,3,0,9,3
127275,10,3,1,0,2,1
127275,9,7,3,0,4,3
127275,8,36,8,0,28,8
127275,7,39,5,0,34,5
127275,6,57,11,0,46,11
127275,5,20,5,0,15,5
127275,4,4,1,0,3,1
132188,8,12,3,0,9,3
132188,7,35,9,0,26,9
132188,6,59,17,0,42,17
132188,5,22,2,0,20,2
132188,4,20,6,0,14,6
132188,3,11,1,0,10,1
132188,2,2,1,0,1,1
181236,9,9,2,0,7,2
181236,8,36,8,0,28,8
181236,7,55,10,0,45,10
181236,6,39,5,0,34,5
181236,5,16,4,0,12,4
181236,4,5,2,0,3,2
181236,3,6,1,0,5,1
181236,1,1,1,0,0,1
24387,10,2,1,0,1,1
24387,9,4,1,0,3,1
24387,8,15,4,0,11,4
24387,7,23,5,0,18,5
24387,6,63,14,0,49,14
24387,5,25,6,0,19,6
24387,4,20,10,0,10,10
24387,3,7,3,0,4,3
24387,2,9,5,0,4,5
10226,10,14,4,0,10,4
10226,9,35,15,0,20,15
10226,8,53,18,0,35,18
10226,7,35,9,0,26,9
10226,6,23,4,0,19,4
10226,5,7,1,0,6,1
10226,3,1,1,0,0,1
2216,9,4,1,0,3,1
2216,8,21,6,0,15,6
2216,7,42,15,0,27,15
2216,6,55,17,0,38,17
2216,5,22,8,0,14,8
2216,4,17,10,0,7,10
2216,3,5,1,0,4,1
2216,2,1,1,0,0,1
182050,10,3,1,0,2,1
182050,9,4,1,0,3,1
182050,8,34,7,4,27,3
182050,7,45,6,0,39,6
182050,6,52,12,0,40,12
182050,4,8,1,0,7,1
182050,3,7,1,0,6,1
182050,2,6,4,0,2,4
145205,9,16,1,0,15,1
145205,8,54,8,0,46,8
145205,7,47,4,0,43,4
145205,6,30,9,0,21,9
145205,5,10,4,0,6,4
145205,4,8,3,0,5,3
145205,3,1,1,0,0,1
145205,2,1,1,0,0,1
41032,10,3,2,0,1,2
41032,8,23,8,0,15,8
41032,7,42,16,0,26,16
41032,6,54,23,0,31,23
41032,5,17,3,0,14,3
41032,4,13,6,0,7,6
41032,3,10,6,0,4,6
41032,2,4,2,0,2,2
18057,8,36,4,0,32,4
18057,7,59,7,0,52,7
18057,6,46,4,0,42,4
18057,5,11,2,0,9,2
18057,4,3,1,0,2,1
18057,3,3,2,0,1,2
86167,10,9,5,0,4,5
86167,9,14,5,0,9,5
86167,8,51,11,0,40,11
86167,7,49,9,0,40,9
86167,6,21,5,0,16,5
86167,4,8,3,0,5,3
86167,3,1,1,0,0,1
86167,2,1,1,0,0,1
86167,1,6,1,0,5,1
232417,9,6,1,0,5,1
232417,8,25,3,0,22,3
232417,7,58,9,0,49,9
232417,6,43,7,0,36,7
232417,5,23,7,0,16,7
232417,4,11,3,0,8,3
12355,10,16,9,0,7,9
12355,9,26,8,0,18,8
12355,8,57,17,0,40,17
12355,7,43,13,0,30,13
12355,6,17,3,0,14,3
12355,5,8,2,0,6,2
12355,3,2,2,0,0,2
42112,10,7,2,0,5,2
42112,9,18,3,0,15,3
42112,8,44,13,0,31,13
42112,7,33,6,0,27,6
42112,6,33,15,0,18,15
42112,5,18,6,0,12,6
42112,4,7,4,0,3,4
42112,3,7,3,0,4,3
42112,1,2,1,0,1,1
57037,9,6,2,0,4,2
57037,7,35,10,0,25,10
57037,6,61,16,0,45,16
57037,5,19,2,0,17,2
57037,4,13,3,0,10,3
57037,3,9,2,0,7,2
57037,2,1,1,0,0,1
57037,1,1,1,0,0,1
150294,10,3,1,0,2,1
150294,9,14,2,0,12,2
150294,8,47,19,2,28,17
150294,7,47,9,0,38,9
150294,6,49,16,0,33,16
150294,5,9,3,0,6,3
150294,4,1,1,0,0,1
154778,9,1,1,0,0,1
154778,8,14,1,0,13,1
154778,7,37,5,0,32,5
154778,6,59,7,1,52,6
154778,5,26,6,0,20,6
154778,4,18,5,0,13,5
154778,3,7,3,0,4,3
16805,10,12,5,0,7,5
16805,9,15,7,0,8,7
16805,8,67,19,0,48,19
16805,7,29,4,0,25,4
16805,6,30,9,0,21,9
16805,5,11,1,0,10,1
16805,4,3,1,0,2,1
16805,1,2,1,0,1,1
46410,10,1,1,0,0,1
46410,9,5,1,0,4,1
46410,8,32,11,0,21,11
46410,7,48,13,0,35,13
46410,6,55,12,0,43,12
46410,5,13,1,0,12,1
46410,4,9,3,0,6,3
46410,3,5,2,0,3,2
6946,10,5,2,0,3,2
6946,9,8,2,0,6,2
6946,8,15,6,0,9,6
6946,7,37,10,0,27,10
6946,6,55,19,0,36,19
6946,5,28,7,0,21,7
6946,4,10,5,0,5,5
6946,3,3,1,0,2,1
6946,2,6,2,0,4,2
6946,1,2,2,0,0,2
126274,10,9,2,0,7,2
126274,9,6,2,0,4,2
126274,8,31,3,0,28,3
126274,7,40,6,0,34,6
126274,6,50,8,0,42,8
126274,4,10,2,0,8,2
126274,3,3,1,0,2,1
153120,10,9,3,1,6,2
153120,9,3,2,0,1,2
153120,8,23,7,2,16,5
153120,7,31,5,1,26,4
153120,6,43,8,0,35,8
153120,5,24,6,0,18,6
153120,4,17,4,1,13,3
153120,3,6,2,0,4,2
153120,2,8,3,0,5,3
153120,1,5,3,0,2,3
19115,9,3,2,0,1,2
19115,8,7,4,0,3,4
19115,7,19,7,0,12,7
19115,6,57,16,0,41,16
19115,5,43,12,0,31,12
19115,4,25,9,0,16,9
19115,3,11,4,0,7,4
19115,2,3,1,0,2,1
69602,8,19,1,0,18,1
69602,7,27,4,0,23,4
69602,6,48,6,0,42,6
69602,5,38,5,0,33,5
69602,4,18,2,0,16,2
69602,3,7,1,0,6,1
1110,8,9,1,0,8,1
1110,7,28,10,0,18,10
1110,6,73,21,0,52,21
1110,5,39,8,0,31,8
1110,4,14,5,0,9,5
1110,3,3,2,0,1,2
1110,2,3,1,0,2,1
145027,8,14,1,0,13,1
145027,7,39,3,0,36,3
145027,6,61,1,0,60,1
145027,5,30,3,0,27,3
145027,4,19,3,0,16,3
145027,3,2,1,0,1,1
145027,2,3,2,0,1,2
866,10,2,1,0,1,1
866,9,1,1,0,0,1
866,8,10,5,0,5,5
866,7,19,5,0,14,5
866,6,47,16,0,31,16
866,5,43,10,0,33,10
866,4,20,6,0,14,6
866,3,21,9,0,12,9
866,2,4,4,0,0,4
866,1,2,1,0,1,1
142988,10,4,3,2,1,1
142988,9,6,3,0,3,3
142988,8,29,10,5,19,5
142988,7,39,4,0,35,4
142988,6,44,10,2,34,8
142988,5,21,6,2,15,4
142988,4,13,5,1,8,4
142988,3,7,5,2,2,3
142988,2,5,3,1,2,2
142988,1,1,1,0,0,1
15911,9,5,2,0,3,2
15911,8,26,7,0,19,7
15911,7,39,8,0,31,8
15911,6,56,7,0,49,7
15911,5,29,10,0,19,10
15911,4,8,3,0,5,3
15911,3,5,2,0,3,2
67601,10,25,7,0,18,7
67601,9,53,14,0,39,14
67601,8,57,15,0,42,15
67601,7,19,5,0,14,5
67601,6,10,1,0,9,1
67601,4,4,2,0,2,2
88464,9,9,3,0,6,3
88464,8,27,4,0,23,4
88464,7,42,7,0,35,7
88464,6,51,10,0,41,10
88464,5,22,7,0,15,7
88464,4,9,4,0,5,4
88464,3,5,1,0,4,1
32164,10,1,1,0,0,1
32164,8,8,2,0,6,2
32164,7,18,2,0,16,2
32164,6,74,15,0,59,15
32164,5,38,7,0,31,7
32164,4,17,5,0,12,5
32164,3,7,3,0,4,3
249670,10,2,2,0,0,2
249670,9,6,1,0,5,1
249670,8,29,2,0,27,2
249670,7,55,8,0,47,8
249670,6,49,12,0,37,12
249670,5,18,5,0,13,5
249670,4,9,5,0,4,5
249670,2,1,1,0,0,1
26522,10,3,1,0,2,1
26522,9,3,2,0,1,2
26522,8,8,2,0,6,2
26522,7,24,4,0,20,4
26522,6,51,15,0,36,15
26522,5,34,12,0,22,12
26522,4,24,9,0,15,9
26522,3,9,5,0,4,5
26522,2,9,3,0,6,3
26522,1,4,2,0,2,2
197285,9,11,2,0,9,2
197285,8,32,4,0,28,4
197285,7,52,4,0,48,4
197285,6,42,6,0,36,6
197285,5,14,2,0,12,2
197285,4,8,1,0,7,1
197285,3,7,3,0,4,3
197285,1,1,1,0,0,1
46747,10,4,1,0,3,1
46747,6,29,7,0,22,7
46747,5,56,12,0,44,12
46747,4,44,13,0,31,13
46747,3,21,10,0,11,10
46747,2,8,4,0,4,4
46747,1,3,1,0,2,1
134637,10,11,2,0,9,2
134637,9,11,2,0,9,2
134637,8,36,10,0,26,10
134637,7,45,7,0,38,7
134637,6,34,7,1,27,6
134637,5,20,5,0,15,5
134637,4,5,1,0,4,1
2538,10,4,1,0,3,1
2538,9,6,1,0,5,1
2538,8,27,7,0,20,7
2538,7,45,12,0,33,12
2538,6,45,8,0,37,8
2538,5,25,5,0,20,5
2538,4,7,4,0,3,4
2538,2,4,2,0,2,2
5736,10,4,2,0,2,2
5736,8,19,2,0,17,2
5736,7,32,7,0,25,7
5736,6,68,27,0,41,27
5736,5,29,6,0,23,6
5736,4,9,3,0,6,3
5736,3,3,3,0,0,3
5736,2,1,1,0,0,1
152767,9,3,1,0,2,1
152767,8,21,6,1,15,5
152767,7,29,3,2,26,1
152767,6,71,10,1,61,9
152767,5,24,6,0,18,6
152767,4,13,4,1,9,3
152767,3,3,1,0,2,1
20005,8,4,2,0,2,2
20005,7,18,1,0,17,1
20005,6,63,23,0,40,23
20005,5,30,13,0,17,13
20005,4,34,9,0,25,9
20005,3,14,6,0,8,6
20005,2,4,1,0,3,1
20005,1,2,2,0,0,2
256918,10,5,2,0,3,2
256918,9,15,2,0,13,2
256918,8,50,7,0,43,7
256918,7,48,4,0,44,4
256918,6,33,2,0,31,2
256918,5,11,2,0,9,2
256918,4,5,2,0,3,2
256918,3,1,1,0,0,1
5157,10,7,2,0,5,2
5157,9,10,6,0,4,6
5157,8,21,4,0,17,4
5157,7,41,9,0,32,9
5157,6,55,16,0,39,16
5157,5,23,9,0,14,9
5157,4,5,1,0,4,1
5157,3,5,1,0,4,1
5157,2,1,1,0,0,1
4402,8,5,3,0,2,3
4402,7,23,3,0,20,3
4402,6,71,20,0,51,20
4402,5,43,14,0,29,14
4402,4,17,4,0,13,4
4402,3,7,4,0,3,4
4402,2,1,1,0,0,1
179385,10,1,1,0,0,1
179385,8,28,8,0,20,8
179385,7,50,13,0,37,13
179385,6,53,14,0,39,14
179385,5,16,7,0,9,7
3663,10,5,1,0,4,1
3663,9,9,3,0,6,3
3663,8,29,12,0,17,12
3663,7,37,10,0,27,10
3663,6,55,15,0,40,15
3663,5,14,6,0,8,6
3663,4,11,2,0,9,2
3663,3,5,3,0,2,3
3663,2,2,1,0,1,1
3600,10,7,3,0,4,3
3600,9,9,3,0,6,3
3600,8,29,9,0,20,9
3600,7,43,7,0,36,7
3600,6,48,14,0,34,14
3600,5,23,9,0,14,9
3600,3,4,3,0,1,3
6824,8,13,3,0,10,3
6824,7,34,9,0,25,9
6824,6,57,7,0,50,7
6824,5,22,6,0,16,6
6824,4,19,3,0,16,3
6824,3,10,3,0,7,3
6824,2,9,4,0,5,4
6824,1,1,1,0,0,1
245240,10,70,60,2,10,58
245240,9,36,26,0,10,26
245240,8,38,33,0,5,33
245240,7,12,8,0,4,8
245240,6,4,1,0,3,1
245240,5,3,1,0,2,1
245240,4,2,2,0,0,2
245240,3,3,1,0,2,1
159452,10,4,3,0,1,3
159452,8,19,2,0,17,2
159452,7,17,3,0,14,3
159452,6,57,10,0,47,10
159452,5,26,3,0,23,3
159452,4,17,3,0,14,3
159452,3,9,2,0,7,2
159452,2,10,3,0,7,3
159452,1,5,2,0,3,2
250754,9,16,2,0,14,2
250754,8,58,9,0,49,9
250754,7,45,12,0,33,12
250754,6,33,9,0,24,9
250754,5,6,2,0,4,2
250754,4,3,1,0,2,1
250754,3,2,1,0,1,1
46744,7,11,3,0,8,3
46744,6,36,9,0,27,9
46744,5,51,11,0,40,11
46744,4,35,10,0,25,10
46744,3,22,8,0,14,8
46744,2,10,3,0,7,3
46744,1,1,1,0,0,1
2600,8,10,3,0,7,3
2600,7,37,12,0,25,12
2600,6,67,17,0,50,17
2600,5,27,8,0,19,8
2600,4,21,12,0,9,12
2600,3,5,2,0,3,2
2600,2,1,1,0,0,1
5966,9,2,1,0,1,1
5966,8,11,3,0,8,3
5966,7,27,5,0,22,5
5966,6,56,8,0,48,8
5966,5,33,8,0,25,8
5966,4,20,5,0,15,5
5966,2,6,3,0,3,3
5966,1,4,1,0,3,1
31410,8,22,6,0,16,6
31410,7,50,14,0,36,14
31410,6,53,12,0,41,12
31410,5,27,8,0,19,8
31410,4,13,6,0,7,6
138338,9,7,1,0,6,1
138338,8,51,22,1,29,21
138338,7,46,14,1,32,13
138338,6,38,11,0,27,11
138338,5,13,5,0,8,5
138338,4,7,4,0,3,4
138338,3,3,2,0,1,2
18824,10,20,6,0,14,6
18824,9,12,4,0,8,4
18824,8,26,8,0,18,8
18824,7,28,10,0,18,10
18824,6,46,19,0,27,19
18824,5,21,7,0,14,7
18824,3,7,3,0,4,3
18824,2,1,1,0,0,1
182487,10,3,1,0,2,1
182487,9,5,2,1,3,1
182487,8,22,7,2,15,5
182487,7,32,10,1,22,9
182487,6,58,6,1,52,5
182487,5,26,3,0,23,3
182487,4,12,2,0,10,2
182487,2,4,3,0,1,3
20096,9,5,1,0,4,1
20096,8,8,1,0,7,1
20096,7,25,5,0,20,5
20096,6,51,9,0,42,9
20096,5,29,7,0,22,7
20096,4,31,6,0,25,6
20096,3,10,2,0,8,2
20096,2,6,3,0,3,3
31547,10,2,1,0,1,1
31547,8,20,3,0,17,3
31547,7,33,1,0,32,1
31547,6,53,6,0,47,6
31547,5,32,5,0,27,5
31547,4,13,4,0,9,4
219276,10,7,3,0,4,3
219276,9,17,6,0,11,6
219276,8,51,8,0,43,8
219276,7,52,10,0,42,10
219276,6,24,4,0,20,4
219276,5,9,2,0,7,2
219276,2,2,1,0,1,1
219276,1,1,1,0,0,1
2388,8,24,7,0,17,7
2388,7,43,15,0,28,15
2388,6,50,12,0,38,12
2388,5,29,4,0,25,4
2388,4,9,3,0,6,3
2388,3,2,1,0,1,1
2388,2,2,1,0,1,1
4127,8,1,1,0,0,1
4127,7,3,1,0,2,1
4127,6,23,7,0,16,7
4127,5,32,6,0,26,6
4127,4,34,6,0,28,6
4127,3,19,4,0,15,4
4127,2,31,15,0,16,15
4127,1,24,8,0,16,8
218025,9,8,2,0,6,2
218025,8,40,11,1,29,10
218025,7,59,17,3,42,14
218025,6,46,9,0,37,9
218025,5,9,1,0,8,1
20821,9,5,1,0,4,1
20821,8,21,8,0,13,8
20821,7,49,16,0,33,16
20821,6,53,14,0,39,14
20821,5,20,10,0,10,10
20821,4,15,8,0,7,8
20821,2,2,1,0,1,1
6555,10,4,1,0,3,1
6555,9,10,6,0,4,6
6555,8,34,13,0,21,13
6555,7,31,12,0,19,12
6555,6,51,19,0,32,19
6555,5,20,8,0,12,8
6555,4,15,5,0,10,5
6555,3,2,1,0,1,1
209696,10,26,11,0,15,11
209696,9,22,4,1,18,3
209696,8,56,11,0,45,11
209696,7,40,7,3,33,4
209696,5,11,2,0,9,2
209696,4,1,1,0,0,1
209696,3,4,3,0,1,3
8374,9,4,2,0,2,2
8374,8,7,4,0,3,4
8374,7,20,6,0,14,6
8374,6,45,13,0,32,13
8374,5,39,8,0,31,8
8374,4,19,6,0,13,6
8374,3,17,5,0,12,5
8374,2,5,3,0,2,3
253344,10,74,30,1,44,29
253344,9,13,3,0,10,3
253344,8,4,1,0,3,1
253344,7,5,1,0,4,1
253344,6,4,1,0,3,1
253344,5,5,1,1,4,0
253344,4,1,1,0,0,1
253344,3,3,2,0,1,2
253344,1,54,32,5,22,27
3843,10,3,1,0,2,1
3843,9,9,3,0,6,3
3843,8,23,10,0,13,10
3843,7,24,7,0,17,7
3843,6,53,22,0,31,22
3843,5,24,8,0,16,8
3843,4,20,6,0,14,6
3843,3,9,2,0,7,2
3843,2,2,1,0,1,1
262388,8,24,1,0,23,1
262388,7,50,5,0,45,5
262388,6,62,11,0,51,11
262388,5,18,2,0,16,2
262388,3,3,1,0,2,1
38694,9,3,2,0,1,2
38694,8,19,7,0,12,7
38694,7,21,7,0,14,7
38694,6,41,11,0,30,11
38694,5,27,5,0,22,5
38694,4,26,12,0,14,12
38694,3,16,6,0,10,6
38694,2,6,5,0,1,5
38694,1,7,4,0,3,4
4852,9,3,1,0,2,1
4852,8,9,2,0,7,2
4852,7,14,5,0,9,5
4852,6,47,23,0,24,23
4852,5,35,8,0,27,8
4852,4,20,6,0,14,6
4852,3,18,7,0,11,7
4852,2,6,2,0,4,2
4852,1,9,7,0,2,7
5482,10,7,3,0,4,3
5482,9,8,2,0,6,2
5482,8,29,8,0,21,8
5482,7,41,13,0,28,13
5482,6,52,16,0,36,16
5482,5,24,8,0,16,8
5482,3,4,1,0,3,1
5482,1,1,1,0,0,1
92363,10,20,13,0,7,13
92363,9,26,10,0,16,10
92363,8,70,25,0,45,25
92363,7,25,10,0,15,10
92363,6,19,9,0,10,9
92363,5,2,1,0,1,1
92363,4,4,4,0,0,4
131616,9,4,1,0,3,1
131616,8,18,4,0,14,4
131616,7,38,6,0,32,6
131616,6,56,9,0,47,9
131616,5,24,6,0,18,6
131616,4,7,1,0,6,1
131616,2,3,1,0,2,1
164110,8,33,4,0,29,4
164110,7,47,5,0,42,5
164110,6,43,6,0,37,6
164110,5,21,1,0,20,1
164110,3,4,1,0,3,1
164110,2,3,2,0,1,2
23878,10,4,3,0,1,3
23878,9,11,2,0,9,2
23878,8,27,10,0,17,10
23878,7,34,9,0,25,9
23878,6,62,21,0,41,21
23878,5,12,4,0,8,4
23878,4,8,1,0,7,1
23878,1,4,1,0,3,1
65521,9,4,2,0,2,2
65521,8,24,5,0,19,5
65521,7,35,5,0,30,5
65521,6,40,14,0,26,14
65521,5,36,11,0,25,11
65521,4,14,3,0,11,3
65521,3,8,3,0,5,3
65521,2,4,1,0,3,1
82449,10,2,1,0,1,1
82449,8,7,2,0,5,2
82449,7,23,7,0,16,7
82449,6,62,17,0,45,17
82449,5,32,8,0,24,8
82449,4,19,9,0,10,9
82449,3,13,2,0,11,2
82449,1,3,3,0,0,3
248949,10,93,12,0,81,12
248949,9,48,8,0,40,8
248949,8,20,2,0,18,2
248949,7,6,1,0,5,1
248949,5,2,1,0,1,1
248949,1,3,2,0,1,2
26205,7,20,4,0,16,4
26205,6,59,6,0,53,6
26205,5,29,2,0,27,2
26205,4,27,6,0,21,6
26205,3,10,3,0,7,3
26205,2,13,8,0,5,8
14007,10,9,3,0,6,3
14007,9,14,2,0,12,2
14007,8,40,14,0,26,14
14007,7,49,13,0,36,13
14007,6,34,6,0,28,6
14007,5,6,3,0,3,3
14007,4,10,4,0,6,4
14007,3,3,3,0,0,3
14007,2,2,2,0,0,2
91430,9,4,1,0,3,1
91430,8,16,1,0,15,1
91430,7,31,3,0,28,3
91430,6,59,8,0,51,8
91430,5,27,4,0,23,4
91430,4,17,4,0,13,4
91430,3,10,2,0,8,2
15722,10,14,6,0,8,6
15722,9,19,4,0,15,4
15722,8,27,5,0,22,5
15722,7,31,12,0,19,12
15722,6,37,5,0,32,5
15722,5,17,3,0,14,3
15722,4,13,3,0,10,3
15722,3,5,1,0,4,1
15722,2,4,1,0,3,1
183578,10,24,6,0,18,6
183578,9,57,13,0,44,13
183578,8,57,14,0,43,14
183578,7,17,6,0,11,6
183578,6,8,4,0,4,4
183578,4,1,1,0,0,1
140779,10,9,2,0,7,2
140779,9,14,6,3,8,3
140779,8,32,6,0,26,6
140779,7,46,12,3,34,9
140779,6,32,8,2,24,6
140779,4,5,1,0,4,1
140779,3,7,1,0,6,1
140779,1,6,5,1,1,4
38981,9,1,1,0,0,1
38981,8,5,1,0,4,1
38981,7,22,5,0,17,5
38981,6,69,15,0,54,15
38981,5,43,9,0,34,9
38981,4,13,2,0,11,2
38981,3,10,2,0,8,2
147685,8,6,2,0,4,2
147685,7,20,1,0,19,1
147685,6,69,4,0,65,4
147685,5,32,5,0,27,5
147685,4,26,3,0,23,3
147685,3,10,4,0,6,4
185344,10,5,1,0,4,1
185344,9,7,5,0,2,5
185344,8,28,4,0,24,4
185344,7,40,3,0,37,3
185344,6,46,7,2,39,5
185344,5,18,3,0,15,3
185344,4,14,1,0,13,1
185344,3,7,1,0,6,1
185344,2,1,1,0,0,1
169146,10,4,1,0,3,1
169146,9,9,5,0,4,5
169146,8,49,8,0,41,8
169146,7,39,5,0,34,5
169146,6,39,8,0,31,8
169146,5,13,2,0,11,2
169146,4,9,3,0,6,3
169146,2,2,1,0,1,1
27101,10,7,1,0,6,1
27101,9,29,13,0,16,13
27101,8,63,15,0,48,15
27101,7,36,7,0,29,7
27101,6,20,7,0,13,7
27101,5,8,4,0,4,4
210271,9,46,7,0,39,7
210271,8,45,3,0,42,3
210271,7,26,5,0,21,5
210271,6,17,5,0,12,5
17026,8,4,3,0,1,3
17026,7,13,8,0,5,8
17026,6,61,18,0,43,18
17026,5,38,12,0,26,12
17026,4,30,12,0,18,12
17026,3,14,4,0,10,4
17026,2,5,1,0,4,1
128352,10,4,2,0,2,2
128352,9,7,1,0,6,1
128352,8,21,2,1,19,1
128352,7,36,6,0,30,6
128352,6,48,10,2,38,8
128352,5,28,10,1,18,9
128352,4,12,4,0,8,4
128352,3,5,1,0,4,1
128352,2,3,2,0,1,2
128352,1,2,1,0,1,1
256788,10,9,5,0,4,5
256788,9,21,6,0,15,6
256788,8,60,13,0,47,13
256788,7,38,4,0,34,4
256788,6,22,3,0,19,3
256788,4,4,1,0,3,1
256788,3,2,1,0,1,1
256788,1,2,1,0,1,1
266966,10,26,1,0,25,1
266966,9,28,2,0,26,2
266966,8,60,6,0,54,6
266966,7,29,3,0,26,3
266966,6,15,3,0,12,3
266966,5,5,1,0,4,1
266966,4,3,1,0,2,1
25233,8,13,1,0,12,1
25233,7,33,6,0,27,6
25233,6,68,8,0,60,8
25233,5,23,3,0,20,3
25233,4,14,4,0,10,4
25233,3,7,2,0,5,2
25233,2,5,1,0,4,1
1402,10,1,1,0,0,1
1402,8,7,3,0,4,3
1402,7,30,8,0,22,8
1402,6,78,19,0,59,19
1402,5,24,5,0,19,5
1402,4,16,3,0,13,3
1402,3,7,2,0,5,2
2312,10,3,2,0,1,2
2312,9,4,1,0,3,1
2312,8,4,1,0,3,1
2312,7,13,1,0,12,1
2312,6,46,13,0,33,13
2312,5,34,5,0,29,5
2312,4,24,3,0,21,3
2312,3,18,3,0,15,3
2312,2,13,3,0,10,3
2312,1,7,4,0,3,4
181959,8,14,1,0,13,1
181959,7,44,8,0,36,8
181959,6,62,13,0,49,13
181959,5,24,8,0,16,8
181959,4,13,3,0,10,3
181959,3,2,1,0,1,1
120906,9,6,1,0,5,1
120906,8,7,2,1,5,1
120906,7,25,2,1,23,1
120906,6,37,4,0,33,4
120906,5,26,5,0,21,5
120906,4,34,8,1,26,7
120906,3,12,2,0,10,2
120906,2,13,3,1,10,2
120906,1,4,2,0,2,2
374,8,20,4,0,16,4
374,7,39,7,0,32,7
374,6,68,18,0,50,18
374,5,27,8,0,19,8
374,4,9,1,0,8,1
374,3,3,2,0,1,2
223151,9,5,1,1,4,0
223151,8,34,6,2,28,4
223151,7,48,11,0,37,11
223151,6,48,3,0,45,3
223151,5,16,2,0,14,2
223151,4,11,3,0,8,3
21779,10,29,11,0,18,11
21779,9,36,10,0,26,10
21779,8,50,18,0,32,18
21779,7,27,6,0,21,6
21779,6,14,3,0,11,3
21779,5,5,2,0,3,2
21779,2,1,1,0,0,1
192829,7,44,8,0,36,8
192829,6,66,9,2,57,7
192829,5,26,5,0,21,5
192829,4,12,2,1,10,1
3936,9,6,3,0,3,3
3936,8,17,10,0,7,10
3936,7,30,12,0,18,12
3936,6,52,10,0,42,10
3936,5,27,10,0,17,10
3936,4,16,10,0,6,10
3936,3,10,7,0,3,7
3936,2,6,2,0,4,2
176963,9,8,1,0,7,1
176963,8,47,11,0,36,11
176963,7,46,13,0,33,13
176963,6,42,5,0,37,5
176963,4,8,1,0,7,1
176963,2,2,1,0,1,1
12304,8,8,1,0,7,1
12304,7,25,5,0,20,5
12304,6,44,9,0,35,9
12304,5,43,7,0,36,7
12304,4,23,4,0,19,4
12304,3,11,2,0,9,2
12304,2,3,2,0,1,2
2311,9,3,1,0,2,1
2311,8,8,1,0,7,1
2311,7,25,3,0,22,3
2311,6,45,7,0,38,7
2311,5,46,12,0,34,12
2311,4,24,6,0,18,6
2311,3,10,3,0,7,3
32424,10,12,4,0,8,4
32424,9,32,10,0,22,10
32424,8,77,23,0,54,23
32424,7,26,6,0,20,6
32424,6,11,3,0,8,3
32424,5,4,3,0,1,3
32424,3,2,1,0,1,1
161928,9,6,2,0,4,2
161928,8,14,2,0,12,2
161928,7,30,4,0,26,4
161928,6,47,12,1,35,11
161928,5,28,2,0,26,2
161928,4,19,2,0,17,2
161928,2,7,1,0,6,1
161928,1,2,1,0,1,1
131232,9,12,4,0,8,4
131232,8,50,16,0,34,16
131232,7,36,4,0,32,4
131232,6,39,8,0,31,8
131232,5,17,5,0,12,5
131232,4,7,2,0,5,2
131232,3,1,1,0,0,1
507,10,7,3,0,4,3
507,9,9,3,0,6,3
507,8,39,10,0,29,10
507,7,48,16,0,32,16
507,6,43,12,0,31,12
507,5,14,4,0,10,4
507,2,1,1,0,0,1
42997,10,18,5,0,13,5
42997,9,41,18,0,23,18
42997,8,58,18,0,40,18
42997,7,23,10,0,13,10
42997,6,17,6,0,11,6
42997,5,7,3,0,4,3
205226,8,10,4,0,6,4
205226,7,23,2,0,21,2
205226,6,41,7,0,34,7
205226,5,36,2,0,34,2
205226,4,21,4,0,17,4
205226,3,20,2,0,18,2
205226,2,8,3,0,5,3
205226,1,3,1,0,2,1
258412,10,5,1,0,4,1
258412,9,10,2,0,8,2
258412,8,51,7,0,44,7
258412,7,46,3,0,43,3
258412,6,32,2,0,30,2
258412,4,4,1,0,3,1
258412,2,3,2,0,1,2
12372,10,5,3,0,2,3
12372,8,14,5,0,9,5
12372,7,27,11,0,16,11
12372,6,55,15,0,40,15
12372,5,25,10,0,15,10
12372,4,15,3,0,12,3
12372,3,13,2,0,11,2
12372,2,5,3,0,2,3
125605,8,29,8,1,21,7
125605,7,31,7,0,24,7
125605,6,48,11,0,37,11
125605,5,24,9,0,15,9
125605,4,10,4,0,6,4
125605,3,15,4,0,11,4
125605,2,2,1,0,1,1
253719,9,20,4,0,16,4
253719,8,69,12,1,57,11
253719,7,51,6,1,45,5
253719,6,22,4,2,18,2
253719,5,5,3,0,2,3
253719,4,3,1,0,2,1
2427,10,3,1,0,2,1
2427,8,14,6,0,8,6
2427,7,38,19,0,19,19
2427,6,63,27,0,36,27
2427,5,25,10,0,15,10
2427,4,12,3,0,9,3
2427,3,5,1,0,4,1
150010,10,3,1,0,2,1
150010,9,11,1,0,10,1
150010,8,43,10,0,33,10
150010,7,35,5,0,30,5
150010,6,30,4,1,26,3
150010,5,15,7,0,8,7
150010,4,7,3,0,4,3
150010,3,8,2,0,6,2
150010,2,7,4,1,3,3
150010,1,6,4,1,2,3
5382,10,3,1,0,2,1
5382,8,8,5,0,3,5
5382,7,28,12,0,16,12
5382,6,53,15,0,38,15
5382,5,40,10,0,30,10
5382,4,20,7,0,13,7
5382,3,5,4,0,1,4
5382,2,5,1,0,4,1
593,9,4,1,0,3,1
593,8,17,3,0,14,3
593,7,52,14,0,38,14
593,6,60,16,0,44,16
593,5,22,10,0,12,10
593,4,5,2,0,3,2
593,3,2,2,0,0,2
593,2,1,1,0,0,1
156420,8,23,2,0,21,2
156420,7,41,5,0,36,5
156420,6,50,3,0,47,3
156420,5,19,4,0,15,4
156420,4,14,1,0,13,1
156420,3,6,2,0,4,2
156420,2,3,1,0,2,1
247980,9,4,3,0,1,3
247980,8,19,4,0,15,4
247980,7,39,6,0,33,6
247980,6,57,9,0,48,9
247980,5,25,1,0,24,1
247980,3,13,4,0,9,4
37906,10,8,1,0,7,1
37906,9,20,3,0,17,3
37906,8,58,11,0,47,11
37906,7,34,9,0,25,9
37906,6,28,8,0,20,8
37906,5,13,3,0,10,3
5178,9,3,1,0,2,1
5178,8,19,10,0,9,10
5178,7,47,22,0,25,22
5178,6,61,25,0,36,25
5178,5,21,9,0,12,9
5178,4,11,5,0,6,5
5178,2,1,1,0,0,1
4368,9,16,6,0,10,6
4368,8,51,16,0,35,16
4368,7,56,18,0,38,18
4368,6,25,7,0,18,7
4368,5,8,1,0,7,1
4368,4,2,1,0,1,1
4368,3,1,1,0,0,1
4368,2,2,1,0,1,1
168582,9,10,2,0,8,2
168582,8,32,3,0,29,3
168582,7,44,9,1,35,8
168582,6,40,8,1,32,7
168582,5,24,2,0,22,2
168582,4,7,1,0,6,1
168582,2,2,1,0,1,1
24321,9,4,1,0,3,1
24321,8,31,15,0,16,15
24321,7,49,16,0,33,16
24321,6,39,10,0,29,10
24321,5,26,12,0,14,12
24321,4,9,3,0,6,3
24321,3,2,2,0,0,2
24321,2,2,2,0,0,2
24321,1,2,1,0,1,1
199723,10,51,14,0,37,14
199723,9,49,8,0,41,8
199723,8,37,3,0,34,3
199723,7,18,3,0,15,3
199723,6,7,1,0,6,1
199723,5,1,1,0,0,1
199723,3,1,1,0,0,1
191387,10,17,7,0,10,7
191387,9,26,10,0,16,10
191387,8,66,17,0,49,17
191387,7,33,11,0,22,11
191387,6,19,3,0,16,3
191387,5,3,1,0,2,1
191387,1,1,1,0,0,1
1831,10,3,1,0,2,1
1831,9,14,7,0,7,7
1831,8,31,7,0,24,7
1831,7,48,10,0,38,10
1831,6,44,16,0,28,16
1831,5,15,7,0,8,7
1831,4,7,2,0,5,2
1831,3,2,1,0,1,1
1831,2,1,1,0,0,1
3065,9,7,3,0,4,3
3065,8,15,6,0,9,6
3065,7,31,12,0,19,12
3065,6,47,5,0,42,5
3065,5,24,6,0,18,6
3065,3,9,1,0,8,1
3065,2,10,4,0,6,4
3065,1,6,3,0,3,3
143869,8,17,2,0,15,2
143869,7,18,3,0,15,3
143869,6,46,4,3,42,1
143869,5,25,1,0,24,1
143869,4,22,4,0,18,4
143869,3,15,5,0,10,5
143869,2,12,5,1,7,4
143869,1,7,5,0,2,5
91759,10,4,3,0,1,3
91759,9,6,2,0,4,2
91759,8,18,6,0,12,6
91759,7,30,10,0,20,10
91759,6,51,12,0,39,12
91759,5,24,4,0,20,4
91759,4,18,6,0,12,6
91759,3,5,1,0,4,1
91759,2,8,2,0,6,2
91759,1,1,1,0,0,1
5452,10,30,12,0,18,12
5452,9,34,10,0,24,10
5452,8,47,11,0,36,11
5452,7,34,9,0,25,9
5452,6,12,4,0,8,4
5452,5,5,1,0,4,1
202737,10,7,4,0,3,4
202737,9,6,1,0,5,1
202737,8,18,5,0,13,5
202737,7,32,6,0,26,6
202737,6,65,12,0,53,12
202737,5,23,4,0,19,4
202737,4,9,3,0,6,3
202737,2,2,2,0,0,2
76436,10,4,4,0,0,4
76436,9,8,2,0,6,2
76436,8,36,18,0,18,18
76436,7,67,24,0,43,24
76436,6,28,3,0,25,3
76436,5,17,6,0,11,6
76436,4,4,1,0,3,1
29638,10,3,2,0,1,2
29638,8,40,14,0,26,14
29638,7,42,17,0,25,17
29638,6,48,14,0,34,14
29638,5,12,6,0,6,6
29638,4,12,4,0,8,4
29638,1,1,1,0,0,1
6118,10,1,1,0,0,1
6118,9,7,2,0,5,2
6118,8,13,8,0,5,8
6118,7,33,14,0,19,14
6118,6,58,19,0,39,19
6118,5,25,12,0,13,12
6118,4,16,8,0,8,8
6118,3,7,4,0,3,4
6118,2,5,5,0,0,5
230275,10,7,4,0,3,4
230275,9,9,2,0,7,2
230275,8,28,2,0,26,2
230275,7,43,5,0,38,5
230275,6,42,5,0,37,5
230275,5,19,5,0,14,5
230275,4,11,2,0,9,2
230275,3,5,1,0,4,1
39941,10,10,5,0,5,5
39941,9,19,6,0,13,6
39941,8,58,17,0,41,17
39941,7,35,13,0,22,13
39941,6,28,6,0,22,6
39941,5,10,4,0,6,4
39941,4,3,1,0,2,1
39941,2,1,1,0,0,1
2574,10,14,9,0,5,9
2574,9,19,10,0,9,10
2574,8,35,17,0,18,17
2574,7,44,18,0,26,18
2574,6,31,8,0,23,8
2574,5,12,6,0,6,6
2574,4,5,3,0,2,3
2574,2,1,1,0,0,1
33112,10,4,1,0,3,1
33112,9,4,3,0,1,3
33112,8,13,2,0,11,2
33112,7,23,1,0,22,1
33112,6,31,6,0,25,6
33112,5,33,2,0,31,2
33112,4,23,2,0,21,2
33112,3,18,4,0,14,4
33112,2,11,2,0,9,2
181192,10,8,1,0,7,1
181192,9,10,1,0,9,1
181192,8,21,3,0,18,3
181192,7,39,2,0,37,2
181192,6,49,8,0,41,8
181192,5,18,1,0,17,1
181192,4,9,1,0,8,1
181192,2,7,2,0,5,2
910,9,3,1,0,2,1
910,8,30,12,0,18,12
910,7,54,18,0,36,18
910,6,44,18,0,26,18
910,5,20,10,0,10,10
910,4,8,2,0,6,2
910,3,4,1,0,3,1
30991,10,4,4,0,0,4
30991,9,7,1,0,6,1
30991,8,38,10,0,28,10
30991,7,41,8,0,33,8
30991,6,41,6,0,35,6
30991,5,17,6,0,11,6
30991,4,8,1,0,7,1
30991,3,5,3,0,2,3
30991,1,3,1,0,2,1
230650,10,6,1,0,5,1
230650,9,19,5,0,14,5
230650,8,55,17,0,38,17
230650,7,46,12,0,34,12
230650,6,22,6,0,16,6
230650,5,8,2,0,6,2
230650,4,3,2,0,1,2
230650,3,5,2,0,3,2
291,10,1,1,0,0,1
291,8,19,4,0,15,4
291,7,42,9,0,33,9
291,6,40,8,0,32,8
291,5,26,4,0,22,4
291,4,11,6,0,5,6
291,3,10,4,0,6,4
291,1,5,2,0,3,2
192668,10,8,3,0,5,3
192668,8,30,10,0,20,10
192668,7,32,7,1,25,6
192668,6,50,7,0,43,7
192668,5,21,7,0,14,7
192668,4,8,2,0,6,2
192668,1,2,1,0,1,1
232090,10,8,3,0,5,3
232090,9,11,2,0,9,2
232090,8,25,3,0,22,3
232090,7,41,7,0,34,7
232090,6,46,9,0,37,9
232090,5,21,2,0,19,2
232090,2,3,1,0,2,1
12055,10,17,9,0,8,9
12055,9,29,16,0,13,16
12055,8,49,18,0,31,18
12055,7,31,12,0,19,12
12055,6,16,3,0,13,3
12055,5,12,5,0,7,5
12055,4,4,2,0,2,2
12055,2,4,3,0,1,3
131581,10,9,3,0,6,3
131581,9,18,4,0,14,4
131581,8,49,14,0,35,14
131581,7,34,13,0,21,13
131581,6,40,7,0,33,7
131581,5,6,1,0,5,1
131581,4,4,1,0,3,1
46748,8,5,1,0,4,1
46748,7,7,2,0,5,2
46748,6,29,10,0,19,10
46748,5,49,6,0,43,6
46748,4,38,15,0,23,15
46748,3,19,8,0,11,8
46748,2,12,5,0,7,5
46748,1,4,3,0,1,3
88140,9,6,2,0,4,2
88140,8,22,6,0,16,6
88140,7,45,9,0,36,9
88140,6,59,20,0,39,20
88140,5,22,3,0,19,3
88140,4,8,3,0,5,3
88140,1,1,1,0,0,1
3416,10,13,2,0,11,2
3416,9,33,18,0,15,18
3416,8,57,24,0,33,24
3416,7,42,12,0,30,12
3416,6,11,4,0,7,4
3416,5,4,2,0,2,2
3416,3,1,1,0,0,1
24168,9,4,2,0,2,2
24168,8,18,5,0,13,5
24168,7,23,3,0,20,3
24168,6,40,6,0,34,6
24168,5,33,4,0,29,4
24168,4,19,3,0,16,3
24168,3,16,2,0,14,2
24168,2,9,5,0,4,5
24168,1,1,1,0,0,1
38558,9,2,1,0,1,1
38558,8,2,1,0,1,1
38558,6,17,6,0,11,6
38558,5,20,4,0,16,4
38558,4,48,17,0,31,17
38558,3,31,3,0,28,3
38558,2,19,6,0,13,6
38558,1,15,2,0,13,2
12897,10,16,6,0,10,6
12897,9,29,5,0,24,5
12897,8,53,9,0,44,9
12897,7,40,9,0,31,9
12897,6,17,4,0,13,4
12897,5,7,2,0,5,2
12897,4,1,1,0,0,1
150925,7,27,5,0,22,5
150925,6,59,6,1,53,5
150925,5,34,4,0,30,4
150925,4,22,3,1,19,2
150925,3,7,2,1,5,1
150925,2,4,3,0,1,3
177725,10,4,2,0,2,2
177725,9,9,2,0,7,2
177725,8,35,14,0,21,14
177725,7,53,11,0,42,11
177725,6,34,9,0,25,9
177725,5,20,4,0,16,4
177725,4,6,4,0,2,4
20233,10,2,1,0,1,1
20233,8,28,7,0,21,7
20233,7,38,4,0,34,4
20233,6,55,8,0,47,8
20233,5,27,7,0,20,7
20233,4,8,3,0,5,3
20233,1,1,1,0,0,1
184460,10,1,1,0,0,1
184460,9,4,3,0,1,3
184460,8,23,3,0,20,3
184460,7,34,7,0,27,7
184460,6,48,5,0,43,5
184460,5,20,1,0,19,1
184460,4,17,1,0,16,1
184460,3,12,4,0,8,4
184460,2,4,2,0,2,2
64080,10,4,2,0,2,2
64080,9,7,3,0,4,3
64080,8,17,8,0,9,8
64080,7,37,11,0,26,11
64080,6,49,11,0,38,11
64080,5,19,5,0,14,5
64080,4,23,5,0,18,5
64080,3,4,2,0,2,2
64080,2,4,2,0,2,2
19957,9,2,1,0,1,1
19957,8,8,2,0,6,2
19957,7,21,5,0,16,5
19957,6,54,24,0,30,24
19957,5,37,13,0,24,13
19957,4,25,11,0,14,11
19957,3,10,5,0,5,5
19957,2,4,3,0,1,3
19957,1,2,1,0,1,1
99308,7,37,11,0,26,11
99308,6,50,11,0,39,11
99308,5,34,6,0,28,6
99308,4,13,2,0,11,2
99308,3,6,2,0,4,2
99308,2,2,1,0,1,1
178839,9,9,6,0,3,6
178839,8,35,7,1,28,6
178839,7,43,9,0,34,9
178839,6,52,12,0,40,12
178839,5,14,4,0,10,4
178839,4,7,1,0,6,1
169375,10,6,2,0,4,2
169375,9,8,5,1,3,4
169375,8,39,14,1,25,13
169375,7,40,8,2,32,6
169375,6,31,4,0,27,4
169375,5,18,9,0,9,9
169375,4,13,7,0,6,7
169375,3,3,2,0,1,2
169375,2,6,2,0,4,2
1932,7,3,1,0,2,1
1932,6,18,5,0,13,5
1932,5,30,8,0,22,8
1932,4,50,14,0,36,14
1932,3,28,10,0,18,10
1932,2,22,8,0,14,8
1932,1,12,4,0,8,4
123406,9,3,1,0,2,1
123406,8,27,10,0,17,10
123406,7,39,10,0,29,10
123406,6,52,9,0,43,9
123406,5,19,7,2,12,5
123406,3,9,3,0,6,3
123406,1,5,1,0,4,1
39066,10,8,2,0,6,2
39066,9,17,5,0,12,5
39066,8,34,12,0,22,12
39066,7,47,16,1,31,15
39066,6,25,9,0,16,9
39066,5,12,5,0,7,5
39066,4,8,5,0,3,5
39066,3,2,1,0,1,1
39066,2,5,1,0,4,1
39066,1,6,4,0,2,4
202771,10,4,1,0,3,1
202771,8,9,2,0,7,2
202771,7,16,1,0,15,1
202771,6,31,5,0,26,5
202771,5,38,9,0,29,9
202771,4,22,3,0,19,3
202771,3,17,5,0,12,5
202771,2,16,5,0,11,5
2078,10,7,3,0,4,3
2078,9,4,3,0,1,3
2078,8,28,9,0,19,9
2078,7,40,15,0,25,15
2078,6,35,9,0,26,9
2078,5,30,4,0,26,4
2078,4,9,3,0,6,3
2078,3,7,5,0,2,5
2078,2,3,1,0,2,1
2078,1,1,1,0,0,1
3584,10,1,1,0,0,1
3584,9,3,1,0,2,1
3584,8,12,4,0,8,4
3584,7,11,1,0,10,1
3584,6,28,4,0,24,4
3584,5,44,8,0,36,8
3584,4,36,9,0,27,9
3584,3,18,7,0,11,7
3584,2,6,2,0,4,2
3584,1,4,2,0,2,2
156878,9,7,2,0,5,2
156878,8,27,7,0,20,7
156878,7,37,5,0,32,5
156878,6,56,16,0,40,16
156878,5,19,6,0,13,6
156878,4,10,2,0,8,2
223360,8,28,2,0,26,2
223360,7,26,2,0,24,2
223360,6,56,6,0,50,6
223360,5,26,5,0,21,5
223360,4,12,1,0,11,1
223360,3,5,1,0,4,1
1782,10,8,6,0,2,6
1782,9,6,3,0,3,3
1782,8,31,15,0,16,15
1782,7,49,23,0,26,23
1782,6,46,16,0,30,16
1782,5,16,5,0,11,5
1782,4,2,2,0,0,2
1782,3,3,1,0,2,1
1782,2,1,1,0,0,1
1782,1,1,1,0,0,1
2860,10,17,11,0,6,11
2860,9,11,7,0,4,7
2860,8,38,14,0,24,14
2860,7,37,17,0,20,17
2860,6,37,15,0,22,15
2860,5,12,6,0,6,6
2860,4,6,2,0,4,2
2860,3,4,1,0,3,1
8324,8,9,2,0,7,2
8324,7,23,10,0,13,10
8324,6,59,21,0,38,21
8324,5,36,12,0,24,12
8324,4,21,8,0,13,8
8324,3,9,4,0,5,4
8324,2,3,1,0,2,1
24116,9,2,1,0,1,1
24116,8,10,4,0,6,4
24116,7,19,3,0,16,3
24116,6,55,9,0,46,9
24116,5,38,7,0,31,7
24116,4,20,7,0,13,7
24116,3,10,4,0,6,4
24116,1,2,1,0,1,1
15999,10,6,2,0,4,2
15999,9,26,15,0,11,15
15999,8,65,22,0,43,22
15999,7,41,13,0,28,13
15999,6,17,6,0,11,6
15999,5,6,3,0,3,3
19040,10,4,1,0,3,1
19040,9,3,1,0,2,1
19040,8,12,5,0,7,5
19040,7,25,13,0,12,13
19040,6,63,26,0,37,26
19040,5,22,10,0,12,10
19040,4,20,12,0,8,12
19040,2,4,2,0,2,2
19040,1,3,1,0,2,1
87907,10,15,2,0,13,2
87907,9,25,6,0,19,6
87907,8,60,18,0,42,18
87907,7,35,12,0,23,12
87907,6,18,7,0,11,7
87907,5,6,1,0,5,1
87907,4,1,1,0,0,1
87907,2,2,1,0,1,1
16141,8,2,1,0,1,1
16141,7,18,6,0,12,6
16141,6,67,18,0,49,18
16141,5,42,7,0,35,7
16141,4,20,7,0,13,7
16141,3,9,4,0,5,4
16141,2,3,1,0,2,1
16141,1,2,1,0,1,1
41100,10,4,2,0,2,2
41100,9,11,5,0,6,5
41100,8,44,22,0,22,22
41100,7,54,18,0,36,18
41100,6,33,16,0,17,16
41100,5,9,6,0,3,6
41100,4,5,3,0,2,3
41100,3,2,2,0,0,2
41100,1,1,1,0,0,1
145259,10,3,1,0,2,1
145259,6,51,11,0,40,11
145259,5,42,8,0,34,8
145259,4,23,4,0,19,4
145259,3,19,3,0,16,3
145259,2,8,1,0,7,1
145259,1,3,2,0,1,2
27613,8,5,2,0,3,2
27613,7,35,14,0,21,14
27613,6,81,16,0,65,16
27613,5,26,5,0,21,5
27613,4,9,1,0,8,1
27613,3,3,1,0,2,1
27613,2,2,2,0,0,2
452,8,11,3,0,8,3
452,7,9,2,0,7,2
452,6,46,18,0,28,18
452,5,44,16,0,28,16
452,4,26,3,0,23,3
452,3,18,10,0,8,10
452,2,6,3,0,3,3
452,1,2,1,0,1,1
11084,10,1,1,0,0,1
11084,8,12,4,0,8,4
11084,7,35,7,0,28,7
11084,6,51,12,0,39,12
11084,5,38,8,0,30,8
11084,4,17,4,0,13,4
11084,3,3,1,0,2,1
11084,1,1,1,0,0,1
38949,10,1,1,0,0,1
38949,8,6,2,0,4,2
38949,7,17,4,0,13,4
38949,6,80,18,0,62,18
38949,5,37,7,0,30,7
38949,4,12,6,0,6,6
38949,3,7,3,0,4,3
38949,2,2,2,0,0,2
38340,10,1,1,0,0,1
38340,9,3,2,0,1,2
38340,8,12,1,0,11,1
38340,7,22,3,0,19,3
38340,6,52,10,0,42,10
38340,5,41,11,0,30,11
38340,4,18,4,0,14,4
38340,3,7,2,0,5,2
38340,2,7,2,0,5,2
198455,9,13,4,0,9,4
198455,8,29,2,0,27,2
198455,7,45,5,0,40,5
198455,6,49,4,1,45,3
198455,5,11,1,0,10,1
198455,4,9,1,0,8,1
198455,3,3,1,0,2,1
255659,9,29,3,0,26,3
255659,8,79,13,0,66,13
255659,7,28,1,0,27,1
255659,6,20,5,0,15,5
255659,3,1,1,0,0,1
255659,2,2,1,0,1,1
6898,8,3,1,0,2,1
6898,7,10,3,0,7,3
6898,6,27,13,0,14,13
6898,5,40,12,0,28,12
6898,4,35,14,0,21,14
6898,3,27,6,0,21,6
6898,2,12,3,0,9,3
6898,1,8,4,0,4,4
21506,7,25,5,0,20,5
21506,6,70,14,0,56,14
21506,5,32,3,0,29,3
21506,4,15,2,0,13,2
21506,3,6,1,0,5,1
21506,2,3,1,0,2,1
21506,1,1,1,0,0,1
10962,10,8,5,0,3,5
10962,9,1,1,0,0,1
10962,8,11,6,0,5,6
10962,7,28,10,0,18,10
10962,6,42,13,0,29,13
10962,5,31,8,0,23,8
10962,4,19,9,0,10,9
10962,3,12,6,0,6,6
10962,2,10,3,0,7,3
6767,10,28,15,0,13,15
6767,9,15,9,0,6,9
6767,8,42,21,0,21,21
6767,7,26,9,0,17,9
6767,6,24,12,0,12,12
6767,5,9,6,0,3,6
6767,4,10,5,0,5,5
6767,3,5,4,0,1,4
6767,2,2,2,0,0,2
209280,10,14,1,0,13,1
209280,9,22,3,0,19,3
209280,8,30,9,1,21,8
209280,7,31,7,2,24,5
209280,6,33,10,2,23,8
209280,5,15,3,1,12,2
209280,4,10,5,0,5,5
209280,3,7,2,1,5,1
2897,8,8,3,0,5,3
2897,7,24,6,0,18,6
2897,6,55,15,0,40,15
2897,5,44,11,0,33,11
2897,4,18,4,0,14,4
2897,3,8,2,0,6,2
2897,2,3,2,0,1,2
4278,10,7,2,0,5,2
4278,9,11,4,0,7,4
4278,8,31,14,0,17,14
4278,7,38,7,0,31,7
4278,6,36,9,0,27,9
4278,5,24,3,0,21,3
4278,4,10,3,0,7,3
4278,3,2,1,0,1,1
4278,2,3,1,0,2,1
35173,7,7,2,0,5,2
35173,6,21,4,0,17,4
35173,5,34,6,0,28,6
35173,4,48,10,0,38,10
35173,3,21,2,0,19,2
35173,2,19,6,0,13,6
35173,1,11,6,0,5,6
253399,10,12,1,0,11,1
253399,9,21,2,0,19,2
253399,8,53,7,0,46,7
253399,7,42,2,0,40,2
253399,6,32,7,0,25,7
253399,5,3,1,0,2,1
64897,10,8,2,0,6,2
64897,9,12,3,0,9,3
64897,8,47,8,0,39,8
64897,7,50,6,0,44,6
2205,10,5,2,0,3,2
2205,9,2,1,0,1,1
2205,8,16,5,0,11,5
2205,7,28,10,0,18,10
2205,6,52,18,0,34,18
2205,5,28,4,0,24,4
2205,4,20,5,0,15,5
2205,3,4,2,0,2,2
2205,2,6,4,0,2,4
2205,1,1,1,0,0,1
1582,10,20,5,0,15,5
1582,9,22,8,0,14,8
1582,8,61,20,0,41,20
1582,7,33,9,0,24,9
1582,6,14,5,0,9,5
1582,5,8,1,0,7,1
1582,3,2,1,0,1,1
8976,10,9,2,0,7,2
8976,9,12,3,0,9,3
8976,8,33,5,0,28,5
8976,7,46,7,0,39,7
8976,6,39,8,0,31,8
8976,5,14,4,0,10,4
8976,4,9,1,0,8,1
170799,10,5,2,0,3,2
170799,9,9,4,0,5,4
170799,8,41,13,3,28,10
170799,7,30,10,1,20,9
170799,6,51,16,2,35,14
170799,5,17,4,1,13,3
170799,4,6,1,0,5,1
170799,3,2,2,0,0,2
6953,8,11,2,0,9,2
6953,7,22,6,0,16,6
6953,6,49,12,0,37,12
6953,5,29,4,0,25,4
6953,4,31,8,0,23,8
6953,3,12,3,0,9,3
6953,2,6,3,0,3,3
6953,1,1,1,0,0,1
1243,10,3,1,0,2,1
1243,9,5,2,0,3,2
1243,8,28,16,0,12,16
1243,7,29,10,0,19,10
1243,6,58,22,0,36,22
1243,5,23,6,0,17,6
1243,4,11,2,0,9,2
2965,8,19,2,0,17,2
2965,7,32,7,0,25,7
2965,6,60,15,0,45,15
2965,5,35,8,0,27,8
2965,4,7,2,0,5,2
2965,3,4,1,0,3,1
23828,10,1,1,0,0,1
23828,8,46,15,0,31,15
23828,7,40,11,0,29,11
23828,6,43,10,0,33,10
23828,5,19,2,0,17,2
23828,4,3,1,0,2,1
23828,2,3,3,0,0,3
224483,10,55,21,0,34,21
224483,9,41,8,0,33,8
224483,8,39,12,0,27,12
224483,7,14,2,0,12,2
224483,6,7,1,0,6,1
224483,3,1,1,0,0,1
2485,10,2,2,0,0,2
2485,8,6,2,0,4,2
2485,7,14,9,0,5,9
2485,6,16,4,0,12,4
2485,5,50,18,0,32,18
2485,4,35,11,0,24,11
2485,3,19,3,0,16,3
2485,2,11,3,0,8,3
2485,1,6,1,0,5,1
754,10,2,1,0,1,1
754,9,5,3,0,2,3
754,8,14,7,0,7,7
754,7,34,17,0,17,17
754,6,66,22,0,44,22
754,5,23,3,0,20,3
754,4,13,7,0,6,7
754,1,1,1,0,0,1
5228,9,7,4,0,3,4
5228,8,31,13,0,18,13
5228,7,47,14,0,33,14
5228,6,39,8,0,31,8
5228,5,23,7,0,16,7
5228,4,7,4,0,3,4
5228,3,6,3,0,3,3
27608,10,3,2,0,1,2
27608,9,3,2,0,1,2
27608,8,25,7,0,18,7
27608,7,35,12,0,23,12
27608,6,57,11,0,46,11
27608,5,23,5,0,18,5
27608,4,9,2,0,7,2
37441,9,6,4,0,2,4
37441,8,41,16,0,25,16
37441,7,59,20,0,39,20
37441,6,33,14,0,19,14
37441,5,14,4,0,10,4
37441,4,6,3,0,3,3
245928,10,14,3,0,11,3
245928,9,32,8,0,24,8
245928,8,68,19,0,49,19
245928,7,36,16,0,20,16
245928,6,9,4,0,5,4
245928,5,3,1,0,2,1
245928,2,2,2,0,0,2
185276,9,8,2,0,6,2
185276,8,23,5,2,18,3
185276,7,36,9,1,27,8
185276,6,56,11,0,45,11
185276,5,24,8,0,16,8
185276,4,10,1,0,9,1
185276,2,2,1,0,1,1
226860,10,1,1,0,0,1
226860,8,22,7,0,15,7
226860,7,39,7,0,32,7
226860,6,69,11,0,58,11
226860,5,22,3,0,19,3
226860,4,7,1,0,6,1
232824,10,8,1,0,7,1
232824,9,18,3,0,15,3
232824,8,65,13,0,52,13
232824,7,45,4,0,41,4
232824,6,18,3,0,15,3
232824,5,7,5,0,2,5
22161,10,12,4,0,8,4
22161,9,40,6,0,34,6
22161,8,52,17,0,35,17
22161,7,36,9,0,27,9
22161,6,17,1,0,16,1
22161,4,2,1,0,1,1
17030,8,33,2,0,31,2
17030,7,57,9,0,48,9
17030,6,49,6,0,43,6
228183,10,7,4,0,3,4
228183,9,20,5,0,15,5
228183,8,49,16,0,33,16
228183,7,45,6,1,39,5
228183,6,28,3,0,25,3
228183,5,6,1,0,5,1
212580,10,15,6,0,9,6
212580,9,10,2,0,8,2
212580,8,58,17,1,41,16
212580,7,43,4,1,39,3
212580,6,21,4,0,17,4
212580,5,10,1,0,9,1
212580,4,3,1,0,2,1
212580,2,1,1,0,0,1
219621,9,2,1,0,1,1
219621,7,59,6,0,53,6
219621,6,48,5,0,43,5
219621,5,15,1,0,14,1
219621,4,9,2,0,7,2
219621,3,2,1,0,1,1
172598,8,15,3,0,12,3
172598,7,25,2,0,23,2
172598,6,60,10,0,50,10
172598,5,26,4,0,22,4
172598,4,20,2,0,18,2
172598,3,5,3,0,2,3
172598,2,5,2,0,3,2
219,8,14,6,0,8,6
219,7,39,10,0,29,10
219,6,62,17,0,45,17
219,5,28,8,0,20,8
219,4,10,4,0,6,4
219,3,2,1,0,1,1
199908,10,2,1,1,1,0
199908,9,11,5,0,6,5
199908,8,42,13,1,29,12
199908,7,49,18,2,31,16
199908,6,38,11,1,27,10
199908,5,13,3,0,10,3
199908,4,2,1,0,1,1
199908,3,3,2,1,1,1
10641,10,20,5,0,15,5
10641,9,34,13,0,21,13
10641,8,56,17,0,39,17
10641,7,32,8,0,24,8
10641,6,10,1,0,9,1
10641,5,6,2,0,4,2
10641,4,1,1,0,0,1
10641,3,2,1,0,1,1
9782,10,5,1,0,4,1
9782,9,7,1,0,6,1
9782,8,18,8,0,10,8
9782,7,32,6,0,26,6
9782,6,62,22,0,40,22
9782,5,21,6,0,15,6
9782,4,12,5,0,7,5
9782,0,1,1,0,0,1
18902,8,5,3,0,2,3
18902,7,26,8,0,18,8
18902,6,65,17,0,48,17
18902,5,39,14,0,25,14
18902,4,14,8,0,6,8
18902,3,6,2,0,4,2
18902,2,4,1,0,3,1
18902,1,1,1,0,0,1
93400,9,7,3,0,4,3
93400,8,32,4,0,28,4
93400,7,46,11,0,35,11
93400,6,47,14,0,33,14
93400,5,18,7,0,11,7
93400,4,7,4,0,3,4
93400,3,3,2,0,1,2
2343,10,5,2,0,3,2
2343,8,26,6,0,20,6
2343,7,32,9,0,23,9
2343,6,48,16,0,32,16
2343,5,26,8,0,18,8
2343,4,15,3,0,12,3
2343,3,3,1,0,2,1
2343,2,1,1,0,0,1
188601,10,2,1,0,1,1
188601,7,26,3,0,23,3
188601,6,65,5,0,60,5
188601,5,24,2,0,22,2
188601,4,17,3,0,14,3
188601,1,4,1,0,3,1
206805,9,16,5,0,11,5
206805,8,66,23,0,43,23
206805,7,54,15,0,39,15
206805,6,20,6,0,14,6
206805,5,5,3,0,2,3
26745,10,9,5,0,4,5
26745,9,12,8,0,4,8
26745,8,33,14,0,19,14
26745,7,42,12,0,30,12
26745,6,35,8,0,27,8
26745,5,15,8,0,7,8
26745,4,7,3,0,4,3
26745,3,6,4,0,2,4
26745,2,1,1,0,0,1
41585,8,26,9,0,17,9
41585,7,26,8,0,18,8
41585,6,58,7,0,51,7
41585,5,31,9,0,22,9
41585,4,10,6,0,4,6
41585,3,9,5,0,4,5
1719,10,2,1,0,1,1
1719,8,13,8,0,5,8
1719,7,32,9,0,23,9
1719,6,49,13,0,36,13
1719,5,28,10,0,18,10
1719,4,13,5,0,8,5
1719,3,18,14,0,4,14
1719,1,2,2,0,0,2
17448,9,6,3,0,3,3
17448,8,17,9,0,8,9
17448,7,30,6,0,24,6
17448,6,48,13,0,35,13
17448,5,30,11,0,19,11
17448,4,17,7,0,10,7
17448,3,10,3,0,7,3
17448,2,3,2,0,1,2
254213,9,8,2,0,6,2
254213,8,48,12,1,36,11
254213,7,49,6,1,43,5
254213,6,38,13,0,25,13
254213,5,7,3,0,4,3
254213,4,3,1,0,2,1
254213,3,2,1,0,1,1
36599,8,13,1,0,12,1
36599,7,35,4,0,31,4
36599,6,48,8,0,40,8
36599,4,18,6,0,12,6
36599,3,15,5,0,10,5
36599,2,8,5,0,3,5
36599,1,2,1,0,1,1
212551,9,8,1,0,7,1
212551,8,40,9,0,31,9
212551,7,49,5,0,44,5
212551,6,46,8,0,38,8
212551,4,4,2,0,2,2
212551,1,1,1,0,0,1
622,8,6,3,0,3,3
622,7,19,10,0,9,10
622,6,48,14,0,34,14
622,5,48,10,0,38,10
622,4,24,9,0,15,9
622,3,9,3,0,6,3
622,2,5,2,0,3,2
250779,8,45,6,0,39,6
250779,7,43,1,0,42,1
250779,6,26,1,0,25,1
250779,5,9,1,0,8,1
250779,4,9,1,0,8,1
250779,3,3,2,0,1,2
250779,2,3,1,0,2,1
124706,9,7,1,0,6,1
124706,8,22,6,1,16,5
124706,7,39,7,4,32,3
124706,6,43,11,3,32,8
124706,5,27,6,1,21,5
124706,4,13,2,0,11,2
124706,3,5,3,1,2,2
53624,10,3,1,0,2,1
53624,9,16,7,0,9,7
53624,8,51,28,0,23,28
53624,7,48,18,0,30,18
53624,6,34,11,0,23,11
53624,5,4,2,0,2,2
53624,4,3,2,0,1,2
53624,3,2,1,0,1,1
126076,9,6,3,0,3,3
126076,8,11,5,0,6,5
126076,7,37,7,0,30,7
126076,6,55,15,1,40,14
126076,5,29,9,0,20,9
126076,4,14,4,0,10,4
126076,3,4,1,0,3,1
126076,2,3,1,0,2,1
23694,7,13,3,0,10,3
23694,6,30,4,0,26,4
23694,5,32,9,0,23,9
23694,4,34,12,0,22,12
23694,3,24,12,0,12,12
23694,2,15,5,0,10,5
23694,1,3,1,0,2,1
222853,10,5,2,0,3,2
222853,9,5,2,0,3,2
222853,8,31,8,0,23,8
222853,7,46,6,0,40,6
222853,6,45,8,0,37,8
222853,5,19,6,0,13,6
222853,3,2,2,0,0,2
4470,7,13,3,0,10,3
4470,6,42,10,0,32,10
4470,5,41,8,0,33,8
4470,4,32,11,0,21,11
4470,3,13,4,0,9,4
4470,2,9,5,0,4,5
4470,1,3,1,0,2,1
95607,8,24,3,0,21,3
95607,7,27,2,0,25,2
95607,6,41,7,0,34,7
95607,5,20,4,0,16,4
95607,3,7,1,0,6,1
95607,2,13,3,0,10,3
5939,8,27,13,0,14,13
5939,7,48,16,0,32,16
5939,6,54,15,0,39,15
5939,5,15,6,0,9,6
5939,4,5,1,0,4,1
5939,3,2,1,0,1,1
5939,2,1,1,0,0,1
146597,10,5,1,0,4,1
146597,8,16,4,0,12,4
146597,7,27,7,0,20,7
146597,6,41,10,0,31,10
146597,5,28,7,0,21,7
146597,4,20,4,0,16,4
146597,3,13,3,0,10,3
146597,2,6,2,0,4,2
146597,1,1,1,0,0,1
191998,9,10,1,0,9,1
191998,8,44,7,0,37,7
191998,7,60,12,0,48,12
191998,6,35,3,0,32,3
191998,5,5,3,0,2,3
191998,4,2,1,0,1,1
7251,10,9,2,0,7,2
7251,9,20,7,0,13,7
7251,8,55,13,0,42,13
7251,7,35,4,0,31,4
7251,6,29,11,0,18,11
7251,4,5,2,0,3,2
38334,10,2,1,0,1,1
38334,8,16,3,0,13,3
38334,7,25,12,0,13,12
38334,6,60,12,0,48,12
38334,5,31,5,0,26,5
38334,4,18,8,0,10,8
38334,3,5,2,0,3,2
38334,2,3,2,0,1,2
1216,10,2,1,0,1,1
1216,9,1,1,0,0,1
1216,8,5,2,0,3,2
1216,7,10,2,0,8,2
1216,6,55,18,0,37,18
1216,5,39,16,0,23,16
1216,4,31,10,0,21,10
1216,3,9,5,0,4,5
1216,2,7,1,0,6,1
8958,10,1,1,0,0,1
8958,8,5,2,0,3,2
8958,7,13,5,0,8,5
8958,6,45,16,0,29,16
8958,5,40,9,0,31,9
8958,4,34,11,0,23,11
8958,3,14,7,0,7,7
8958,2,8,3,0,5,3
8958,1,1,1,0,0,1
1331,10,1,1,0,0,1
1331,9,1,1,0,0,1
1331,8,11,1,0,10,1
1331,7,28,7,0,21,7
1331,6,54,17,0,37,17
1331,5,42,14,0,28,14
1331,4,14,1,0,13,1
1331,3,9,3,0,6,3
1007,8,16,2,0,14,2
1007,7,30,6,0,24,6
1007,6,49,8,0,41,8
1007,5,29,6,0,23,6
1007,4,22,7,0,15,7
1007,3,9,5,0,4,5
1007,2,4,1,0,3,1
2990,8,10,2,0,8,2
2990,7,23,9,0,14,9
2990,6,49,17,0,32,17
2990,5,32,9,0,23,9
2990,4,23,8,0,15,8
2990,3,12,2,0,10,2
2990,2,10,4,0,6,4
3623,8,5,3,0,2,3
3623,7,9,4,0,5,4
3623,6,23,8,0,15,8
3623,5,22,6,0,16,6
3623,4,38,9,0,29,9
3623,3,25,7,0,18,7
3623,2,25,12,0,13,12
3623,1,13,4,0,9,4
218824,8,24,3,0,21,3
218824,7,34,6,0,28,6
218824,6,40,3,0,37,3
218824,5,26,3,0,23,3
218824,4,17,2,0,15,2
218824,3,9,2,0,7,2
4745,10,1,1,0,0,1
4745,9,4,1,0,3,1
4745,8,11,8,0,3,8
4745,7,27,9,0,18,9
4745,6,46,22,0,24,22
4745,5,25,8,0,17,8
4745,4,18,12,0,6,12
4745,3,17,6,0,11,6
4745,2,5,3,0,2,3
4745,1,6,3,0,3,3
595,9,1,1,0,0,1
595,8,8,2,0,6,2
595,7,27,8,0,19,8
595,6,38,6,0,32,6
595,5,44,13,0,31,13
595,4,30,9,0,21,9
595,3,8,5,0,3,5
595,2,3,1,0,2,1
3309,10,3,1,0,2,1
3309,8,15,6,0,9,6
3309,7,34,9,0,25,9
3309,6,48,12,0,36,12
3309,5,36,9,0,27,9
3309,4,16,6,0,10,6
3309,1,1,1,0,0,1
84730,10,8,5,0,3,5
84730,8,6,2,0,4,2
84730,7,6,1,0,5,1
84730,6,26,16,0,10,16
84730,5,39,13,0,26,13
84730,4,34,13,0,21,13
84730,3,17,11,0,6,11
84730,2,11,4,0,7,4
84730,1,12,4,0,8,4
28718,10,2,1,0,1,1
28718,8,2,2,0,0,2
28718,7,11,2,0,9,2
28718,6,34,5,0,29,5
28718,5,32,3,0,29,3
28718,4,32,3,0,29,3
28718,3,26,6,0,20,6
28718,2,7,1,0,6,1
28718,1,14,4,0,10,4
177815,9,3,3,0,0,3
177815,8,31,6,0,25,6
177815,7,45,7,0,38,7
177815,6,57,8,0,49,8
177815,5,14,5,0,9,5
177815,4,7,1,0,6,1
31294,9,2,1,0,1,1
31294,8,11,4,0,7,4
31294,7,21,5,0,16,5
31294,6,50,5,0,45,5
31294,5,29,2,0,27,2
31294,4,23,6,0,17,6
31294,3,11,1,0,10,1
31294,2,5,2,0,3,2
3370,10,1,1,0,0,1
3370,9,4,1,0,3,1
3370,8,9,1,0,8,1
3370,7,29,9,0,20,9
3370,6,54,13,0,41,13
3370,5,36,9,0,27,9
3370,4,18,12,0,6,12
3370,2,3,3,0,0,3
3370,1,3,1,0,2,1
23258,10,1,1,0,0,1
23258,9,4,3,0,1,3
23258,8,15,4,0,11,4
23258,7,42,12,0,30,12
23258,6,57,11,0,46,11
23258,5,21,5,0,16,5
23258,4,11,1,0,10,1
23258,3,7,1,0,6,1
4881,10,10,3,0,7,3
4881,9,12,5,0,7,5
4881,8,23,12,0,11,12
4881,7,29,12,0,17,12
4881,6,48,16,0,32,16
4881,5,17,8,0,9,8
4881,4,15,8,0,7,8
4881,3,2,2,0,0,2
1723,10,1,1,0,0,1
1723,8,5,2,0,3,2
1723,7,24,7,0,17,7
1723,6,43,14,0,29,14
1723,5,39,7,0,32,7
1723,4,29,11,0,18,11
1723,3,13,7,0,6,7
1723,2,5,1,0,4,1
255683,10,4,1,0,3,1
255683,9,7,1,0,6,1
255683,8,39,5,0,34,5
255683,7,48,5,0,43,5
255683,6,46,2,0,44,2
255683,5,10,1,0,9,1
21414,10,6,4,0,2,4
21414,9,30,13,0,17,13
21414,8,59,21,0,38,21
21414,7,44,17,0,27,17
21414,6,13,4,0,9,4
21414,5,4,2,0,2,2
21414,4,2,2,0,0,2
21414,3,1,1,0,0,1
21414,2,1,1,0,0,1
150013,10,15,5,0,10,5
150013,9,34,7,0,27,7
150013,8,57,22,0,35,22
150013,7,32,10,0,22,10
150013,6,15,5,0,10,5
150013,5,2,1,0,1,1
150013,4,2,2,0,0,2
150013,3,2,1,0,1,1
243538,10,22,5,0,17,5
243538,9,30,7,1,23,6
243538,8,71,16,2,55,14
243538,7,23,3,1,20,2
243538,6,11,2,0,9,2
243538,4,2,1,0,1,1
243538,2,1,1,0,0,1
178361,9,4,3,0,1,3
178361,8,23,9,0,14,9
178361,7,51,9,0,42,9
178361,6,43,6,0,37,6
178361,5,18,4,0,14,4
178361,4,16,5,0,11,5
178361,3,3,1,0,2,1
3110,10,4,3,0,1,3
3110,9,11,2,0,9,2
3110,8,45,15,0,30,15
3110,7,41,20,0,21,20
3110,6,39,14,0,25,14
3110,5,13,4,0,9,4
3110,4,4,1,0,3,1
3110,3,2,2,0,0,2
36314,10,34,10,0,24,10
36314,9,43,10,0,33,10
36314,8,48,12,0,36,12
36314,7,19,3,0,16,3
36314,6,11,5,0,6,5
36314,5,2,2,0,0,2
156482,10,15,10,1,5,9
156482,9,26,14,0,12,14
156482,8,57,17,1,40,16
156482,7,33,10,0,23,10
156482,6,21,2,1,19,1
20772,10,5,3,0,2,3
20772,9,8,2,0,6,2
20772,8,35,4,0,31,4
20772,7,43,9,0,34,9
20772,6,30,3,0,27,3
20772,5,16,4,0,12,4
20772,4,17,4,0,13,4
20772,3,4,2,0,2,2
20772,2,1,1,0,0,1
154895,10,6,2,0,4,2
154895,9,23,6,0,17,6
154895,8,55,17,1,38,16
154895,7,25,6,2,19,4
154895,6,31,5,0,26,5
154895,5,6,1,0,5,1
154895,4,7,5,1,2,4
154895,3,3,1,0,2,1
126703,8,15,3,0,12,3
126703,7,20,1,0,19,1
126703,6,49,5,0,44,5
126703,5,34,1,0,33,1
126703,4,13,1,0,12,1
126703,3,11,3,0,8,3
141087,10,1,1,0,0,1
141087,8,13,5,0,8,5
141087,7,28,8,0,20,8
141087,6,51,7,0,44,7
141087,5,36,9,0,27,9
141087,4,12,2,0,10,2
141087,3,11,1,0,10,1
141087,2,3,1,0,2,1
141087,1,1,1,0,0,1
3662,10,4,1,0,3,1
3662,9,10,5,0,5,5
3662,8,23,9,0,14,9
3662,7,36,18,0,18,18
3662,6,39,14,0,25,14
3662,5,27,8,0,19,8
3662,4,8,3,0,5,3
3662,3,9,6,0,3,6
2275,8,11,3,0,8,3
2275,7,14,1,0,13,1
2275,6,32,11,0,21,11
2275,5,27,10,0,17,10
2275,4,20,6,0,14,6
2275,3,20,11,0,9,11
2275,2,13,6,0,7,6
2275,1,6,3,0,3,3
23829,10,2,1,0,1,1
23829,8,33,7,0,26,7
23829,7,43,15,0,28,15
23829,6,48,16,0,32,16
23829,5,17,5,0,12,5
23829,4,10,3,0,7,3
23829,3,3,1,0,2,1
23829,2,2,2,0,0,2
159355,9,5,3,0,2,3
159355,8,54,15,0,39,15
159355,7,43,15,0,28,15
159355,6,43,14,0,29,14
159355,5,9,2,0,7,2
159355,4,3,1,0,2,1
2779,8,11,6,0,5,6
2779,7,23,10,0,13,10
2779,6,59,20,0,39,20
2779,5,39,9,0,30,9
2779,4,12,5,0,7,5
2779,3,10,6,0,4,6
170825,10,11,1,0,10,1
170825,9,9,4,1,5,3
170825,8,37,8,0,29,8
170825,7,37,6,2,31,4
170825,6,40,7,1,33,6
170825,5,12,4,0,8,4
170825,4,6,3,0,3,3
170825,3,4,2,0,2,2
170825,2,2,1,0,1,1
170825,1,1,1,0,0,1
128927,8,13,2,0,11,2
128927,7,40,5,0,35,5
128927,6,56,6,0,50,6
128927,5,30,5,0,25,5
128927,4,10,2,0,8,2
128927,3,4,1,0,3,1
192623,10,3,3,0,0,3
192623,9,9,3,0,6,3
192623,8,27,6,3,21,3
192623,7,31,4,0,27,4
192623,6,47,12,0,35,12
192623,5,24,4,0,20,4
192623,2,2,2,0,0,2
71668,10,7,3,0,4,3
71668,9,25,12,0,13,12
71668,8,55,19,0,36,19
71668,7,30,8,0,22,8
71668,6,31,10,0,21,10
71668,5,3,2,0,1,2
71668,4,4,2,0,2,2
71668,2,1,1,0,0,1
3977,10,3,1,0,2,1
3977,9,4,2,0,2,2
3977,8,25,10,0,15,10
3977,7,39,16,0,23,16
3977,6,59,19,0,40,19
3977,5,14,2,0,12,2
3977,4,9,1,0,8,1
3977,3,4,1,0,3,1
3977,2,2,1,0,1,1
97824,9,1,1,0,0,1
97824,8,11,2,0,9,2
97824,7,23,6,0,17,6
97824,6,49,12,1,37,11
97824,5,33,8,0,25,8
97824,4,15,4,0,11,4
97824,3,12,3,0,9,3
97824,2,13,5,0,8,5
63829,9,2,1,0,1,1
63829,8,17,6,0,11,6
63829,7,35,12,0,23,12
63829,6,58,25,1,33,24
63829,5,21,7,0,14,7
63829,4,17,9,0,8,9
63829,3,5,4,0,1,4
63829,2,4,3,0,1,3
20589,8,9,2,0,7,2
20589,7,24,3,0,21,3
20589,6,35,7,0,28,7
20589,5,44,10,0,34,10
20589,4,20,4,0,16,4
20589,3,10,4,0,6,4
20589,2,8,3,0,5,3
20589,1,7,3,0,4,3
2215,10,1,1,0,0,1
2215,9,2,1,0,1,1
2215,8,10,3,0,7,3
2215,7,32,11,0,21,11
2215,6,60,17,0,43,17
2215,5,35,5,0,30,5
2215,4,12,1,0,11,1
2215,2,3,2,0,1,2
21286,10,2,1,0,1,1
21286,9,5,4,0,1,4
21286,8,15,8,0,7,8
21286,7,35,14,0,21,14
21286,6,57,27,0,30,27
21286,5,24,7,0,17,7
21286,4,14,8,0,6,8
21286,3,4,2,0,2,2
21286,2,3,3,0,0,3
3015,8,20,5,0,15,5
3015,7,36,5,0,31,5
3015,6,54,17,0,37,17
3015,5,26,6,0,20,6
3015,4,8,2,0,6,2
3015,3,2,1,0,1,1
22924,10,1,1,0,0,1
22924,9,6,2,0,4,2
22924,8,30,12,0,18,12
22924,7,39,8,0,31,8
22924,6,48,19,0,29,19
22924,5,19,9,0,10,9
22924,4,10,5,0,5,5
22924,3,4,1,0,3,1
22924,2,1,1,0,0,1
22924,1,1,1,0,0,1
236272,9,11,6,1,5,5
236272,8,34,10,2,24,8
236272,7,46,9,1,37,8
236272,6,46,6,0,40,6
236272,5,14,1,0,13,1
236272,3,2,1,0,1,1
236272,2,1,1,0,0,1
148282,10,4,3,0,1,3
148282,8,26,6,1,20,5
148282,7,35,4,0,31,4
148282,6,42,10,1,32,9
148282,5,21,3,0,18,3
148282,4,13,7,0,6,7
148282,3,8,3,0,5,3
229006,10,8,2,0,6,2
229006,9,6,2,0,4,2
229006,8,32,9,0,23,9
229006,7,53,8,0,45,8
229006,6,41,8,0,33,8
229006,5,15,1,0,14,1
229006,4,3,2,0,1,2
224134,10,11,2,0,9,2
224134,9,12,1,0,11,1
224134,8,30,3,0,27,3
224134,7,32,2,0,30,2
224134,6,42,5,0,37,5
224134,4,5,1,0,4,1
224134,3,6,4,0,2,4
224134,2,6,3,0,3,3
10623,10,4,1,0,3,1
10623,9,12,6,0,6,6
10623,8,55,16,0,39,16
10623,7,45,15,0,30,15
10623,6,27,6,0,21,6
10623,5,11,6,0,5,6
202819,10,30,11,0,19,11
202819,9,19,6,0,13,6
202819,8,49,12,0,37,12
202819,7,34,6,0,28,6
202819,6,22,4,0,18,4
202819,4,1,1,0,0,1
175512,6,15,3,0,12,3
175512,5,20,4,1,16,3
175512,4,25,6,1,19,5
175512,3,30,2,0,28,2
175512,2,34,9,2,25,7
175512,1,32,12,3,20,9
4226,10,4,3,0,1,3
4226,9,27,15,0,12,15
4226,8,36,12,0,24,12
4226,7,44,17,0,27,17
4226,6,30,10,0,20,10
4226,5,11,3,0,8,3
4226,4,6,2,0,4,2
4226,3,1,1,0,0,1
193328,7,26,1,0,25,1
193328,6,58,6,0,52,6
193328,4,10,1,0,9,1
193328,2,1,1,0,0,1
193328,1,5,3,0,2,3
1514,8,10,2,0,8,2
1514,7,14,3,0,11,3
1514,6,46,13,0,33,13
1514,5,47,12,0,35,12
1514,4,26,7,0,19,7
1514,3,10,2,0,8,2
1514,2,5,1,0,4,1
178397,9,8,4,1,4,3
178397,8,21,3,0,18,3
178397,7,39,5,1,34,4
178397,6,48,4,1,44,3
178397,5,15,1,1,14,0
178397,4,10,1,0,9,1
178397,3,12,1,0,11,1
178397,1,3,1,0,2,1
64875,9,3,1,0,2,1
64875,7,13,2,0,11,2
64875,6,39,5,0,34,5
64875,5,47,7,0,40,7
64875,4,29,13,0,16,13
64875,3,5,1,0,4,1
64875,2,11,3,0,8,3
64875,1,2,2,0,0,2
29676,8,17,7,0,10,7
29676,7,29,7,0,22,7
29676,6,42,7,0,35,7
29676,5,29,10,0,19,10
29676,4,20,3,0,17,3
29676,3,6,1,0,5,1
29676,2,10,2,0,8,2
207783,10,3,1,0,2,1
207783,8,17,3,0,14,3
207783,7,37,6,0,31,6
207783,6,64,9,0,55,9
207783,5,21,3,0,18,3
207783,3,4,2,0,2,2
207783,2,2,2,0,0,2
226445,10,7,2,0,5,2
226445,9,14,4,1,10,3
226445,8,62,15,1,47,14
226445,7,42,11,2,31,9
226445,6,19,3,0,16,3
226445,5,10,4,0,6,4
226445,3,3,1,0,2,1
226445,1,2,1,0,1,1
178494,9,16,3,0,13,3
178494,8,39,7,0,32,7
178494,7,40,4,0,36,4
178494,6,26,4,0,22,4
178494,5,16,2,0,14,2
178494,3,1,1,0,0,1
178494,2,2,1,0,1,1
178939,10,4,2,0,2,2
178939,9,5,1,0,4,1
178939,8,8,4,0,4,4
178939,7,33,5,0,28,5
178939,6,57,8,0,49,8
178939,5,29,7,0,22,7
178939,4,15,6,0,9,6
188196,8,17,4,0,13,4
188196,7,41,9,0,32,9
188196,6,63,13,0,50,13
188196,5,20,4,0,16,4
5965,10,6,1,0,5,1
5965,9,11,5,0,6,5
5965,8,35,16,0,19,16
5965,7,46,20,0,26,20
5965,6,33,5,0,28,5
5965,5,19,3,0,16,3
5965,4,8,2,0,6,2
5559,10,7,2,0,5,2
5559,9,7,2,0,5,2
5559,8,30,12,0,18,12
5559,7,47,13,0,34,13
5559,6,38,14,0,24,14
5559,5,21,4,0,17,4
5559,4,6,1,0,5,1
5559,3,1,1,0,0,1
5559,1,1,1,0,0,1
629,9,2,1,0,1,1
629,8,3,1,0,2,1
629,7,17,5,0,12,5
629,6,43,13,0,30,13
629,5,41,10,0,31,10
629,4,30,12,0,18,12
629,3,12,3,0,9,3
629,2,6,3,0,3,3
629,1,4,2,0,2,2
1321,9,5,4,0,1,4
1321,8,22,9,0,13,9
1321,7,33,13,0,20,13
1321,6,54,16,0,38,16
1321,5,29,11,0,18,11
1321,4,7,4,0,3,4
1321,3,5,1,0,4,1
1321,1,1,1,0,0,1
88950,8,25,1,0,24,1
88950,7,31,9,0,22,9
88950,6,66,12,0,54,12
88950,5,16,3,0,13,3
88950,4,15,2,0,13,2
88950,3,5,2,0,3,2
1373,8,10,2,0,8,2
1373,7,23,6,0,17,6
1373,6,33,10,0,23,10
1373,5,12,4,0,8,4
1373,2,3,1,0,2,1
1373,1,1,1,0,0,1
189829,10,1,1,0,0,1
189829,8,28,1,0,27,1
189829,7,49,13,1,36,12
189829,6,48,7,0,41,7
189829,5,16,4,0,12,4
189829,2,1,1,0,0,1
36231,8,10,4,0,6,4
36231,7,10,4,0,6,4
36231,6,45,9,0,36,9
36231,5,37,10,0,27,10
36231,4,30,7,0,23,7
36231,3,17,11,0,6,11
36231,2,5,3,0,2,3
605,9,3,2,0,1,2
605,7,26,6,0,20,6
605,6,51,14,0,37,14
605,5,37,11,0,26,11
605,4,20,8,0,12,8
605,3,12,8,0,4,8
605,2,5,1,0,4,1
126025,10,4,2,0,2,2
126025,9,8,3,0,5,3
126025,8,35,9,1,26,8
126025,7,36,11,0,25,11
126025,6,33,8,0,25,8
126025,5,19,3,0,16,3
126025,4,13,1,0,12,1
126025,3,6,2,0,4,2
126025,2,4,2,0,2,2
65889,8,14,4,0,10,4
65889,7,32,4,0,28,4
65889,6,48,13,0,35,13
65889,5,23,8,0,15,8
65889,4,25,6,0,19,6
65889,3,8,3,0,5,3
65889,2,4,2,0,2,2
75441,10,10,3,0,7,3
75441,9,14,2,0,12,2
75441,8,49,13,0,36,13
75441,7,31,6,0,25,6
75441,6,29,5,0,24,5
75441,5,3,1,0,2,1
75441,4,3,2,0,1,2
75441,3,4,1,0,3,1
75441,2,5,2,0,3,2
75441,1,10,4,0,6,4
185262,10,7,2,0,5,2
185262,9,9,2,0,7,2
185262,8,21,3,0,18,3
185262,7,52,11,0,41,11
185262,6,36,5,0,31,5
185262,5,14,4,0,10,4
185262,4,10,1,0,9,1
185262,3,3,1,0,2,1
185262,2,1,1,0,0,1
185262,1,5,3,0,2,3
40416,10,2,1,0,1,1
40416,8,9,1,0,8,1
40416,7,31,8,0,23,8
40416,6,41,8,0,33,8
40416,5,40,8,0,32,8
40416,4,23,3,0,20,3
40416,3,4,2,0,2,2
40416,2,5,2,0,3,2
9296,10,5,3,0,2,3
9296,9,8,2,0,6,2
9296,8,37,11,0,26,11
9296,7,40,9,0,31,9
9296,6,49,12,0,37,12
9296,5,11,3,0,8,3
9296,4,6,2,0,4,2
227171,10,2,1,0,1,1
227171,8,41,10,0,31,10
227171,7,63,9,0,54,9
227171,6,27,6,0,21,6
227171,5,10,3,0,7,3
227171,4,6,2,0,4,2
227171,3,3,1,0,2,1
129294,10,19,5,1,14,4
129294,9,33,11,5,22,6
129294,8,64,15,3,49,12
129294,7,19,6,0,13,6
129294,6,12,4,0,8,4
129294,5,6,1,0,5,1
129294,4,3,1,0,2,1
129294,1,4,3,0,1,3
232980,9,8,5,0,3,5
232980,8,39,5,0,34,5
232980,7,61,2,0,59,2
232980,5,15,2,0,13,2
12131,10,22,11,0,11,11
12131,9,16,8,0,8,8
12131,8,23,11,0,12,11
12131,7,33,14,0,19,14
12131,6,35,16,0,19,16
12131,5,11,4,0,7,4
12131,4,11,6,0,5,6
12131,3,4,3,0,1,3
12131,2,1,1,0,0,1
148517,9,4,1,0,3,1
148517,8,11,4,0,7,4
148517,7,22,4,0,18,4
148517,6,45,11,0,34,11
148517,5,32,11,0,21,11
148517,4,22,9,0,13,9
148517,3,14,5,0,9,5
148517,2,7,2,0,5,2
256568,8,35,8,0,27,8
256568,7,36,3,0,33,3
256568,6,32,3,0,29,3
256568,5,20,1,0,19,1
256568,4,6,1,0,5,1
256568,3,6,1,0,5,1
256568,2,4,1,0,3,1
256568,1,2,1,0,1,1
135019,8,30,8,2,22,6
135019,7,35,8,0,27,8
135019,6,45,11,0,34,11
135019,5,21,5,0,16,5
135019,4,12,5,0,7,5
135019,3,8,5,0,3,5
135019,2,2,1,0,1,1
27830,8,11,3,0,8,3
27830,7,38,12,0,26,12
27830,6,58,20,0,38,20
27830,5,23,11,0,12,11
27830,4,14,8,0,6,8
27830,3,9,2,0,7,2
27830,2,1,1,0,0,1
9912,8,8,1,0,7,1
9912,7,19,2,0,17,2
9912,6,53,17,0,36,17
9912,5,37,14,0,23,14
9912,4,19,7,0,12,7
9912,3,8,5,0,3,5
9912,2,10,2,0,8,2
9912,1,2,1,0,1,1
212958,10,11,8,0,3,8
212958,9,20,11,0,9,11
212958,8,38,13,0,25,13
212958,7,24,6,0,18,6
212958,6,31,4,0,27,4
212958,5,14,3,0,11,3
212958,4,8,1,0,7,1
212958,3,10,1,0,9,1
20422,7,5,2,0,3,2
20422,6,35,4,0,31,4
20422,5,39,10,0,29,10
20422,4,33,4,0,29,4
20422,3,20,1,0,19,1
20422,2,16,5,0,11,5
20422,1,6,3,0,3,3
257321,9,18,4,0,14,4
257321,8,40,2,0,38,2
257321,7,34,6,0,28,6
257321,6,19,2,0,17,2
257321,5,16,3,0,13,3
257321,4,3,2,0,1,2
257321,3,11,7,0,4,7
257321,2,2,1,0,1,1
257321,1,7,5,0,2,5
927,9,3,1,0,2,1
927,8,6,2,0,4,2
927,7,17,5,0,12,5
927,6,43,15,0,28,15
927,5,29,7,0,22,7
927,4,26,9,0,17,9
927,3,14,4,0,10,4
927,2,11,2,0,9,2
131493,10,2,1,0,1,1
131493,8,25,7,0,18,7
131493,7,49,14,0,35,14
131493,6,63,9,0,54,9
131493,5,12,2,0,10,2
124881,9,6,2,0,4,2
124881,8,18,1,0,17,1
124881,7,31,4,0,27,4
124881,6,51,6,0,45,6
124881,5,30,5,0,25,5
124881,3,5,2,0,3,2
124881,2,7,2,0,5,2
120268,9,2,1,0,1,1
120268,8,9,3,0,6,3
120268,7,22,6,0,16,6
120268,6,47,14,0,33,14
120268,5,40,9,0,31,9
120268,4,21,5,1,16,4
120268,3,9,2,0,7,2
120268,2,2,1,0,1,1
120268,1,5,1,0,4,1
102792,8,22,11,0,11,11
102792,7,25,7,0,18,7
102792,6,42,9,0,33,9
102792,5,28,1,0,27,1
102792,4,17,4,0,13,4
102792,3,10,3,0,7,3
102792,2,7,3,0,4,3
102792,1,2,1,0,1,1
27028,9,29,2,0,27,2
27028,8,46,15,0,31,15
27028,7,38,10,0,28,10
27028,6,22,6,0,16,6
27028,5,8,2,0,6,2
27028,4,2,1,0,1,1
27028,3,3,1,0,2,1
249675,10,15,5,0,10,5
249675,9,18,6,0,12,6
249675,8,54,21,0,33,21
249675,7,43,16,0,27,16
249675,6,23,9,0,14,9
249675,5,4,2,0,2,2
62226,10,5,1,0,4,1
62226,8,48,16,0,32,16
62226,7,45,11,0,34,11
62226,6,28,11,0,17,11
62226,5,9,3,0,6,3
62226,4,13,12,0,1,12
62226,2,1,1,0,0,1
62226,1,2,1,0,1,1
37257,10,9,3,0,6,3
37257,9,9,2,0,7,2
37257,8,54,15,0,39,15
37257,7,35,6,0,29,6
37257,6,28,10,0,18,10
37257,5,14,6,0,8,6
37257,4,4,2,0,2,2
37257,3,3,1,0,2,1
37257,2,1,1,0,0,1
26124,9,4,1,0,3,1
26124,8,14,4,0,10,4
26124,7,29,9,0,20,9
26124,6,58,10,0,48,10
26124,5,33,7,0,26,7
26124,4,9,3,0,6,3
26124,3,6,4,0,2,4
26124,2,4,2,0,2,2
5779,8,7,4,0,3,4
5779,7,19,7,0,12,7
5779,6,51,19,0,32,19
5779,5,23,5,0,18,5
5779,4,12,4,0,8,4
5779,3,6,1,0,5,1
5779,2,5,4,0,1,4
32047,9,3,1,0,2,1
32047,8,19,6,0,13,6
32047,7,37,12,0,25,12
32047,6,41,14,0,27,14
32047,5,24,7,0,17,7
32047,4,16,8,0,8,8
32047,3,6,4,0,2,4
32047,2,8,4,0,4,4
94902,10,25,10,0,15,10
94902,9,19,1,0,18,1
94902,8,38,6,0,32,6
94902,7,34,5,0,29,5
94902,6,28,7,0,21,7
94902,5,7,2,0,5,2
94902,4,1,1,0,0,1
94902,3,2,1,0,1,1
94902,1,3,1,0,2,1
6240,10,4,2,0,2,2
6240,8,27,12,0,15,12
6240,7,37,9,0,28,9
6240,6,44,13,0,31,13
6240,5,25,8,0,17,8
6240,4,13,1,0,12,1
6240,3,3,2,0,1,2
6240,1,2,1,0,1,1
2443,10,4,1,0,3,1
2443,9,12,4,0,8,4
2443,8,27,11,0,16,11
2443,7,46,16,0,30,16
2443,6,42,14,0,28,14
2443,5,13,6,0,7,6
2443,4,6,4,0,2,4
2443,3,5,3,0,2,3
2443,2,2,1,0,1,1
172008,10,5,2,0,3,2
172008,9,14,3,0,11,3
172008,8,46,3,0,43,3
172008,7,46,6,0,40,6
172008,6,32,5,0,27,5
172008,5,6,3,0,3,3
172008,4,4,1,0,3,1
172008,3,3,1,0,2,1
172008,2,1,1,0,0,1
70097,10,5,2,0,3,2
70097,9,7,1,0,6,1
70097,8,21,6,0,15,6
70097,7,40,9,0,31,9
70097,6,53,9,0,44,9
70097,5,15,4,0,11,4
70097,4,12,3,0,9,3
17530,10,6,4,0,2,4
17530,8,34,12,0,22,12
17530,7,33,11,0,22,11
17530,6,43,10,0,33,10
17530,5,18,5,0,13,5
17530,4,13,6,0,7,6
17530,3,2,1,0,1,1
17530,2,1,1,0,0,1
10534,10,2,1,0,1,1
10534,8,12,7,0,5,7
10534,7,28,10,0,18,10
10534,6,67,25,0,42,25
10534,5,35,9,0,26,9
10534,4,6,3,0,3,3
23598,8,7,2,0,5,2
23598,7,14,4,0,10,4
23598,6,66,21,0,45,21
23598,5,33,12,0,21,12
23598,4,22,10,0,12,10
23598,3,8,5,0,3,5
23598,2,4,1,0,3,1
3668,9,6,2,0,4,2
3668,8,10,3,0,7,3
3668,7,24,7,0,17,7
3668,6,48,13,0,35,13
3668,5,30,8,0,22,8
3668,4,20,8,0,12,8
3668,3,10,3,0,7,3
3668,2,5,2,0,3,2
3668,1,2,1,0,1,1
221599,10,23,11,1,12,10
221599,9,27,11,1,16,10
221599,8,56,12,3,44,9
221599,7,32,5,0,27,5
221599,6,15,3,1,12,2
143323,10,6,1,0,5,1
143323,9,5,1,0,4,1
143323,8,25,8,0,17,8
143323,7,33,3,0,30,3
143323,6,50,4,0,46,4
143323,5,17,2,0,15,2
143323,4,14,5,0,9,5
4113,10,8,4,0,4,4
4113,9,6,3,0,3,3
4113,8,36,17,0,19,17
4113,7,50,16,0,34,16
4113,6,26,8,0,18,8
4113,5,21,6,0,15,6
4113,4,6,3,0,3,3
4113,3,2,1,0,1,1
2310,8,7,1,0,6,1
2310,7,29,6,0,23,6
2310,6,64,9,0,55,9
2310,5,30,4,0,26,4
2310,4,21,4,0,17,4
2310,3,4,1,0,3,1
22377,9,13,5,0,8,5
22377,8,40,9,0,31,9
22377,7,50,11,0,39,11
22377,6,21,6,0,15,6
22377,5,8,3,0,5,3
22377,4,10,3,0,7,3
22377,3,7,3,0,4,3
22377,2,3,3,0,0,3
22377,1,2,2,0,0,2
86882,9,2,1,0,1,1
86882,8,20,5,0,15,5
86882,7,24,4,0,20,4
86882,6,49,11,0,38,11
86882,5,27,6,0,21,6
86882,4,21,6,0,15,6
86882,3,6,3,0,3,3
86882,2,4,1,0,3,1
163172,10,30,9,0,21,9
163172,9,41,11,0,30,11
163172,8,58,16,0,42,16
163172,7,17,5,0,12,5
163172,6,7,3,0,4,3
21503,10,5,1,0,4,1
21503,9,7,2,0,5,2
21503,8,16,5,0,11,5
21503,7,37,4,0,33,4
21503,6,58,5,0,53,5
21503,5,25,3,0,22,3
21503,4,6,1,0,5,1
21503,2,2,1,0,1,1
151310,10,2,1,0,1,1
151310,8,29,7,0,22,7
151310,7,54,14,0,40,14
151310,6,48,10,0,38,10
151310,5,15,2,0,13,2
151310,4,3,1,0,2,1
151310,3,3,1,0,2,1
151310,2,1,1,0,0,1
126789,10,4,1,0,3,1
126789,9,8,2,0,6,2
126789,8,34,6,0,28,6
126789,7,30,6,0,24,6
126789,6,42,7,0,35,7
126789,5,23,3,0,20,3
126789,4,9,1,0,8,1
9284,8,9,3,0,6,3
9284,7,20,11,0,9,11
9284,6,65,20,0,45,20
9284,5,38,10,0,28,10
9284,4,14,5,0,9,5
9284,3,7,2,0,5,2
9284,2,3,1,0,2,1
261529,9,8,4,0,4,4
261529,8,28,3,0,25,3
261529,7,34,8,0,26,8
261529,6,40,6,0,34,6
261529,5,24,3,0,21,3
261529,4,9,5,0,4,5
261529,3,10,2,0,8,2
261529,2,2,1,0,1,1
138973,10,8,7,0,1,7
138973,9,5,2,0,3,2
138973,8,21,10,0,11,10
138973,7,30,6,0,24,6
138973,6,55,11,0,44,11
138973,5,18,3,0,15,3
138973,4,8,3,0,5,3
138973,3,10,1,0,9,1
12263,10,2,2,0,0,2
12263,9,10,5,0,5,5
12263,8,23,9,0,14,9
12263,7,29,10,0,19,10
12263,6,38,10,0,28,10
12263,5,26,6,0,20,6
12263,4,13,8,0,5,8
12263,3,8,4,0,4,4
12263,1,5,2,0,3,2
26118,10,3,1,0,2,1
26118,9,2,1,0,1,1
26118,8,32,20,0,12,20
26118,7,53,22,0,31,22
26118,6,46,12,0,34,12
26118,5,13,4,0,9,4
26118,4,5,1,0,4,1
5829,10,5,2,0,3,2
5829,9,10,4,0,6,4
5829,8,41,9,0,32,9
5829,7,46,8,0,38,8
5829,6,36,11,0,25,11
5829,5,12,4,0,8,4
21666,10,2,1,0,1,1
21666,9,6,1,0,5,1
21666,8,12,3,0,9,3
21666,7,30,7,0,23,7
21666,6,49,12,0,37,12
21666,5,25,9,0,16,9
21666,4,13,2,0,11,2
21666,3,10,4,0,6,4
21666,2,5,2,0,3,2
127798,7,15,3,1,12,2
127798,6,36,8,1,28,7
127798,5,26,5,0,21,5
127798,4,29,8,0,21,8
127798,3,13,5,1,8,4
127798,2,13,6,0,7,6
127798,1,5,2,0,3,2
6388,7,18,4,0,14,4
6388,6,28,7,0,21,7
6388,5,46,20,0,26,20
6388,4,33,10,0,23,10
6388,3,18,6,0,12,6
3924,8,7,4,0,3,4
3924,7,27,13,0,14,13
3924,6,57,22,0,35,22
3924,5,34,15,0,19,15
3924,4,17,9,0,8,9
120316,10,2,1,0,1,1
120316,9,10,7,0,3,7
120316,8,36,5,0,31,5
120316,7,41,8,0,33,8
120316,6,33,3,0,30,3
120316,5,19,5,0,14,5
120316,4,9,2,0,7,2
120316,2,3,2,0,1,2
258413,8,47,7,0,40,7
258413,7,43,2,0,41,2
258413,6,25,2,0,23,2
258413,5,14,2,0,12,2
258413,4,7,2,0,5,2
258413,3,3,1,0,2,1
258413,2,2,1,0,1,1
258413,1,3,2,0,1,2
31069,10,2,2,0,0,2
31069,8,12,2,0,10,2
31069,7,25,6,0,19,6
31069,6,44,10,0,34,10
31069,5,27,6,0,21,6
31069,4,21,7,0,14,7
31069,3,13,5,0,8,5
31069,2,7,4,0,3,4
180937,9,12,2,0,10,2
180937,8,35,4,0,31,4
180937,7,43,2,0,41,2
180937,6,33,7,0,26,7
180937,5,19,4,0,15,4
180937,4,4,1,0,3,1
230361,10,6,1,0,5,1
230361,9,10,3,0,7,3
230361,8,44,8,0,36,8
230361,7,41,6,0,35,6
230361,6,37,7,0,30,7
230361,5,11,3,0,8,3
230361,4,5,2,0,3,2
32469,10,3,1,0,2,1
32469,9,5,1,0,4,1
32469,8,24,11,0,13,11
32469,7,29,8,0,21,8
32469,6,57,12,0,45,12
32469,5,20,6,0,14,6
32469,4,8,2,0,6,2
32469,3,5,1,0,4,1
32469,2,4,2,0,2,2
42969,9,4,1,0,3,1
42969,8,11,3,0,8,3
42969,7,25,10,0,15,10
42969,6,49,17,0,32,17
42969,5,32,8,0,24,8
42969,4,11,5,0,6,5
42969,3,8,4,0,4,4
42969,2,13,7,0,6,7
7641,9,3,3,0,0,3
7641,8,10,3,0,7,3
7641,7,25,13,0,12,13
7641,6,61,23,0,38,23
7641,5,36,10,0,26,10
7641,4,16,2,0,14,2
7641,3,2,1,0,1,1
5430,9,2,1,0,1,1
5430,8,10,3,0,7,3
5430,7,18,4,0,14,4
5430,6,42,8,0,34,8
5430,5,39,7,0,32,7
5430,4,25,10,0,15,10
5430,3,10,4,0,6,4
5430,2,5,2,0,3,2
5430,1,2,1,0,1,1
91666,10,7,3,0,4,3
91666,9,18,6,0,12,6
91666,8,43,5,0,38,5
91666,7,36,12,0,24,12
91666,6,34,5,0,29,5
91666,2,3,3,0,0,3
91666,1,1,1,0,0,1
155636,10,4,2,0,2,2
155636,9,7,3,0,4,3
155636,8,43,6,0,37,6
155636,7,53,11,0,42,11
155636,6,32,5,0,27,5
155636,5,9,3,0,6,3
155636,4,5,2,0,3,2
155636,3,3,1,0,2,1
130004,8,14,4,0,10,4
130004,7,46,7,0,39,7
130004,6,50,7,0,43,7
130004,5,22,2,0,20,2
130004,4,11,4,0,7,4
130004,3,7,1,0,6,1
157323,10,26,6,0,20,6
157323,9,42,10,0,32,10
157323,8,48,16,0,32,16
157323,7,17,4,0,13,4
157323,6,13,6,0,7,6
157323,5,7,6,0,1,6
13886,9,3,2,0,1,2
13886,7,17,6,0,11,6
13886,6,54,13,0,41,13
13886,5,33,9,0,24,9
13886,4,20,1,0,19,1
13886,3,17,4,0,13,4
13886,2,3,1,0,2,1
58253,8,10,2,0,8,2
58253,7,15,4,0,11,4
58253,6,45,12,0,33,12
58253,5,46,8,0,38,8
58253,4,25,9,0,16,9
58253,3,8,1,0,7,1
58253,2,4,1,0,3,1
268201,10,35,9,0,26,9
268201,9,42,3,0,39,3
268201,8,49,10,0,39,10
268201,7,15,1,0,14,1
268201,4,3,2,1,1,1
3316,10,2,1,0,1,1
3316,9,5,1,0,4,1
3316,8,39,7,0,32,7
3316,7,49,14,0,35,14
3316,6,32,14,0,18,14
3316,5,15,7,0,8,7
3316,4,8,6,0,2,6
3316,3,5,1,0,4,1
3316,2,1,1,0,0,1
38805,10,4,3,0,1,3
38805,9,14,6,0,8,6
38805,8,53,11,0,42,11
38805,7,43,13,0,30,13
38805,6,22,8,0,14,8
38805,5,9,6,0,3,6
38805,4,5,3,0,2,3
38805,3,3,2,0,1,2
1160,10,2,1,0,1,1
1160,8,25,13,0,12,13
1160,7,46,13,0,33,13
1160,6,51,13,0,38,13
1160,5,13,4,0,9,4
1160,4,8,4,0,4,4
1160,3,3,1,0,2,1
24932,8,6,3,0,3,3
24932,7,13,6,0,7,6
24932,6,54,23,0,31,23
24932,5,42,16,0,26,16
24932,4,24,8,0,16,8
24932,3,13,5,0,8,5
94331,10,3,1,0,2,1
94331,9,12,2,0,10,2
94331,8,38,15,0,23,15
94331,7,47,14,0,33,14
94331,6,36,13,0,23,13
94331,5,10,3,0,7,3
94331,4,3,1,0,2,1
94331,3,4,2,0,2,2
94331,1,2,2,0,0,2
89912,10,1,1,0,0,1
89912,8,23,6,0,17,6
89912,7,27,6,0,21,6
89912,6,59,21,0,38,21
89912,5,23,11,0,12,11
89912,4,15,5,0,10,5
89912,2,3,1,0,2,1
62809,8,26,5,0,21,5
62809,7,39,17,0,22,17
62809,6,52,10,0,42,10
62809,5,18,8,0,10,8
62809,4,10,1,0,9,1
62809,3,7,5,0,2,5
40800,8,20,1,0,19,1
40800,7,27,4,0,23,4
40800,6,66,13,0,53,13
40800,5,24,4,0,20,4
40800,4,8,3,0,5,3
40800,2,1,1,0,0,1
217466,10,7,1,0,6,1
217466,8,44,6,0,38,6
217466,7,49,2,0,47,2
217466,6,27,5,0,22,5
217466,5,11,2,0,9,2
217466,4,4,1,0,3,1
9802,8,6,4,0,2,4
9802,7,25,12,0,13,12
9802,6,46,20,0,26,20
9802,5,29,4,0,25,4
9802,4,30,11,0,19,11
9802,3,12,7,0,5,7
9802,2,3,2,0,1,2
9802,1,5,3,0,2,3
1348,8,12,9,0,3,9
1348,7,28,10,0,18,10
1348,6,44,10,0,34,10
1348,5,37,8,0,29,8
1348,4,17,6,0,11,6
1348,3,8,1,0,7,1
1348,2,3,1,0,2,1
3155,8,8,2,0,6,2
3155,7,22,12,0,10,12
3155,6,65,18,0,47,18
3155,5,36,12,0,24,12
3155,4,13,4,0,9,4
3155,3,5,1,0,4,1
258437,10,10,1,0,9,1
258437,9,6,2,0,4,2
258437,8,32,2,0,30,2
258437,7,48,7,0,41,7
258437,6,41,2,0,39,2
258437,5,14,1,0,13,1
62814,10,3,2,0,1,2
62814,9,11,1,0,10,1
62814,8,53,15,0,38,15
62814,7,50,9,0,41,9
62814,6,26,5,0,21,5
3419,9,1,1,0,0,1
3419,8,4,2,0,2,2
3419,7,10,4,0,6,4
3419,6,21,6,0,15,6
3419,5,32,11,0,21,11
3419,4,32,9,0,23,9
3419,3,34,9,0,25,9
3419,2,15,5,0,10,5
3419,1,4,3,0,1,3
215213,10,21,9,0,12,9
215213,9,9,2,0,7,2
215213,8,38,12,0,26,12
215213,7,31,6,0,25,6
215213,6,23,3,0,20,3
215213,5,11,2,0,9,2
215213,2,8,3,0,5,3
215213,1,2,2,0,0,2
2553,10,3,2,0,1,2
2553,9,7,4,0,3,4
2553,8,19,12,0,7,12
2553,7,37,14,0,23,14
2553,6,34,11,0,23,11
2553,5,21,13,0,8,13
2553,4,11,2,0,9,2
2553,3,3,1,0,2,1
2553,2,2,1,0,1,1
228570,10,3,1,0,2,1
228570,9,5,3,0,2,3
228570,8,60,19,0,41,19
228570,7,39,13,0,26,13
228570,6,39,9,0,30,9
228570,5,3,2,0,1,2
228570,4,4,1,0,3,1
2517,10,1,1,0,0,1
2517,9,3,2,0,1,2
2517,8,5,2,0,3,2
2517,7,16,4,0,12,4
2517,6,51,16,0,35,16
2517,5,37,4,0,33,4
2517,4,27,8,0,19,8
2517,3,10,4,0,6,4
35763,9,1,1,0,0,1
35763,8,12,5,0,7,5
35763,7,25,9,0,16,9
35763,6,63,15,0,48,15
35763,5,26,7,0,19,7
35763,4,18,7,0,11,7
35763,3,3,1,0,2,1
216224,10,7,2,0,5,2
216224,9,5,2,0,3,2
216224,8,20,8,0,12,8
216224,7,36,5,0,31,5
216224,6,36,6,0,30,6
216224,5,27,4,0,23,4
216224,4,9,2,0,7,2
216224,3,9,3,0,6,3
216224,2,2,1,0,1,1
216224,1,3,1,0,2,1
3910,9,2,1,0,1,1
3910,8,4,1,0,3,1
3910,7,14,3,0,11,3
3910,6,56,14,0,42,14
3910,5,38,11,0,27,11
3910,4,20,10,0,10,10
3910,3,8,2,0,6,2
3910,2,9,5,0,4,5
3910,1,3,1,0,2,1
7451,10,4,2,0,2,2
7451,9,16,5,0,11,5
7451,8,31,9,0,22,9
7451,7,32,8,0,24,8
7451,6,41,12,0,29,12
7451,5,19,4,0,15,4
7451,3,3,1,0,2,1
7451,2,3,1,0,2,1
7451,1,2,1,0,1,1
19537,10,4,1,0,3,1
19537,9,4,3,0,1,3
19537,8,25,6,0,19,6
19537,7,43,10,0,33,10
19537,6,47,11,0,36,11
19537,5,17,4,0,13,4
19537,4,8,3,0,5,3
19537,3,5,4,0,1,4
19537,2,1,1,0,0,1
8636,8,11,2,0,9,2
8636,7,16,2,0,14,2
8636,6,40,10,0,30,10
8636,5,31,6,0,25,6
8636,4,25,6,0,19,6
8636,3,13,4,0,9,4
8636,2,10,1,0,9,1
8636,1,3,1,0,2,1
232524,10,2,1,0,1,1
232524,9,8,3,0,5,3
232524,8,37,8,1,29,7
232524,7,41,10,0,31,10
232524,6,55,12,1,43,11
232524,5,8,3,0,5,3
232524,4,4,2,0,2,2
19671,10,5,1,0,4,1
19671,9,5,2,0,3,2
19671,8,4,2,0,2,2
19671,7,28,10,0,18,10
19671,6,47,9,0,38,9
19671,5,34,15,0,19,15
19671,4,19,11,0,8,11
19671,3,10,5,0,5,5
19671,2,2,2,0,0,2
41334,8,12,2,0,10,2
41334,7,8,2,0,6,2
41334,6,52,10,0,42,10
41334,5,37,9,0,28,9
41334,4,16,5,0,11,5
41334,3,15,9,0,6,9
41334,2,9,4,0,5,4
182635,9,6,4,0,2,4
182635,8,23,2,0,21,2
182635,7,35,3,0,32,3
182635,6,44,5,0,39,5
182635,5,26,4,0,22,4
182635,4,10,3,0,7,3
37683,9,4,1,0,3,1
37683,8,22,6,0,16,6
37683,7,35,12,0,23,12
37683,6,41,14,0,27,14
37683,5,30,6,0,24,6
37683,4,12,6,0,6,6
37683,3,6,4,0,2,4
109456,8,18,6,1,12,5
109456,7,32,6,1,26,5
109456,6,39,11,3,28,8
109456,5,28,7,0,21,7
109456,4,11,2,0,9,2
109456,3,10,3,1,7,2
109456,2,2,1,0,1,1
109456,1,12,7,3,5,4
1803,10,6,1,0,5,1
1803,9,19,9,0,10,9
1803,8,53,18,0,35,18
1803,7,32,9,0,23,9
1803,6,30,12,0,18,12
1803,5,6,2,0,4,2
1803,4,6,1,0,5,1
180650,10,1,1,0,0,1
180650,8,18,1,0,17,1
180650,7,36,4,0,32,4
180650,6,52,9,0,43,9
180650,5,24,4,0,20,4
180650,4,13,3,0,10,3
180650,3,3,1,0,2,1
355,9,2,1,0,1,1
355,8,11,4,0,7,4
355,7,31,12,0,19,12
355,6,54,16,0,38,16
355,5,30,10,0,20,10
355,4,11,3,0,8,3
355,3,13,7,0,6,7
224403,10,26,14,0,12,14
224403,9,27,13,0,14,13
224403,8,53,13,0,40,13
224403,7,27,7,0,20,7
224403,6,14,2,0,12,2
224403,5,3,2,1,1,1
224403,4,3,1,0,2,1
7464,8,6,3,0,3,3
7464,7,27,12,0,15,12
7464,6,58,34,0,24,34
7464,5,40,14,0,26,14
7464,4,17,4,0,13,4
7464,3,1,1,0,0,1
7464,2,4,1,0,3,1
10925,10,2,1,0,1,1
10925,7,12,3,0,9,3
10925,6,43,9,0,34,9
10925,5,42,9,0,33,9
10925,4,32,9,0,23,9
10925,3,10,6,0,4,6
10925,2,7,1,0,6,1
10925,1,1,1,0,0,1
1528,8,15,8,0,7,8
1528,7,27,13,0,14,13
1528,6,46,15,0,31,15
1528,5,41,17,0,24,17
1528,4,13,3,0,10,3
1528,3,7,3,0,4,3
1528,2,2,1,0,1,1
1528,1,1,1,0,0,1
195709,10,23,2,0,21,2
195709,9,33,3,0,30,3
195709,8,44,3,0,41,3
195709,7,42,5,1,37,4
5656,10,5,1,0,4,1
5656,9,5,1,0,4,1
5656,8,26,11,0,15,11
5656,7,34,6,0,28,6
5656,6,38,10,0,28,10
5656,5,25,5,0,20,5
5656,4,7,4,0,3,4
5656,3,8,2,0,6,2
5656,2,4,1,0,3,1
5656,1,1,1,0,0,1
149639,10,11,6,0,5,6
149639,9,7,2,0,5,2
149639,8,43,15,3,28,12
149639,7,30,7,0,23,7
149639,6,36,6,0,30,6
149639,5,8,1,0,7,1
149639,4,11,2,0,9,2
149639,2,2,1,0,1,1
103666,10,5,2,0,3,2
103666,9,7,2,0,5,2
103666,8,35,4,0,31,4
103666,7,43,5,0,38,5
103666,6,40,6,0,34,6
103666,5,15,2,0,13,2
103666,4,5,2,0,3,2
2040,8,10,7,0,3,7
2040,7,32,8,0,24,8
2040,6,55,16,0,39,16
2040,5,31,12,0,19,12
2040,4,13,5,0,8,5
2040,3,7,4,0,3,4
115793,10,2,2,0,0,2
115793,7,6,2,0,4,2
115793,6,26,2,0,24,2
115793,5,34,4,0,30,4
115793,4,32,4,0,28,4
115793,3,22,2,0,20,2
115793,2,19,4,0,15,4
115793,1,6,2,0,4,2
161719,10,3,1,0,2,1
161719,9,13,3,0,10,3
161719,8,34,7,3,27,4
161719,7,34,7,0,27,7
161719,6,38,9,1,29,8
161719,5,13,1,0,12,1
161719,4,12,5,0,7,5
161719,3,5,2,0,3,2
1744,10,6,2,0,4,2
1744,8,10,2,0,8,2
1744,7,20,9,0,11,9
1744,6,52,17,0,35,17
1744,5,30,9,0,21,9
1744,4,21,6,0,15,6
1744,3,12,8,0,4,8
1744,2,1,1,0,0,1
50719,8,18,5,0,13,5
50719,7,35,2,0,33,2
50719,6,61,2,0,59,2
50719,5,14,1,0,13,1
50719,4,8,1,0,7,1
50719,2,2,1,0,1,1
50719,1,1,1,0,0,1
5635,10,5,2,0,3,2
5635,9,16,5,0,11,5
5635,8,50,17,0,33,17
5635,7,42,14,0,28,14
5635,6,24,8,0,16,8
5635,5,9,5,0,4,5
5635,4,2,2,0,0,2
5635,3,1,1,0,0,1
5635,1,3,3,0,0,3
63900,9,1,1,0,0,1
63900,8,10,6,0,4,6
63900,7,16,3,0,13,3
63900,6,54,10,0,44,10
63900,5,31,6,0,25,6
63900,4,30,6,0,24,6
63900,3,8,4,0,4,4
1691,10,2,1,0,1,1
1691,8,13,5,0,8,5
1691,7,32,11,0,21,11
1691,6,49,15,0,34,15
1691,5,25,6,0,19,6
1691,4,19,4,0,15,4
1691,3,5,3,0,2,3
1691,2,6,2,0,4,2
3724,10,2,1,0,1,1
3724,8,26,9,0,17,9
3724,7,50,14,0,36,14
3724,6,41,10,0,31,10
3724,5,20,3,0,17,3
3724,4,6,4,0,2,4
3724,3,2,2,0,0,2
226605,10,13,7,2,6,5
226605,9,20,12,2,8,10
226605,8,53,17,3,36,14
226605,7,43,7,2,36,5
226605,6,15,4,1,11,3
226605,5,6,1,0,5,1
226605,4,3,1,0,2,1
226605,1,1,1,0,0,1
4235,9,5,2,0,3,2
4235,8,14,7,0,7,7
4235,7,45,13,0,32,13
4235,6,54,13,0,41,13
4235,5,20,10,0,10,10
4235,4,6,4,0,2,4
4235,3,5,2,0,3,2
2794,10,6,5,0,1,5
2794,9,12,4,0,8,4
2794,8,45,19,0,26,19
2794,7,32,7,0,25,7
2794,6,35,15,0,20,15
2794,5,12,5,0,7,5
2794,4,6,1,0,5,1
2794,3,3,2,0,1,2
2794,2,1,1,0,0,1
205826,10,6,3,0,3,3
205826,9,6,1,0,5,1
205826,8,39,9,0,30,9
205826,7,40,8,0,32,8
205826,6,40,4,0,36,4
205826,5,15,3,0,12,3
205826,3,2,1,0,1,1
2844,9,10,4,0,6,4
2844,8,28,11,0,17,11
2844,7,52,17,0,35,17
2844,6,38,8,0,30,8
2844,5,14,4,0,10,4
2844,4,5,1,0,4,1
2844,2,2,1,0,1,1
225981,8,19,1,0,18,1
225981,7,37,6,0,31,6
225981,6,42,6,0,36,6
225981,5,24,2,0,22,2
225981,4,15,2,0,13,2
225981,3,4,1,0,3,1
38499,9,1,1,0,0,1
38499,7,40,8,0,32,8
38499,6,67,22,0,45,22
38499,5,21,4,0,17,4
54201,10,3,1,0,2,1
54201,9,4,1,0,3,1
54201,8,30,9,0,21,9
54201,7,42,16,0,26,16
54201,6,51,20,0,31,20
54201,5,9,4,0,5,4
54201,4,10,4,0,6,4
54201,3,2,1,0,1,1
54201,2,1,1,0,0,1
16807,8,7,1,0,6,1
16807,7,12,5,0,7,5
16807,6,29,11,0,18,11
16807,5,42,20,0,22,20
16807,4,28,7,0,21,7
16807,3,16,8,0,8,8
16807,2,12,7,0,5,7
16807,1,7,4,0,3,4
12325,9,3,2,0,1,2
12325,8,27,9,0,18,9
12325,7,33,11,0,22,11
12325,6,48,14,0,34,14
12325,5,21,5,0,16,5
12325,4,12,4,0,8,4
12325,3,3,2,0,1,2
12325,2,3,2,0,1,2
12325,1,1,1,0,0,1
190017,10,7,2,0,5,2
190017,9,9,2,1,7,1
190017,8,34,6,0,28,6
190017,7,38,7,1,31,6
190017,6,42,3,0,39,3
190017,5,13,3,0,10,3
190017,4,6,2,0,4,2
190017,3,2,1,0,1,1
190017,1,2,2,1,0,1
179930,9,5,1,0,4,1
179930,8,17,7,2,10,5
179930,7,24,4,1,20,3
179930,6,59,17,1,42,16
179930,5,23,4,0,19,4
179930,4,16,6,0,10,6
179930,3,6,3,0,3,3
179930,1,1,1,0,0,1
183949,9,8,1,0,7,1
183949,8,19,4,0,15,4
183949,7,44,7,0,37,7
183949,6,51,5,0,46,5
183949,5,17,3,0,14,3
4162,8,6,3,0,3,3
4162,7,15,5,0,10,5
4162,6,47,15,0,32,15
4162,5,42,18,0,24,18
4162,4,19,8,0,11,8
4162,3,14,5,0,9,5
4162,2,7,4,0,3,4
4162,1,1,1,0,0,1
8285,9,2,1,0,1,1
8285,8,40,8,0,32,8
8285,7,43,11,0,32,11
8285,6,39,8,0,31,8
8285,5,14,3,0,11,3
8285,4,7,2,0,5,2
8887,10,12,7,0,5,7
8887,9,10,4,0,6,4
8887,8,48,18,0,30,18
8887,7,43,13,0,30,13
8887,6,23,4,0,19,4
8887,5,14,3,0,11,3
8887,4,2,2,0,0,2
149296,9,3,2,0,1,2
149296,8,11,2,0,9,2
149296,7,39,9,0,30,9
149296,6,52,9,0,43,9
149296,5,27,10,0,17,10
149296,4,13,2,0,11,2
5837,8,11,6,0,5,6
5837,7,26,10,0,16,10
5837,6,45,11,0,34,11
5837,5,37,9,0,28,9
5837,4,21,10,0,11,10
5837,3,6,3,0,3,3
5837,2,3,2,0,1,2
5837,1,1,1,0,0,1
7537,10,3,2,0,1,2
7537,9,3,2,0,1,2
7537,8,31,11,0,20,11
7537,7,41,11,0,30,11
7537,6,46,19,0,27,19
7537,5,18,8,0,10,8
7537,4,9,3,0,6,3
7537,1,1,1,0,0,1
174584,10,6,2,1,4,1
174584,9,7,1,0,6,1
174584,8,39,11,0,28,11
174584,7,36,10,1,26,9
174584,6,33,12,2,21,10
174584,5,16,6,2,10,4
174584,4,10,3,1,7,2
174584,2,2,1,0,1,1
174584,1,1,1,0,0,1
223449,10,4,1,1,3,0
223449,9,5,3,0,2,3
223449,8,41,6,2,35,4
223449,7,49,6,1,43,5
223449,6,37,7,0,30,7
223449,5,7,1,0,6,1
223449,4,7,1,0,6,1
223449,3,1,1,0,0,1
13703,7,13,4,0,9,4
13703,6,31,6,0,25,6
13703,5,48,18,0,30,18
13703,4,30,6,0,24,6
13703,3,14,6,0,8,6
13703,1,4,1,0,3,1
68876,10,2,2,0,0,2
68876,9,8,3,0,5,3
68876,8,29,10,0,19,10
68876,7,34,10,0,24,10
68876,6,45,19,0,26,19
68876,5,14,2,0,12,2
68876,4,11,6,0,5,6
68876,3,6,5,0,1,5
68876,2,1,1,0,0,1
68876,1,2,2,0,0,2
1358,10,9,4,0,5,4
1358,9,11,7,0,4,7
1358,8,48,23,0,25,23
1358,7,27,8,0,19,8
1358,6,35,13,0,22,13
1358,5,17,3,0,14,3
1358,4,4,2,0,2,2
1358,2,1,1,0,0,1
243435,9,4,1,0,3,1
243435,8,18,2,0,16,2
243435,7,27,1,0,26,1
243435,6,52,6,0,46,6
243435,5,27,3,0,24,3
243435,4,12,1,0,11,1
243435,3,6,1,0,5,1
146197,10,6,2,0,4,2
146197,9,13,3,0,10,3
146197,8,34,9,2,25,7
146197,7,29,5,0,24,5
146197,6,38,11,0,27,11
146197,5,12,1,0,11,1
146197,4,8,1,0,7,1
146197,3,8,3,0,5,3
146197,2,4,3,0,1,3
1866,9,2,1,0,1,1
1866,8,15,1,0,14,1
1866,7,21,1,0,20,1
1866,6,46,6,0,40,6
1866,5,39,4,0,35,4
1866,4,20,2,0,18,2
1866,3,6,1,0,5,1
40417,9,2,1,0,1,1
40417,8,12,4,0,8,4
40417,7,26,3,0,23,3
40417,6,48,5,0,43,5
40417,5,30,3,0,27,3
40417,4,22,7,0,15,7
40417,3,6,2,0,4,2
40417,2,6,3,0,3,3
1132,9,2,1,0,1,1
1132,8,17,5,0,12,5
1132,7,20,3,0,17,3
1132,6,44,5,0,39,5
1132,5,40,5,0,35,5
1132,4,19,7,0,12,7
1132,3,7,1,0,6,1
1132,2,3,2,0,1,2
5475,10,4,1,0,3,1
5475,9,7,2,0,5,2
5475,8,20,4,0,16,4
5475,7,27,6,0,21,6
5475,6,38,15,0,23,15
5475,5,30,14,0,16,14
5475,4,13,9,0,4,9
5475,3,4,2,0,2,2
5475,2,6,3,0,3,3
5475,1,3,1,0,2,1
2082,10,8,4,0,4,4
2082,8,19,3,0,16,3
2082,7,37,9,0,28,9
2082,6,44,4,0,40,4
2082,5,16,3,0,13,3
2082,4,13,5,0,8,5
2082,3,7,4,0,3,4
2082,1,2,1,0,1,1
122271,9,5,1,0,4,1
122271,8,24,3,0,21,3
122271,7,23,5,0,18,5
122271,6,53,15,1,38,14
122271,5,19,10,0,9,10
122271,4,11,7,1,4,6
122271,3,7,4,0,3,4
122271,1,5,2,0,3,2
20953,8,9,4,0,5,4
20953,7,25,7,0,18,7
20953,6,65,17,0,48,17
20953,5,30,8,0,22,8
20953,4,9,1,0,8,1
20953,3,5,3,0,2,3
20953,2,6,3,0,3,3
88253,10,13,3,0,10,3
88253,9,11,3,0,8,3
88253,8,60,16,0,44,16
88253,7,41,15,0,26,15
88253,6,21,9,0,12,9
88253,3,2,2,0,0,2
65590,9,4,1,0,3,1
65590,8,10,2,0,8,2
65590,7,35,5,0,30,5
65590,6,60,10,0,50,10
65590,5,30,4,0,26,4
65590,4,5,1,0,4,1
65590,2,2,2,0,0,2
126426,10,5,1,0,4,1
126426,9,9,2,0,7,2
126426,8,25,12,0,13,12
126426,7,47,19,0,28,19
126426,6,40,12,0,28,12
126426,5,14,3,0,11,3
126426,4,6,1,0,5,1
126426,3,4,2,0,2,2
170431,9,2,1,0,1,1
170431,8,13,2,2,11,0
170431,7,40,7,1,33,6
170431,6,56,9,1,47,8
170431,5,23,3,0,20,3
170431,3,3,1,0,2,1
170431,2,1,1,0,0,1
2149,9,2,1,0,1,1
2149,8,12,6,0,6,6
2149,7,22,4,0,18,4
2149,6,53,7,0,46,7
2149,5,34,8,0,26,8
2149,4,16,4,0,12,4
2149,3,9,3,0,6,3
184917,10,6,1,0,5,1
184917,9,4,1,0,3,1
184917,8,23,9,0,14,9
184917,7,28,7,0,21,7
184917,6,41,6,0,35,6
184917,5,29,4,0,25,4
184917,4,13,3,0,10,3
184917,3,6,3,0,3,3
99777,10,7,3,0,4,3
99777,9,7,1,0,6,1
99777,8,17,2,0,15,2
99777,7,25,7,0,18,7
99777,6,43,7,0,36,7
99777,5,23,5,0,18,5
99777,4,13,3,0,10,3
99777,3,10,5,0,5,5
99777,2,5,1,0,4,1
99777,1,1,1,0,0,1
8071,9,4,2,0,2,2
8071,8,22,9,0,13,9
8071,7,35,10,0,25,10
8071,6,57,13,0,44,13
8071,5,25,7,0,18,7
8071,4,5,1,0,4,1
8071,1,1,1,0,0,1
171663,8,9,5,0,4,5
171663,7,31,10,0,21,10
171663,6,63,15,0,48,15
171663,5,20,6,0,14,6
171663,4,11,4,0,7,4
171663,3,7,2,0,5,2
171663,1,1,1,0,0,1
3369,10,6,2,0,4,2
3369,9,4,1,0,3,1
3369,8,33,13,0,20,13
3369,7,34,15,0,19,15
3369,6,37,12,0,25,12
3369,5,21,8,0,13,8
3369,4,12,8,0,4,8
215392,8,22,6,0,16,6
215392,7,34,6,0,28,6
215392,6,50,5,0,45,5
215392,5,21,4,0,17,4
215392,4,12,3,0,9,3
215392,2,3,1,0,2,1
6698,10,5,1,0,4,1
6698,9,5,1,0,4,1
6698,8,13,5,0,8,5
6698,7,19,10,0,9,10
6698,6,48,16,0,32,16
6698,5,30,13,0,17,13
6698,4,12,7,0,5,7
6698,3,9,4,0,5,4
6698,2,9,5,0,4,5
91425,9,4,1,0,3,1
91425,8,15,4,0,11,4
91425,7,45,5,0,40,5
91425,6,47,7,0,40,7
91425,5,25,5,0,20,5
91425,4,8,2,0,6,2
240759,8,29,4,0,25,4
240759,7,44,4,0,40,4
240759,6,46,7,0,39,7
240759,5,14,3,0,11,3
240759,4,5,1,0,4,1
89695,10,6,2,0,4,2
89695,8,43,13,0,30,13
89695,7,46,15,0,31,15
89695,6,42,14,0,28,14
89695,5,6,3,0,3,3
154857,10,5,3,0,2,3
154857,9,6,1,0,5,1
154857,8,44,6,0,38,6
154857,7,38,6,0,32,6
154857,6,32,5,0,27,5
154857,5,13,1,0,12,1
154857,3,3,1,0,2,1
154857,2,4,3,0,1,3
97939,10,11,9,0,2,9
97939,9,12,6,0,6,6
97939,8,29,8,1,21,7
97939,7,36,10,2,26,8
97939,6,41,11,0,30,11
97939,5,8,3,1,5,2
97939,4,10,6,0,4,6
97939,3,3,1,0,2,1
97939,2,1,1,0,0,1
1588,8,14,3,0,11,3
1588,7,25,4,0,21,4
1588,6,60,14,0,46,14
1588,5,27,5,0,22,5
1588,4,14,5,0,9,5
1588,3,6,1,0,5,1
1588,2,4,1,0,3,1
3411,10,5,2,0,3,2
3411,9,19,4,0,15,4
3411,8,43,12,0,31,12
3411,7,37,8,0,29,8
3411,6,24,7,0,17,7
3411,5,10,4,0,6,4
3411,4,6,3,0,3,3
3411,3,3,1,0,2,1
3411,2,2,1,0,1,1
3411,1,2,2,0,0,2
217554,9,3,1,0,2,1
217554,8,16,6,0,10,6
217554,7,29,6,0,23,6
217554,6,68,8,0,60,8
217554,5,19,3,0,16,3
217554,4,11,2,0,9,2
217554,2,2,1,0,1,1
158267,9,7,2,0,5,2
158267,7,26,4,0,22,4
158267,6,65,8,0,57,8
158267,5,27,4,0,23,4
158267,2,2,1,0,1,1
232345,10,2,1,0,1,1
232345,9,6,1,0,5,1
232345,8,27,5,0,22,5
232345,7,46,3,0,43,3
232345,6,46,13,1,33,12
232345,5,12,3,0,9,3
232345,4,8,2,0,6,2
232345,3,3,2,0,1,2
232345,1,1,1,0,0,1
2725,9,4,2,0,2,2
2725,8,14,6,0,8,6
2725,7,22,6,0,16,6
2725,6,49,12,0,37,12
2725,5,31,12,0,19,12
2725,4,11,6,0,5,6
2725,3,11,5,0,6,5
2725,2,5,1,0,4,1
4892,10,1,1,0,0,1
4892,9,5,1,0,4,1
4892,8,9,5,0,4,5
4892,7,11,6,0,5,6
4892,6,37,16,0,21,16
4892,5,46,25,0,21,25
4892,4,17,11,0,6,11
4892,3,5,1,0,4,1
1869,8,17,4,0,13,4
1869,7,31,4,0,27,4
1869,6,40,13,0,27,13
1869,5,23,6,0,17,6
1869,4,19,2,0,17,2
1869,3,9,2,0,7,2
1869,2,3,1,0,2,1
156062,8,19,1,0,18,1
156062,7,44,2,0,42,2
156062,6,47,1,0,46,1
156062,5,15,3,0,12,3
156062,4,13,2,0,11,2
147171,10,10,6,0,4,6
147171,9,20,9,0,11,9
147171,8,47,7,1,40,6
147171,7,33,7,1,26,6
147171,6,25,3,1,22,2
147171,5,8,2,0,6,2
147171,4,3,1,0,2,1
15386,10,2,2,0,0,2
15386,9,4,2,0,2,2
15386,8,29,14,0,15,14
15386,7,42,16,0,26,16
15386,6,46,18,0,28,18
15386,5,18,5,0,13,5
23917,10,1,1,0,0,1
23917,9,9,6,0,3,6
23917,8,55,28,0,27,28
23917,7,47,16,0,31,16
23917,6,19,6,0,13,6
23917,5,8,5,0,3,5
23917,4,5,4,0,1,4
23917,3,3,1,0,2,1
23917,1,3,2,0,1,2
180920,9,4,2,0,2,2
180920,8,14,2,0,12,2
180920,7,22,5,0,17,5
180920,6,40,12,0,28,12
180920,5,32,2,0,30,2
180920,4,15,4,0,11,4
180920,3,15,3,0,12,3
180920,2,6,3,0,3,3
113301,9,9,6,0,3,6
113301,8,21,8,0,13,8
113301,7,33,9,0,24,9
113301,6,47,6,0,41,6
113301,5,24,7,0,17,7
113301,4,10,3,0,7,3
113301,3,5,1,0,4,1
68250,10,4,1,0,3,1
68250,9,4,1,0,3,1
68250,8,31,11,0,20,11
68250,7,53,20,0,33,20
68250,6,43,18,0,25,18
68250,5,11,5,0,6,5
68250,4,4,2,0,2,2
181464,10,12,8,0,4,8
181464,9,13,6,0,7,6
181464,8,31,11,3,20,8
181464,7,25,5,1,20,4
181464,6,41,7,1,34,6
181464,5,13,3,0,10,3
181464,4,8,2,0,6,2
181464,3,7,1,0,6,1
33967,7,20,4,0,16,4
33967,6,39,9,0,30,9
33967,5,46,13,0,33,13
33967,4,19,5,0,14,5
33967,3,17,5,0,12,5
33967,2,3,2,0,1,2
33967,1,3,1,0,2,1
136554,8,14,2,0,12,2
136554,7,20,2,0,18,2
136554,6,38,4,0,34,4
136554,5,30,6,0,24,6
136554,4,26,5,0,21,5
136554,3,9,5,0,4,5
136554,2,7,2,0,5,2
136554,1,4,2,0,2,2
31216,8,17,6,0,11,6
31216,7,27,6,0,21,6
31216,6,47,22,0,25,22
31216,5,20,5,0,15,5
31216,4,13,4,0,9,4
31216,3,12,2,0,10,2
31216,2,6,4,0,2,4
31216,1,5,3,0,2,3
20889,10,6,1,0,5,1
20889,9,16,7,0,9,7
20889,8,52,20,0,32,20
20889,7,36,9,0,27,9
20889,6,25,9,0,16,9
20889,5,10,5,0,5,5
20889,4,5,3,0,2,3
20889,3,1,1,0,0,1
5235,10,5,2,0,3,2
5235,8,27,3,0,24,3
5235,7,53,8,0,45,8
5235,6,40,7,0,33,7
5235,5,16,4,0,12,4
5235,4,5,1,0,4,1
5235,3,3,2,0,1,2
241796,10,16,7,0,9,7
241796,9,9,2,0,7,2
241796,8,35,4,0,31,4
241796,7,39,7,0,32,7
241796,6,33,4,0,29,4
241796,5,8,1,0,7,1
241796,4,5,1,0,4,1
241796,3,3,1,0,2,1
8432,9,2,1,0,1,1
8432,8,1,1,0,0,1
8432,7,15,5,0,10,5
8432,6,32,12,0,20,12
8432,5,46,9,0,37,9
8432,4,29,8,0,21,8
8432,3,9,2,0,7,2
8432,2,13,5,0,8,5
8432,1,3,1,0,2,1
28508,10,3,1,0,2,1
28508,8,10,1,0,9,1
28508,7,23,6,0,17,6
28508,6,46,11,0,35,11
28508,5,27,4,0,23,4
28508,4,25,6,0,19,6
28508,3,6,1,0,5,1
28508,2,4,2,0,2,2
5992,9,1,1,0,0,1
5992,8,19,6,0,13,6
5992,7,35,14,0,21,14
5992,6,64,17,0,47,17
5992,5,19,7,0,12,7
5992,4,8,4,0,4,4
58624,10,6,3,0,3,3
58624,9,12,3,0,9,3
58624,8,63,21,0,42,21
58624,7,50,17,0,33,17
58624,6,16,5,0,11,5
58624,4,1,1,0,0,1
17125,9,2,1,0,1,1
17125,8,36,15,0,21,15
17125,7,30,9,0,21,9
17125,6,48,25,0,23,25
17125,5,17,10,0,7,10
17125,4,12,9,0,3,9
17125,2,2,2,0,0,2
167,10,1,1,0,0,1
167,8,23,5,0,18,5
167,7,36,8,0,28,8
167,6,49,5,0,44,5
167,5,19,2,0,17,2
167,4,7,3,0,4,3
167,3,8,4,0,4,4
167,2,1,1,0,0,1
167,1,1,1,0,0,1
1780,10,5,3,0,2,3
1780,9,9,4,0,5,4
1780,8,25,10,0,15,10
1780,7,29,12,0,17,12
1780,6,46,14,0,32,14
1780,5,24,7,0,17,7
1780,4,9,4,0,5,4
1780,3,3,3,0,0,3
160908,9,14,3,0,11,3
160908,8,61,10,0,51,10
160908,7,29,3,0,26,3
160908,6,22,2,0,20,2
160908,4,7,3,0,4,3
160908,2,2,2,0,0,2
41573,9,1,1,0,0,1
41573,8,9,2,0,7,2
41573,7,20,6,0,14,6
41573,6,65,11,0,54,11
41573,5,25,6,0,19,6
41573,4,16,1,0,15,1
41573,3,9,4,0,5,4
41573,2,5,1,0,4,1
175861,10,7,1,0,6,1
175861,9,4,2,0,2,2
175861,8,4,1,0,3,1
175861,7,14,3,0,11,3
175861,6,31,12,0,19,12
175861,5,24,2,0,22,2
175861,4,21,3,0,18,3
175861,3,23,7,0,16,7
175861,2,12,2,0,10,2
175861,1,10,3,0,7,3
5232,9,1,1,0,0,1
5232,7,15,5,0,10,5
5232,6,31,13,0,18,13
5232,5,37,18,0,19,18
5232,4,35,16,0,19,16
5232,3,15,8,0,7,8
5232,2,11,6,0,5,6
5232,1,4,3,0,1,3
1375,9,4,2,0,2,2
1375,8,22,3,0,19,3
1375,7,40,12,0,28,12
1375,6,48,19,0,29,19
1375,5,21,4,0,17,4
1375,4,8,3,0,5,3
1375,2,2,1,0,1,1
18686,10,8,2,0,6,2
18686,7,17,1,0,16,1
18686,6,25,4,0,21,4
18686,5,37,8,0,29,8
18686,4,23,3,0,20,3
18686,3,17,5,0,12,5
18686,2,9,3,0,6,3
18686,1,9,2,0,7,2
175023,9,8,3,0,5,3
175023,8,24,4,0,20,4
175023,7,39,5,0,34,5
175023,6,44,12,0,32,12
175023,5,17,4,0,13,4
175023,4,9,1,0,8,1
175023,3,4,2,0,2,2
32495,10,3,2,0,1,2
32495,9,4,1,0,3,1
32495,8,11,3,0,8,3
32495,7,27,5,0,22,5
32495,6,41,13,0,28,13
32495,5,23,7,0,16,7
32495,4,16,4,0,12,4
32495,3,12,3,0,9,3
32495,2,10,2,0,8,2
18481,10,4,1,0,3,1
18481,9,4,3,0,1,3
18481,8,19,8,0,11,8
18481,7,30,10,0,20,10
18481,6,65,29,0,36,29
18481,5,18,5,0,13,5
18481,4,7,2,0,5,2
18481,3,2,2,0,0,2
172309,8,31,5,0,26,5
172309,7,38,7,0,31,7
172309,6,56,8,0,48,8
172309,5,17,2,0,15,2
172309,4,6,1,0,5,1
20031,8,15,5,0,10,5
20031,7,22,8,0,14,8
20031,6,72,24,0,48,24
20031,5,20,6,0,14,6
20031,4,18,7,0,11,7
20031,3,2,2,0,0,2
3003,10,20,7,0,13,7
3003,9,21,9,0,12,9
3003,8,47,14,0,33,14
3003,7,31,11,0,20,11
3003,6,21,6,0,15,6
3003,5,6,3,0,3,3
3003,4,4,3,0,1,3
72808,9,7,1,0,6,1
72808,8,22,3,0,19,3
72808,7,36,3,0,33,3
72808,6,51,7,0,44,7
72808,5,16,1,0,15,1
72808,4,12,2,0,10,2
72808,1,2,1,0,1,1
197269,9,13,4,0,9,4
197269,8,41,5,1,36,4
197269,7,46,19,0,27,19
197269,6,39,6,1,33,5
197269,4,2,1,0,1,1
89951,8,29,6,0,23,6
89951,7,47,10,0,37,10
89951,6,44,5,0,39,5
89951,5,14,2,0,12,2
89951,1,1,1,0,0,1
2929,10,5,1,0,4,1
2929,7,14,5,0,9,5
2929,6,31,7,0,24,7
2929,5,32,7,0,25,7
2929,4,32,13,0,19,13
2929,3,17,6,0,11,6
2929,2,11,1,0,10,1
2929,1,3,1,0,2,1
188390,10,21,2,0,19,2
188390,9,41,14,0,27,14
188390,8,51,12,0,39,12
188390,7,17,4,0,13,4
188390,6,13,3,0,10,3
188390,5,3,2,0,1,2
188390,4,1,1,0,0,1
188390,3,2,2,0,0,2
8104,8,5,1,0,4,1
8104,7,16,3,0,13,3
8104,6,37,7,0,30,7
8104,5,35,6,0,29,6
8104,4,26,5,0,21,5
8104,3,15,2,0,13,2
8104,2,12,3,0,9,3
8104,1,2,1,0,1,1
19212,10,5,2,0,3,2
19212,9,5,2,0,3,2
19212,8,28,11,0,17,11
19212,7,37,12,0,25,12
19212,6,54,26,0,28,26
19212,5,12,5,0,7,5
19212,4,6,4,0,2,4
19212,2,3,1,0,2,1
1252,10,1,1,0,0,1
1252,9,5,3,0,2,3
1252,8,15,6,0,9,6
1252,7,22,7,0,15,7
1252,6,54,17,0,37,17
1252,5,32,3,0,29,3
1252,4,13,3,0,10,3
1252,3,5,1,0,4,1
1252,2,2,1,0,1,1
1252,1,1,1,0,0,1
19505,10,6,1,0,5,1
19505,9,4,2,0,2,2
19505,8,19,3,0,16,3
19505,7,38,6,0,32,6
19505,6,37,5,0,32,5
19505,5,20,3,0,17,3
19505,4,17,5,0,12,5
19505,3,3,1,0,2,1
19505,2,5,1,0,4,1
4275,10,7,4,0,3,4
4275,9,17,9,0,8,9
4275,8,47,22,0,25,22
4275,7,43,10,0,33,10
4275,6,17,3,0,14,3
4275,5,13,2,0,11,2
4275,4,2,2,0,0,2
5480,10,4,2,0,2,2
5480,9,5,3,0,2,3
5480,8,25,14,0,11,14
5480,7,41,9,0,32,9
5480,6,40,14,0,26,14
5480,5,18,5,0,13,5
5480,4,7,4,0,3,4
5480,3,6,2,0,4,2
5480,2,1,1,0,0,1
5480,1,2,2,0,0,2
5171,10,11,4,0,7,4
5171,9,16,9,0,7,9
5171,8,33,11,0,22,11
5171,7,40,7,0,33,7
5171,6,23,5,0,18,5
5171,5,18,8,0,10,8
5171,3,5,3,0,2,3
128028,8,11,4,0,7,4
128028,7,21,3,0,18,3
128028,6,44,5,0,39,5
128028,5,30,5,0,25,5
128028,4,17,2,0,15,2
128028,3,10,3,0,7,3
128028,2,8,2,0,6,2
128028,1,5,1,0,4,1
41311,9,5,1,0,4,1
41311,7,29,1,0,28,1
41311,6,52,3,0,49,3
41311,4,14,1,0,13,1
41311,3,5,1,0,4,1
41311,2,2,1,0,1,1
41311,1,3,1,0,2,1
18212,10,8,1,0,7,1
18212,8,22,4,0,18,4
18212,7,27,3,0,24,3
18212,6,52,7,0,45,7
18212,5,19,5,0,14,5
18212,4,9,2,0,7,2
18212,3,3,1,0,2,1
18212,2,3,1,0,2,1
3850,10,4,3,0,1,3
3850,9,2,1,0,1,1
3850,8,13,5,0,8,5
3850,7,18,11,0,7,11
3850,6,34,6,0,28,6
3850,5,25,9,0,16,9
3850,4,18,6,0,12,6
3850,3,22,8,0,14,8
3850,2,10,6,0,4,6
3850,1,3,3,0,0,3
150761,10,26,4,0,22,4
150761,9,41,6,0,35,6
150761,8,53,10,0,43,10
150761,7,19,2,0,17,2
150761,6,5,1,0,4,1
150761,5,1,1,0,0,1
93287,10,11,1,0,10,1
93287,9,14,2,0,12,2
93287,8,41,2,0,39,2
93287,7,35,11,0,24,11
93287,6,34,6,0,28,6
93287,5,9,1,0,8,1
7753,9,8,2,0,6,2
7753,8,26,13,0,13,13
7753,7,50,16,0,34,16
7753,6,32,11,0,21,11
7753,5,20,6,0,14,6
7753,4,4,3,0,1,3
7753,3,3,2,0,1,2
7753,1,2,1,0,1,1
141067,10,40,15,0,25,15
141067,9,35,13,1,22,12
141067,8,45,10,0,35,10
141067,7,16,5,0,11,5
141067,6,10,1,0,9,1
141067,1,2,1,0,1,1
130908,10,1,1,0,0,1
130908,8,31,6,0,25,6
130908,7,37,5,0,32,5
130908,6,46,3,0,43,3
130908,4,7,2,0,5,2
130908,3,5,2,0,3,2
245487,9,18,6,0,12,6
245487,8,71,35,0,36,35
245487,7,38,15,0,23,15
245487,6,14,11,0,3,11
245487,5,7,4,0,3,4
245487,4,1,1,0,0,1
20645,8,7,1,0,6,1
20645,7,19,1,0,18,1
20645,6,65,8,0,57,8
20645,5,32,7,0,25,7
20645,4,19,2,0,17,2
205101,10,12,10,0,2,10
205101,9,9,6,0,3,6
205101,8,13,5,1,8,4
205101,7,17,4,0,13,4
205101,6,32,4,0,28,4
205101,5,13,2,0,11,2
205101,4,8,4,0,4,4
205101,3,13,3,0,10,3
205101,2,4,2,1,2,1
205101,1,20,13,2,7,11
8722,10,5,1,0,4,1
8722,9,7,3,0,4,3
8722,8,30,7,0,23,7
8722,7,44,17,0,27,17
8722,6,43,10,0,33,10
8722,5,14,6,0,8,6
8722,4,4,2,0,2,2
8722,3,2,1,0,1,1
6282,10,3,1,0,2,1
6282,8,29,11,0,18,11
6282,7,33,9,0,24,9
6282,6,44,14,0,30,14
6282,5,20,4,0,16,4
6282,4,17,8,0,9,8
147009,9,6,2,0,4,2
147009,8,12,4,0,8,4
147009,7,20,8,0,12,8
147009,6,57,9,0,48,9
147009,5,25,3,0,22,3
147009,4,19,8,0,11,8
147009,3,6,3,0,3,3
147009,2,2,1,0,1,1
218933,10,18,3,0,15,3
218933,9,33,8,0,25,8
218933,8,54,13,0,41,13
218933,7,26,2,0,24,2
218933,6,11,2,0,9,2
218933,1,2,1,0,1,1
254088,9,10,2,0,8,2
254088,8,47,8,0,39,8
254088,7,46,3,0,43,3
254088,6,34,6,0,28,6
254088,5,4,1,0,3,1
254088,4,6,3,0,3,3
877,9,2,1,0,1,1
877,8,9,1,0,8,1
877,7,26,7,0,19,7
877,6,55,11,0,44,11
877,5,22,6,0,16,6
877,4,24,6,0,18,6
877,3,6,1,0,5,1
877,2,3,3,0,0,3
877,1,2,2,0,0,2
260201,9,10,4,0,6,4
260201,8,34,4,0,30,4
260201,7,50,7,0,43,7
260201,6,31,7,0,24,7
260201,5,8,1,0,7,1
260201,4,4,3,0,1,3
260201,3,3,1,0,2,1
260201,1,7,1,0,6,1
100169,10,9,4,0,5,4
100169,9,15,7,0,8,7
100169,8,63,24,0,39,24
100169,7,38,17,0,21,17
100169,6,17,5,0,12,5
100169,5,6,5,0,1,5
44338,10,4,1,0,3,1
44338,9,8,2,0,6,2
44338,8,20,2,0,18,2
44338,7,34,7,0,27,7
44338,6,48,8,0,40,8
44338,5,16,3,0,13,3
44338,4,11,2,0,9,2
44338,3,4,2,0,2,2
44338,1,3,1,0,2,1
76447,10,3,2,0,1,2
76447,9,4,2,0,2,2
76447,8,18,7,0,11,7
76447,7,27,8,0,19,8
76447,6,37,10,0,27,10
76447,5,27,3,0,24,3
76447,4,14,5,0,9,5
76447,3,7,2,0,5,2
76447,2,8,6,0,2,6
128204,10,16,4,0,12,4
128204,9,18,9,2,9,7
128204,8,36,15,2,21,13
128204,7,36,8,1,28,7
128204,6,30,6,1,24,5
128204,5,10,1,0,9,1
128204,4,1,1,0,0,1
226256,10,6,2,0,4,2
226256,9,8,2,0,6,2
226256,8,34,3,0,31,3
226256,7,41,5,0,36,5
226256,6,39,4,0,35,4
226256,5,13,2,0,11,2
226256,4,7,1,0,6,1
226256,3,1,1,0,0,1
205774,10,7,2,0,5,2
205774,9,7,3,0,4,3
205774,8,45,6,0,39,6
205774,7,45,5,0,40,5
205774,6,25,3,0,22,3
205774,5,10,1,0,9,1
205774,4,6,1,0,5,1
205774,3,3,1,0,2,1
205774,2,1,1,0,0,1
25453,9,5,2,0,3,2
25453,8,17,2,0,15,2
25453,7,35,13,0,22,13
25453,6,59,13,0,46,13
25453,5,12,2,0,10,2
25453,4,16,5,0,11,5
27870,9,1,1,0,0,1
27870,8,7,3,0,4,3
27870,7,13,7,0,6,7
27870,6,55,12,0,43,12
27870,5,38,12,0,26,12
27870,4,14,7,0,7,7
27870,3,15,6,0,9,6
27870,2,4,3,0,1,3
221198,10,4,1,0,3,1
221198,9,7,3,0,4,3
221198,8,16,4,1,12,3
221198,7,37,5,0,32,5
221198,6,43,10,1,33,9
221198,5,22,7,0,15,7
221198,4,11,2,0,9,2
221198,3,5,3,0,2,3
221198,2,4,1,0,3,1
6383,9,3,1,0,2,1
6383,8,11,1,0,10,1
6383,7,20,3,0,17,3
6383,6,44,9,0,35,9
6383,5,31,3,0,28,3
6383,3,10,1,0,9,1
6383,2,6,2,0,4,2
6383,1,4,3,0,1,3
21358,10,34,7,0,27,7
21358,9,30,8,0,22,8
21358,8,37,9,0,28,9
21358,7,16,7,0,9,7
21358,6,20,4,0,16,4
21358,5,4,3,0,1,3
21358,2,1,1,0,0,1
241334,10,23,9,0,14,9
241334,9,12,4,0,8,4
241334,8,37,6,2,31,4
241334,7,36,6,2,30,4
241334,6,18,4,1,14,3
241334,5,10,6,2,4,4
241334,4,7,4,1,3,3
241334,3,4,1,1,3,0
241334,1,1,1,0,0,1
612,9,6,3,0,3,3
612,8,8,5,0,3,5
612,7,36,7,0,29,7
612,6,47,13,0,34,13
612,5,30,7,0,23,7
612,4,9,6,0,3,6
612,3,7,2,0,5,2
612,1,2,1,0,1,1
29126,9,5,3,0,2,3
29126,8,18,9,0,9,9
29126,7,40,10,0,30,10
29126,6,51,17,0,34,17
29126,5,18,6,0,12,6
29126,4,13,2,0,11,2
29126,2,3,2,0,1,2
31803,9,2,2,0,0,2
31803,8,18,6,0,12,6
31803,7,37,11,0,26,11
31803,6,53,14,0,39,14
31803,5,24,6,0,18,6
31803,4,10,4,0,6,4
31803,3,4,2,0,2,2
130134,10,10,7,1,3,6
130134,9,26,11,0,15,11
130134,8,47,12,3,35,9
130134,7,21,3,1,18,2
130134,6,16,4,0,12,4
130134,5,10,3,1,7,2
130134,4,5,1,0,4,1
130134,3,7,2,0,5,2
130134,2,2,1,0,1,1
130134,1,5,3,0,2,3
12567,10,13,11,0,2,11
12567,9,19,9,0,10,9
12567,8,45,18,0,27,18
12567,7,43,18,0,25,18
12567,6,14,5,0,9,5
12567,5,7,3,0,4,3
12567,4,4,1,0,3,1
12567,3,1,1,0,0,1
12567,1,2,1,0,1,1
140386,10,1,1,0,0,1
140386,9,4,2,0,2,2
140386,8,8,4,0,4,4
140386,7,25,7,0,18,7
140386,6,48,9,0,39,9
140386,5,30,2,0,28,2
140386,4,19,2,0,17,2
140386,3,9,1,0,8,1
140386,1,2,1,0,1,1
243994,10,11,8,0,3,8
243994,9,6,1,0,5,1
243994,8,34,6,0,28,6
243994,7,37,2,0,35,2
243994,6,37,5,0,32,5
243994,5,16,4,0,12,4
243994,4,6,1,0,5,1
236248,10,10,3,0,7,3
236248,9,13,3,0,10,3
236248,8,49,8,0,41,8
236248,7,44,6,0,38,6
236248,6,24,3,0,21,3
9855,10,14,7,0,7,7
9855,9,15,7,0,8,7
9855,8,33,9,0,24,9
9855,7,34,6,0,28,6
9855,6,24,5,0,19,5
9855,5,13,5,0,8,5
9855,4,8,3,0,5,3
9855,3,5,2,0,3,2
9855,2,1,1,0,0,1
9855,1,1,1,0,0,1
836,10,2,1,0,1,1
836,9,5,2,0,3,2
836,8,39,9,0,30,9
836,7,48,16,0,32,16
836,6,29,13,0,16,13
836,5,13,7,0,6,7
836,4,9,3,0,6,3
137789,10,2,2,0,0,2
137789,8,21,3,0,18,3
137789,7,29,3,0,26,3
137789,6,54,11,0,43,11
137789,5,21,3,0,18,3
137789,4,13,2,0,11,2
137789,3,6,1,0,5,1
166658,8,6,1,0,5,1
166658,7,12,3,0,9,3
166658,6,37,8,0,29,8
166658,5,34,9,0,25,9
166658,4,19,2,0,17,2
166658,3,23,5,0,18,5
166658,2,13,6,0,7,6
166658,1,4,1,0,3,1
130229,8,23,6,0,17,6
130229,7,31,7,0,24,7
130229,6,64,9,0,55,9
130229,4,12,3,0,9,3
130229,3,2,1,0,1,1
130229,2,2,1,0,1,1
166026,9,2,1,0,1,1
166026,8,11,5,0,6,5
166026,7,25,8,0,17,8
166026,6,42,5,0,37,5
166026,5,33,2,0,31,2
166026,4,21,4,0,17,4
166026,3,5,1,0,4,1
166026,2,6,4,0,2,4
195231,10,8,2,0,6,2
195231,9,6,2,1,4,1
195231,8,25,6,1,19,5
195231,7,44,11,2,33,9
195231,6,37,6,2,31,4
195231,3,5,2,0,3,2
5700,8,25,10,0,15,10
5700,7,29,12,0,17,12
5700,6,57,15,0,42,15
5700,5,18,3,0,15,3
5700,4,12,3,0,9,3
224013,8,18,3,0,15,3
224013,7,38,8,0,30,8
224013,6,53,6,0,47,6
224013,5,16,4,0,12,4
224013,4,14,4,0,10,4
224013,3,5,2,0,3,2
687,10,1,1,0,0,1
687,8,19,7,0,12,7
687,7,36,9,0,27,9
687,6,58,15,0,43,15
687,5,20,6,0,14,6
687,4,9,5,0,4,5
687,3,3,3,0,0,3
687,2,1,1,0,0,1
249039,9,5,3,0,2,3
249039,8,25,5,0,20,5
249039,7,31,3,0,28,3
249039,6,49,3,0,46,3
249039,5,20,5,0,15,5
249039,4,11,2,0,9,2
249039,3,5,1,0,4,1
14036,9,5,2,0,3,2
14036,8,14,2,0,12,2
14036,7,27,4,0,23,4
14036,6,50,7,0,43,7
14036,5,24,2,0,22,2
14036,4,14,1,0,13,1
14036,3,9,1,0,8,1
14036,1,1,1,0,0,1
170669,10,23,15,1,8,14
170669,9,47,14,0,33,14
170669,8,56,19,4,37,15
170669,7,8,2,0,6,2
170669,6,7,5,0,2,5
170669,5,3,2,0,1,2
170669,4,3,2,0,1,2
10642,10,16,6,0,10,6
10642,9,39,12,0,27,12
10642,8,49,12,0,37,12
10642,7,28,6,0,22,6
10642,5,6,1,0,5,1
135508,10,11,6,0,5,6
135508,9,26,5,0,21,5
135508,8,39,16,0,23,16
135508,7,15,7,0,8,7
135508,6,27,10,0,17,10
135508,5,11,1,0,10,1
135508,4,8,6,0,2,6
135508,3,7,4,0,3,4
135508,2,4,2,0,2,2
173784,9,6,1,0,5,1
173784,8,24,6,0,18,6
173784,7,32,1,0,31,1
173784,6,41,11,0,30,11
173784,5,23,2,0,21,2
173784,4,13,4,0,9,4
173784,3,4,1,0,3,1
8316,10,14,2,0,12,2
8316,9,27,6,0,21,6
8316,8,47,12,0,35,12
8316,7,31,9,0,22,9
8316,6,19,8,0,11,8
8316,5,7,2,0,5,2
8316,4,2,1,0,1,1
5491,9,6,4,0,2,4
5491,8,19,6,0,13,6
5491,7,32,11,0,21,11
5491,6,52,13,0,39,13
5491,5,24,6,0,18,6
5491,4,8,2,0,6,2
5491,3,5,1,0,4,1
5491,1,1,1,0,0,1
35179,10,4,1,0,3,1
35179,9,9,1,0,8,1
35179,8,21,2,0,19,2
35179,7,37,9,0,28,9
35179,6,53,9,0,44,9
35179,5,17,3,0,14,3
172033,9,3,1,0,2,1
172033,8,14,3,0,11,3
172033,7,36,7,0,29,7
172033,6,53,8,0,45,8
172033,5,28,6,0,22,6
172033,4,10,1,0,9,1
230765,9,18,4,1,14,3
230765,8,46,8,2,38,6
230765,7,40,3,0,37,3
230765,6,20,3,0,17,3
230765,4,6,2,0,4,2
12964,8,9,7,0,2,7
12964,7,25,11,0,14,11
12964,6,60,19,0,41,19
12964,5,25,7,0,18,7
12964,4,17,6,0,11,6
12964,3,5,3,0,2,3
229599,10,10,7,0,3,7
229599,9,15,5,0,10,5
229599,8,32,4,0,28,4
229599,7,34,5,0,29,5
229599,6,35,3,0,32,3
229599,5,12,1,0,11,1
229599,3,4,1,0,3,1
36597,10,10,4,0,6,4
36597,9,19,8,0,11,8
36597,8,58,9,0,49,9
36597,7,42,9,0,33,9
36597,6,11,3,0,8,3
36597,5,5,3,0,2,3
36597,4,2,1,0,1,1
18399,8,5,2,0,3,2
18399,7,19,9,0,10,9
18399,6,51,20,0,31,20
18399,5,37,13,0,24,13
18399,4,24,7,0,17,7
18399,3,4,1,0,3,1
18399,1,2,1,0,1,1
32149,10,8,5,0,3,5
32149,9,13,4,0,9,4
32149,8,32,10,0,22,10
32149,7,36,17,0,19,17
32149,6,27,14,0,13,14
32149,5,18,5,0,13,5
32149,4,7,1,0,6,1
32149,3,3,2,0,1,2
32149,2,3,2,0,1,2
16369,9,3,2,0,1,2
16369,8,16,8,0,8,8
16369,7,37,11,0,26,11
16369,6,45,11,0,34,11
16369,5,33,6,0,27,6
16369,4,7,1,0,6,1
16369,3,6,1,0,5,1
207242,9,10,4,0,6,4
207242,8,44,9,2,35,7
207242,7,34,7,1,27,6
207242,6,42,11,2,31,9
207242,5,10,3,0,7,3
207242,4,3,2,0,1,2
130907,8,15,4,0,11,4
130907,7,33,5,0,28,5
130907,6,52,3,0,49,3
130907,5,28,2,0,26,2
219475,10,4,2,0,2,2
219475,9,6,1,0,5,1
219475,8,31,10,0,21,10
219475,7,47,7,0,40,7
219475,6,39,7,0,32,7
219475,5,9,2,0,7,2
219475,4,10,2,0,8,2
5042,10,9,4,0,5,4
5042,9,12,5,0,7,5
5042,8,45,13,0,32,13
5042,7,38,7,0,31,7
5042,6,29,7,0,22,7
5042,5,11,6,0,5,6
5042,4,2,1,0,1,1
2426,10,2,1,0,1,1
2426,9,2,1,0,1,1
2426,8,7,2,0,5,2
2426,7,12,3,0,9,3
2426,6,43,14,0,29,14
2426,5,33,12,0,21,12
2426,4,29,10,0,19,10
2426,3,11,6,0,5,6
2426,2,7,4,0,3,4
247733,10,3,2,0,1,2
247733,9,7,3,0,4,3
247733,8,33,8,0,25,8
247733,7,46,8,0,38,8
247733,6,27,7,0,20,7
247733,5,14,4,0,10,4
247733,4,10,5,0,5,5
247733,3,5,3,0,2,3
247733,2,2,1,0,1,1
118315,9,6,1,0,5,1
118315,8,11,4,0,7,4
118315,7,26,6,1,20,5
118315,6,37,8,0,29,8
118315,5,26,6,2,20,4
118315,4,20,3,1,17,2
118315,3,5,1,0,4,1
118315,2,7,2,0,5,2
118315,1,6,4,1,2,3
41890,10,4,1,0,3,1
41890,8,9,2,0,7,2
41890,7,25,9,0,16,9
41890,6,43,5,0,38,5
41890,5,26,3,0,23,3
41890,4,21,3,0,18,3
41890,3,11,2,0,9,2
41890,2,6,2,0,4,2
1288,10,4,2,0,2,2
1288,7,38,19,0,19,19
1288,6,60,22,0,38,22
1288,5,17,5,0,12,5
1288,4,12,6,0,6,6
1288,3,4,1,0,3,1
227605,9,17,4,0,13,4
227605,8,45,9,0,36,9
227605,7,30,10,0,20,10
227605,6,19,4,0,15,4
227605,5,6,3,0,3,3
227605,4,15,6,0,9,6
227605,3,9,2,0,7,2
227605,1,1,1,0,0,1
8307,10,3,2,0,1,2
8307,9,5,1,0,4,1
8307,8,14,5,0,9,5
8307,7,32,12,0,20,12
8307,6,54,16,0,38,16
8307,5,20,4,0,16,4
8307,4,11,1,0,10,1
8307,3,4,3,0,1,3
8307,2,3,1,0,2,1
8307,1,1,1,0,0,1
8326,9,5,1,0,4,1
8326,8,21,7,0,14,7
8326,7,19,10,0,9,10
8326,6,46,15,0,31,15
8326,5,26,8,0,18,8
8326,4,14,2,0,12,2
8326,3,5,3,0,2,3
8326,2,2,2,0,0,2
8326,1,7,4,0,3,4
20081,8,21,6,0,15,6
20081,7,41,13,0,28,13
20081,6,51,10,0,41,10
20081,5,16,6,0,10,6
20081,4,11,2,0,9,2
20081,3,6,2,0,4,2
176458,8,21,4,0,17,4
176458,7,39,10,0,29,10
176458,6,42,4,0,38,4
176458,5,25,4,0,21,4
176458,4,10,7,0,3,7
176458,3,6,1,0,5,1
12898,10,15,3,0,12,3
12898,9,19,7,0,12,7
12898,8,45,11,0,34,11
12898,7,43,9,0,34,9
12898,6,16,5,0,11,5
12898,5,5,1,0,4,1
12898,3,1,1,0,0,1
12898,2,1,1,0,0,1
1636,9,4,2,0,2,2
1636,8,12,4,0,8,4
1636,7,15,4,0,11,4
1636,6,45,10,0,35,10
1636,5,36,7,0,29,7
1636,4,15,10,0,5,10
1636,3,11,3,0,8,3
1636,2,9,4,0,5,4
117784,7,12,4,0,8,4
117784,6,39,12,0,27,12
117784,5,43,12,0,31,12
117784,4,29,10,0,19,10
117784,3,10,1,0,9,1
117784,2,3,1,0,2,1
117784,1,3,2,0,1,2
191191,10,2,1,0,1,1
191191,9,4,2,0,2,2
191191,8,21,7,1,14,6
191191,7,48,9,1,39,8
191191,6,52,9,1,43,8
191191,5,14,1,0,13,1
191191,4,7,3,1,4,2
35652,8,6,2,0,4,2
35652,7,12,5,0,7,5
35652,6,44,9,0,35,9
35652,5,40,9,0,31,9
35652,4,24,7,0,17,7
35652,3,13,2,0,11,2
35652,2,7,4,0,3,4
23761,10,5,1,0,4,1
23761,8,28,9,0,19,9
23761,7,51,15,0,36,15
23761,6,31,10,0,21,10
23761,5,17,6,0,11,6
23761,4,8,5,0,3,5
23761,3,5,4,0,1,4
38187,9,4,1,0,3,1
38187,8,16,3,0,13,3
38187,7,35,5,0,30,5
38187,6,54,10,0,44,10
38187,5,22,8,0,14,8
38187,4,10,3,0,7,3
38187,3,3,1,0,2,1
152846,10,15,3,1,12,2
152846,9,18,4,0,14,4
152846,8,44,8,0,36,8
152846,7,35,9,1,26,8
152846,6,16,2,0,14,2
152846,5,10,3,0,7,3
152846,4,2,2,0,0,2
152846,3,6,3,0,3,3
11542,9,4,1,0,3,1
11542,8,9,2,0,7,2
11542,7,26,3,0,23,3
11542,6,32,9,0,23,9
11542,5,15,5,0,10,5
11542,4,3,1,0,2,1
7975,9,4,1,0,3,1
7975,8,32,12,0,20,12
7975,7,52,13,0,39,13
7975,6,30,10,0,20,10
7975,5,14,1,0,13,1
7975,4,6,3,0,3,3
7975,3,5,4,0,1,4
118452,8,13,1,0,12,1
118452,7,44,6,0,38,6
118452,6,49,9,0,40,9
118452,5,24,5,0,19,5
118452,4,12,3,0,9,3
118452,3,1,1,0,0,1
130725,10,5,3,0,2,3
130725,8,9,5,0,4,5
130725,7,24,5,0,19,5
130725,6,62,14,0,48,14
130725,5,27,7,0,20,7
130725,4,8,1,0,7,1
130725,3,6,1,0,5,1
130725,2,1,1,0,0,1
27884,10,3,1,0,2,1
27884,9,5,2,0,3,2
27884,8,18,5,0,13,5
27884,7,36,11,0,25,11
27884,6,34,14,0,20,14
27884,5,28,11,0,17,11
27884,4,14,6,0,8,6
27884,3,5,2,0,3,2
27884,2,3,1,0,2,1
38924,8,6,3,0,3,3
38924,7,21,6,0,15,6
38924,6,39,8,0,31,8
38924,5,20,8,0,12,8
38924,4,9,4,0,5,4
13648,9,3,1,0,2,1
13648,7,21,3,0,18,3
13648,6,48,13,0,35,13
13648,5,27,1,0,26,1
13648,4,19,6,0,13,6
13648,3,6,2,0,4,2
201416,10,12,6,0,6,6
201416,9,14,8,1,6,7
201416,8,22,7,1,15,6
201416,7,24,8,2,16,6
201416,6,36,6,3,30,3
201416,5,18,4,1,14,3
201416,4,10,4,0,6,4
201416,3,3,1,0,2,1
201416,2,4,1,0,3,1
201416,1,3,1,0,2,1
1816,8,16,5,0,11,5
1816,7,20,7,0,13,7
1816,6,55,9,0,46,9
1816,5,26,6,0,20,6
1816,4,16,2,0,14,2
1816,2,4,1,0,3,1
857,8,8,2,0,6,2
857,7,21,5,0,16,5
857,6,53,12,0,41,12
857,5,35,9,0,26,9
857,4,11,3,0,8,3
857,3,14,3,0,11,3
857,1,1,1,0,0,1
188347,8,20,4,0,16,4
188347,7,23,2,0,21,2
188347,6,47,4,0,43,4
188347,5,20,3,0,17,3
188347,4,10,4,0,6,4
3594,9,2,2,0,0,2
3594,8,17,5,0,12,5
3594,7,21,9,0,12,9
3594,6,71,20,0,51,20
3594,5,21,5,0,16,5
3594,4,9,1,0,8,1
794,10,1,1,0,0,1
794,8,4,2,0,2,2
794,7,26,9,0,17,9
794,6,49,16,0,33,16
794,5,37,10,0,27,10
794,4,21,8,0,13,8
794,3,5,1,0,4,1
2214,10,1,1,0,0,1
2214,9,2,1,0,1,1
2214,8,11,4,0,7,4
2214,7,21,4,0,17,4
2214,6,47,15,0,32,15
2214,5,29,4,0,25,4
2214,4,15,6,0,9,6
2214,3,4,1,0,3,1
133,9,7,1,0,6,1
133,8,13,7,0,6,7
133,7,36,9,0,27,9
133,6,47,11,0,36,11
133,5,27,12,0,15,12
133,4,9,2,0,7,2
133,3,5,1,0,4,1
133,2,2,1,0,1,1
133633,8,17,1,0,16,1
133633,7,20,7,0,13,7
133633,6,41,9,1,32,8
133633,5,37,11,2,26,9
133633,4,16,4,0,12,4
133633,3,10,4,0,6,4
133633,2,4,1,0,3,1
4125,8,17,6,0,11,6
4125,7,33,11,0,22,11
4125,6,59,19,0,40,19
4125,5,20,11,0,9,11
4125,4,9,4,0,5,4
4125,3,2,1,0,1,1
4125,2,3,1,0,2,1
4125,1,1,1,0,0,1
154519,10,21,13,0,8,13
154519,9,32,15,0,17,15
154519,8,42,8,0,34,8
154519,7,30,4,0,26,4
154519,6,11,1,0,10,1
154519,4,4,2,0,2,2
38986,10,7,3,0,4,3
38986,9,18,7,0,11,7
38986,8,59,17,0,42,17
38986,7,42,15,0,27,15
38986,6,12,5,0,7,5
38986,5,4,3,0,1,3
38986,4,3,3,0,0,3
2431,7,8,3,0,5,3
2431,6,27,6,0,21,6
2431,5,25,10,0,15,10
2431,4,33,12,0,21,12
2431,3,20,6,0,14,6
2431,2,11,8,0,3,8
2431,1,1,1,0,0,1
22863,10,4,3,0,1,3
22863,9,11,7,0,4,7
22863,8,26,7,0,19,7
22863,7,37,9,0,28,9
22863,6,38,13,0,25,13
22863,5,19,7,0,12,7
22863,4,9,4,0,5,4
22863,3,1,1,0,0,1
4978,10,5,1,0,4,1
4978,9,8,3,0,5,3
4978,8,26,5,0,21,5
4978,7,40,9,0,31,9
4978,6,41,10,0,31,10
4978,5,13,2,0,11,2
4978,3,8,3,0,5,3
4978,2,1,1,0,0,1
4978,1,1,1,0,0,1
147474,10,5,2,0,3,2
147474,9,15,3,0,12,3
147474,8,25,7,0,18,7
147474,7,43,5,0,38,5
147474,6,32,4,0,28,4
147474,5,13,1,0,12,1
147474,4,4,2,0,2,2
147474,3,7,3,0,4,3
147474,2,2,1,0,1,1
192906,10,4,2,1,2,1
192906,9,10,5,0,5,5
192906,8,51,17,3,34,14
192906,7,38,10,1,28,9
192906,6,32,6,1,26,5
192906,5,5,2,0,3,2
192906,3,4,2,0,2,2
218028,9,4,2,0,2,2
218028,8,27,4,0,23,4
218028,7,40,4,0,36,4
218028,6,43,6,0,37,6
218028,4,8,3,0,5,3
218028,2,2,1,0,1,1
218028,1,1,1,0,0,1
149620,10,37,4,0,33,4
149620,9,40,7,0,33,7
149620,8,44,12,0,32,12
149620,7,14,4,0,10,4
149620,6,6,2,0,4,2
149620,2,1,1,0,0,1
87141,10,8,6,0,2,6
87141,9,7,2,0,5,2
87141,8,29,9,0,20,9
87141,7,26,3,0,23,3
87141,6,42,8,0,34,8
87141,5,19,5,0,14,5
87141,4,7,2,0,5,2
87141,3,5,4,0,1,4
180471,10,8,4,1,4,3
180471,9,7,3,0,4,3
180471,8,36,13,5,23,8
180471,7,45,6,0,39,6
180471,6,27,5,1,22,4
180471,5,14,2,0,12,2
180471,4,2,1,0,1,1
180471,3,4,2,0,2,2
174802,10,11,4,0,7,4
174802,9,23,6,0,17,6
174802,8,52,14,1,38,13
174802,7,33,4,0,29,4
174802,6,13,4,1,9,3
174802,5,7,2,0,5,2
174802,4,4,2,0,2,2
148639,9,4,2,0,2,2
148639,8,19,4,0,15,4
148639,7,45,8,0,37,8
148639,6,50,5,0,45,5
148639,5,17,1,0,16,1
148639,4,7,3,0,4,3
148639,3,3,1,0,2,1
25775,10,17,5,0,12,5
25775,9,28,9,0,19,9
25775,8,56,12,0,44,12
25775,7,29,8,0,21,8
25775,6,11,3,0,8,3
25775,3,1,1,0,0,1
72535,10,5,1,0,4,1
72535,9,3,1,0,2,1
72535,8,17,3,1,14,2
72535,7,20,5,0,15,5
72535,6,35,9,0,26,9
72535,5,25,10,3,15,7
72535,4,17,6,0,11,6
72535,3,9,3,1,6,2
72535,2,11,5,1,6,4
72535,1,4,2,0,2,2
197408,9,7,3,0,4,3
197408,8,39,11,0,28,11
197408,7,44,11,0,33,11
197408,6,34,7,0,27,7
197408,5,11,1,0,10,1
197408,4,3,1,0,2,1
197408,3,2,1,0,1,1
2049,9,2,1,0,1,1
2049,8,15,4,0,11,4
2049,7,34,11,0,23,11
2049,6,50,22,0,28,22
2049,5,27,9,0,18,9
2049,4,10,5,0,5,5
2049,3,6,4,0,2,4
14940,10,2,1,0,1,1
14940,8,20,2,0,18,2
14940,7,43,3,0,40,3
14940,6,57,10,0,47,10
14940,5,14,2,0,12,2
1940,10,1,1,0,0,1
1940,9,5,2,0,3,2
1940,8,16,6,0,10,6
1940,7,30,10,0,20,10
1940,6,54,16,0,38,16
1940,5,22,7,0,15,7
1940,4,10,4,0,6,4
1940,2,3,1,0,2,1
1940,1,2,2,0,0,2
156474,10,8,2,0,6,2
156474,9,16,2,1,14,1
156474,8,38,7,2,31,5
156474,7,34,4,0,30,4
156474,6,23,2,0,21,2
156474,5,6,2,0,4,2
156474,4,7,1,0,6,1
156474,3,5,3,0,2,3
156474,1,7,3,0,4,3
148507,10,2,1,0,1,1
148507,9,3,1,0,2,1
148507,8,39,8,0,31,8
148507,7,39,6,1,33,5
148507,6,42,7,1,35,6
148507,5,17,3,1,14,2
148507,4,3,1,0,2,1
184525,9,10,2,0,8,2
184525,8,12,3,0,9,3
184525,7,19,2,0,17,2
184525,6,51,8,0,43,8
184525,5,26,4,0,22,4
184525,4,17,4,0,13,4
31935,8,10,4,0,6,4
31935,7,24,6,0,18,6
31935,6,55,23,0,32,23
31935,5,29,9,0,20,9
31935,4,19,11,0,8,11
31935,3,4,1,0,3,1
15731,10,2,1,0,1,1
15731,8,17,9,0,8,9
15731,7,26,12,0,14,12
15731,6,48,20,0,28,20
15731,5,25,6,0,19,6
15731,4,17,6,0,11,6
15731,3,4,3,0,1,3
3637,10,9,4,0,5,4
3637,9,13,2,0,11,2
3637,8,32,16,1,16,15
3637,7,32,8,0,24,8
3637,6,45,18,0,27,18
3637,5,6,1,0,5,1
3637,4,5,2,0,3,2
60311,8,3,2,0,1,2
60311,7,21,2,0,19,2
60311,6,48,10,0,38,10
60311,5,30,2,0,28,2
60311,4,23,6,0,17,6
60311,3,17,10,0,7,10
238889,10,16,6,0,10,6
238889,9,22,9,1,13,8
238889,8,54,9,1,45,8
238889,7,25,3,0,22,3
238889,6,18,5,0,13,5
238889,5,6,3,0,3,3
238889,3,2,1,0,1,1
238889,2,2,1,0,1,1
171978,8,14,1,0,13,1
171978,7,33,5,0,28,5
171978,6,46,5,0,41,5
171978,5,20,3,0,17,3
171978,4,13,6,0,7,6
171978,2,6,1,0,5,1
165522,10,11,2,0,9,2
165522,9,6,2,0,4,2
165522,8,20,3,0,17,3
165522,7,55,6,0,49,6
165522,6,35,3,0,32,3
165522,5,12,3,0,9,3
165522,3,1,1,0,0,1
47130,8,18,4,0,14,4
47130,7,31,9,0,22,9
47130,6,49,8,0,41,8
47130,5,18,2,0,16,2
47130,4,14,2,0,12,2
47130,3,6,1,0,5,1
47130,2,4,2,0,2,2
41033,10,5,1,0,4,1
41033,9,9,2,0,7,2
41033,8,41,14,0,27,14
41033,7,54,21,0,33,21
41033,6,22,7,0,15,7
41033,5,9,5,0,4,5
41033,4,3,2,0,1,2
41033,3,2,2,0,0,2
23912,10,5,2,0,3,2
23912,9,4,2,0,2,2
23912,8,11,5,0,6,5
23912,7,29,9,0,20,9
23912,6,54,16,0,38,16
23912,5,21,6,0,15,6
23912,4,11,6,0,5,6
23912,3,7,6,0,1,6
23912,2,3,1,0,2,1
42207,9,2,1,0,1,1
42207,8,13,4,0,9,4
42207,7,27,10,0,17,10
42207,6,63,15,0,48,15
42207,5,22,5,0,17,5
42207,4,13,3,0,10,3
42207,2,3,1,0,2,1
5476,10,10,2,0,8,2
5476,9,18,8,0,10,8
5476,8,33,13,0,20,13
5476,7,40,12,0,28,12
5476,6,27,7,0,20,7
5476,5,9,1,0,8,1
5476,4,7,3,0,4,3
5476,2,1,1,0,0,1
160125,10,5,1,1,4,0
160125,8,18,7,0,11,7
160125,7,33,4,0,29,4
160125,6,48,11,0,37,11
160125,5,19,5,0,14,5
160125,4,10,1,0,9,1
160125,3,4,2,0,2,2
4200,10,8,2,0,6,2
4200,9,13,1,0,12,1
4200,8,41,11,0,30,11
4200,7,38,7,0,31,7
4200,6,33,9,0,24,9
4200,5,10,6,0,4,6
160067,10,3,2,0,1,2
160067,9,6,2,0,4,2
160067,7,18,3,2,15,1
160067,6,32,4,1,28,3
160067,5,27,2,0,25,2
160067,4,19,4,0,15,4
160067,3,10,4,0,6,4
160067,2,7,2,0,5,2
160067,1,8,5,0,3,5
21436,10,3,1,0,2,1
21436,9,17,5,0,12,5
21436,8,47,19,0,28,19
21436,7,38,19,0,19,19
21436,6,23,9,0,14,9
21436,5,11,6,0,5,6
21436,4,3,1,0,2,1
21436,3,2,1,0,1,1
100172,9,9,2,0,7,2
100172,8,35,15,4,20,11
100172,7,37,8,1,29,7
100172,6,35,12,0,23,12
100172,5,10,5,0,5,5
100172,4,10,2,0,8,2
231962,10,7,1,0,6,1
231962,9,16,2,0,14,2
231962,8,36,6,0,30,6
231962,7,56,4,0,52,4
231962,5,9,2,0,7,2
231962,4,4,1,0,3,1
231962,2,1,1,0,0,1
214910,10,4,3,0,1,3
214910,9,11,5,0,6,5
214910,8,21,4,1,17,3
214910,7,36,1,0,35,1
214910,6,36,6,0,30,6
214910,5,17,6,0,11,6
214910,4,13,4,0,9,4
67609,10,1,1,0,0,1
67609,9,5,2,0,3,2
67609,8,17,1,0,16,1
67609,7,21,5,0,16,5
67609,6,39,16,0,23,16
67609,5,30,8,0,22,8
67609,4,23,10,0,13,10
67609,3,7,5,0,2,5
136240,10,1,1,0,0,1
136240,9,6,2,0,4,2
136240,8,16,2,0,14,2
136240,7,33,4,0,29,4
136240,6,50,6,0,44,6
136240,5,20,3,0,17,3
136240,4,15,4,0,11,4
136240,1,1,1,0,0,1
1256,8,8,1,0,7,1
1256,7,11,4,0,7,4
1256,6,27,13,0,14,13
1256,5,38,15,0,23,15
1256,4,30,12,0,18,12
1256,3,14,3,0,11,3
1256,2,8,3,0,5,3
1256,1,8,3,0,5,3
191070,8,21,3,0,18,3
191070,7,43,6,0,37,6
191070,6,59,8,0,51,8
191070,5,13,2,0,11,2
191070,4,3,1,0,2,1
191070,2,2,1,0,1,1
401,10,1,1,0,0,1
401,9,8,4,0,4,4
401,8,17,5,0,12,5
401,7,42,9,0,33,9
401,6,50,14,0,36,14
401,5,18,5,0,13,5
401,4,6,1,0,5,1
177542,10,5,2,0,3,2
177542,9,11,3,0,8,3
177542,8,26,7,0,19,7
177542,7,40,6,0,34,6
177542,6,32,11,0,21,11
177542,5,17,2,0,15,2
177542,2,3,1,0,2,1
5294,10,4,2,0,2,2
5294,9,4,3,0,1,3
5294,8,25,7,0,18,7
5294,7,41,16,0,25,16
5294,6,47,17,0,30,17
5294,5,13,7,0,6,7
5294,4,6,2,0,4,2
5294,3,5,2,0,3,2
5253,10,2,1,0,1,1
5253,8,3,1,0,2,1
5253,7,3,2,0,1,2
5253,6,37,14,0,23,14
5253,5,31,8,0,23,8
5253,4,34,8,0,26,8
5253,3,16,3,0,13,3
5253,2,17,6,0,11,6
5253,1,2,2,0,0,2
7310,10,3,1,0,2,1
7310,9,3,2,0,1,2
7310,8,25,10,0,15,10
7310,7,32,11,0,21,11
7310,6,46,9,0,37,9
7310,5,23,8,0,15,8
7310,4,10,2,0,8,2
7310,3,3,1,0,2,1
195454,9,2,1,0,1,1
195454,8,25,1,0,24,1
195454,7,46,12,1,34,11
195454,6,53,10,2,43,8
195454,5,9,3,0,6,3
195454,4,5,3,1,2,2
195454,3,2,1,0,1,1
23055,10,3,1,0,2,1
23055,9,7,2,0,5,2
23055,8,32,16,0,16,16
23055,7,42,17,0,25,17
23055,6,36,16,0,20,16
23055,5,14,5,0,9,5
23055,4,7,3,0,4,3
23055,2,2,1,0,1,1
42360,10,2,1,0,1,1
42360,9,2,1,0,1,1
42360,8,15,4,0,11,4
42360,7,20,7,0,13,7
42360,6,48,6,0,42,6
42360,5,26,6,0,20,6
42360,4,17,4,0,13,4
42360,3,11,2,0,9,2
42360,2,3,1,0,2,1
292,8,8,1,0,7,1
292,7,24,6,0,18,6
292,6,58,8,0,50,8
292,5,31,3,0,28,3
292,4,15,5,0,10,5
292,3,5,1,0,4,1
292,1,2,1,0,1,1
130764,10,6,1,0,5,1
130764,8,22,1,0,21,1
130764,7,32,5,1,27,4
130764,6,39,8,1,31,7
130764,5,15,5,1,10,4
130764,4,13,4,0,9,4
130764,1,4,3,2,1,1
3640,9,1,1,0,0,1
3640,8,3,1,0,2,1
3640,7,15,4,0,11,4
3640,6,39,7,0,32,7
3640,5,52,16,0,36,16
3640,4,22,8,0,14,8
3640,3,6,1,0,5,1
3640,2,6,2,0,4,2
141019,8,3,2,0,1,2
141019,7,4,1,0,3,1
141019,6,31,5,0,26,5
141019,5,34,6,0,28,6
141019,4,30,3,0,27,3
141019,3,18,3,0,15,3
141019,2,14,8,0,6,8
141019,1,11,2,0,9,2
2106,10,1,1,0,0,1
2106,9,5,2,0,3,2
2106,8,7,2,0,5,2
2106,7,28,6,0,22,6
2106,6,37,6,0,31,6
2106,5,23,8,0,15,8
2106,4,16,7,0,9,7
2106,3,8,4,0,4,4
2106,2,14,9,0,5,9
2106,1,6,6,0,0,6
7467,10,2,1,0,1,1
7467,8,5,2,0,3,2
7467,7,4,1,0,3,1
7467,6,11,1,0,10,1
7467,5,17,2,0,15,2
7467,4,27,5,0,22,5
7467,3,26,8,0,18,8
7467,2,28,15,0,13,15
7467,1,23,13,0,10,13
231639,10,6,2,0,4,2
231639,9,15,3,0,12,3
231639,8,32,5,0,27,5
231639,7,45,7,0,38,7
231639,6,35,10,0,25,10
231639,5,7,3,0,4,3
231639,4,4,1,0,3,1
170395,10,6,2,0,4,2
170395,8,6,1,1,5,0
170395,7,21,4,0,17,4
170395,6,38,6,2,32,4
170395,5,36,12,1,24,11
170395,4,19,4,0,15,4
170395,3,10,1,0,9,1
170395,2,5,3,0,2,3
67878,10,10,8,0,2,8
67878,9,15,4,0,11,4
67878,8,37,13,0,24,13
67878,7,30,12,0,18,12
67878,6,21,7,0,14,7
67878,5,10,2,0,8,2
67878,4,9,2,0,7,2
67878,3,5,2,0,3,2
67878,2,4,2,0,2,2
67878,1,3,2,0,1,2
5383,8,17,6,0,11,6
5383,7,29,7,0,22,7
5383,6,58,17,0,41,17
5383,5,21,10,0,11,10
5383,4,10,4,0,6,4
135557,8,19,4,0,15,4
135557,7,29,6,0,23,6
135557,6,40,10,1,30,9
135557,5,26,8,0,18,8
135557,4,10,5,0,5,5
135557,3,10,3,1,7,2
135557,2,6,3,0,3,3
136143,10,5,1,0,4,1
136143,9,2,1,0,1,1
136143,8,5,1,0,4,1
136143,7,12,3,0,9,3
136143,6,36,3,0,33,3
136143,5,27,1,0,26,1
136143,4,21,4,0,17,4
136143,3,10,1,0,9,1
136143,2,14,3,0,11,3
136143,1,12,5,0,7,5
1346,8,5,2,0,3,2
1346,7,33,8,0,25,8
1346,6,57,19,0,38,19
1346,5,28,6,0,22,6
1346,4,14,6,0,8,6
1346,3,2,1,0,1,1
1346,2,4,2,0,2,2
60245,8,27,9,0,18,9
60245,7,38,10,0,28,10
60245,6,49,15,0,34,15
60245,5,18,4,0,14,4
60245,4,7,1,0,6,1
122691,9,10,1,0,9,1
122691,8,33,8,0,25,8
122691,7,40,11,0,29,11
122691,6,30,7,0,23,7
122691,5,17,3,0,14,3
122691,3,3,1,0,2,1
3157,10,3,2,0,1,2
3157,9,5,1,0,4,1
3157,8,17,5,0,12,5
3157,7,19,8,0,11,8
3157,6,45,24,0,21,24
3157,5,22,11,0,11,11
3157,4,22,9,0,13,9
3157,3,8,3,0,5,3
3157,2,2,1,0,1,1
11983,10,1,1,0,0,1
11983,8,10,2,0,8,2
11983,7,34,5,0,29,5
11983,6,46,9,0,37,9
11983,5,23,4,0,19,4
11983,4,18,5,0,13,5
11983,3,5,2,0,3,2
11983,2,2,1,0,1,1
11983,1,2,1,0,1,1
2698,9,3,1,0,2,1
2698,8,22,6,0,16,6
2698,7,49,10,0,39,10
2698,6,41,8,0,33,8
2698,5,10,1,0,9,1
2698,4,15,2,0,13,2
2698,2,1,1,0,0,1
198791,10,5,2,0,3,2
198791,9,11,3,0,8,3
198791,8,35,9,1,26,8
198791,7,39,5,0,34,5
198791,6,30,7,0,23,7
198791,4,9,1,0,8,1
57349,8,15,5,0,10,5
57349,7,37,10,0,27,10
57349,6,47,9,0,38,9
57349,5,26,7,0,19,7
57349,4,9,1,0,8,1
131788,9,5,1,0,4,1
131788,8,17,4,0,13,4
131788,7,33,5,0,28,5
131788,6,51,6,0,45,6
131788,5,18,5,0,13,5
131788,4,10,2,0,8,2
131788,3,3,1,0,2,1
131788,2,4,2,0,2,2
247313,10,2,1,0,1,1
247313,8,42,6,0,36,6
247313,7,51,9,0,42,9
247313,6,28,3,0,25,3
247313,5,9,1,0,8,1
170922,9,12,6,0,6,6
170922,8,27,4,0,23,4
170922,7,28,6,0,22,6
170922,6,46,7,0,39,7
170922,5,19,2,0,17,2
170922,3,3,1,0,2,1
170922,2,2,2,0,0,2
151446,10,21,7,0,14,7
151446,8,39,3,0,36,3
151446,7,20,2,0,18,2
151446,6,37,3,0,34,3
151446,5,10,1,0,9,1
10467,9,10,2,0,8,2
10467,8,17,3,0,14,3
10467,7,29,6,0,23,6
10467,6,45,6,0,39,6
10467,5,24,4,0,20,4
10467,4,11,3,0,8,3
10467,3,6,5,0,1,5
217531,9,4,1,0,3,1
217531,8,49,11,0,38,11
217531,7,45,8,0,37,8
217531,6,26,6,0,20,6
217531,5,9,1,0,8,1
217531,4,9,6,0,3,6
217531,3,2,1,0,1,1
4781,10,1,1,0,0,1
4781,8,5,2,0,3,2
4781,7,10,1,0,9,1
4781,6,31,10,0,21,10
4781,5,41,5,0,36,5
4781,4,33,9,0,24,9
4781,3,14,4,0,10,4
4781,2,6,3,0,3,3
5217,10,15,5,0,10,5
5217,9,15,3,0,12,3
5217,8,51,15,0,36,15
5217,7,29,6,0,23,6
5217,6,21,5,0,16,5
5217,5,9,5,0,4,5
5217,4,2,2,0,0,2
206540,8,10,2,0,8,2
206540,7,18,4,0,14,4
206540,6,45,8,0,37,8
206540,5,29,11,0,18,11
206540,4,21,1,0,20,1
206540,3,13,4,0,9,4
206540,1,2,1,0,1,1
56995,10,18,5,0,13,5
56995,9,22,2,0,20,2
56995,8,52,16,0,36,16
56995,7,30,7,0,23,7
56995,6,16,3,0,13,3
56995,5,4,2,0,2,2
253106,10,21,2,0,19,2
253106,9,21,1,0,20,1
253106,8,56,4,0,52,4
253106,7,24,4,0,20,4
253106,6,16,4,0,12,4
253106,5,4,1,0,3,1
43526,9,12,7,0,5,7
43526,8,62,19,0,43,19
43526,7,42,13,0,29,13
43526,6,17,8,0,9,8
43526,5,4,3,0,1,3
43526,4,2,1,0,1,1
126021,10,16,4,0,12,4
126021,9,24,3,0,21,3
126021,8,48,8,0,40,8
126021,7,24,2,0,22,2
126021,2,2,1,0,1,1
24245,9,3,1,0,2,1
24245,8,8,4,0,4,4
24245,7,22,8,0,14,8
24245,6,54,19,0,35,19
24245,5,30,9,0,21,9
24245,4,11,4,0,7,4
24245,3,9,3,0,6,3
24245,2,4,2,0,2,2
24245,1,2,2,0,0,2
84732,8,24,5,0,19,5
84732,7,44,4,0,40,4
84732,6,47,5,0,42,5
84732,5,15,5,0,10,5
84732,4,5,1,0,4,1
84732,3,1,1,0,0,1
84732,1,1,1,0,0,1
172480,8,8,2,0,6,2
172480,7,26,2,0,24,2
172480,6,57,8,0,49,8
172480,5,34,3,0,31,3
172480,4,10,3,0,7,3
172480,3,3,1,0,2,1
8486,8,3,1,0,2,1
8486,7,7,1,0,6,1
8486,6,27,9,0,18,9
8486,5,27,7,0,20,7
8486,4,42,14,0,28,14
8486,3,24,5,0,19,5
8486,2,6,4,0,2,4
40421,10,1,1,0,0,1
40421,9,4,2,0,2,2
40421,7,10,1,0,9,1
40421,6,35,7,0,28,7
40421,5,36,11,0,25,11
40421,4,19,5,0,14,5
40421,3,17,6,0,11,6
40421,2,12,4,0,8,4
40421,1,3,2,0,1,2
3820,10,1,1,0,0,1
3820,8,4,1,0,3,1
3820,7,7,1,0,6,1
3820,6,27,6,0,21,6
3820,5,33,4,0,29,4
3820,4,31,13,0,18,13
3820,3,13,5,0,8,5
3820,2,14,7,0,7,7
3820,1,11,6,0,5,6
786,8,6,2,0,4,2
786,7,16,2,0,14,2
786,6,19,5,0,14,5
786,5,30,6,0,24,6
786,4,31,7,0,24,7
786,3,17,7,0,10,7
786,2,11,7,0,4,7
786,1,12,5,0,7,5
231939,7,18,2,0,16,2
231939,6,24,4,0,20,4
231939,5,38,4,0,34,4
231939,4,26,4,0,22,4
231939,3,16,5,0,11,5
231939,2,11,2,0,9,2
231939,1,6,4,0,2,4
183441,10,3,2,0,1,2
183441,9,3,1,0,2,1
183441,8,27,4,0,23,4
183441,7,44,12,0,32,12
183441,6,40,10,0,30,10
183441,5,12,2,0,10,2
183441,4,10,2,0,8,2
183441,1,1,1,0,0,1
2217,8,15,7,0,8,7
2217,7,22,3,0,19,3
2217,6,57,13,0,44,13
2217,5,36,10,0,26,10
2217,4,7,1,0,6,1
2217,3,5,1,0,4,1
166726,10,5,1,0,4,1
166726,9,12,5,0,7,5
166726,8,38,2,0,36,2
166726,7,33,3,0,30,3
166726,5,16,1,0,15,1
3581,9,7,3,0,4,3
3581,8,21,2,0,19,2
3581,7,36,7,0,29,7
3581,6,38,7,0,31,7
3581,5,25,7,0,18,7
3581,4,9,7,0,2,7
3581,3,5,4,0,1,4
251247,10,30,5,0,25,5
251247,9,36,12,2,24,10
251247,8,47,12,2,35,10
251247,7,14,5,1,9,4
251247,6,8,2,0,6,2
251247,5,2,1,0,1,1
251247,4,3,1,0,2,1
251247,3,2,1,0,1,1
251247,1,2,1,1,1,0
5142,10,7,5,0,2,5
5142,9,6,1,0,5,1
5142,8,18,10,0,8,10
5142,7,51,18,0,33,18
5142,6,35,14,0,21,14
5142,5,15,3,0,12,3
5142,4,7,4,0,3,4
5142,2,1,1,0,0,1
281,9,2,1,0,1,1
281,8,3,2,0,1,2
281,7,12,3,0,9,3
281,6,30,6,0,24,6
281,5,31,6,0,25,6
281,4,32,2,0,30,2
281,3,20,4,0,16,4
281,2,11,4,0,7,4
281,1,2,1,0,1,1
12065,10,3,1,0,2,1
12065,9,3,2,0,1,2
12065,8,11,5,0,6,5
12065,7,22,10,0,12,10
12065,6,59,23,0,36,23
12065,5,24,2,0,22,2
12065,4,12,2,0,10,2
12065,3,6,3,0,3,3
12065,2,3,2,0,1,2
11147,10,2,1,0,1,1
11147,9,3,1,0,2,1
11147,8,7,4,0,3,4
11147,7,13,4,0,9,4
11147,6,33,6,0,27,6
11147,5,37,9,0,28,9
11147,4,22,2,0,20,2
11147,3,10,3,0,7,3
11147,2,13,5,0,8,5
11147,1,3,2,0,1,2
31380,8,13,6,0,7,6
31380,7,35,10,0,25,10
31380,6,34,10,0,24,10
31380,5,30,11,0,19,11
31380,4,13,4,0,9,4
31380,3,8,3,0,5,3
31380,2,4,3,0,1,3
31380,1,4,4,0,0,4
7256,10,1,1,0,0,1
7256,9,5,2,0,3,2
7256,8,4,3,0,1,3
7256,7,21,6,0,15,6
7256,6,50,14,0,36,14
7256,5,32,9,0,23,9
7256,4,12,4,0,8,4
7256,3,12,8,0,4,8
7256,2,3,1,0,2,1
7256,1,3,1,0,2,1
193551,10,13,6,0,7,6
193551,9,13,3,0,10,3
193551,8,42,8,0,34,8
193551,7,37,10,1,27,9
193551,6,24,4,0,20,4
193551,4,3,1,0,2,1
29379,10,13,9,0,4,9
29379,9,23,9,0,14,9
29379,8,53,16,0,37,16
29379,7,31,13,0,18,13
29379,6,12,6,0,6,6
29379,5,7,3,0,4,3
29379,4,2,1,0,1,1
29379,3,2,2,0,0,2
37,10,1,1,0,0,1
37,8,10,2,0,8,2
37,7,31,8,0,23,8
37,6,33,5,0,28,5
37,5,37,9,0,28,9
37,4,19,9,0,10,9
37,3,4,3,0,1,3
37,2,4,1,0,3,1
5012,8,9,1,0,8,1
5012,7,20,5,0,15,5
5012,6,49,14,0,35,14
5012,5,33,9,0,24,9
5012,4,19,10,0,9,10
5012,3,7,1,0,6,1
5012,2,4,2,0,2,2
2946,8,9,5,0,4,5
2946,7,15,7,0,8,7
2946,6,53,16,0,37,16
2946,5,31,13,0,18,13
2946,4,24,9,0,15,9
15505,9,3,2,0,1,2
15505,8,1,1,0,0,1
15505,7,14,3,0,11,3
15505,6,33,9,0,24,9
15505,5,40,10,0,30,10
15505,4,27,3,0,24,3
15505,3,17,6,0,11,6
15505,2,4,2,0,2,2
15505,1,3,1,0,2,1
164627,10,7,6,0,1,6
164627,9,10,4,0,6,4
164627,8,37,13,5,24,8
164627,7,34,5,1,29,4
164627,6,27,8,0,19,8
164627,5,15,3,0,12,3
164627,4,6,2,0,4,2
164627,3,6,2,0,4,2
164627,2,1,1,0,0,1
232831,8,9,3,0,6,3
232831,7,24,5,0,19,5
232831,6,36,8,0,28,8
232831,5,31,10,0,21,10
232831,4,21,2,0,19,2
232831,3,8,3,0,5,3
232831,2,6,2,0,4,2
232831,1,4,2,0,2,2
16355,8,9,2,0,7,2
16355,7,27,7,0,20,7
16355,6,57,10,0,47,10
16355,5,24,3,0,21,3
16355,4,13,4,0,9,4
16355,3,5,1,0,4,1
16355,1,2,1,0,1,1
157521,10,12,5,0,7,5
157521,9,15,7,0,8,7
157521,8,41,13,1,28,12
157521,7,31,13,0,18,13
157521,6,12,5,0,7,5
157521,5,11,9,1,2,8
157521,4,13,7,0,6,7
157521,3,2,1,0,1,1
157521,2,5,4,0,1,4
157521,1,1,1,0,0,1
11122,10,6,4,0,2,4
11122,9,18,10,0,8,10
11122,8,38,17,0,21,17
11122,7,43,11,0,32,11
11122,6,27,10,0,17,10
11122,5,6,1,0,5,1
11122,4,3,1,0,2,1
250561,10,8,2,0,6,2
250561,9,19,5,0,14,5
250561,8,59,9,0,50,9
250561,7,30,3,0,27,3
250561,6,15,3,0,12,3
250561,4,3,2,0,1,2
5467,10,3,2,0,1,2
5467,9,7,2,0,5,2
5467,8,14,1,0,13,1
5467,7,21,6,0,15,6
5467,6,50,14,0,36,14
5467,5,36,7,0,29,7
5467,4,9,3,0,6,3
5467,3,1,1,0,0,1
5467,2,2,1,0,1,1
272,8,17,2,0,15,2
272,7,45,13,0,32,13
272,6,52,11,0,41,11
272,5,21,8,0,13,8
272,4,5,2,0,3,2
272,3,1,1,0,0,1
10964,10,3,2,0,1,2
10964,9,10,4,0,6,4
10964,8,42,11,0,31,11
10964,7,52,14,0,38,14
10964,6,22,8,0,14,8
10964,5,7,4,0,3,4
10964,4,1,1,0,0,1
10964,3,4,2,0,2,2
10964,2,1,1,0,0,1
265256,10,2,1,0,1,1
265256,9,11,4,0,7,4
265256,8,33,2,0,31,2
265256,7,41,7,0,34,7
265256,6,34,8,0,26,8
265256,5,9,6,0,3,6
265256,4,10,3,0,7,3
265256,2,3,1,0,2,1
4208,8,16,9,0,7,9
4208,7,25,10,0,15,10
4208,6,50,16,0,34,16
4208,5,32,11,0,21,11
4208,4,11,4,0,7,4
4208,3,6,2,0,4,2
4208,2,1,1,0,0,1
180853,10,19,8,0,11,8
180853,9,12,7,0,5,7
180853,8,35,5,0,30,5
180853,7,25,6,0,19,6
180853,6,26,5,1,21,4
180853,5,10,2,0,8,2
180853,4,2,1,0,1,1
180853,3,9,7,1,2,6
180853,2,2,1,1,1,0
180853,1,2,1,0,1,1
4201,10,6,2,0,4,2
4201,9,15,2,0,13,2
4201,8,31,6,0,25,6
4201,7,52,8,0,44,8
4201,6,24,2,0,22,2
4201,5,8,4,0,4,4
4201,3,2,2,0,0,2
88559,10,3,1,0,2,1
88559,9,8,5,0,3,5
88559,8,31,10,0,21,10
88559,7,41,15,0,26,15
88559,6,34,10,0,24,10
88559,5,17,7,0,10,7
88559,4,4,2,0,2,2
88559,3,2,1,0,1,1
88559,2,2,1,0,1,1
188018,10,5,2,0,3,2
188018,9,6,2,0,4,2
188018,8,22,6,0,16,6
188018,7,35,5,0,30,5
188018,6,46,9,0,37,9
188018,5,19,6,0,13,6
188018,4,4,2,0,2,2
188018,2,2,2,0,0,2
255639,10,3,1,0,2,1
255639,9,6,2,0,4,2
255639,8,27,4,0,23,4
255639,7,37,5,0,32,5
255639,6,36,7,0,29,7
255639,5,17,4,0,13,4
255639,4,9,1,0,8,1
255639,3,6,2,0,4,2
430,8,13,5,0,8,5
430,7,29,9,0,20,9
430,6,57,10,0,47,10
430,5,30,10,0,20,10
430,4,7,4,0,3,4
63778,9,4,2,0,2,2
63778,8,32,9,0,23,9
63778,7,53,16,0,37,16
63778,6,36,11,0,25,11
63778,5,12,4,0,8,4
2597,9,2,1,0,1,1
2597,8,11,5,0,6,5
2597,7,28,9,0,19,9
2597,6,53,17,0,36,17
2597,5,21,8,0,13,8
2597,4,12,4,0,8,4
2597,3,10,4,0,6,4
34185,8,13,3,0,10,3
34185,7,37,6,0,31,6
34185,6,48,12,0,36,12
34185,5,28,5,0,23,5
34185,4,9,1,0,8,1
34185,3,5,1,0,4,1
34185,2,1,1,0,0,1
20781,10,1,1,0,0,1
20781,8,9,2,0,7,2
20781,7,28,11,0,17,11
20781,6,46,9,0,37,9
20781,5,27,5,0,22,5
20781,4,15,5,0,10,5
20781,3,10,2,0,8,2
20781,2,5,2,0,3,2
32107,8,7,1,0,6,1
32107,7,26,8,0,18,8
32107,6,40,8,0,32,8
32107,5,34,4,0,30,4
32107,4,18,5,0,13,5
32107,3,14,4,0,10,4
32107,2,2,1,0,1,1
23658,10,2,1,0,1,1
23658,8,6,2,0,4,2
23658,7,34,5,0,29,5
23658,6,68,20,0,48,20
23658,5,21,4,0,17,4
23658,4,7,2,0,5,2
23658,3,1,1,0,0,1
28246,8,11,6,0,5,6
28246,7,25,7,0,18,7
28246,6,43,12,0,31,12
28246,5,34,10,0,24,10
28246,4,12,4,0,8,4
28246,3,8,2,0,6,2
28246,2,7,4,0,3,4
66851,9,8,2,0,6,2
66851,8,31,3,0,28,3
66851,7,26,3,0,23,3
66851,6,38,6,0,32,6
66851,5,18,1,0,17,1
66851,4,6,2,0,4,2
66851,3,11,1,0,10,1
118553,10,3,1,0,2,1
118553,8,21,4,0,17,4
118553,7,38,5,0,33,5
118553,6,53,7,0,46,7
118553,5,14,3,0,11,3
15000,10,1,1,0,0,1
15000,9,8,1,0,7,1
15000,7,30,5,0,25,5
15000,6,51,5,0,46,5
15000,5,24,1,0,23,1
15000,4,9,3,0,6,3
15000,1,1,1,0,0,1
17235,10,1,1,0,0,1
17235,9,2,1,0,1,1
17235,8,16,6,0,10,6
17235,7,44,19,0,25,19
17235,6,44,17,0,27,17
17235,5,21,4,0,17,4
17235,4,10,4,0,6,4
17235,3,4,3,0,1,3
2855,9,4,4,0,0,4
2855,8,2,1,0,1,1
2855,7,10,5,0,5,5
2855,6,40,8,0,32,8
2855,5,36,13,0,23,13
2855,4,22,8,0,14,8
2855,3,14,5,0,9,5
2855,2,11,4,0,7,4
2855,1,3,1,0,2,1
198961,10,1,1,0,0,1
198961,9,2,1,0,1,1
198961,7,14,3,0,11,3
198961,6,34,10,0,24,10
198961,5,39,7,0,32,7
198961,4,36,6,0,30,6
198961,3,10,2,0,8,2
129204,10,26,15,0,11,15
129204,9,30,14,0,16,14
129204,8,39,11,0,28,11
129204,7,19,6,0,13,6
129204,6,12,5,0,7,5
129204,5,4,2,0,2,2
129204,4,6,5,0,1,5
129204,2,2,1,0,1,1
22392,10,9,3,0,6,3
22392,8,17,4,0,13,4
22392,7,19,4,0,15,4
22392,6,38,6,0,32,6
22392,5,24,8,0,16,8
22392,4,14,5,0,9,5
22392,3,12,2,0,10,2
22392,2,3,1,0,2,1
5957,10,4,3,0,1,3
5957,9,3,2,0,1,2
5957,8,12,5,0,7,5
5957,7,17,9,0,8,9
5957,6,47,20,0,27,20
5957,5,26,9,0,17,9
5957,4,14,4,0,10,4
5957,3,11,3,0,8,3
5957,2,6,1,0,5,1
221155,9,25,7,2,18,5
221155,8,49,8,2,41,6
221155,7,34,4,0,30,4
221155,6,18,5,1,13,4
221155,5,8,3,0,5,3
221155,2,1,1,0,0,1
21705,8,10,1,0,9,1
21705,7,22,5,0,17,5
21705,5,29,4,0,25,4
21705,4,20,6,0,14,6
21705,3,10,3,0,7,3
21705,2,5,2,0,3,2
21705,1,3,1,0,2,1
134615,10,3,1,0,2,1
134615,9,3,2,1,1,1
134615,8,17,5,1,12,4
134615,7,25,3,1,22,2
134615,6,39,9,4,30,5
134615,5,16,5,1,11,4
134615,4,15,6,1,9,5
134615,3,10,3,0,7,3
134615,2,9,3,0,6,3
158093,10,7,4,0,3,4
158093,9,8,2,0,6,2
158093,8,23,7,0,16,7
158093,7,20,4,0,16,4
158093,6,44,8,0,36,8
158093,5,16,3,0,13,3
158093,4,17,3,0,14,3
158093,3,5,2,0,3,2
34444,9,5,1,0,4,1
34444,8,11,3,0,8,3
34444,7,27,5,0,22,5
34444,6,52,6,0,46,6
34444,5,22,2,0,20,2
34444,4,14,5,0,9,5
34444,3,4,1,0,3,1
40651,8,11,4,0,7,4
40651,7,26,7,0,19,7
40651,6,39,10,0,29,10
40651,5,27,9,0,18,9
40651,4,19,7,0,12,7
40651,3,8,4,0,4,4
40651,2,3,1,0,2,1
40651,1,3,3,0,0,3
2494,10,4,2,0,2,2
2494,9,8,3,0,5,3
2494,8,32,11,0,21,11
2494,7,45,13,0,32,13
2494,6,22,3,0,19,3
2494,4,9,5,0,4,5
2494,3,3,1,0,2,1
3249,10,2,1,0,1,1
3249,9,4,1,0,3,1
3249,8,5,1,0,4,1
3249,7,21,5,0,16,5
3249,6,51,10,0,41,10
3249,5,31,7,0,24,7
3249,4,18,1,0,17,1
3249,3,7,3,0,4,3
3249,1,1,1,0,0,1
255618,9,5,3,0,2,3
255618,8,12,3,0,9,3
255618,7,28,6,0,22,6
255618,6,44,7,0,37,7
255618,5,18,1,0,17,1
255618,4,16,1,0,15,1
255618,3,8,2,0,6,2
255618,2,5,1,0,4,1
255618,1,4,1,0,3,1
255990,10,9,5,0,4,5
255990,9,12,5,0,7,5
255990,8,45,4,0,41,4
255990,7,30,6,0,24,6
255990,6,28,5,0,23,5
255990,5,12,3,0,9,3
255990,4,2,1,0,1,1
138201,8,13,4,0,9,4
138201,7,31,7,0,24,7
138201,6,43,9,0,34,9
138201,5,30,5,0,25,5
138201,4,14,3,0,11,3
138201,3,6,1,0,5,1
138201,2,3,1,0,2,1
193500,8,16,6,1,10,5
193500,7,12,1,0,11,1
193500,6,36,5,1,31,4
193500,5,19,1,0,18,1
193500,4,19,5,0,14,5
193500,3,11,2,0,9,2
193500,2,11,7,1,4,6
193500,1,5,2,0,3,2
204755,8,15,5,2,10,3
204755,7,42,7,0,35,7
204755,6,45,6,0,39,6
204755,5,18,2,0,16,2
204755,4,7,2,0,5,2
204755,3,5,1,0,4,1
204755,2,3,2,0,1,2
4037,10,4,1,0,3,1
4037,9,1,1,0,0,1
4037,7,12,6,0,6,6
4037,6,39,10,0,29,10
4037,5,40,14,0,26,14
4037,4,29,5,0,24,5
4037,3,8,2,0,6,2
1081,10,5,3,0,2,3
1081,9,8,5,0,3,5
1081,8,25,18,0,7,18
1081,7,29,12,0,17,12
1081,6,37,19,0,18,19
1081,5,19,8,0,11,8
1081,4,10,9,0,1,9
1081,3,5,1,0,4,1
1081,2,3,2,0,1,2
210295,10,28,9,0,19,9
210295,9,19,5,0,14,5
210295,8,28,6,0,22,6
210295,7,28,3,0,25,3
210295,6,22,5,0,17,5
210295,5,8,2,0,6,2
210295,3,6,2,0,4,2
210295,2,1,1,0,0,1
8945,8,4,2,0,2,2
8945,7,19,10,0,9,10
8945,6,61,27,0,34,27
8945,5,31,13,0,18,13
8945,4,14,4,0,10,4
8945,3,4,3,0,1,3
8945,2,5,2,0,3,2
8945,1,1,1,0,0,1
184117,9,10,5,1,5,4
184117,8,15,3,0,12,3
184117,7,52,8,1,44,7
184117,6,32,7,1,25,6
184117,5,16,3,0,13,3
184117,3,3,2,1,1,1
184117,2,2,1,0,1,1
73543,9,8,1,0,7,1
73543,8,31,6,0,25,6
73543,7,31,7,0,24,7
73543,6,39,4,0,35,4
73543,5,19,1,0,18,1
73543,4,10,3,0,7,3
10986,8,31,14,0,17,14
10986,7,44,9,0,35,9
10986,6,43,12,0,31,12
10986,5,12,3,0,9,3
10986,4,6,4,0,2,4
5686,10,10,5,0,5,5
5686,9,21,9,0,12,9
5686,8,46,14,0,32,14
5686,7,31,10,0,21,10
5686,6,19,3,0,16,3
5686,5,8,2,0,6,2
5686,4,3,2,0,1,2
5686,3,2,2,0,0,2
5686,2,1,1,0,0,1
14076,9,2,1,0,1,1
14076,7,8,2,0,6,2
14076,6,31,11,0,20,11
14076,5,27,8,0,19,8
14076,4,34,9,0,25,9
14076,3,23,12,0,11,12
14076,2,10,3,0,7,3
14076,1,3,2,0,1,2
142124,9,13,1,0,12,1
142124,8,43,1,0,42,1
142124,7,36,3,0,33,3
142124,6,23,2,0,21,2
142124,5,12,3,0,9,3
142124,1,1,1,0,0,1
7420,10,10,4,0,6,4
7420,9,9,4,0,5,4
7420,8,22,4,0,18,4
7420,7,34,4,0,30,4
7420,6,38,8,0,30,8
7420,5,17,3,0,14,3
7420,4,7,1,0,6,1
28828,10,4,1,0,3,1
28828,9,8,1,0,7,1
28828,8,25,8,0,17,8
28828,7,42,14,0,28,14
28828,6,40,6,0,34,6
28828,5,12,2,0,10,2
28828,4,5,2,0,3,2
28828,2,3,1,0,2,1
771,10,3,1,0,2,1
771,9,2,1,0,1,1
771,8,29,13,0,16,13
771,7,43,15,0,28,15
771,6,48,11,0,37,11
771,5,6,1,0,5,1
771,4,6,2,0,4,2
771,3,3,2,0,1,2
771,1,1,1,0,0,1
194194,10,1,1,0,0,1
194194,8,20,3,0,17,3
194194,7,48,3,0,45,3
194194,6,47,3,0,44,3
76442,8,12,2,0,10,2
76442,7,41,10,0,31,10
76442,6,41,14,0,27,14
76442,5,16,5,0,11,5
76442,4,15,6,0,9,6
76442,3,9,2,0,7,2
76442,2,3,1,0,2,1
76442,1,1,1,0,0,1
7064,10,3,1,0,2,1
7064,9,3,1,0,2,1
7064,8,30,18,0,12,18
7064,7,45,21,0,24,21
7064,6,31,9,0,22,9
7064,5,20,8,0,12,8
7064,4,6,2,0,4,2
7064,2,1,1,0,0,1
5272,9,4,1,0,3,1
5272,8,9,5,0,4,5
5272,7,17,5,0,12,5
5272,6,47,17,0,30,17
5272,5,30,7,0,23,7
5272,4,16,6,0,10,6
5272,3,10,6,0,4,6
5272,2,5,1,0,4,1
5272,1,2,1,0,1,1
130242,8,17,1,0,16,1
130242,7,44,6,0,38,6
130242,6,49,6,0,43,6
130242,5,16,3,0,13,3
130242,4,7,1,0,6,1
2362,9,2,1,0,1,1
2362,8,10,1,0,9,1
2362,7,26,11,0,15,11
2362,6,50,13,0,37,13
2362,5,28,12,0,16,12
2362,4,18,4,0,14,4
2362,3,3,1,0,2,1
2362,2,2,1,0,1,1
940,9,2,1,0,1,1
940,8,10,2,0,8,2
940,7,44,15,0,29,15
940,6,49,7,0,42,7
940,5,23,5,0,18,5
940,4,7,2,0,5,2
940,3,5,2,0,3,2
1973,8,8,3,0,5,3
1973,7,17,6,0,11,6
1973,6,48,7,0,41,7
1973,5,33,6,0,27,6
1973,4,21,5,0,16,5
1973,3,9,2,0,7,2
1973,2,5,1,0,4,1
129858,10,4,1,0,3,1
129858,9,6,1,0,5,1
129858,8,22,2,0,20,2
129858,7,33,3,0,30,3
129858,6,48,11,0,37,11
129858,5,20,2,0,18,2
129858,4,4,1,0,3,1
129858,3,1,1,0,0,1
557,9,2,2,0,0,2
557,8,13,3,0,10,3
557,7,23,5,0,18,5
557,6,54,12,0,42,12
557,5,30,6,0,24,6
557,4,12,2,0,10,2
557,3,4,1,0,3,1
557,2,2,1,0,1,1
68340,8,15,4,0,11,4
68340,7,27,4,0,23,4
68340,6,48,11,0,37,11
68340,5,31,7,0,24,7
68340,3,5,1,0,4,1
103670,10,17,3,0,14,3
103670,9,29,6,0,23,6
103670,8,38,8,0,30,8
103670,7,25,3,0,22,3
103670,6,21,6,0,15,6
103670,4,3,3,0,0,3
103670,3,2,2,0,0,2
7822,8,5,1,0,4,1
7822,7,10,1,0,9,1
7822,6,22,3,0,19,3
7822,5,16,2,0,14,2
7822,4,18,6,0,12,6
7822,3,13,4,0,9,4
7822,2,25,10,0,15,10
7822,1,20,8,0,12,8
13455,10,4,1,0,3,1
13455,9,3,2,0,1,2
13455,8,31,13,0,18,13
13455,7,41,13,0,28,13
13455,6,39,14,0,25,14
13455,5,15,8,0,7,8
13455,4,5,3,0,2,3
13455,3,3,3,0,0,3
36523,9,1,1,0,0,1
36523,8,8,3,0,5,3
36523,7,22,9,0,13,9
36523,6,60,13,0,47,13
36523,5,24,8,0,16,8
36523,4,11,4,0,7,4
36523,3,6,1,0,5,1
36523,2,7,2,0,5,2
180611,10,11,5,0,6,5
180611,9,13,5,0,8,5
180611,8,9,4,1,5,3
180611,7,11,2,0,9,2
180611,6,11,2,1,9,1
180611,5,12,2,0,10,2
180611,4,15,5,1,10,4
180611,3,9,2,0,7,2
180611,2,17,7,1,10,6
180611,1,32,21,0,11,21
3089,9,3,2,0,1,2
3089,8,9,4,0,5,4
3089,7,19,2,0,17,2
3089,6,39,13,0,26,13
3089,5,31,11,0,20,11
3089,4,22,8,0,14,8
3089,3,12,6,0,6,6
3089,2,4,2,0,2,2
3089,1,1,1,0,0,1
228051,10,38,12,0,26,12
228051,9,44,5,0,39,5
228051,8,39,12,0,27,12
228051,5,1,1,0,0,1
228051,4,1,1,0,0,1
228051,1,1,1,0,0,1
2169,9,6,1,0,5,1
2169,8,9,2,0,7,2
2169,7,20,7,0,13,7
2169,6,44,11,0,33,11
2169,5,22,10,0,12,10
2169,4,13,5,0,8,5
2169,3,16,12,0,4,12
2169,2,7,4,0,3,4
2169,1,1,1,0,0,1
25937,10,5,2,0,3,2
25937,9,2,1,0,1,1
25937,8,21,9,0,12,9
25937,7,37,15,0,22,15
25937,6,35,11,0,24,11
25937,5,15,5,0,10,5
25937,4,15,8,0,7,8
25937,3,6,3,0,3,3
25937,2,3,3,0,0,3
25937,1,1,1,0,0,1
67823,9,3,1,0,2,1
67823,8,20,1,0,19,1
67823,7,39,5,0,34,5
67823,6,46,1,0,45,1
67823,5,17,2,0,15,2
95710,10,3,1,0,2,1
95710,7,18,3,0,15,3
95710,6,35,10,0,25,10
95710,5,24,2,0,22,2
95710,4,22,3,0,19,3
95710,3,12,2,0,10,2
95710,2,9,2,0,7,2
144709,10,3,1,0,2,1
144709,9,6,1,0,5,1
144709,8,30,10,0,20,10
144709,7,46,15,0,31,15
144709,6,37,5,0,32,5
144709,5,8,2,0,6,2
144709,3,6,1,0,5,1
144709,2,1,1,0,0,1
179929,10,1,1,0,0,1
179929,8,26,10,4,16,6
179929,7,36,9,2,27,7
179929,6,51,8,2,43,6
179929,5,17,2,0,15,2
19918,10,6,1,0,5,1
19918,9,3,2,0,1,2
19918,8,25,9,0,16,9
19918,7,31,9,0,22,9
19918,6,46,14,0,32,14
19918,5,19,10,0,9,10
19918,4,2,2,0,0,2
19918,3,6,3,0,3,3
7709,10,1,1,0,0,1
7709,8,3,1,0,2,1
7709,7,10,6,0,4,6
7709,6,26,12,0,14,12
7709,5,42,10,0,32,10
7709,4,26,10,0,16,10
7709,3,13,4,0,9,4
7709,2,15,7,0,8,7
7709,1,4,2,0,2,2
80869,10,5,2,0,3,2
80869,9,12,7,0,5,7
80869,8,26,10,0,16,10
80869,7,26,2,0,24,2
80869,6,31,5,0,26,5
80869,5,11,4,0,7,4
80869,4,9,1,0,8,1
80869,3,6,2,0,4,2
80869,2,11,6,0,5,6
211808,10,24,5,0,19,5
211808,9,13,5,0,8,5
211808,8,23,6,2,17,4
211808,7,24,3,1,21,2
211808,6,23,3,0,20,3
211808,5,16,3,0,13,3
211808,4,5,1,1,4,0
211808,3,7,2,0,5,2
211808,1,2,1,0,1,1
80908,10,1,1,0,0,1
80908,8,12,2,0,10,2
80908,7,23,7,0,16,7
80908,6,52,17,0,35,17
80908,5,24,2,0,22,2
80908,3,8,2,0,6,2
4317,9,2,1,0,1,1
4317,8,13,5,0,8,5
4317,7,23,5,0,18,5
4317,6,46,13,0,33,13
4317,5,36,9,0,27,9
4317,4,11,6,0,5,6
4317,3,7,2,0,5,2
247935,10,9,3,0,6,3
247935,9,23,6,0,17,6
247935,8,56,13,2,43,11
247935,7,32,6,0,26,6
247935,6,14,1,0,13,1
247935,5,5,2,0,3,2
5698,9,11,4,0,7,4
5698,8,44,9,0,35,9
5698,7,39,11,0,28,11
5698,6,27,8,0,19,8
5698,5,10,2,0,8,2
5698,4,4,1,0,3,1
25920,10,3,2,0,1,2
25920,9,5,2,0,3,2
25920,8,11,5,0,6,5
25920,7,21,9,0,12,9
25920,6,45,19,0,26,19
25920,5,24,4,0,20,4
25920,4,15,6,0,9,6
25920,3,8,4,0,4,4
25920,2,4,2,0,2,2
25920,1,4,2,0,2,2
135107,10,2,1,1,1,0
135107,9,1,1,0,0,1
135107,8,11,4,1,7,3
135107,7,30,9,1,21,8
135107,6,46,7,0,39,7
135107,5,29,10,1,19,9
135107,4,13,7,0,6,7
135107,3,4,2,0,2,2
135107,2,3,1,1,2,0
33624,7,28,1,0,27,1
33624,6,48,5,0,43,5
33624,5,24,2,0,22,2
33624,4,13,3,0,10,3
33624,3,5,1,0,4,1
33624,2,4,1,0,3,1
93577,9,5,1,0,4,1
93577,7,17,1,0,16,1
93577,6,57,16,0,41,16
93577,5,34,7,0,27,7
93577,4,10,3,0,7,3
93577,3,10,6,0,4,6
93577,2,3,1,0,2,1
6121,10,4,2,0,2,2
6121,8,20,8,0,12,8
6121,7,32,12,0,20,12
6121,6,47,19,0,28,19
6121,5,23,6,0,17,6
6121,4,7,2,0,5,2
6121,3,4,3,0,1,3
9177,10,6,2,0,4,2
9177,9,10,3,0,7,3
9177,8,18,8,0,10,8
9177,7,37,12,0,25,12
9177,6,41,11,0,30,11
9177,5,12,4,0,8,4
9177,4,11,5,0,6,5
9177,3,3,1,0,2,1
9177,2,1,1,0,0,1
141418,10,19,6,0,13,6
141418,9,21,10,0,11,10
141418,8,20,5,0,15,5
141418,7,20,2,0,18,2
141418,6,25,5,0,20,5
141418,5,15,4,0,11,4
141418,4,10,4,0,6,4
141418,3,6,3,0,3,3
141418,2,1,1,0,0,1
192777,10,2,1,0,1,1
192777,8,28,3,0,25,3
192777,7,46,6,0,40,6
192777,5,10,1,0,9,1
192777,3,3,1,0,2,1
89956,7,20,3,0,17,3
89956,6,41,10,0,31,10
89956,5,37,7,0,30,7
89956,4,18,5,0,13,5
89956,3,10,4,0,6,4
89956,2,4,1,0,3,1
174926,9,8,2,0,6,2
174926,8,40,10,2,30,8
174926,7,52,8,1,44,7
174926,6,24,3,0,21,3
174926,5,10,2,1,8,1
174926,3,1,1,0,0,1
5485,10,5,4,0,1,4
5485,9,9,4,0,5,4
5485,8,30,9,0,21,9
5485,7,34,12,0,22,12
5485,6,40,10,0,30,10
5485,5,8,2,0,6,2
5485,4,10,3,0,7,3
5485,3,2,1,0,1,1
5485,1,1,1,0,0,1
23957,10,1,1,0,0,1
23957,9,2,1,0,1,1
23957,8,11,6,0,5,6
23957,7,26,12,0,14,12
23957,6,52,25,0,27,25
23957,5,27,10,0,17,10
23957,4,13,7,0,6,7
23957,3,4,1,0,3,1
23957,2,2,2,0,0,2
23957,1,1,1,0,0,1
201478,10,4,2,0,2,2
201478,9,11,4,0,7,4
201478,8,36,10,1,26,9
201478,7,50,9,1,41,8
201478,6,28,6,1,22,5
94255,10,24,11,0,13,11
94255,9,16,7,0,9,7
94255,8,36,12,1,24,11
94255,7,21,4,0,17,4
94255,6,21,8,0,13,8
94255,5,9,2,0,7,2
94255,4,6,1,0,5,1
94255,3,5,3,0,2,3
99132,10,9,2,0,7,2
99132,9,11,5,0,6,5
99132,8,39,13,0,26,13
99132,7,28,7,0,21,7
99132,6,22,7,0,15,7
99132,5,16,5,0,11,5
99132,4,7,2,0,5,2
99132,2,5,1,0,4,1
99132,1,1,1,0,0,1
42920,9,1,1,0,0,1
42920,8,10,2,0,8,2
42920,7,16,7,0,9,7
42920,6,40,16,0,24,16
42920,5,25,7,0,18,7
42920,4,32,10,0,22,10
42920,3,6,4,0,2,4
42920,2,8,2,0,6,2
8986,9,5,2,0,3,2
8986,8,20,2,0,18,2
8986,7,38,13,0,25,13
8986,6,39,10,0,29,10
8986,5,17,7,0,10,7
8986,4,7,3,0,4,3
8986,3,9,3,0,6,3
8986,2,2,2,0,0,2
130682,8,14,2,0,12,2
130682,7,26,3,0,23,3
130682,6,37,6,0,31,6
130682,5,30,2,0,28,2
130682,4,12,2,0,10,2
130682,1,4,3,0,1,3
35256,10,3,2,0,1,2
35256,9,7,2,0,5,2
35256,8,12,4,0,8,4
35256,7,28,7,0,21,7
35256,6,37,16,0,21,16
35256,5,19,5,0,14,5
35256,4,17,4,0,13,4
35256,3,10,7,0,3,7
35256,2,6,5,0,1,5
109643,9,5,4,0,1,4
109643,8,18,5,0,13,5
109643,7,16,4,0,12,4
109643,6,44,13,0,31,13
109643,5,26,6,1,20,5
109643,4,17,7,0,10,7
109643,3,9,3,0,6,3
109643,2,2,2,0,0,2
2298,9,15,3,0,12,3
2298,8,41,15,0,26,15
2298,7,39,9,0,30,9
2298,6,28,7,0,21,7
2298,5,7,1,0,6,1
2298,4,7,4,0,3,4
183831,10,10,2,0,8,2
183831,8,15,1,0,14,1
183831,7,23,5,0,18,5
183831,6,35,4,0,31,4
183831,5,21,1,1,20,0
183831,4,10,2,0,8,2
183831,3,9,5,0,4,5
183831,1,5,3,0,2,3
151410,10,6,2,0,4,2
151410,9,9,3,0,6,3
151410,8,18,5,1,13,4
151410,7,25,3,0,22,3
151410,6,33,7,1,26,6
151410,5,16,2,1,14,1
151410,4,17,4,0,13,4
151410,2,6,3,2,3,1
151410,1,2,1,0,1,1
1305,10,1,1,0,0,1
1305,9,3,1,0,2,1
1305,8,14,7,0,7,7
1305,7,34,13,0,21,13
1305,6,57,13,0,44,13
1305,5,14,4,0,10,4
1305,4,7,4,0,3,4
1305,3,5,2,0,3,2
1305,2,3,1,0,2,1
151016,10,4,1,0,3,1
151016,9,2,1,0,1,1
151016,8,18,3,0,15,3
151016,7,39,7,0,32,7
151016,6,44,5,0,39,5
151016,5,14,2,0,12,2
151016,4,9,2,0,7,2
151016,3,6,2,0,4,2
151016,2,3,2,0,1,2
8818,9,1,1,0,0,1
8818,8,11,7,0,4,7
8818,7,29,12,0,17,12
8818,6,57,24,0,33,24
8818,5,30,4,0,26,4
8818,4,7,3,0,4,3
8818,3,3,1,0,2,1
35477,10,6,1,0,5,1
35477,8,56,10,0,46,10
35477,7,37,5,0,32,5
35477,6,20,4,0,16,4
35477,5,5,2,0,3,2
189166,8,17,2,0,15,2
189166,7,35,6,0,29,6
189166,6,42,8,0,34,8
189166,5,17,2,0,15,2
189166,4,11,3,0,8,3
189166,3,8,2,0,6,2
156096,10,12,2,0,10,2
156096,8,36,8,0,28,8
156096,7,53,10,0,43,10
156096,6,21,4,0,17,4
156096,5,6,1,0,5,1
156096,2,1,1,0,0,1
197333,10,29,13,0,16,13
197333,9,38,9,0,29,9
197333,8,44,5,0,39,5
197333,7,16,1,0,15,1
197333,3,1,1,0,0,1
197333,2,1,1,0,0,1
1772,10,4,3,0,1,3
1772,9,7,2,0,5,2
1772,8,15,8,0,7,8
1772,7,33,12,0,21,12
1772,6,43,15,0,28,15
1772,5,29,12,0,17,12
1772,4,4,2,0,2,2
1772,3,4,2,0,2,2
207845,10,4,2,0,2,2
207845,9,9,5,0,4,5
207845,8,39,10,0,29,10
207845,7,32,5,0,27,5
207845,6,39,4,0,35,4
207845,5,9,3,0,6,3
207845,4,5,2,0,3,2
36661,10,3,2,0,1,2
36661,9,4,2,0,2,2
36661,8,35,9,0,26,9
36661,7,27,5,0,22,5
36661,6,35,9,0,26,9
36661,5,20,8,0,12,8
36661,4,10,5,0,5,5
36661,1,1,1,0,0,1
4382,10,1,1,0,0,1
4382,9,3,1,0,2,1
4382,8,7,1,0,6,1
4382,7,18,3,0,15,3
4382,6,37,7,0,30,7
4382,5,26,10,0,16,10
4382,4,23,10,0,13,10
4382,3,10,6,0,4,6
4382,2,10,4,0,6,4
4382,1,4,2,0,2,2
221669,10,12,4,0,8,4
221669,9,29,11,0,18,11
221669,8,53,11,0,42,11
221669,7,17,1,0,16,1
221669,6,15,4,1,11,3
221669,5,8,2,0,6,2
221669,4,4,1,0,3,1
643,10,3,1,0,2,1
643,9,9,2,0,7,2
643,8,18,5,0,13,5
643,7,29,8,0,21,8
643,6,39,9,0,30,9
643,5,23,9,0,14,9
643,4,10,2,0,8,2
643,3,6,3,0,3,3
140840,10,8,2,0,6,2
140840,9,8,2,0,6,2
140840,8,22,6,0,16,6
140840,6,23,3,0,20,3
140840,5,21,4,0,17,4
140840,4,18,5,0,13,5
140840,3,12,3,0,9,3
140840,2,5,2,0,3,2
140840,1,9,3,0,6,3
211450,8,22,3,0,19,3
211450,7,36,4,0,32,4
211450,6,40,6,0,34,6
211450,5,20,2,0,18,2
211450,4,11,2,0,9,2
211450,3,5,1,0,4,1
211450,2,2,1,0,1,1
204143,10,16,5,0,11,5
204143,9,17,7,2,10,5
204143,8,28,7,1,21,6
204143,7,26,5,2,21,3
204143,6,24,3,0,21,3
204143,5,7,1,0,6,1
204143,2,5,4,0,1,4
204143,1,6,2,0,4,2
156007,10,3,2,0,1,2
156007,9,16,4,0,12,4
156007,8,49,15,0,34,15
156007,7,34,11,0,23,11
156007,6,24,6,0,18,6
156007,5,7,3,0,4,3
156007,4,1,1,0,0,1
156007,2,2,2,0,0,2
1014,8,27,5,0,22,5
1014,7,41,9,0,32,9
1014,6,34,7,0,27,7
1014,5,11,1,0,10,1
1014,4,8,1,0,7,1
1014,3,1,1,0,0,1
3091,10,2,1,0,1,1
3091,8,8,3,0,5,3
3091,7,21,4,0,17,4
3091,6,46,11,0,35,11
3091,5,27,7,0,20,7
3091,4,20,5,0,15,5
3091,3,7,2,0,5,2
3091,2,3,2,0,1,2
956,9,3,2,0,1,2
956,8,14,4,0,10,4
956,7,30,11,0,19,11
956,6,41,10,0,31,10
956,5,27,11,0,16,11
956,4,10,6,0,4,6
956,3,9,2,0,7,2
20528,9,11,4,0,7,4
20528,8,18,8,0,10,8
20528,7,23,2,0,21,2
20528,6,40,12,0,28,12
20528,5,21,9,0,12,9
20528,4,15,2,0,13,2
20528,3,7,3,0,4,3
20528,2,2,2,0,0,2
178958,10,6,3,0,3,3
178958,9,10,2,0,8,2
178958,8,23,6,2,17,4
178958,7,37,10,3,27,7
178958,6,36,2,0,34,2
178958,5,17,2,0,15,2
178958,4,5,1,0,4,1
178958,3,3,1,0,2,1
178958,2,1,1,0,0,1
141734,9,2,1,0,1,1
141734,8,15,4,0,11,4
141734,7,28,10,0,18,10
141734,6,60,16,0,44,16
141734,5,19,4,0,15,4
141734,4,8,2,0,6,2
141734,3,5,3,0,2,3
249833,10,3,1,0,2,1
249833,9,12,2,0,10,2
249833,8,27,4,0,23,4
249833,7,32,1,0,31,1
249833,6,41,6,0,35,6
249833,5,13,2,0,11,2
249833,4,6,2,0,4,2
249833,3,3,1,0,2,1
158753,10,24,5,0,19,5
158753,9,25,7,0,18,7
158753,8,42,9,3,33,6
158753,7,23,2,0,21,2
158753,6,14,1,0,13,1
158753,5,3,1,0,2,1
158753,4,3,2,0,1,2
158753,3,3,1,0,2,1
158753,2,1,1,0,0,1
158753,1,1,1,1,0,0
8782,10,7,2,0,5,2
8782,9,8,3,0,5,3
8782,8,34,9,0,25,9
8782,7,39,14,0,25,14
8782,6,30,7,0,23,7
8782,5,15,4,0,11,4
8782,4,4,1,0,3,1
13981,10,5,2,0,3,2
13981,9,6,2,0,4,2
13981,8,26,14,0,12,14
13981,7,39,18,0,21,18
13981,6,30,15,0,15,15
13981,5,21,6,0,15,6
13981,4,8,6,0,2,6
13981,3,3,2,0,1,2
22080,10,3,1,0,2,1
22080,8,6,1,0,5,1
22080,7,27,2,0,25,2
22080,6,39,6,0,33,6
22080,5,27,4,0,23,4
22080,4,26,5,0,21,5
22080,3,6,1,0,5,1
5707,8,14,4,0,10,4
5707,7,21,7,0,14,7
5707,6,44,14,0,30,14
5707,5,31,7,0,24,7
5707,4,14,4,0,10,4
5707,3,8,2,0,6,2
5707,2,2,1,0,1,1
188343,10,10,4,1,6,3
188343,9,19,7,1,12,6
188343,8,42,10,2,32,8
188343,7,23,4,0,19,4
188343,6,23,3,0,20,3
188343,5,10,2,0,8,2
188343,4,7,2,0,5,2
188343,3,3,1,0,2,1
1354,9,3,1,0,2,1
1354,8,5,1,0,4,1
1354,7,25,11,0,14,11
1354,6,50,6,0,44,6
1354,5,27,1,0,26,1
1354,4,16,5,0,11,5
1354,3,7,1,0,6,1
1354,2,3,2,0,1,2
179627,10,2,1,1,1,0
179627,9,8,4,0,4,4
179627,8,22,2,1,20,1
179627,7,40,5,3,35,2
179627,6,43,6,1,37,5
179627,5,12,2,1,10,1
179627,4,4,1,0,3,1
15110,8,20,5,0,15,5
15110,7,31,4,0,27,4
15110,6,30,4,0,26,4
15110,5,19,4,0,15,4
15110,4,16,2,0,14,2
15110,2,4,2,0,2,2
168230,10,57,41,0,16,41
168230,9,16,6,0,10,6
168230,8,18,6,1,12,5
168230,7,16,3,0,13,3
168230,6,13,5,0,8,5
168230,5,4,1,0,3,1
168230,4,6,1,0,5,1
168230,3,4,1,0,3,1
168230,1,2,1,0,1,1
24083,9,1,1,0,0,1
24083,8,5,2,0,3,2
24083,7,21,8,0,13,8
24083,6,66,29,0,37,29
24083,5,22,11,0,11,11
24083,4,17,8,0,9,8
24083,3,5,4,0,1,4
135796,10,15,3,0,12,3
135796,9,37,8,0,29,8
135796,8,47,11,0,36,11
135796,7,25,5,0,20,5
135796,6,7,2,0,5,2
135796,5,3,1,0,2,1
3914,10,3,1,0,2,1
3914,8,11,8,0,3,8
3914,7,14,7,0,7,7
3914,6,37,14,0,23,14
3914,5,21,6,0,15,6
3914,4,25,8,0,17,8
3914,3,10,3,0,7,3
3914,2,9,4,0,5,4
24078,9,8,4,0,4,4
24078,8,21,10,0,11,10
24078,7,41,18,0,23,18
24078,6,42,19,0,23,19
24078,5,20,7,0,13,7
24078,4,5,2,0,3,2
2856,8,11,4,0,7,4
2856,7,25,7,0,18,7
2856,6,52,16,0,36,16
2856,5,24,12,0,12,12
2856,4,9,2,0,7,2
2856,3,7,3,0,4,3
2856,2,6,6,0,0,6
153481,9,2,1,0,1,1
153481,8,30,9,0,21,9
153481,7,40,9,0,31,9
153481,6,44,6,0,38,6
153481,5,13,3,0,10,3
153481,4,7,3,0,4,3
153481,2,1,1,0,0,1
5725,10,3,1,0,2,1
5725,8,13,3,0,10,3
5725,7,23,9,0,14,9
5725,6,51,17,0,34,17
5725,5,21,10,0,11,10
5725,4,10,4,0,6,4
5725,3,10,3,0,7,3
5725,2,3,2,0,1,2
4959,10,5,1,0,4,1
4959,9,6,1,0,5,1
4959,8,28,8,0,20,8
4959,7,33,15,0,18,15
4959,6,35,7,0,28,7
4959,5,14,7,0,7,7
4959,4,10,6,0,4,6
4959,3,2,2,0,0,2
4959,2,3,2,0,1,2
4959,1,1,1,0,0,1
163432,10,14,7,0,7,7
163432,8,35,4,0,31,4
163432,7,28,5,0,23,5
163432,6,33,5,1,28,4
163432,5,10,4,1,6,3
163432,4,5,1,0,4,1
163432,3,2,2,0,0,2
163432,2,2,1,0,1,1
53376,8,12,1,0,11,1
53376,7,17,5,0,12,5
53376,6,28,8,0,20,8
53376,5,24,7,0,17,7
53376,4,21,8,0,13,8
53376,3,18,5,0,13,5
53376,2,8,5,0,3,5
53376,1,6,2,0,4,2
85424,10,40,17,0,23,17
85424,9,44,8,0,36,8
85424,8,30,5,0,25,5
85424,7,14,4,0,10,4
85424,3,2,1,0,1,1
202494,10,4,1,0,3,1
202494,8,21,9,0,12,9
202494,7,36,5,0,31,5
202494,6,40,4,0,36,4
202494,5,13,3,0,10,3
202494,4,13,4,0,9,4
202494,3,3,1,0,2,1
202494,1,3,2,0,1,2
10149,10,7,3,0,4,3
10149,9,10,2,0,8,2
10149,8,22,10,0,12,10
10149,7,44,15,0,29,15
10149,6,30,5,0,25,5
10149,5,10,2,0,8,2
10149,4,9,4,0,5,4
10149,3,3,3,0,0,3
10149,2,2,2,0,0,2
212382,9,7,1,0,6,1
212382,8,24,9,0,15,9
212382,7,48,15,0,33,15
212382,6,32,8,0,24,8
212382,4,5,1,0,4,1
54745,8,11,1,0,10,1
54745,7,23,5,0,18,5
54745,6,43,6,0,37,6
54745,5,36,9,0,27,9
54745,4,16,6,0,10,6
54745,3,5,2,0,3,2
425,8,15,2,0,13,2
425,7,37,16,0,21,16
425,6,46,14,0,32,14
425,5,25,12,0,13,12
425,4,10,2,0,8,2
7994,10,4,1,0,3,1
7994,9,11,5,0,6,5
7994,8,27,11,0,16,11
7994,7,32,14,0,18,14
7994,6,38,7,0,31,7
7994,5,15,1,0,14,1
7994,4,6,3,0,3,3
13513,8,8,2,0,6,2
13513,7,15,6,0,9,6
13513,6,55,8,0,47,8
13513,5,27,9,0,18,9
13513,4,16,3,0,13,3
13513,3,8,1,0,7,1
13513,2,6,2,0,4,2
233960,9,4,1,0,3,1
233960,8,21,4,0,17,4
233960,7,38,10,0,28,10
233960,6,46,8,0,38,8
233960,5,17,5,0,12,5
233960,3,4,1,0,3,1
233960,2,1,1,0,0,1
11778,10,2,1,0,1,1
11778,9,1,1,0,0,1
11778,8,3,2,0,1,2
11778,7,11,8,0,3,8
11778,6,37,15,0,22,15
11778,5,21,5,0,16,5
11778,4,34,17,0,17,17
11778,3,21,7,0,14,7
11778,2,7,3,0,4,3
117707,8,20,2,0,18,2
117707,7,32,5,0,27,5
117707,6,51,10,0,41,10
117707,5,15,1,0,14,1
117707,4,10,2,0,8,2
1898,9,2,1,0,1,1
1898,8,13,4,0,9,4
1898,7,22,2,0,20,2
1898,6,40,8,0,32,8
1898,5,20,4,0,16,4
1898,4,7,1,0,6,1
1898,3,5,1,0,4,1
1898,2,1,1,0,0,1
4598,10,1,1,0,0,1
4598,8,5,4,0,1,4
4598,6,42,6,0,36,6
4598,5,32,6,0,26,6
4598,4,26,5,0,21,5
4598,3,6,3,0,3,3
4598,1,1,1,0,0,1
5755,10,1,1,0,0,1
5755,9,3,3,0,0,3
5755,8,8,7,0,1,7
5755,7,18,7,0,11,7
5755,6,33,10,0,23,10
5755,5,30,12,0,18,12
5755,4,6,2,0,4,2
5755,3,9,3,0,6,3
5755,1,1,1,0,0,1
20044,9,8,1,0,7,1
20044,8,29,7,0,22,7
20044,7,42,6,0,36,6
20044,6,27,7,0,20,7
20044,5,11,3,0,8,3
20044,4,5,1,0,4,1
20044,2,1,1,0,0,1
220368,9,3,1,0,2,1
220368,8,19,4,0,15,4
220368,7,41,8,0,33,8
220368,6,41,8,1,33,7
220368,5,15,3,1,12,2
220368,4,4,1,0,3,1
220368,3,7,5,0,2,5
220368,2,2,1,0,1,1
147241,9,17,8,1,9,7
147241,8,40,12,1,28,11
147241,7,41,6,0,35,6
147241,6,24,6,0,18,6
147241,5,10,1,0,9,1
147241,4,3,2,0,1,2
157653,10,11,6,0,5,6
157653,9,27,8,0,19,8
157653,8,40,10,0,30,10
157653,7,24,7,0,17,7
157653,6,16,7,0,9,7
157653,5,5,4,0,1,4
157653,4,7,4,0,3,4
157653,3,4,3,0,1,3
157653,2,2,2,0,0,2
157653,1,1,1,0,0,1
9161,10,5,2,0,3,2
9161,9,6,3,0,3,3
9161,8,17,6,0,11,6
9161,7,28,6,0,22,6
9161,6,39,15,0,24,15
9161,5,22,3,0,19,3
9161,4,10,4,0,6,4
9161,3,7,3,0,4,3
9161,1,1,1,0,0,1
6380,10,7,3,0,4,3
6380,9,7,2,0,5,2
6380,8,22,8,0,14,8
6380,7,30,9,0,21,9
6380,6,32,9,0,23,9
6380,5,21,5,0,16,5
6380,4,10,2,0,8,2
6380,3,5,2,0,3,2
6380,2,2,2,0,0,2
6380,1,1,1,0,0,1
153116,8,13,3,0,10,3
153116,7,12,1,0,11,1
153116,6,51,8,0,43,8
153116,5,25,5,0,20,5
153116,4,13,6,0,7,6
153116,3,16,3,0,13,3
153116,2,4,1,0,3,1
171447,7,19,2,0,17,2
171447,6,52,12,0,40,12
171447,5,22,3,0,19,3
171447,4,18,3,0,15,3
171447,3,15,3,0,12,3
171447,2,5,1,0,4,1
22472,10,4,3,0,1,3
22472,9,5,2,0,3,2
22472,8,35,11,0,24,11
22472,7,50,16,0,34,16
22472,6,26,15,0,11,15
22472,5,7,6,0,1,6
22472,4,7,4,0,3,4
22472,3,2,2,0,0,2
5996,8,4,2,0,2,2
5996,7,19,4,0,15,4
5996,6,33,4,0,29,4
5996,5,45,15,0,30,15
5996,4,20,5,0,15,5
5996,3,9,3,0,6,3
5996,2,6,4,0,2,4
89927,7,15,5,0,10,5
89927,6,46,10,0,36,10
89927,5,45,6,0,39,6
89927,4,18,5,0,13,5
89927,3,8,3,0,5,3
195455,8,9,2,0,7,2
195455,7,17,1,0,16,1
195455,6,41,6,1,35,5
195455,5,26,3,0,23,3
195455,4,20,5,1,15,4
195455,3,12,6,1,6,5
195455,2,5,2,0,3,2
195455,1,3,1,0,2,1
253786,9,10,3,0,7,3
253786,8,53,10,0,43,10
253786,7,36,8,0,28,8
253786,6,20,1,0,19,1
253786,5,7,2,0,5,2
9476,10,2,1,0,1,1
9476,8,39,13,0,26,13
9476,7,40,10,0,30,10
9476,6,32,9,0,23,9
9476,5,10,2,0,8,2
9476,3,3,2,0,1,2
9476,2,1,1,0,0,1
42368,8,9,3,0,6,3
42368,7,30,7,0,23,7
42368,6,44,12,0,32,12
42368,5,23,9,0,14,9
42368,4,17,6,0,11,6
42368,3,5,2,0,3,2
42368,2,4,2,0,2,2
42368,1,4,2,0,2,2
117987,7,26,3,0,23,3
117987,6,39,7,0,32,7
117987,5,32,4,0,28,4
117987,4,18,2,0,16,2
117987,3,9,1,0,8,1
117987,2,4,3,0,1,3
206299,10,9,2,0,7,2
206299,9,28,10,1,18,9
206299,8,48,10,1,38,9
206299,7,27,4,0,23,4
206299,6,9,3,0,6,3
206299,4,5,2,0,3,2
206299,3,3,3,0,0,3
206299,2,2,1,0,1,1
206299,1,2,1,0,1,1
256297,10,13,2,0,11,2
256297,9,15,5,0,10,5
256297,8,46,7,0,39,7
256297,7,31,5,0,26,5
256297,6,20,2,0,18,2
256297,4,5,2,0,3,2
17807,9,12,1,0,11,1
17807,8,11,1,0,10,1
17807,7,25,4,0,21,4
17807,6,36,8,0,28,8
17807,5,25,11,0,14,11
17807,4,13,5,0,8,5
17807,3,5,2,0,3,2
17807,1,6,3,0,3,3
5304,10,2,1,0,1,1
5304,9,2,1,0,1,1
5304,8,10,3,0,7,3
5304,7,13,2,0,11,2
5304,6,35,8,0,27,8
5304,5,37,13,0,24,13
5304,4,19,7,0,12,7
5304,3,12,3,0,9,3
5304,2,6,3,0,3,3
177843,10,2,1,0,1,1
177843,9,2,1,0,1,1
177843,8,14,3,0,11,3
177843,7,33,3,0,30,3
177843,6,51,6,0,45,6
177843,5,21,4,0,17,4
177843,4,8,2,0,6,2
177843,3,2,1,0,1,1
177843,1,1,1,0,0,1
72799,9,10,6,0,4,6
72799,8,38,17,0,21,17
72799,7,33,10,0,23,10
72799,6,26,5,0,21,5
72799,5,11,3,0,8,3
72799,3,2,2,1,0,1
72799,1,1,1,0,0,1
128219,10,9,3,0,6,3
128219,9,5,2,0,3,2
128219,8,11,4,0,7,4
128219,7,26,5,0,21,5
128219,6,39,10,0,29,10
128219,5,22,3,0,19,3
128219,4,13,3,0,10,3
128219,3,3,1,0,2,1
128219,2,8,2,0,6,2
200280,10,19,11,1,8,10
200280,9,17,10,0,7,10
200280,8,42,10,2,32,8
200280,7,28,3,1,25,2
200280,6,19,8,1,11,7
200280,4,2,1,0,1,1
200280,2,1,1,0,0,1
150138,10,6,1,0,5,1
150138,9,10,1,0,9,1
150138,8,18,2,0,16,2
150138,7,32,5,0,27,5
150138,6,33,5,0,28,5
150138,5,19,4,0,15,4
150138,4,7,2,0,5,2
150138,2,5,1,0,4,1
150138,1,3,1,0,2,1
153839,8,12,2,0,10,2
153839,7,34,7,0,27,7
153839,6,61,14,0,47,14
153839,5,15,1,0,14,1
153839,4,10,2,0,8,2
99130,10,10,4,0,6,4
99130,9,16,8,0,8,8
99130,8,45,14,0,31,14
99130,7,36,6,1,30,5
99130,6,22,9,0,13,9
99130,5,4,1,0,3,1
99130,4,3,2,0,1,2
20018,9,1,1,0,0,1
20018,8,5,2,0,3,2
20018,7,23,4,0,19,4
20018,6,45,14,0,31,14
20018,5,30,10,0,20,10
20018,4,16,7,0,9,7
20018,3,15,7,0,8,7
31821,9,8,2,0,6,2
31821,8,33,3,0,30,3
31821,7,42,8,0,34,8
31821,6,30,5,0,25,5
31821,5,8,1,0,7,1
31821,4,8,2,0,6,2
31821,2,1,1,0,0,1
5575,10,7,6,0,1,6
5575,9,7,6,0,1,6
5575,8,27,18,0,9,18
5575,7,28,13,0,15,13
5575,6,30,10,0,20,10
5575,5,19,6,0,13,6
5575,4,9,8,0,1,8
5575,3,6,2,0,4,2
5575,2,2,1,0,1,1
1337,9,4,1,0,3,1
1337,8,16,7,0,9,7
1337,7,34,12,0,22,12
1337,6,48,16,0,32,16
1337,5,20,4,0,16,4
1337,4,10,1,0,9,1
1337,3,2,1,0,1,1
1337,2,2,1,0,1,1
12604,10,4,2,0,2,2
12604,9,4,3,0,1,3
12604,8,20,13,0,7,13
12604,7,29,13,0,16,13
12604,6,52,23,0,29,23
12604,5,11,5,0,6,5
12604,4,10,7,0,3,7
12604,3,3,2,0,1,2
12604,2,3,2,0,1,2
2157,10,9,3,0,6,3
2157,9,13,4,0,9,4
2157,8,19,4,0,15,4
2157,7,37,16,0,21,16
2157,6,34,10,0,24,10
2157,5,13,4,0,9,4
2157,4,7,2,0,5,2
2157,3,3,1,0,2,1
2157,2,1,1,0,0,1
127648,9,10,2,0,8,2
127648,7,18,1,0,17,1
127648,6,50,2,0,48,2
127648,5,23,2,0,21,2
127648,1,3,1,0,2,1
4815,10,20,10,0,10,10
4815,9,7,1,0,6,1
4815,8,13,6,0,7,6
4815,7,19,3,0,16,3
4815,6,21,6,0,15,6
4815,5,13,9,0,4,9
4815,4,6,1,0,5,1
4815,3,8,6,0,2,6
4815,2,12,7,0,5,7
4815,1,17,12,0,5,12
129225,10,3,2,0,1,2
129225,9,6,2,0,4,2
129225,8,32,8,0,24,8
129225,7,38,7,0,31,7
129225,6,39,5,0,34,5
129225,5,13,4,0,9,4
129225,4,4,2,0,2,2
4268,9,1,1,0,0,1
4268,8,11,1,0,10,1
4268,7,23,10,0,13,10
4268,6,47,14,0,33,14
4268,5,24,9,0,15,9
4268,4,21,5,0,16,5
4268,3,4,1,0,3,1
4268,2,5,3,0,2,3
162292,10,2,1,0,1,1
162292,9,6,2,0,4,2
162292,8,30,14,0,16,14
162292,7,35,9,0,26,9
162292,6,35,12,0,23,12
162292,5,17,5,0,12,5
162292,4,8,2,0,6,2
162292,2,2,1,0,1,1
203191,10,23,7,0,16,7
203191,9,25,8,2,17,6
203191,8,44,10,2,34,8
203191,7,11,1,0,10,1
203191,6,23,5,0,18,5
203191,2,2,2,0,0,2
13782,8,6,1,0,5,1
13782,6,24,6,0,18,6
13782,5,32,6,0,26,6
13782,4,27,7,0,20,7
13782,3,19,5,0,14,5
13782,2,12,2,0,10,2
13782,1,6,2,0,4,2
256728,10,5,1,0,4,1
256728,9,6,1,0,5,1
256728,8,32,4,0,28,4
256728,7,41,10,1,31,9
256728,6,24,5,0,19,5
256728,5,15,2,0,13,2
256728,4,9,2,0,7,2
256728,3,3,1,0,2,1
256728,1,2,1,0,1,1
173504,10,48,20,0,28,20
173504,9,37,12,0,25,12
173504,8,31,11,0,20,11
173504,7,12,4,0,8,4
6929,10,7,1,0,6,1
6929,9,9,3,0,6,3
6929,8,28,12,0,16,12
6929,7,39,18,0,21,18
6929,6,31,9,0,22,9
6929,5,15,2,0,13,2
6929,4,7,1,0,6,1
19735,10,4,2,0,2,2
19735,9,1,1,0,0,1
19735,8,13,4,0,9,4
19735,7,31,11,0,20,11
19735,6,44,17,0,27,17
19735,5,18,10,0,8,10
19735,4,13,5,0,8,5
19735,3,6,1,0,5,1
19735,2,5,3,0,2,3
39219,8,10,3,0,7,3
39219,7,30,7,0,23,7
39219,6,62,13,0,49,13
39219,5,18,7,0,11,7
39219,4,3,1,0,2,1
39219,3,8,3,0,5,3
39219,2,3,1,0,2,1
200512,9,10,3,0,7,3
200512,8,31,9,1,22,8
200512,7,32,10,3,22,7
200512,6,39,3,0,36,3
200512,5,12,4,0,8,4
2988,10,2,2,0,0,2
2988,8,8,1,0,7,1
2988,7,26,10,0,16,10
2988,6,55,23,0,32,23
2988,5,26,8,0,18,8
2988,4,13,2,0,11,2
2988,3,3,2,0,1,2
1244,9,5,4,0,1,4
1244,8,13,5,0,8,5
1244,7,33,11,0,22,11
1244,6,46,13,0,33,13
1244,5,21,7,0,14,7
1244,4,11,5,0,6,5
1244,2,5,3,0,2,3
252,10,6,5,0,1,5
252,8,18,9,0,9,9
252,7,38,18,0,20,18
252,6,43,23,0,20,23
252,5,15,7,0,8,7
252,4,7,2,0,5,2
273,10,1,1,0,0,1
273,9,7,2,0,5,2
273,8,9,2,0,7,2
273,7,20,6,0,14,6
273,6,44,10,0,34,10
273,5,24,5,0,19,5
273,4,16,6,0,10,6
273,3,7,3,0,4,3
273,2,7,3,0,4,3
92094,8,16,4,0,12,4
92094,7,13,2,0,11,2
92094,6,35,8,0,27,8
92094,5,32,4,0,28,4
92094,4,17,4,0,13,4
92094,3,10,1,0,9,1
92094,2,5,1,0,4,1
136058,8,4,1,0,3,1
136058,6,41,5,0,36,5
136058,5,30,6,0,24,6
136058,4,24,2,0,22,2
136058,2,7,2,0,5,2
20182,9,1,1,0,0,1
20182,8,10,2,0,8,2
20182,7,11,1,0,10,1
20182,6,29,4,0,25,4
20182,5,36,5,0,31,5
20182,4,22,4,0,18,4
20182,3,11,2,0,9,2
20182,2,9,2,0,7,2
153815,9,7,2,0,5,2
153815,8,28,9,0,19,9
153815,7,41,8,2,33,6
153815,6,33,8,1,25,7
153815,5,17,4,1,13,3
153815,4,4,2,0,2,2
32990,10,18,8,0,10,8
32990,9,32,9,0,23,9
32990,8,43,11,0,32,11
32990,7,25,3,0,22,3
32990,6,6,2,0,4,2
32990,5,6,1,0,5,1
32990,4,2,2,0,0,2
32990,3,2,2,0,0,2
210418,10,8,5,1,3,4
210418,9,12,2,0,10,2
210418,8,34,9,1,25,8
210418,7,30,3,1,27,2
210418,6,29,4,1,25,3
210418,5,11,2,0,9,2
210418,4,7,2,0,5,2
210418,3,3,1,0,2,1
233194,10,2,2,0,0,2
233194,9,10,3,0,7,3
233194,8,45,11,0,34,11
233194,7,40,4,0,36,4
233194,6,30,6,0,24,6
233194,5,5,1,0,4,1
7755,10,3,2,0,1,2
7755,9,8,2,0,6,2
7755,8,49,21,0,28,21
7755,7,36,12,0,24,12
7755,6,28,10,0,18,10
7755,5,5,2,0,3,2
145478,8,22,3,0,19,3
145478,7,43,13,0,30,13
145478,6,41,10,0,31,10
145478,5,18,2,0,16,2
145478,1,1,1,0,0,1
18835,8,19,8,0,11,8
18835,7,26,10,0,16,10
18835,6,43,16,0,27,16
18835,5,24,11,0,13,11
18835,4,13,4,0,9,4
18835,3,7,5,0,2,5
127096,10,1,1,0,0,1
127096,9,3,2,0,1,2
127096,8,15,2,0,13,2
127096,7,39,9,0,30,9
127096,6,45,9,0,36,9
127096,5,19,6,0,13,6
127096,4,7,1,0,6,1
135431,10,2,1,0,1,1
135431,8,13,1,0,12,1
135431,6,43,9,0,34,9
135431,5,23,4,0,19,4
135431,4,19,4,0,15,4
135431,3,9,3,0,6,3
68186,8,19,10,0,9,10
68186,7,39,13,0,26,13
68186,6,50,15,0,35,15
68186,5,17,6,0,11,6
68186,4,5,2,0,3,2
68186,3,1,1,0,0,1
173770,10,3,1,0,2,1
173770,8,14,4,1,10,3
173770,7,27,3,0,24,3
173770,6,51,8,4,43,4
173770,5,22,4,0,18,4
173770,4,11,4,1,7,3
173770,3,5,1,0,4,1
173770,2,2,1,0,1,1
197588,10,17,9,1,8,8
197588,9,10,3,0,7,3
197588,8,21,3,2,18,1
197588,7,31,4,0,27,4
197588,6,33,7,1,26,6
197588,5,15,1,0,14,1
29952,10,2,1,0,1,1
29952,9,4,1,0,3,1
29952,8,38,20,0,18,20
29952,7,38,15,0,23,15
29952,6,40,11,0,29,11
29952,5,10,4,0,6,4
29952,3,1,1,0,0,1
11573,9,1,1,0,0,1
11573,7,17,5,0,12,5
11573,6,37,11,0,26,11
11573,5,30,8,0,22,8
11573,4,25,9,0,16,9
11573,3,5,3,0,2,3
11573,2,6,2,0,4,2
203967,10,3,2,0,1,2
203967,8,14,6,0,8,6
203967,7,23,2,1,21,1
203967,6,35,4,1,31,3
203967,5,26,4,1,22,3
203967,4,9,1,1,8,0
203967,3,9,2,0,7,2
203967,2,7,3,0,4,3
203967,1,5,3,0,2,3
13403,10,6,2,0,4,2
13403,9,39,17,0,22,17
13403,8,40,15,0,25,15
13403,7,33,11,0,22,11
13403,6,15,5,0,10,5
226176,10,27,6,0,21,6
226176,9,37,6,0,31,6
226176,8,35,6,0,29,6
226176,7,19,2,0,17,2
226176,6,5,1,0,4,1
226176,5,5,2,0,3,2
226176,4,2,1,0,1,1
226176,2,3,2,0,1,2
226176,1,1,1,0,0,1
216014,8,17,3,0,14,3
216014,6,44,3,0,41,3
216014,5,15,2,0,13,2
216014,4,13,3,0,10,3
216014,2,3,1,0,2,1
216014,1,2,1,0,1,1
1594,10,7,3,0,4,3
1594,9,5,1,0,4,1
1594,8,15,5,0,10,5
1594,7,31,6,0,25,6
1594,6,38,14,0,24,14
1594,5,20,11,0,9,11
1594,4,12,3,0,9,3
1594,3,4,1,0,3,1
1594,2,3,3,0,0,3
125608,8,13,2,0,11,2
125608,7,31,8,0,23,8
125608,6,31,6,0,25,6
125608,5,24,11,0,13,11
125608,4,11,2,0,9,2
125608,2,7,4,0,3,4
125608,1,3,1,0,2,1
12876,10,1,1,0,0,1
12876,8,5,2,0,3,2
12876,7,14,8,0,6,8
12876,6,35,18,0,17,18
12876,5,43,19,0,24,19
12876,4,24,8,0,16,8
12876,3,8,4,0,4,4
12876,2,4,3,0,1,3
12876,1,1,1,0,0,1
1383,10,5,1,0,4,1
1383,9,4,1,0,3,1
1383,8,23,1,0,22,1
1383,7,29,9,0,20,9
1383,6,48,9,0,39,9
1383,5,15,1,0,14,1
1383,4,7,1,0,6,1
138963,10,12,3,0,9,3
138963,9,21,6,0,15,6
138963,8,53,15,0,38,15
138963,7,24,12,0,12,12
138963,6,16,7,0,9,7
138963,5,4,3,0,1,3
138963,1,2,1,0,1,1
10676,10,7,3,0,4,3
10676,9,8,1,0,7,1
10676,8,14,1,0,13,1
10676,7,23,7,0,16,7
10676,6,44,18,0,26,18
10676,5,24,5,0,19,5
10676,4,9,4,0,5,4
10676,3,5,3,0,2,3
197865,10,10,4,0,6,4
197865,9,8,5,1,3,4
197865,8,22,8,2,14,6
197865,7,22,4,0,18,4
197865,6,34,9,1,25,8
197865,5,18,5,0,13,5
197865,4,10,3,0,7,3
197865,3,3,3,0,0,3
197865,2,6,5,0,1,5
197865,1,2,2,0,0,2
1306,10,1,1,0,0,1
1306,9,1,1,0,0,1
1306,8,19,9,1,10,8
1306,7,20,5,0,15,5
1306,6,32,14,1,18,13
1306,5,28,7,0,21,7
1306,4,16,6,0,10,6
1306,3,9,3,0,6,3
1306,2,6,2,0,4,2
1306,1,3,2,0,1,2
4558,8,7,2,0,5,2
4558,7,15,4,0,11,4
4558,6,44,18,0,26,18
4558,5,30,12,0,18,12
4558,4,23,10,0,13,10
4558,3,9,2,0,7,2
4558,2,4,3,0,1,3
375,10,1,1,0,0,1
375,9,1,1,0,0,1
375,8,6,2,0,4,2
375,7,19,10,0,9,10
375,6,39,17,1,22,16
375,5,30,8,0,22,8
375,4,19,9,0,10,9
375,3,12,5,0,7,5
375,2,6,1,0,5,1
181390,10,2,1,0,1,1
181390,8,10,2,0,8,2
181390,7,25,5,0,20,5
181390,6,47,5,0,42,5
181390,5,24,4,0,20,4
181390,4,14,5,0,9,5
181390,3,6,2,0,4,2
181390,2,5,2,0,3,2
147721,8,7,3,0,4,3
147721,7,17,6,0,11,6
147721,6,48,5,0,43,5
147721,5,26,6,0,20,6
147721,4,24,5,0,19,5
147721,3,7,1,0,6,1
147721,2,2,1,0,1,1
205819,10,6,1,0,5,1
205819,9,10,2,0,8,2
205819,8,30,4,0,26,4
205819,7,42,4,0,38,4
205819,6,30,3,0,27,3
205819,4,8,1,0,7,1
205819,3,3,1,0,2,1
205819,2,1,1,0,0,1
33156,8,12,5,0,7,5
33156,7,41,15,0,26,15
33156,6,50,16,0,34,16
33156,5,17,3,0,14,3
33156,4,10,3,0,7,3
33156,1,2,2,0,0,2
166859,10,15,8,0,7,8
166859,9,24,13,2,11,11
166859,8,46,16,1,30,15
166859,7,22,4,0,18,4
166859,6,15,5,0,10,5
166859,5,5,1,0,4,1
166859,3,5,2,0,3,2
166859,2,1,1,0,0,1
73655,9,1,1,0,0,1
73655,8,18,4,0,14,4
73655,7,39,13,0,26,13
73655,6,41,8,0,33,8
73655,5,21,6,0,15,6
73655,4,8,3,0,5,3
73655,3,5,2,0,3,2
2091,10,6,3,0,3,3
2091,9,15,8,0,7,8
2091,8,26,10,0,16,10
2091,7,36,10,0,26,10
2091,6,32,5,0,27,5
2091,5,13,3,0,10,3
2091,3,2,1,0,1,1
89767,8,20,2,0,18,2
89767,7,35,2,0,33,2
89767,6,40,2,0,38,2
89767,5,14,1,0,13,1
89767,4,7,2,0,5,2
179918,8,21,3,0,18,3
179918,7,29,8,0,21,8
179918,6,30,7,0,23,7
179918,5,16,5,0,11,5
179918,4,14,3,0,11,3
179918,3,9,3,0,6,3
179918,1,4,2,0,2,2
246742,10,7,2,0,5,2
246742,9,15,1,0,14,1
246742,8,43,3,0,40,3
246742,7,43,3,0,40,3
246742,6,19,1,0,18,1
246742,4,3,1,0,2,1
246742,3,2,1,0,1,1
63052,8,12,3,0,9,3
63052,7,35,8,0,27,8
63052,6,51,8,0,43,8
63052,5,15,1,0,14,1
63052,4,10,1,0,9,1
63052,3,5,1,0,4,1
3941,8,9,3,0,6,3
3941,7,16,3,0,13,3
3941,6,41,7,0,34,7
3941,5,31,7,0,24,7
3941,4,20,3,0,17,3
3941,3,11,5,0,6,5
3941,2,5,2,0,3,2
76065,8,12,5,0,7,5
76065,7,18,3,0,15,3
76065,6,39,6,0,33,6
76065,5,33,9,0,24,9
76065,4,12,3,0,9,3
76065,3,14,4,0,10,4
76065,2,5,1,0,4,1
124356,8,25,6,0,19,6
124356,7,35,6,0,29,6
124356,6,35,4,0,31,4
124356,4,3,1,0,2,1
9300,10,6,2,0,4,2
9300,9,5,2,0,3,2
9300,8,31,10,0,21,10
9300,7,26,9,0,17,9
9300,6,40,17,0,23,17
9300,5,16,7,0,9,7
9300,4,4,3,0,1,3
9300,3,4,2,0,2,2
9300,2,1,1,0,0,1
9300,1,1,1,0,0,1
5002,10,2,2,0,0,2
5002,8,10,5,0,5,5
5002,7,25,7,0,18,7
5002,6,41,14,0,27,14
5002,5,25,8,0,17,8
5002,4,16,6,0,10,6
5002,3,7,4,0,3,4
5002,2,7,3,0,4,3
5002,1,1,1,0,0,1
215482,10,4,1,0,3,1
215482,9,7,3,0,4,3
215482,8,21,6,0,15,6
215482,7,40,8,0,32,8
215482,6,36,9,0,27,9
215482,5,14,7,0,7,7
215482,4,8,2,0,6,2
215482,3,2,2,0,0,2
215482,1,2,1,0,1,1
10998,8,12,5,0,7,5
10998,7,30,11,0,19,11
10998,6,44,10,0,34,10
10998,5,27,5,0,22,5
10998,4,16,5,0,11,5
10998,3,2,1,0,1,1
813,10,4,1,0,3,1
813,7,14,2,0,12,2
813,6,42,12,0,30,12
813,5,33,9,0,24,9
813,4,21,7,0,14,7
813,3,10,3,0,7,3
813,2,5,2,0,3,2
813,1,1,1,0,0,1
9921,8,2,1,0,1,1
9921,7,6,3,0,3,3
9921,6,24,5,0,19,5
9921,5,30,9,0,21,9
9921,4,39,11,0,28,11
9921,3,18,4,0,14,4
9921,2,12,7,0,5,7
9921,1,3,3,0,0,3
7844,10,7,4,0,3,4
7844,9,13,7,0,6,7
7844,8,45,21,0,24,21
7844,7,39,11,0,28,11
7844,6,17,4,0,13,4
7844,5,9,1,0,8,1
7844,4,4,2,0,2,2
4916,10,3,1,0,2,1
4916,9,8,3,0,5,3
4916,8,32,10,0,22,10
4916,7,32,13,0,19,13
4916,6,31,7,0,24,7
4916,5,16,7,0,9,7
4916,4,5,4,0,1,4
4916,3,5,4,0,1,4
4916,2,2,2,0,0,2
7067,8,10,3,0,7,3
7067,7,27,7,0,20,7
7067,6,48,16,0,32,16
7067,5,28,6,0,22,6
7067,4,11,3,0,8,3
7067,3,5,1,0,4,1
167237,8,22,3,0,19,3
167237,7,41,5,0,36,5
167237,6,42,10,0,32,10
167237,3,3,1,0,2,1
167237,2,1,1,0,0,1
12291,10,2,2,0,0,2
12291,9,1,1,0,0,1
12291,8,11,1,0,10,1
12291,7,29,9,0,20,9
12291,6,40,14,0,26,14
12291,5,26,10,0,16,10
12291,4,16,8,0,8,8
12291,3,5,2,0,3,2
12291,2,3,3,0,0,3
12291,1,2,1,0,1,1
224119,10,18,5,0,13,5
224119,9,11,5,0,6,5
224119,8,32,12,0,20,12
224119,7,23,6,1,17,5
224119,6,19,4,0,15,4
224119,5,17,2,0,15,2
224119,4,5,1,0,4,1
224119,3,5,2,0,3,2
224119,2,3,1,0,2,1
1512,10,5,3,0,2,3
1512,9,6,3,0,3,3
1512,8,10,7,0,3,7
1512,7,24,6,0,18,6
1512,6,35,12,0,23,12
1512,5,24,9,0,15,9
1512,4,12,3,0,9,3
1512,3,9,4,0,5,4
1512,2,6,3,0,3,3
1512,1,3,2,0,1,2
208663,10,7,3,0,4,3
208663,9,10,5,0,5,5
208663,8,24,7,2,17,5
208663,7,35,8,0,27,8
208663,6,32,5,0,27,5
208663,5,11,2,0,9,2
208663,3,2,1,0,1,1
208663,1,2,1,0,1,1
116593,7,7,2,0,5,2
116593,6,33,5,0,28,5
116593,5,36,6,0,30,6
116593,4,29,4,0,25,4
116593,3,10,4,0,6,4
116593,2,6,1,0,5,1
116593,1,4,3,0,1,3
58565,9,3,1,0,2,1
58565,7,23,5,0,18,5
58565,6,55,7,0,48,7
58565,5,26,3,0,23,3
58565,4,12,4,0,8,4
58565,3,2,1,0,1,1
35306,8,16,8,0,8,8
35306,7,34,11,0,23,11
35306,6,50,16,0,34,16
35306,5,20,6,0,14,6
35306,4,8,2,0,6,2
207010,10,5,3,0,2,3
207010,9,9,1,0,8,1
207010,8,40,7,0,33,7
207010,7,34,4,0,30,4
207010,6,37,4,0,33,4
207010,3,3,2,0,1,2
207010,2,2,1,0,1,1
7955,9,2,1,0,1,1
7955,8,11,3,0,8,3
7955,7,38,19,0,19,19
7955,6,53,13,0,40,13
7955,5,20,6,0,14,6
7955,4,4,2,0,2,2
7955,2,1,1,0,0,1
119856,8,11,1,0,10,1
119856,7,17,1,0,16,1
119856,6,48,8,0,40,8
119856,5,32,4,0,28,4
119856,4,13,3,0,10,3
119856,3,6,2,0,4,2
119856,2,5,1,0,4,1
158237,10,4,3,0,1,3
158237,9,11,3,0,8,3
158237,8,59,17,0,42,17
158237,7,36,12,0,24,12
158237,6,18,7,0,11,7
158237,5,2,1,0,1,1
158237,3,1,1,0,0,1
25687,9,4,1,0,3,1
25687,8,15,2,0,13,2
25687,7,39,7,0,32,7
25687,6,49,13,0,36,13
25687,5,13,6,0,7,6
25687,4,8,2,0,6,2
25687,3,3,1,0,2,1
25687,2,1,1,0,0,1
20120,10,4,1,0,3,1
20120,8,15,5,0,10,5
20120,7,20,5,0,15,5
20120,6,55,16,0,39,16
20120,5,22,6,0,16,6
20120,4,11,4,0,7,4
20120,3,4,1,0,3,1
98472,9,5,1,0,4,1
98472,8,13,4,0,9,4
98472,7,22,4,0,18,4
98472,6,43,9,0,34,9
98472,5,21,1,0,20,1
98472,4,18,4,0,14,4
98472,3,6,1,0,5,1
98472,2,4,1,0,3,1
15435,10,11,8,0,3,8
15435,9,9,4,0,5,4
15435,8,20,8,0,12,8
15435,7,41,11,0,30,11
15435,6,28,11,0,17,11
15435,5,13,1,0,12,1
15435,4,6,2,0,4,2
15435,3,4,1,0,3,1
8079,10,5,2,0,3,2
8079,9,5,1,0,4,1
8079,8,20,9,0,11,9
8079,7,21,11,0,10,11
8079,6,40,14,0,26,14
8079,5,22,9,0,13,9
8079,4,13,6,0,7,6
8079,3,5,4,0,1,4
8079,1,2,1,0,1,1
38471,10,6,2,0,4,2
38471,9,14,7,0,7,7
38471,8,47,16,0,31,16
38471,7,34,13,0,21,13
38471,6,18,6,0,12,6
38471,5,10,4,0,6,4
38471,4,4,2,0,2,2
221644,8,6,1,0,5,1
221644,7,24,4,0,20,4
221644,6,40,6,0,34,6
221644,5,20,4,0,16,4
221644,4,17,4,0,13,4
221644,3,14,4,0,10,4
221644,2,9,2,0,7,2
207991,10,49,15,2,34,13
207991,9,34,9,1,25,8
207991,8,37,5,1,32,4
207991,7,7,2,1,5,1
207991,6,3,1,0,2,1
207991,5,3,1,0,2,1
207991,4,4,3,0,1,3
207991,1,3,1,0,2,1
4141,9,3,1,0,2,1
4141,8,13,5,0,8,5
4141,7,29,13,0,16,13
4141,6,48,20,0,28,20
4141,5,22,5,0,17,5
4141,4,12,4,0,8,4
4141,3,4,1,0,3,1
206,8,16,1,0,15,1
206,7,30,2,0,28,2
206,6,40,7,0,33,7
206,5,29,6,0,23,6
206,4,8,3,0,5,3
206,3,8,5,0,3,5
210008,10,7,2,1,5,1
210008,9,16,4,0,12,4
210008,8,38,6,0,32,6
210008,7,44,7,0,37,7
210008,6,17,4,0,13,4
210008,4,4,1,0,3,1
4150,7,13,4,0,9,4
4150,6,44,13,0,31,13
4150,5,36,13,0,23,13
4150,4,20,7,0,13,7
4150,3,10,6,0,4,6
4150,2,5,2,0,3,2
118955,8,6,1,0,5,1
118955,7,11,3,0,8,3
118955,6,24,2,0,22,2
118955,5,23,1,0,22,1
118955,4,25,1,0,24,1
118955,3,20,5,0,15,5
118955,2,18,4,0,14,4
118955,1,6,1,0,5,1
3344,9,1,1,0,0,1
3344,7,7,4,0,3,4
3344,6,27,7,0,20,7
3344,5,25,8,0,17,8
3344,4,29,10,0,19,10
3344,3,23,9,0,14,9
3344,2,11,4,0,7,4
3344,1,9,8,0,1,8
28060,8,18,5,0,13,5
28060,7,33,11,0,22,11
28060,6,42,16,0,26,16
28060,5,26,8,0,18,8
28060,4,6,2,0,4,2
28060,3,4,2,0,2,2
181331,8,11,1,0,10,1
181331,7,34,9,0,25,9
181331,6,48,6,0,42,6
181331,5,19,3,0,16,3
181331,4,14,4,0,10,4
181331,3,2,1,0,1,1
252197,9,7,1,0,6,1
252197,8,12,1,0,11,1
252197,7,33,9,1,24,8
252197,6,37,3,1,34,2
252197,5,16,2,0,14,2
252197,4,8,2,0,6,2
252197,3,8,1,0,7,1
252197,2,6,2,0,4,2
252197,1,4,1,1,3,0
191285,10,8,1,0,7,1
191285,9,8,2,0,6,2
191285,8,29,8,2,21,6
191285,7,38,8,1,30,7
191285,6,35,6,2,29,4
191285,5,7,1,0,6,1
191285,4,4,1,0,3,1
191285,3,4,1,0,3,1
94373,10,31,21,0,10,21
94373,9,34,13,0,21,13
94373,8,38,10,0,28,10
94373,7,17,4,0,13,4
94373,6,9,4,0,5,4
94373,4,1,1,0,0,1
94373,2,2,1,0,1,1
197067,10,5,1,0,4,1
197067,9,8,1,1,7,0
197067,8,21,4,3,17,1
197067,7,32,5,1,27,4
197067,6,34,8,2,26,6
197067,5,22,2,0,20,2
206450,10,16,9,0,7,9
206450,9,8,1,0,7,1
206450,8,20,2,0,18,2
206450,7,38,2,0,36,2
206450,6,20,3,0,17,3
206450,5,15,1,0,14,1
206450,2,4,1,0,3,1
8813,10,9,6,0,3,6
8813,9,5,5,0,0,5
8813,8,17,11,0,6,11
8813,7,10,5,0,5,5
8813,6,21,16,0,5,16
8813,5,24,15,0,9,15
8813,4,13,8,0,5,8
8813,3,5,5,0,0,5
8813,2,7,6,0,1,6
8813,1,22,17,0,5,17
1246,10,3,2,0,1,2
1246,9,6,3,0,3,3
1246,8,24,6,0,18,6
1246,7,22,10,0,12,10
1246,6,37,11,0,26,11
1246,5,24,6,0,18,6
1246,4,9,4,0,5,4
1246,3,4,1,0,3,1
1246,2,4,1,0,3,1
192274,8,45,12,1,33,11
192274,7,37,7,2,30,5
192274,6,28,6,1,22,5
192274,5,10,1,0,9,1
192274,4,3,1,0,2,1
172310,8,9,1,0,8,1
172310,7,24,5,0,19,5
172310,6,36,5,0,31,5
172310,5,34,2,0,32,2
172310,4,13,3,0,10,3
172310,3,10,1,0,9,1
40851,8,4,2,0,2,2
40851,7,11,1,0,10,1
40851,6,41,17,0,24,17
40851,5,37,9,0,28,9
40851,4,21,6,0,15,6
40851,3,8,3,0,5,3
40851,2,5,3,0,2,3
40851,1,4,2,0,2,2
4172,8,9,1,0,8,1
4172,7,25,8,0,17,8
4172,6,53,19,0,34,19
4172,5,24,6,0,18,6
4172,4,11,3,0,8,3
4172,2,3,1,0,2,1
5637,10,4,1,0,3,1
5637,9,11,5,0,6,5
5637,8,17,10,0,7,10
5637,7,23,4,0,19,4
5637,6,33,15,0,18,15
5637,5,17,6,0,11,6
5637,4,17,10,0,7,10
5637,3,9,7,0,2,7
5637,2,1,1,0,0,1
5637,1,1,1,0,0,1
39565,8,16,5,0,11,5
39565,7,40,16,0,24,16
39565,6,43,21,0,22,21
39565,5,18,4,0,14,4
39565,4,9,3,0,6,3
39565,2,2,2,0,0,2
116860,8,19,2,0,17,2
116860,6,51,7,0,44,7
116860,4,9,1,0,8,1
116860,3,2,1,0,1,1
116860,2,2,1,0,1,1
116860,1,1,1,0,0,1
41757,9,5,2,0,3,2
41757,8,16,6,0,10,6
41757,7,23,7,0,16,7
41757,6,44,15,0,29,15
41757,5,25,8,0,17,8
41757,4,7,1,0,6,1
41757,3,4,2,0,2,2
57139,10,3,1,0,2,1
57139,9,3,1,0,2,1
57139,8,18,4,0,14,4
57139,7,25,14,0,11,14
57139,6,49,17,0,32,17
57139,5,22,10,0,12,10
57139,4,7,1,0,6,1
57139,3,3,2,0,1,2
23946,7,9,2,0,7,2
23946,6,28,7,0,21,7
23946,5,30,3,0,27,3
23946,4,24,2,0,22,2
23946,3,20,3,0,17,3
23946,2,18,2,0,16,2
32431,8,8,3,0,5,3
32431,7,14,6,0,8,6
32431,6,46,13,0,33,13
32431,5,38,12,0,26,12
32431,4,18,4,0,14,4
32431,3,6,2,0,4,2
144150,10,5,4,0,1,4
144150,9,16,6,1,10,5
144150,8,35,13,3,22,10
144150,7,35,8,0,27,8
144150,6,32,5,0,27,5
144150,5,6,2,1,4,1
144150,1,1,1,0,0,1
284,9,8,5,0,3,5
284,8,27,10,0,17,10
284,7,25,12,0,13,12
284,6,29,9,0,20,9
284,5,22,5,0,17,5
284,4,12,5,0,7,5
284,3,4,4,0,0,4
284,2,3,1,0,2,1
3889,8,3,1,0,2,1
3889,7,13,3,0,10,3
3889,6,39,16,0,23,16
3889,5,32,9,0,23,9
3889,4,21,8,0,13,8
3889,3,11,3,0,8,3
3889,2,6,2,0,4,2
3889,1,1,1,0,0,1
180345,10,1,1,0,0,1
180345,8,36,9,0,27,9
180345,7,40,3,0,37,3
180345,6,31,4,0,27,4
180345,4,5,1,0,4,1
180345,3,2,1,0,1,1
5260,8,5,1,0,4,1
5260,7,12,2,0,10,2
5260,6,19,6,0,13,6
5260,5,29,4,0,25,4
5260,4,27,6,0,21,6
5260,3,14,5,0,9,5
5260,2,14,6,0,8,6
32171,10,3,1,0,2,1
32171,9,18,11,0,7,11
32171,8,47,11,0,36,11
32171,7,30,6,0,24,6
32171,6,23,2,0,21,2
32171,2,2,1,0,1,1
155440,10,5,3,0,2,3
155440,9,4,1,0,3,1
155440,8,18,11,1,7,10
155440,7,26,7,0,19,7
155440,6,37,14,2,23,12
155440,5,18,5,1,13,4
155440,4,16,4,0,12,4
155440,3,4,1,0,3,1
155440,2,2,1,0,1,1
155440,1,2,1,0,1,1
83,10,2,1,0,1,1
83,9,4,1,0,3,1
83,8,16,5,0,11,5
83,7,46,9,0,37,9
83,6,38,11,0,27,11
83,5,12,1,0,11,1
83,4,10,5,0,5,5
83,3,2,1,0,1,1
83,2,1,1,0,0,1
83,1,1,1,0,0,1
27959,9,1,1,0,0,1
27959,8,4,2,0,2,2
27959,7,3,1,0,2,1
27959,6,21,8,0,13,8
27959,5,21,4,0,17,4
27959,4,29,13,0,16,13
27959,3,25,5,0,20,5
27959,2,11,4,0,7,4
27959,1,16,8,0,8,8
175541,10,5,1,1,4,0
175541,9,4,2,1,2,1
175541,8,42,4,1,38,3
175541,7,35,5,0,30,5
175541,6,30,9,1,21,8
175541,5,9,4,0,5,4
175541,4,4,2,0,2,2
175541,3,3,2,0,1,2
12459,10,3,1,0,2,1
12459,9,4,1,0,3,1
12459,8,29,7,0,22,7
12459,7,46,14,0,32,14
12459,6,21,7,0,14,7
12459,5,17,7,0,10,7
12459,4,4,3,0,1,3
12459,3,5,5,0,0,5
12459,2,1,1,0,0,1
12459,1,2,2,0,0,2
3998,9,1,1,0,0,1
3998,8,14,1,0,13,1
3998,7,27,3,0,24,3
3998,6,53,11,0,42,11
3998,5,22,7,0,15,7
3998,4,8,4,0,4,4
3998,3,3,2,0,1,2
3998,1,1,1,0,0,1
41496,10,1,1,0,0,1
41496,8,10,1,0,9,1
41496,7,20,7,0,13,7
41496,6,55,19,0,36,19
41496,5,26,9,0,17,9
41496,4,13,3,0,10,3
41496,3,5,1,0,4,1
162476,10,8,1,0,7,1
162476,8,39,1,0,38,1
162476,7,35,5,0,30,5
162476,6,25,2,0,23,2
162476,5,16,2,0,14,2
162476,2,1,1,0,0,1
8939,10,15,2,0,13,2
8939,8,30,10,0,20,10
8939,7,35,5,0,30,5
8939,6,30,2,0,28,2
8939,5,7,1,0,6,1
3616,9,6,1,0,5,1
3616,8,15,4,0,11,4
3616,7,29,9,0,20,9
3616,6,36,6,0,30,6
3616,5,26,9,0,17,9
3616,4,12,8,0,4,8
3616,3,8,3,0,5,3
101988,10,5,5,1,0,4
101988,8,7,2,0,5,2
101988,7,16,2,1,14,1
101988,6,19,6,1,13,5
101988,5,27,11,2,16,9
101988,4,19,5,0,14,5
101988,3,16,4,1,12,3
101988,2,13,7,0,6,7
101988,1,8,6,4,2,2
13767,8,13,1,0,12,1
13767,7,30,3,0,27,3
13767,6,36,10,0,26,10
13767,5,29,9,0,20,9
13767,4,13,2,0,11,2
13767,2,3,2,0,1,2
13767,1,3,1,0,2,1
224675,10,3,2,0,1,2
224675,9,13,3,1,10,2
224675,8,28,7,0,21,7
224675,7,31,4,1,27,3
224675,6,29,4,0,25,4
224675,5,14,4,0,10,4
224675,3,6,1,0,5,1
8308,8,7,3,0,4,3
8308,7,10,5,0,5,5
8308,6,41,13,0,28,13
8308,5,32,14,0,18,14
8308,4,23,14,0,9,14
8308,3,9,5,0,4,5
8308,2,7,3,0,4,3
8308,1,2,1,0,1,1
227002,10,11,3,0,8,3
227002,9,21,6,1,15,5
227002,8,52,12,0,40,12
227002,7,21,3,0,18,3
227002,6,15,2,0,13,2
227002,5,5,1,0,4,1
227002,3,3,3,0,0,3
227002,2,1,1,0,0,1
148443,9,6,1,0,5,1
148443,8,21,1,0,20,1
148443,7,43,11,0,32,11
148443,6,38,7,0,31,7
148443,5,9,3,0,6,3
148443,4,8,2,0,6,2
104498,10,8,1,0,7,1
104498,9,10,3,0,7,3
104498,8,31,9,0,22,9
104498,7,37,8,0,29,8
104498,6,33,8,0,25,8
104498,5,7,2,0,5,2
104498,4,1,1,0,0,1
104498,3,3,1,1,2,0
400,8,10,2,0,8,2
400,7,14,2,0,12,2
400,6,37,9,0,28,9
400,5,33,5,0,28,5
400,4,21,3,0,18,3
400,3,12,7,0,5,7
400,2,3,1,0,2,1
176960,9,2,1,0,1,1
176960,8,20,3,1,17,2
176960,7,38,7,0,31,7
176960,6,43,8,2,35,6
176960,5,15,4,0,11,4
176960,4,5,1,0,4,1
176960,3,3,1,0,2,1
176960,2,3,1,0,2,1
124647,8,17,4,0,13,4
124647,7,20,2,1,18,1
124647,6,46,11,0,35,11
124647,5,25,10,2,15,8
124647,4,12,4,1,8,3
124647,3,4,2,0,2,2
124647,2,4,1,0,3,1
124647,1,3,2,1,1,1
88316,10,5,1,0,4,1
88316,9,8,4,0,4,4
88316,8,30,9,0,21,9
88316,7,21,3,0,18,3
88316,6,28,8,0,20,8
88316,5,19,3,0,16,3
88316,4,10,3,0,7,3
88316,3,3,1,0,2,1
88316,2,8,3,0,5,3
34943,9,3,1,0,2,1
34943,8,12,3,0,9,3
34943,7,18,4,0,14,4
34943,6,53,15,0,38,15
34943,5,33,9,0,24,9
34943,4,10,7,0,3,7
259038,10,6,2,0,4,2
259038,9,7,3,0,4,3
259038,8,38,8,0,30,8
259038,7,43,7,2,36,5
259038,6,30,1,0,29,1
259038,5,5,1,0,4,1
259038,4,3,1,0,2,1
21809,8,9,1,0,8,1
21809,7,20,4,0,16,4
21809,6,44,20,0,24,20
21809,5,24,9,0,15,9
21809,4,15,3,0,12,3
21809,3,10,3,0,7,3
21809,2,5,3,0,2,3
11432,10,14,5,0,9,5
11432,9,21,10,0,11,10
11432,8,37,7,0,30,7
11432,7,20,5,0,15,5
11432,6,25,3,0,22,3
11432,2,1,1,0,0,1
11432,1,2,2,0,0,2
34744,8,11,5,0,6,5
34744,7,27,10,0,17,10
34744,6,55,24,0,31,24
34744,5,26,13,0,13,13
34744,4,5,1,0,4,1
34744,3,3,3,0,0,3
34744,2,2,1,0,1,1
171234,9,5,2,1,3,1
171234,8,21,5,0,16,5
171234,7,40,13,1,27,12
171234,6,42,8,0,34,8
171234,4,6,3,0,3,3
229315,9,19,2,0,17,2
229315,8,44,7,0,37,7
229315,7,24,3,0,21,3
229315,6,23,2,0,21,2
229315,1,3,2,0,1,2
241106,10,3,1,0,2,1
241106,9,14,3,0,11,3
241106,8,35,11,0,24,11
241106,7,34,5,0,29,5
241106,6,27,5,1,22,4
241106,5,8,2,0,6,2
241106,4,4,1,0,3,1
241106,3,3,1,0,2,1
15407,10,2,2,0,0,2
15407,9,4,2,0,2,2
15407,8,16,11,0,5,11
15407,7,21,13,0,8,13
15407,6,40,13,0,27,13
15407,5,24,7,0,17,7
15407,4,17,6,0,11,6
15407,3,5,2,0,3,2
15407,2,2,2,0,0,2
178896,10,38,14,0,24,14
178896,9,53,17,0,36,17
178896,8,27,5,0,22,5
178896,7,5,2,0,3,2
178896,6,3,2,0,1,2
178896,2,1,1,0,0,1
1240,9,1,1,0,0,1
1240,7,19,2,0,17,2
1240,6,50,13,0,37,13
1240,5,33,12,0,21,12
1240,4,19,9,0,10,9
1240,3,7,2,0,5,2
5687,10,6,1,0,5,1
5687,9,9,1,0,8,1
5687,8,43,14,0,29,14
5687,7,34,10,0,24,10
5687,6,23,8,0,15,8
5687,5,13,2,0,11,2
5687,4,2,1,0,1,1
162654,8,10,2,0,8,2
162654,7,25,9,0,16,9
162654,6,54,12,0,42,12
162654,5,20,6,0,14,6
162654,4,11,3,0,8,3
162654,3,5,1,0,4,1
162654,2,7,3,0,4,3
9577,9,3,2,0,1,2
9577,8,18,12,0,6,12
9577,7,29,17,0,12,17
9577,6,44,21,0,23,21
9577,5,19,6,0,13,6
9577,4,7,3,0,4,3
9577,3,4,1,0,3,1
9577,2,4,2,0,2,2
140179,9,1,1,0,0,1
140179,8,17,4,0,13,4
140179,7,26,1,0,25,1
140179,6,48,9,0,39,9
140179,5,18,2,0,16,2
140179,4,10,2,0,8,2
140179,3,4,2,0,2,2
140179,1,5,2,0,3,2
145304,10,4,1,0,3,1
145304,9,4,2,0,2,2
145304,8,23,2,0,21,2
145304,7,23,3,0,20,3
145304,6,32,7,2,25,5
145304,5,17,3,0,14,3
145304,4,17,6,0,11,6
145304,3,7,2,1,5,1
145304,2,3,2,1,1,1
174402,10,23,4,0,19,4
174402,9,36,11,0,25,11
174402,8,46,11,0,35,11
174402,7,14,4,0,10,4
174402,6,7,2,0,5,2
174402,4,2,1,0,1,1
174402,2,1,1,0,0,1
108679,9,5,2,0,3,2
108679,8,12,3,1,9,2
108679,7,30,7,2,23,5
108679,6,44,9,0,35,9
108679,5,24,4,0,20,4
108679,4,5,3,0,2,3
108679,3,9,2,0,7,2
8553,10,2,2,0,0,2
8553,9,14,10,0,4,10
8553,8,38,18,0,20,18
8553,7,28,18,0,10,18
8553,6,33,13,0,20,13
8553,5,11,2,0,9,2
8553,4,3,1,0,2,1
8553,3,1,1,0,0,1
166976,10,9,3,1,6,2
166976,8,36,7,2,29,5
166976,7,31,4,1,27,3
166976,6,29,8,1,21,7
166976,5,6,2,0,4,2
166976,4,5,3,0,2,3
166976,2,4,2,0,2,2
166976,1,2,1,0,1,1
201861,10,13,6,0,7,6
201861,9,17,5,1,12,4
201861,8,41,6,0,35,6
201861,7,27,5,0,22,5
201861,6,18,2,0,16,2
201861,5,7,1,0,6,1
201861,4,4,4,0,0,4
201861,3,2,1,1,1,0
182047,10,2,1,0,1,1
182047,9,3,1,0,2,1
182047,8,29,9,0,20,9
182047,7,48,18,0,30,18
182047,6,40,8,0,32,8
182047,5,4,2,0,2,2
182047,4,3,1,0,2,1
23777,8,10,5,0,5,5
23777,7,24,11,0,13,11
23777,6,42,15,0,27,15
23777,5,29,13,0,16,13
23777,4,9,2,0,7,2
23777,2,5,3,0,2,3
23777,1,1,1,0,0,1
247704,10,10,7,0,3,7
247704,9,17,7,1,10,6
247704,8,53,14,0,39,14
247704,7,31,7,1,24,6
247704,6,13,2,1,11,1
247704,5,3,1,0,2,1
247704,4,3,1,0,2,1
247704,1,2,2,0,0,2
174805,10,17,7,0,10,7
174805,9,19,6,0,13,6
174805,8,61,12,2,49,10
174805,7,18,3,0,15,3
174805,6,12,2,0,10,2
174805,5,2,1,0,1,1
174805,3,1,1,0,0,1
29026,10,26,6,1,20,5
29026,9,19,5,0,14,5
29026,8,32,7,0,25,7
29026,7,23,5,0,18,5
29026,6,20,6,0,14,6
29026,5,4,1,0,3,1
29026,3,3,2,0,1,2
29026,1,1,1,0,0,1
176502,8,11,3,0,8,3
176502,7,29,4,0,25,4
176502,6,44,7,0,37,7
176502,5,16,2,0,14,2
176502,4,11,2,0,9,2
176502,3,12,2,0,10,2
176502,2,2,2,0,0,2
25537,10,5,3,0,2,3
25537,9,7,2,0,5,2
25537,8,40,18,0,22,18
25537,7,32,10,0,22,10
25537,6,28,10,0,18,10
25537,5,9,3,0,6,3
25537,4,3,1,0,2,1
25537,3,5,2,0,3,2
10668,10,2,1,0,1,1
10668,9,8,5,0,3,5
10668,8,42,14,0,28,14
10668,7,36,5,0,31,5
10668,6,22,7,0,15,7
10668,5,12,4,0,8,4
10668,4,2,1,0,1,1
10668,3,3,3,0,0,3
10668,2,1,1,0,0,1
10668,1,3,2,0,1,2
271518,10,17,4,0,13,4
271518,9,17,2,0,15,2
271518,8,54,6,0,48,6
271518,7,32,2,0,30,2
271518,6,8,1,0,7,1
2710,8,6,1,0,5,1
2710,7,32,9,0,23,9
2710,6,49,16,0,33,16
2710,5,27,7,0,20,7
2710,4,9,4,0,5,4
2710,3,5,3,0,2,3
154982,8,13,2,0,11,2
154982,7,33,2,0,31,2
154982,6,41,3,0,38,3
154982,5,18,2,0,16,2
154982,4,18,2,0,16,2
154982,2,3,1,0,2,1
264055,8,52,9,0,43,9
264055,7,46,11,0,35,11
264055,6,21,3,0,18,3
264055,4,4,1,0,3,1
113567,9,11,2,0,9,2
113567,8,49,13,0,36,13
113567,7,35,6,0,29,6
113567,6,15,1,0,14,1
113567,4,5,2,0,3,2
113567,2,2,1,0,1,1
113567,1,2,1,0,1,1
36596,10,1,1,0,0,1
36596,9,14,5,0,9,5
36596,8,39,18,0,21,18
36596,7,40,18,0,22,18
36596,6,23,11,0,12,11
36596,5,8,3,0,5,3
36596,4,2,1,0,1,1
36596,3,3,1,0,2,1
36596,2,1,1,0,0,1
35423,10,19,7,0,12,7
35423,9,15,7,0,8,7
35423,8,21,8,0,13,8
35423,7,9,4,0,5,4
35423,6,7,4,0,3,4
35423,5,2,1,0,1,1
35423,4,2,1,0,1,1
234337,9,5,1,0,4,1
234337,8,40,8,0,32,8
234337,7,45,9,0,36,9
234337,6,20,4,0,16,4
234337,5,10,3,0,7,3
5060,9,7,1,0,6,1
5060,8,41,13,0,28,13
5060,7,37,7,0,30,7
5060,6,21,5,0,16,5
5060,5,13,4,0,9,4
5060,4,6,3,0,3,3
5060,3,2,1,0,1,1
143701,10,2,1,0,1,1
143701,9,9,2,0,7,2
143701,8,26,4,0,22,4
143701,7,21,2,0,19,2
143701,6,34,9,0,25,9
143701,5,18,3,0,15,3
143701,4,7,1,0,6,1
143701,3,9,3,0,6,3
143701,2,3,1,0,2,1
143701,1,2,1,0,1,1
108711,10,3,1,0,2,1
108711,9,9,3,0,6,3
108711,8,23,4,0,19,4
108711,7,22,6,0,16,6
108711,6,29,4,0,25,4
108711,5,11,3,0,8,3
108711,4,14,4,0,10,4
108711,3,8,2,0,6,2
108711,2,6,2,0,4,2
108711,1,6,2,0,4,2
34342,7,25,6,0,19,6
34342,6,45,15,0,30,15
34342,5,22,3,0,19,3
34342,4,23,10,0,13,10
34342,3,2,1,0,1,1
34342,2,3,2,0,1,2
3965,9,4,1,0,3,1
3965,8,14,5,0,9,5
3965,7,28,9,0,19,9
3965,6,49,20,0,29,20
3965,5,24,6,0,18,6
3965,4,9,4,0,5,4
3965,3,2,2,0,0,2
170969,10,1,1,0,0,1
170969,9,8,3,0,5,3
170969,8,18,6,0,12,6
170969,7,40,6,0,34,6
170969,6,45,8,0,37,8
170969,5,15,1,0,14,1
7097,10,2,1,0,1,1
7097,9,3,1,0,2,1
7097,8,11,5,0,6,5
7097,7,15,1,0,14,1
7097,6,48,14,0,34,14
7097,5,24,12,0,12,12
7097,4,14,2,0,12,2
7097,3,9,5,0,4,5
7097,2,5,3,0,2,3
2335,9,8,2,0,6,2
2335,8,20,2,0,18,2
2335,7,33,7,0,26,7
2335,6,34,11,0,23,11
2335,5,19,6,0,13,6
2335,4,7,3,0,4,3
2335,3,7,1,0,6,1
204498,10,5,2,0,3,2
204498,8,23,12,0,11,12
204498,7,33,5,0,28,5
204498,6,38,5,0,33,5
204498,5,16,2,0,14,2
4105,10,1,1,0,0,1
4105,9,3,1,0,2,1
4105,8,11,3,0,8,3
4105,7,17,3,0,14,3
4105,6,38,9,0,29,9
4105,5,17,4,0,13,4
4105,4,22,10,0,12,10
4105,3,12,6,0,6,6
4105,2,7,3,0,4,3
4105,1,3,2,0,1,2
227693,9,6,1,0,5,1
227693,8,23,3,0,20,3
227693,7,34,11,0,23,11
227693,6,37,3,0,34,3
227693,5,22,4,0,18,4
227693,4,6,2,0,4,2
227693,2,1,1,0,0,1
2088,9,1,1,0,0,1
2088,7,25,7,0,18,7
2088,6,33,5,0,28,5
2088,5,14,1,0,13,1
25144,10,2,1,0,1,1
25144,9,3,2,0,1,2
25144,8,5,1,0,4,1
25144,7,17,3,0,14,3
25144,6,41,13,0,28,13
25144,5,28,5,0,23,5
25144,4,13,4,0,9,4
25144,3,8,2,0,6,2
25144,2,10,5,0,5,5
25144,1,4,4,0,0,4
153870,10,12,10,0,2,10
153870,9,8,6,0,2,6
153870,8,27,6,0,21,6
153870,7,42,6,0,36,6
153870,6,26,10,0,16,10
153870,3,1,1,0,0,1
153870,1,5,4,0,1,4
28717,10,3,1,0,2,1
28717,8,10,3,0,7,3
28717,7,15,10,0,5,10
28717,6,50,15,0,35,15
28717,5,27,7,0,20,7
28717,4,9,5,0,4,5
28717,3,9,2,0,7,2
28717,2,7,3,0,4,3
785,10,3,1,0,2,1
785,8,6,2,0,4,2
785,7,12,3,0,9,3
785,6,37,5,0,32,5
785,5,32,6,0,26,6
785,4,18,7,0,11,7
785,3,13,6,0,7,6
785,2,6,2,0,4,2
785,1,3,2,0,1,2
146548,10,5,1,0,4,1
146548,9,9,1,0,8,1
146548,8,25,9,0,16,9
146548,7,40,3,0,37,3
146548,5,8,1,0,7,1
146548,3,4,1,0,3,1
146548,1,6,2,0,4,2
1225,8,1,1,0,0,1
1225,7,14,3,0,11,3
1225,6,34,4,0,30,4
1225,5,45,8,0,37,8
1225,4,25,3,0,22,3
1225,3,8,3,0,5,3
1225,2,4,2,0,2,2
174991,10,4,1,0,3,1
174991,9,8,3,0,5,3
174991,8,15,2,1,13,1
174991,7,36,8,2,28,6
174991,6,34,13,1,21,12
174991,5,18,3,1,15,2
174991,4,13,4,0,9,4
174991,3,3,1,0,2,1
95364,8,15,3,0,12,3
95364,7,30,5,0,25,5
95364,6,46,8,0,38,8
95364,5,22,3,0,19,3
95364,4,8,1,0,7,1
95364,3,5,1,0,4,1
9685,10,2,2,0,0,2
9685,9,5,3,0,2,3
9685,8,22,10,0,12,10
9685,7,28,13,0,15,13
9685,6,35,13,0,22,13
9685,5,22,9,0,13,9
9685,4,9,1,0,8,1
9685,3,5,2,0,3,2
9685,2,1,1,0,0,1
2096,8,14,7,0,7,7
2096,7,23,10,0,13,10
2096,6,43,12,0,31,12
2096,5,27,13,0,14,13
2096,4,16,6,0,10,6
2096,3,5,3,0,2,3
2096,2,1,1,0,0,1
86270,9,1,1,0,0,1
86270,7,20,5,0,15,5
86270,6,49,10,0,39,10
86270,5,26,10,0,16,10
86270,4,17,4,0,13,4
86270,3,5,2,0,3,2
86270,2,6,1,0,5,1
192296,10,20,11,0,9,11
192296,9,21,9,1,12,8
192296,8,37,11,1,26,10
192296,7,27,3,0,24,3
192296,6,14,5,0,9,5
192296,5,3,1,0,2,1
192296,4,5,4,0,1,4
192296,3,2,2,0,0,2
92499,8,10,1,0,9,1
92499,7,21,3,0,18,3
92499,6,48,6,0,42,6
92499,5,27,3,0,24,3
92499,4,15,2,0,13,2
454,10,1,1,0,0,1
454,9,1,1,0,0,1
454,8,17,7,0,10,7
454,7,32,12,0,20,12
454,6,42,15,0,27,15
454,5,26,9,0,17,9
454,4,9,1,0,8,1
454,3,2,2,0,0,2
27190,8,3,2,0,1,2
27190,7,8,5,0,3,5
27190,6,26,5,0,21,5
27190,5,30,7,0,23,7
27190,4,36,5,0,31,5
27190,3,19,2,0,17,2
27190,2,5,1,0,4,1
27190,1,4,2,0,2,2
4442,8,2,1,0,1,1
4442,7,24,5,0,19,5
4442,6,39,11,0,28,11
4442,5,26,8,0,18,8
4442,4,21,6,0,15,6
4442,3,9,4,0,5,4
4442,2,6,3,0,3,3
4442,1,2,1,0,1,1
17623,9,3,2,0,1,2
17623,8,10,1,0,9,1
17623,7,34,3,0,31,3
17623,6,44,3,0,41,3
17623,5,20,5,0,15,5
17623,3,4,2,0,2,2
17623,2,3,1,0,2,1
17623,1,4,2,0,2,2
32680,7,17,2,0,15,2
32680,6,41,12,0,29,12
32680,5,31,7,0,24,7
32680,4,14,2,0,12,2
32680,3,8,1,0,7,1
32680,2,8,2,0,6,2
32680,1,4,2,0,2,2
413,10,3,1,0,2,1
413,8,17,5,0,12,5
413,7,36,11,0,25,11
413,6,30,8,0,22,8
413,5,23,6,0,17,6
413,4,9,2,0,7,2
413,3,6,2,0,4,2
413,2,2,1,0,1,1
2989,8,9,4,0,5,4
2989,7,20,7,0,13,7
2989,6,42,15,0,27,15
2989,5,31,8,0,23,8
2989,4,17,5,0,12,5
2989,3,4,3,0,1,3
186793,10,9,5,1,4,4
186793,9,9,5,0,4,5
186793,8,32,16,2,16,14
186793,7,25,6,0,19,6
186793,6,36,6,0,30,6
186793,4,6,3,0,3,3
186793,3,3,2,0,1,2
188225,10,28,14,0,14,14
188225,9,19,8,1,11,7
188225,8,36,7,0,29,7
188225,7,23,1,0,22,1
188225,6,19,2,0,17,2
13223,9,5,1,0,4,1
13223,8,23,6,0,17,6
13223,7,44,12,0,32,12
13223,6,43,14,0,29,14
13223,5,12,3,0,9,3
168752,9,5,1,0,4,1
168752,8,17,4,0,13,4
168752,7,31,4,0,27,4
168752,6,44,7,0,37,7
168752,5,21,3,0,18,3
168752,4,6,3,0,3,3
5646,7,15,1,0,14,1
5646,6,51,8,0,43,8
5646,5,22,3,0,19,3
5646,4,17,4,0,13,4
5646,3,10,3,0,7,3
5646,2,5,2,0,3,2
19544,10,26,1,0,25,1
19544,9,30,4,0,26,4
19544,7,18,2,0,16,2
19544,6,24,1,0,23,1
19544,5,6,1,0,5,1
19544,4,6,2,0,4,2
19544,3,1,1,0,0,1
10915,8,7,1,0,6,1
10915,7,20,4,0,16,4
10915,6,49,12,0,37,12
10915,5,27,3,0,24,3
10915,4,13,5,0,8,5
10915,3,11,5,0,6,5
66896,10,5,5,0,0,5
66896,8,16,5,0,11,5
66896,7,24,7,0,17,7
66896,6,48,13,0,35,13
66896,5,21,4,0,17,4
66896,4,4,2,0,2,2
66896,3,2,2,0,0,2
66896,1,2,1,0,1,1
1313,9,20,5,0,15,5
1313,8,45,15,0,30,15
1313,7,41,11,0,30,11
1313,6,14,5,0,9,5
1313,4,2,1,0,1,1
1313,3,1,1,0,0,1
177482,9,11,2,0,9,2
177482,8,23,6,2,17,4
177482,7,26,6,1,20,5
177482,6,31,3,0,28,3
177482,5,20,3,0,17,3
177482,4,6,1,0,5,1
177482,3,6,1,0,5,1
13924,10,4,1,0,3,1
13924,9,13,3,0,10,3
13924,8,31,11,0,20,11
13924,7,33,16,0,17,16
13924,6,25,9,0,16,9
13924,5,7,2,0,5,2
13924,4,10,4,0,6,4
13924,3,5,1,0,4,1
13924,2,2,1,0,1,1
150539,10,1,1,0,0,1
150539,8,5,1,0,4,1
150539,7,27,6,0,21,6
150539,6,46,6,0,40,6
150539,5,24,5,0,19,5
150539,4,14,5,0,9,5
150539,3,6,1,0,5,1
150539,1,2,1,0,1,1
1686,8,7,2,0,5,2
1686,7,23,7,0,16,7
1686,6,40,12,0,28,12
1686,5,29,10,0,19,10
1686,4,21,5,0,16,5
1686,3,6,1,0,5,1
1686,2,2,1,0,1,1
10283,10,2,1,0,1,1
10283,9,6,4,0,2,4
10283,8,11,8,0,3,8
10283,7,20,15,0,5,15
10283,6,21,12,0,9,12
10283,5,30,14,0,16,14
10283,4,15,9,0,6,9
10283,3,11,7,0,4,7
10283,2,7,6,0,1,6
10283,1,7,5,0,2,5
8173,8,6,2,0,4,2
8173,7,13,1,0,12,1
8173,6,32,7,0,25,7
8173,5,30,4,0,26,4
8173,4,20,5,0,15,5
8173,3,12,1,0,11,1
8173,2,9,3,0,6,3
8173,1,4,1,0,3,1
3549,7,8,1,0,7,1
3549,6,22,7,0,15,7
3549,5,28,5,0,23,5
3549,4,30,9,0,21,9
3549,3,23,5,0,18,5
3549,2,8,2,0,6,2
3549,1,9,5,0,4,5
26080,7,20,5,0,15,5
26080,6,54,16,0,38,16
26080,5,33,6,0,27,6
26080,4,12,4,0,8,4
26080,3,3,1,0,2,1
26080,2,1,1,0,0,1
147144,10,7,3,0,4,3
147144,9,10,4,0,6,4
147144,8,27,11,0,16,11
147144,7,25,9,0,16,9
147144,6,36,9,0,27,9
147144,5,12,2,0,10,2
147144,4,6,3,0,3,3
147144,1,2,1,0,1,1
258411,9,19,2,0,17,2
258411,8,38,3,0,35,3
258411,7,34,6,0,28,6
258411,6,16,1,0,15,1
258411,5,12,1,0,11,1
258411,4,3,1,0,2,1
258411,3,3,2,0,1,2
210101,10,11,1,0,10,1
210101,9,21,10,0,11,10
210101,8,39,12,1,27,11
210101,7,28,5,0,23,5
210101,6,19,4,0,15,4
210101,5,8,2,0,6,2
210101,3,1,1,0,0,1
128855,10,3,2,0,1,2
128855,8,12,3,0,9,3
128855,7,26,3,0,23,3
128855,6,46,4,0,42,4
128855,5,23,3,0,20,3
128855,4,9,1,0,8,1
128855,3,6,2,0,4,2
128855,2,1,1,0,0,1
28102,9,2,1,0,1,1
28102,8,7,4,0,3,4
28102,7,29,3,0,26,3
28102,6,48,8,0,40,8
28102,5,26,8,0,18,8
28102,4,13,4,0,9,4
28102,3,2,2,0,0,2
28102,1,2,2,0,0,2
203462,9,8,3,0,5,3
203462,8,20,4,0,16,4
203462,7,34,4,0,30,4
203462,6,41,8,0,33,8
203462,5,18,1,0,17,1
203462,4,3,2,0,1,2
203462,3,1,1,0,0,1
227162,10,6,2,0,4,2
227162,9,5,2,0,3,2
227162,8,17,6,0,11,6
227162,7,43,12,0,31,12
227162,6,39,16,0,23,16
227162,5,6,3,0,3,3
227162,4,5,1,0,4,1
227162,3,4,1,0,3,1
98197,10,4,1,0,3,1
98197,8,19,1,0,18,1
98197,7,22,3,0,19,3
98197,6,32,3,0,29,3
98197,4,17,4,0,13,4
98197,2,2,1,0,1,1
98197,1,3,1,0,2,1
56690,7,29,6,0,23,6
56690,6,50,5,0,45,5
56690,5,19,5,0,14,5
56690,4,5,1,0,4,1
11038,10,9,3,0,6,3
11038,9,15,3,0,12,3
11038,8,33,4,1,29,3
11038,7,30,6,0,24,6
11038,6,25,3,0,22,3
11038,3,1,1,0,0,1
31968,10,7,2,0,5,2
31968,9,7,1,0,6,1
31968,8,23,2,0,21,2
31968,6,36,2,0,34,2
31968,5,12,1,0,11,1
13115,10,3,1,0,2,1
13115,7,14,1,0,13,1
13115,6,40,3,0,37,3
13115,5,26,5,0,21,5
13115,4,15,5,0,10,5
13115,3,11,2,0,9,2
13115,2,4,1,0,3,1
13115,1,2,1,0,1,1
176914,10,8,2,0,6,2
176914,9,9,1,0,8,1
176914,8,25,6,0,19,6
176914,7,31,4,0,27,4
176914,6,31,2,0,29,2
176914,5,12,3,0,9,3
176914,4,7,2,0,5,2
38062,10,5,2,0,3,2
38062,8,27,4,0,23,4
38062,7,36,5,0,31,5
38062,6,26,4,0,22,4
38062,5,8,1,0,7,1
38062,4,12,2,0,10,2
38062,1,2,1,0,1,1
67034,9,1,1,0,0,1
67034,8,14,3,0,11,3
67034,7,22,5,0,17,5
67034,6,46,12,0,34,12
67034,5,22,5,0,17,5
67034,4,12,5,0,7,5
67034,3,8,1,0,7,1
8066,10,13,5,0,8,5
8066,9,20,9,0,11,9
8066,8,46,14,0,32,14
8066,7,24,10,0,14,10
8066,6,17,6,0,11,6
1012,9,2,1,0,1,1
1012,8,13,1,0,12,1
1012,7,21,4,0,17,4
1012,6,46,5,0,41,5
1012,5,22,4,0,18,4
1012,4,14,6,0,8,6
1012,3,8,2,0,6,2
1012,2,3,1,0,2,1
18606,10,25,7,0,18,7
18606,9,25,13,0,12,13
18606,8,30,13,0,17,13
18606,7,14,6,0,8,6
18606,6,16,7,0,9,7
18606,5,6,3,0,3,3
18606,4,2,2,0,0,2
18606,3,3,2,0,1,2
18606,2,3,1,0,2,1
18606,1,5,1,0,4,1
5465,9,4,2,0,2,2
5465,8,4,2,0,2,2
5465,7,24,8,0,16,8
5465,6,28,14,0,14,14
5465,5,34,9,0,25,9
5465,4,20,7,0,13,7
5465,3,6,2,0,4,2
5465,2,4,1,0,3,1
5465,1,4,1,0,3,1
102219,10,3,2,0,1,2
102219,9,4,1,0,3,1
102219,8,21,7,0,14,7
102219,7,32,8,0,24,8
102219,6,34,10,0,24,10
102219,5,12,2,0,10,2
102219,4,17,2,0,15,2
102219,3,6,1,0,5,1
6559,9,2,1,0,1,1
6559,8,20,4,0,16,4
6559,7,48,14,0,34,14
6559,6,29,6,0,23,6
6559,5,12,3,0,9,3
6559,4,9,4,0,5,4
6559,3,2,1,0,1,1
6559,2,4,2,0,2,2
92497,8,13,4,0,9,4
92497,6,47,7,0,40,7
92497,5,24,3,0,21,3
92497,4,15,5,0,10,5
92497,3,9,3,0,6,3
92497,2,5,3,0,2,3
92497,1,3,1,0,2,1
20734,10,17,7,0,10,7
20734,9,17,4,0,13,4
20734,8,40,12,0,28,12
20734,7,32,10,1,22,9
20734,6,14,4,0,10,4
20734,5,4,2,0,2,2
20734,4,1,1,0,0,1
20734,3,2,1,1,1,0
20734,2,2,2,0,0,2
145609,10,6,1,0,5,1
145609,9,11,5,0,6,5
145609,8,43,14,0,29,14
145609,7,20,4,0,16,4
145609,6,31,12,0,19,12
145609,3,2,1,0,1,1
145609,1,2,1,0,1,1
106174,8,10,3,0,7,3
106174,7,42,9,2,33,7
106174,6,44,9,0,35,9
106174,5,15,6,0,9,6
106174,4,8,1,0,7,1
106174,3,7,2,0,5,2
106174,2,2,1,0,1,1
151369,9,3,1,0,2,1
151369,8,14,1,0,13,1
151369,7,30,7,0,23,7
151369,6,48,7,0,41,7
151369,5,18,1,0,17,1
151369,4,10,1,0,9,1
151369,2,3,1,0,2,1
148,9,4,4,0,0,4
148,8,5,4,0,1,4
148,7,22,3,0,19,3
148,6,47,10,0,37,10
148,5,32,7,0,25,7
148,4,10,5,0,5,5
148,3,5,2,0,3,2
148,2,2,1,0,1,1
148,1,1,1,0,0,1
41934,10,14,9,0,5,9
41934,9,26,9,0,17,9
41934,8,51,10,0,41,10
41934,7,24,6,0,18,6
41934,6,11,2,0,9,2
230731,10,5,2,0,3,2
230731,9,9,1,0,8,1
230731,8,19,4,2,15,2
230731,7,36,6,1,30,5
230731,6,31,4,1,27,3
230731,5,17,3,0,14,3
230731,4,9,4,0,5,4
230731,3,3,1,0,2,1
9091,8,6,1,0,5,1
9091,7,12,4,0,8,4
9091,6,29,9,0,20,9
9091,5,32,7,0,25,7
9091,4,22,10,0,12,10
9091,3,16,4,0,12,4
9091,2,8,2,0,6,2
9091,1,4,2,0,2,2
20832,8,10,4,0,6,4
20832,7,17,5,0,12,5
20832,6,42,9,0,33,9
20832,5,31,4,0,27,4
20832,4,11,1,0,10,1
20832,3,9,3,0,6,3
20832,1,3,1,0,2,1
150599,9,6,1,0,5,1
150599,8,12,1,0,11,1
150599,7,25,4,0,21,4
150599,6,40,3,0,37,3
150599,5,25,3,0,22,3
150599,4,12,3,0,9,3
150599,3,7,2,0,5,2
15804,10,2,2,0,0,2
15804,8,3,3,0,0,3
15804,7,11,6,0,5,6
15804,6,21,8,0,13,8
15804,5,27,6,0,21,6
15804,4,19,8,0,11,8
15804,3,18,7,0,11,7
15804,2,14,5,0,9,5
15804,1,14,5,0,9,5
33024,9,4,1,0,3,1
33024,7,21,4,0,17,4
33024,6,39,5,0,34,5
33024,5,26,6,0,20,6
33024,4,14,5,0,9,5
199881,10,13,2,0,11,2
199881,9,23,3,0,20,3
199881,8,53,8,0,45,8
199881,7,21,2,0,19,2
199881,6,7,1,0,6,1
199881,4,3,1,0,2,1
199881,1,3,1,0,2,1
14132,10,2,1,0,1,1
14132,9,5,2,0,3,2
14132,8,6,1,0,5,1
14132,7,19,8,0,11,8
14132,6,37,9,0,28,9
14132,5,26,8,0,18,8
14132,4,12,2,0,10,2
14132,3,9,3,0,6,3
14132,2,5,1,0,4,1
14132,1,8,2,0,6,2
57803,9,9,4,0,5,4
57803,8,30,13,0,17,13
57803,7,37,12,0,25,12
57803,6,39,16,0,23,16
57803,5,10,5,0,5,5
57803,4,4,2,0,2,2
193248,9,7,3,0,4,3
193248,8,30,4,0,26,4
193248,7,32,5,1,27,4
193248,6,36,11,3,25,8
193248,5,11,2,0,9,2
193248,4,5,2,0,3,2
193248,3,3,1,0,2,1
178335,9,3,2,1,1,1
178335,8,14,7,2,7,5
178335,7,31,4,0,27,4
178335,6,53,15,3,38,12
178335,5,19,5,0,14,5
178335,4,7,1,0,6,1
178335,3,2,1,0,1,1
149621,8,20,3,0,17,3
149621,7,39,8,0,31,8
149621,6,32,5,0,27,5
149621,5,12,2,0,10,2
149621,4,11,2,0,9,2
149621,3,3,1,0,2,1
149621,2,3,1,0,2,1
4257,9,3,1,0,2,1
4257,8,5,3,0,2,3
4257,7,15,8,0,7,8
4257,6,50,17,0,33,17
4257,5,34,12,0,22,12
4257,4,15,6,0,9,6
4257,3,4,2,0,2,2
4257,2,2,1,0,1,1
4257,1,1,1,0,0,1
163047,10,15,3,0,12,3
163047,9,14,1,0,13,1
163047,8,38,6,0,32,6
163047,7,32,8,0,24,8
163047,6,16,2,0,14,2
163047,5,7,1,0,6,1
163047,4,5,3,0,2,3
245214,9,3,1,0,2,1
245214,8,28,2,0,26,2
245214,7,25,1,0,24,1
245214,6,38,2,0,36,2
245214,5,20,3,0,17,3
245214,4,7,2,0,5,2
245214,3,4,1,0,3,1
245214,2,2,1,0,1,1
31853,10,7,1,0,6,1
31853,9,11,2,0,9,2
31853,8,38,10,0,28,10
31853,7,38,9,0,29,9
31853,6,29,11,0,18,11
31853,4,3,2,0,1,2
225316,9,4,1,0,3,1
225316,8,27,6,0,21,6
225316,7,46,5,0,41,5
225316,6,27,4,0,23,4
225316,5,11,1,0,10,1
225316,4,7,2,0,5,2
225316,3,3,1,0,2,1
10320,8,2,1,0,1,1
10320,7,8,5,0,3,5
10320,6,6,2,0,4,2
10320,5,26,10,0,16,10
10320,4,38,15,0,23,15
10320,3,24,9,0,15,9
10320,2,15,8,0,7,8
10320,1,7,2,0,5,2
66825,8,13,3,0,10,3
66825,7,32,9,0,23,9
66825,6,43,10,0,33,10
66825,5,21,5,0,16,5
66825,4,10,2,0,8,2
66825,3,4,1,0,3,1
66825,2,3,1,0,2,1
41646,8,11,2,0,9,2
41646,7,13,4,0,9,4
41646,6,42,10,0,32,10
41646,5,27,11,0,16,11
41646,4,10,4,0,6,4
41646,3,15,6,0,9,6
175626,10,9,7,1,2,6
175626,9,15,8,1,7,7
175626,8,39,18,5,21,13
175626,7,22,5,0,17,5
175626,6,24,4,0,20,4
175626,5,6,4,0,2,4
175626,4,6,2,0,4,2
175626,2,3,1,0,2,1
175626,1,3,2,0,1,2
3403,10,3,3,0,0,3
3403,9,8,3,0,5,3
3403,8,19,7,0,12,7
3403,7,36,5,0,31,5
3403,6,34,13,0,21,13
3403,5,17,6,0,11,6
3403,4,4,4,0,0,4
3403,3,4,3,0,1,3
3403,2,2,1,0,1,1
10323,10,4,1,0,3,1
10323,9,6,2,0,4,2
10323,8,26,4,0,22,4
10323,7,32,4,0,28,4
10323,6,36,8,0,28,8
10323,5,8,1,0,7,1
10323,2,3,1,0,2,1
1784,10,5,5,0,0,5
1784,9,11,3,0,8,3
1784,8,32,15,0,17,15
1784,7,30,10,0,20,10
1784,6,27,9,0,18,9
1784,5,12,4,0,8,4
1784,4,9,4,0,5,4
16149,8,13,1,0,12,1
16149,7,37,8,0,29,8
16149,6,53,11,0,42,11
16149,5,18,2,0,16,2
93879,9,8,2,0,6,2
93879,8,16,3,0,13,3
93879,7,23,7,0,16,7
93879,6,41,12,0,29,12
93879,5,19,9,0,10,9
93879,4,13,2,0,11,2
93879,3,5,3,0,2,3
93879,1,2,1,0,1,1
6431,10,15,11,0,4,11
6431,9,25,12,0,13,12
6431,8,32,8,0,24,8
6431,7,27,9,0,18,9
6431,6,20,4,0,16,4
6431,5,7,2,0,5,2
6431,3,1,1,0,0,1
254123,10,20,8,0,12,8
254123,9,32,10,0,22,10
254123,8,46,7,0,39,7
254123,7,17,3,0,14,3
254123,5,2,1,0,1,1
254123,4,3,1,0,2,1
254123,2,1,1,0,0,1
1291,9,2,1,0,1,1
1291,8,4,1,0,3,1
1291,7,21,8,0,13,8
1291,6,44,14,0,30,14
1291,5,35,12,0,23,12
1291,4,15,6,0,9,6
1291,3,5,1,0,4,1
1291,2,1,1,0,0,1
103261,8,5,1,0,4,1
103261,7,12,3,0,9,3
103261,6,36,5,0,31,5
103261,5,23,8,0,15,8
103261,4,25,10,0,15,10
103261,3,13,2,0,11,2
103261,2,10,5,0,5,5
103261,1,4,1,0,3,1
141437,10,4,1,0,3,1
141437,9,5,3,0,2,3
141437,8,16,4,0,12,4
141437,7,30,5,1,25,4
141437,6,37,4,0,33,4
141437,5,15,1,0,14,1
141437,4,11,1,0,10,1
141437,3,7,2,0,5,2
141437,2,3,3,0,0,3
38764,10,15,7,0,8,7
38764,9,20,5,0,15,5
38764,8,38,12,0,26,12
38764,7,27,6,0,21,6
38764,6,18,4,0,14,4
38764,5,5,1,0,4,1
38764,4,5,3,0,2,3
170477,10,7,4,1,3,3
170477,9,21,9,1,12,8
170477,8,44,15,2,29,13
170477,7,25,1,0,24,1
170477,6,16,2,0,14,2
170477,5,5,1,0,4,1
170477,4,5,2,0,3,2
170477,3,2,1,0,1,1
170477,2,2,1,0,1,1
28224,8,6,4,0,2,4
28224,7,11,4,0,7,4
28224,6,30,5,0,25,5
28224,5,28,10,0,18,10
28224,4,18,8,0,10,8
28224,3,11,6,0,5,6
28224,2,14,7,0,7,7
28224,1,6,4,0,2,4
107463,8,16,4,0,12,4
107463,7,23,3,0,20,3
107463,6,52,10,0,42,10
107463,5,18,3,0,15,3
107463,4,9,1,0,8,1
107463,3,2,1,0,1,1
22606,10,3,2,0,1,2
22606,9,17,6,0,11,6
22606,8,32,17,0,15,17
22606,7,23,5,0,18,5
22606,6,21,9,0,12,9
22606,5,13,6,0,7,6
22606,4,9,3,0,6,3
22606,3,2,2,0,0,2
22606,2,5,5,0,0,5
22606,1,3,1,0,2,1
15163,8,9,3,0,6,3
15163,7,15,2,0,13,2
15163,6,45,21,0,24,21
15163,5,28,6,0,22,6
15163,4,19,6,0,13,6
15163,3,6,3,0,3,3
15163,2,2,2,0,0,2
15163,1,1,1,0,0,1
171489,8,11,3,0,8,3
171489,7,30,3,0,27,3
171489,6,47,9,0,38,9
171489,5,18,1,0,17,1
171489,4,13,2,0,11,2
171489,3,5,2,0,3,2
138616,10,8,5,0,3,5
138616,9,7,2,0,5,2
138616,8,21,6,0,15,6
138616,7,17,1,0,16,1
138616,6,39,6,0,33,6
138616,5,14,1,0,13,1
138616,4,12,1,0,11,1
138616,2,3,2,0,1,2
37680,8,12,2,0,10,2
37680,7,22,2,0,20,2
37680,6,43,18,0,25,18
37680,5,23,10,0,13,10
37680,4,16,3,0,13,3
37680,3,8,6,0,2,6
37680,2,3,1,0,2,1
158815,10,15,4,0,11,4
158815,9,38,14,0,24,14
158815,8,48,14,0,34,14
158815,7,21,9,0,12,9
84671,8,16,4,0,12,4
84671,7,27,10,0,17,10
84671,6,44,8,0,36,8
84671,5,19,6,0,13,6
84671,4,11,2,0,9,2
84671,3,5,3,0,2,3
166276,8,35,4,0,31,4
166276,7,22,4,0,18,4
166276,6,31,5,0,26,5
166276,5,20,6,0,14,6
166276,4,11,5,0,6,5
166276,2,2,1,0,1,1
269144,10,4,1,0,3,1
269144,9,13,1,0,12,1
269144,8,53,10,0,43,10
269144,7,39,5,0,34,5
269144,6,22,5,0,17,5
269144,4,2,1,0,1,1
538,9,8,5,0,3,5
538,8,19,3,0,16,3
538,7,33,6,0,27,6
538,6,39,11,0,28,11
538,5,15,2,0,13,2
538,4,8,3,0,5,3
538,3,3,1,0,2,1
538,2,1,1,0,0,1
214125,10,6,2,1,4,1
214125,9,15,6,0,9,6
214125,8,42,10,1,32,9
214125,7,27,1,0,26,1
214125,6,24,3,0,21,3
214125,4,4,1,0,3,1
214125,2,1,1,0,0,1
1066,10,2,1,0,1,1
1066,8,12,2,0,10,2
1066,7,34,6,0,28,6
1066,6,49,8,0,41,8
1066,5,13,1,0,12,1
1066,4,9,1,0,8,1
1066,3,3,1,0,2,1
1753,9,1,1,0,0,1
1753,8,6,3,0,3,3
1753,7,28,8,0,20,8
1753,6,48,13,0,35,13
1753,5,27,2,0,25,2
1753,4,14,4,0,10,4
1753,3,2,1,0,1,1
1753,2,1,1,0,0,1
4084,10,3,1,0,2,1
4084,9,6,4,0,2,4
4084,8,9,5,0,4,5
4084,7,31,12,0,19,12
4084,6,39,8,0,31,8
4084,5,25,7,0,18,7
4084,4,10,2,0,8,2
4084,3,1,1,0,0,1
4084,2,2,1,0,1,1
30958,10,13,3,0,10,3
30958,9,25,4,0,21,4
30958,8,43,12,0,31,12
30958,7,28,7,0,21,7
30958,6,11,3,0,8,3
30958,5,5,2,0,3,2
30958,4,1,1,0,0,1
7453,10,14,4,0,10,4
7453,9,18,8,0,10,8
7453,8,42,7,0,35,7
7453,7,28,8,0,20,8
7453,6,16,6,0,10,6
7453,4,2,2,0,0,2
7453,3,3,2,0,1,2
2742,10,4,2,0,2,2
2742,9,13,5,0,8,5
2742,8,23,11,0,12,11
2742,7,43,7,0,36,7
2742,6,28,6,0,22,6
2742,5,12,1,0,11,1
2742,1,1,1,0,0,1
249763,10,3,1,0,2,1
249763,9,3,1,0,2,1
249763,8,33,5,0,28,5
249763,7,52,8,0,44,8
249763,6,26,3,0,23,3
19466,8,6,1,0,5,1
19466,7,19,2,0,17,2
19466,6,38,5,0,33,5
19466,5,29,6,0,23,6
19466,4,16,6,0,10,6
19466,3,8,3,0,5,3
19466,2,5,2,0,3,2
19466,1,5,2,0,3,2
23827,10,9,2,0,7,2
23827,9,14,6,0,8,6
23827,8,39,9,0,30,9
23827,7,31,4,0,27,4
23827,6,20,3,0,17,3
23827,5,8,1,0,7,1
23827,4,4,3,0,1,3
40958,8,3,1,0,2,1
40958,7,27,6,0,21,6
40958,6,50,15,0,35,15
40958,5,27,8,0,19,8
40958,4,16,2,0,14,2
229742,10,2,2,0,0,2
229742,8,21,6,0,15,6
229742,7,37,8,0,29,8
229742,6,41,9,0,32,9
229742,5,12,3,0,9,3
229742,4,9,3,0,6,3
229742,3,2,1,0,1,1
104617,8,9,2,0,7,2
104617,7,20,2,0,18,2
104617,6,44,6,0,38,6
104617,5,25,8,0,17,8
104617,4,12,3,0,9,3
104617,3,11,2,0,9,2
104617,2,4,3,0,1,3
29382,8,34,9,0,25,9
29382,7,35,9,0,26,9
29382,6,34,13,0,21,13
29382,5,13,5,0,8,5
29382,4,3,2,0,1,2
29382,3,2,2,0,0,2
29382,1,1,1,0,0,1
76681,8,13,2,0,11,2
76681,7,25,6,0,19,6
76681,6,43,9,0,34,9
76681,5,26,8,0,18,8
76681,4,12,4,0,8,4
5278,8,22,10,0,12,10
5278,7,42,13,0,29,13
5278,6,39,11,0,28,11
5278,5,14,4,0,10,4
5278,4,6,1,0,5,1
5278,3,4,3,0,1,3
1174,7,20,3,0,17,3
1174,6,27,5,0,22,5
1174,5,24,5,0,19,5
1174,4,28,5,0,23,5
1174,3,10,2,0,8,2
1174,2,13,3,0,10,3
157135,10,3,1,0,2,1
157135,9,5,3,0,2,3
157135,8,31,11,0,20,11
157135,7,18,7,0,11,7
157135,6,38,12,0,26,12
157135,5,15,5,0,10,5
157135,4,9,2,0,7,2
157135,2,4,2,0,2,2
157135,1,1,1,0,0,1
252985,10,14,3,0,11,3
252985,9,14,2,0,12,2
252985,8,27,3,0,24,3
252985,7,29,7,0,22,7
252985,6,20,4,0,16,4
252985,5,7,2,0,5,2
252985,4,4,1,0,3,1
252985,1,7,1,0,6,1
1450,9,1,1,0,0,1
1450,8,4,1,0,3,1
1450,7,18,4,0,14,4
1450,6,45,8,0,37,8
1450,5,29,3,0,26,3
1450,4,15,2,0,13,2
1450,3,9,3,0,6,3
1450,1,3,1,0,2,1
5041,10,4,1,0,3,1
5041,9,9,4,0,5,4
5041,8,38,7,0,31,7
5041,7,27,6,0,21,6
5041,6,33,5,0,28,5
5041,5,12,3,0,9,3
12899,10,11,4,0,7,4
12899,9,22,8,0,14,8
12899,8,35,4,0,31,4
12899,7,46,9,0,37,9
12899,6,6,1,0,5,1
12899,5,4,1,0,3,1
12899,4,2,1,0,1,1
12899,2,1,1,0,0,1
1804,10,2,1,0,1,1
1804,9,3,2,0,1,2
1804,8,21,9,0,12,9
1804,7,38,13,0,25,13
1804,6,31,4,0,27,4
1804,5,22,5,0,17,5
1804,4,6,4,0,2,4
40561,10,2,1,0,1,1
40561,9,8,3,0,5,3
40561,8,32,12,0,20,12
40561,7,31,8,0,23,8
40561,6,32,6,0,26,6
40561,5,15,1,0,14,1
169102,10,11,4,0,7,4
169102,9,12,4,0,8,4
169102,8,25,4,0,21,4
169102,7,23,2,0,21,2
169102,6,24,3,0,21,3
169102,5,13,2,1,11,1
169102,3,7,4,0,3,4
169102,2,3,1,0,2,1
3485,8,14,3,0,11,3
3485,7,32,8,0,24,8
3485,6,38,3,0,35,3
3485,5,19,4,0,15,4
3485,2,3,1,0,2,1
3063,10,4,2,0,2,2
3063,9,5,2,0,3,2
3063,8,17,7,0,10,7
3063,7,39,10,0,29,10
3063,6,33,11,0,22,11
3063,5,12,2,0,10,2
3063,4,6,3,0,3,3
3063,3,8,3,0,5,3
3063,2,1,1,0,0,1
3063,1,2,2,0,0,2
171775,8,20,5,0,15,5
171775,7,29,6,0,23,6
171775,6,45,10,2,35,8
171775,5,16,2,0,14,2
171775,4,6,1,0,5,1
171775,3,5,3,0,2,3
171775,1,1,1,0,0,1
189506,10,5,3,0,2,3
189506,9,19,4,0,15,4
189506,8,44,12,2,32,10
189506,7,26,6,1,20,5
189506,6,13,1,1,12,0
189506,5,11,2,0,9,2
189506,4,2,1,0,1,1
189506,3,3,1,0,2,1
189506,1,1,1,0,0,1
223619,10,10,3,1,7,2
223619,9,27,4,0,23,4
223619,8,39,9,0,30,9
223619,7,27,5,0,22,5
223619,6,12,3,0,9,3
223619,5,6,1,0,5,1
198971,10,10,3,1,7,2
198971,9,8,2,0,6,2
198971,8,35,7,3,28,4
198971,7,29,4,0,25,4
198971,6,21,4,0,17,4
198971,5,11,5,1,6,4
198971,4,6,1,0,5,1
198971,2,1,1,0,0,1
249411,10,10,4,0,6,4
249411,9,12,2,0,10,2
249411,8,48,7,0,41,7
249411,7,35,7,0,28,7
249411,5,7,1,0,6,1
17395,10,2,1,0,1,1
17395,9,8,2,0,6,2
17395,8,37,7,0,30,7
17395,7,43,15,0,28,15
17395,6,19,9,0,10,9
17395,5,14,8,0,6,8
236245,9,9,1,0,8,1
236245,8,21,2,0,19,2
236245,7,36,1,0,35,1
236245,6,36,2,0,34,2
236245,5,15,2,0,13,2
236245,4,4,2,0,2,2
152174,10,5,2,0,3,2
152174,9,4,2,0,2,2
152174,8,17,3,0,14,3
152174,7,26,5,0,21,5
152174,6,41,8,0,33,8
152174,5,20,5,0,15,5
152174,4,5,2,0,3,2
152174,3,5,1,0,4,1
152174,2,2,1,0,1,1
177538,8,42,7,0,35,7
177538,7,26,4,0,22,4
177538,6,25,5,0,20,5
177538,5,10,2,0,8,2
177538,4,8,3,0,5,3
177538,3,5,2,0,3,2
177538,2,3,2,0,1,2
166,8,9,6,0,3,6
166,7,22,7,0,15,7
166,6,47,14,0,33,14
166,5,19,6,0,13,6
166,4,14,6,0,8,6
166,3,7,5,0,2,5
166,2,2,1,0,1,1
166,1,3,1,0,2,1
144223,10,6,3,0,3,3
144223,9,10,2,0,8,2
144223,8,34,7,0,27,7
144223,7,33,7,0,26,7
144223,6,26,5,0,21,5
144223,5,11,3,0,8,3
144223,4,4,2,0,2,2
144223,2,1,1,0,0,1
24230,9,2,2,0,0,2
24230,8,18,7,0,11,7
24230,7,42,13,0,29,13
24230,6,33,14,0,19,14
24230,5,19,8,0,11,8
24230,4,6,1,0,5,1
24230,3,3,2,0,1,2
24230,2,3,2,0,1,2
142265,10,4,2,0,2,2
142265,9,12,5,0,7,5
142265,8,31,1,0,30,1
142265,7,35,6,0,29,6
142265,6,25,5,1,20,4
142265,5,13,4,1,9,3
142265,4,4,1,0,3,1
142265,3,1,1,0,0,1
107649,9,2,1,0,1,1
107649,8,15,2,0,13,2
107649,7,31,8,0,23,8
107649,6,47,13,0,34,13
107649,5,21,5,0,16,5
107649,4,6,2,0,4,2
107649,3,4,1,0,3,1
36297,10,5,1,0,4,1
36297,9,14,2,0,12,2
36297,8,46,15,0,31,15
36297,7,32,8,0,24,8
36297,6,20,6,0,14,6
36297,5,6,3,0,3,3
36297,4,2,2,0,0,2
36297,2,1,1,0,0,1
25013,8,15,12,0,3,12
25013,7,27,10,0,17,10
25013,6,41,16,0,25,16
25013,5,17,7,0,10,7
25013,4,10,5,0,5,5
25013,3,11,7,0,4,7
25013,2,4,3,0,1,3
25013,1,1,1,0,0,1
240529,10,9,2,0,7,2
240529,9,10,3,1,7,2
240529,8,39,7,1,32,6
240529,7,45,5,1,40,4
240529,6,14,3,1,11,2
240529,5,9,2,0,7,2
240529,4,3,1,1,2,0
240529,1,1,1,0,0,1
11730,8,15,6,0,9,6
11730,7,33,12,0,21,12
11730,6,47,13,0,34,13
11730,5,16,8,0,8,8
11730,4,8,3,0,5,3
11730,3,4,2,0,2,2
906,9,1,1,0,0,1
906,8,7,1,0,6,1
906,7,25,4,0,21,4
906,6,51,14,0,37,14
906,5,27,5,0,22,5
906,4,7,2,0,5,2
906,3,6,2,0,4,2
122867,9,4,1,0,3,1
122867,8,15,2,0,13,2
122867,7,23,5,0,18,5
122867,6,32,6,0,26,6
122867,5,27,7,0,20,7
122867,4,16,1,0,15,1
122867,3,4,2,0,2,2
33984,8,14,5,0,9,5
33984,7,33,12,0,21,12
33984,6,40,15,0,25,15
33984,5,22,5,0,17,5
33984,3,5,1,0,4,1
5351,10,10,6,0,4,6
5351,9,9,2,0,7,2
5351,8,31,12,0,19,12
5351,7,36,8,0,28,8
5351,6,23,5,0,18,5
5351,5,10,6,0,4,6
5351,4,4,2,0,2,2
5351,2,1,1,0,0,1
5351,1,1,1,0,0,1
121414,9,2,1,0,1,1
121414,8,10,1,0,9,1
121414,7,15,4,0,11,4
121414,6,36,11,0,25,11
121414,5,22,5,0,17,5
121414,4,18,3,0,15,3
121414,3,10,5,0,5,5
121414,2,9,4,0,5,4
121414,1,3,1,0,2,1
16196,10,5,3,0,2,3
16196,9,4,1,0,3,1
16196,8,28,13,0,15,13
16196,7,29,13,0,16,13
16196,6,39,14,0,25,14
16196,5,10,6,0,4,6
16196,4,9,5,0,4,5
16196,2,2,2,0,0,2
37755,8,10,3,0,7,3
37755,7,21,8,0,13,8
37755,6,58,17,0,41,17
37755,5,25,7,0,18,7
37755,4,7,1,0,6,1
37755,3,1,1,0,0,1
37755,2,1,1,0,0,1
5186,10,1,1,0,0,1
5186,9,5,2,0,3,2
5186,8,13,3,0,10,3
5186,7,30,7,0,23,7
5186,6,43,10,0,33,10
5186,5,17,4,0,13,4
5186,4,12,3,0,9,3
5186,2,3,2,0,1,2
20646,10,10,2,0,8,2
20646,9,24,10,0,14,10
20646,8,58,15,0,43,15
20646,7,17,5,0,12,5
20646,6,11,6,0,5,6
20646,5,2,2,0,0,2
20646,4,3,2,0,1,2
180,8,8,7,0,1,7
180,7,26,10,0,16,10
180,6,47,14,0,33,14
180,5,29,3,0,26,3
180,4,11,5,0,6,5
180,3,2,1,0,1,1
180,2,2,1,0,1,1
7215,10,7,2,0,5,2
7215,9,10,5,0,5,5
7215,8,46,18,0,28,18
7215,7,32,11,0,21,11
7215,6,17,3,0,14,3
7215,5,11,2,0,9,2
2144,9,1,1,0,0,1
2144,8,8,3,0,5,3
2144,7,12,6,0,6,6
2144,6,37,14,0,23,14
2144,5,26,6,0,20,6
2144,4,22,7,0,15,7
2144,3,10,5,0,5,5
2144,2,8,5,0,3,5
2144,1,2,1,0,1,1
2189,10,1,1,0,0,1
2189,9,2,1,0,1,1
2189,8,11,4,0,7,4
2189,7,35,9,0,26,9
2189,6,49,14,0,35,14
2189,5,14,4,0,10,4
2189,4,7,1,0,6,1
2189,3,5,1,0,4,1
2189,2,1,1,0,0,1
14525,8,19,4,0,15,4
14525,7,36,9,0,27,9
14525,6,44,12,0,32,12
14525,5,14,3,0,11,3
14525,4,6,3,0,3,3
51195,10,2,1,0,1,1
51195,9,15,5,0,10,5
51195,8,30,10,0,20,10
51195,7,33,11,0,22,11
51195,6,31,9,0,22,9
51195,5,6,1,0,5,1
51195,4,5,2,0,3,2
51195,3,2,2,0,0,2
154742,10,5,2,0,3,2
154742,9,4,1,0,3,1
154742,8,16,2,0,14,2
154742,7,37,8,0,29,8
154742,6,44,7,0,37,7
154742,5,9,3,0,6,3
154742,2,4,2,0,2,2
27736,10,7,5,0,2,5
27736,9,14,6,0,8,6
27736,8,29,6,0,23,6
27736,7,26,11,0,15,11
27736,6,32,14,0,18,14
27736,5,10,6,0,4,6
27736,2,1,1,0,0,1
18058,9,1,1,0,0,1
18058,8,19,1,0,18,1
18058,7,35,3,0,32,3
18058,6,42,10,0,32,10
18058,5,19,2,0,17,2
18058,4,5,2,0,3,2
18058,1,1,1,0,0,1
118247,9,2,1,0,1,1
118247,8,34,3,0,31,3
118247,7,29,6,0,23,6
118247,6,33,10,0,23,10
118247,5,15,3,0,12,3
118247,4,8,2,0,6,2
15235,10,6,2,0,4,2
15235,9,14,6,0,8,6
15235,8,41,11,0,30,11
15235,7,31,6,0,25,6
15235,6,21,4,0,17,4
15235,5,10,3,0,7,3
4842,9,4,1,0,3,1
4842,8,17,5,0,12,5
4842,7,23,9,0,14,9
4842,6,45,12,1,33,11
4842,5,18,5,0,13,5
4842,4,11,3,0,8,3
4842,3,2,1,0,1,1
8031,9,1,1,0,0,1
8031,8,5,2,0,3,2
8031,7,8,3,0,5,3
8031,6,17,3,0,14,3
8031,5,24,11,0,13,11
8031,4,27,8,0,19,8
8031,3,15,9,0,6,9
8031,2,16,9,0,7,9
8031,1,11,4,0,7,4
24927,10,1,1,0,0,1
24927,8,9,3,0,6,3
24927,7,22,4,0,18,4
24927,6,47,10,0,37,10
24927,5,24,6,0,18,6
24927,4,14,3,0,11,3
127432,10,2,1,0,1,1
127432,9,7,2,0,5,2
127432,8,41,7,0,34,7
127432,7,39,7,0,32,7
127432,6,24,4,0,20,4
127432,5,8,2,0,6,2
127432,4,3,1,0,2,1
7634,10,9,5,0,4,5
7634,9,14,5,0,9,5
7634,8,39,9,0,30,9
7634,7,32,7,0,25,7
7634,6,21,2,0,19,2
7634,5,8,2,0,6,2
8812,10,4,2,0,2,2
8812,9,11,3,0,8,3
8812,8,38,9,0,29,9
8812,7,43,15,0,28,15
8812,6,17,3,0,14,3
8812,5,9,2,0,7,2
8812,4,2,1,0,1,1
8812,3,1,1,0,0,1
161849,9,5,2,0,3,2
161849,8,16,6,0,10,6
161849,7,29,8,0,21,8
161849,6,43,9,0,34,9
161849,5,14,5,0,9,5
161849,4,6,3,0,3,3
161849,3,9,5,0,4,5
161849,2,1,1,0,0,1
128425,10,15,5,0,10,5
128425,9,22,2,0,20,2
128425,8,32,2,0,30,2
128425,6,25,2,0,23,2
201305,8,11,2,0,9,2
201305,7,23,6,1,17,5
201305,6,34,5,0,29,5
201305,5,32,6,0,26,6
201305,4,15,2,0,13,2
201305,3,6,2,0,4,2
201305,1,2,2,0,0,2
256952,10,23,4,0,19,4
256952,9,24,2,0,22,2
256952,8,45,10,0,35,10
256952,7,22,3,0,19,3
256952,6,12,1,0,11,1
43927,10,3,1,0,2,1
43927,8,7,1,0,6,1
43927,7,26,3,0,23,3
43927,6,45,5,0,40,5
43927,5,19,2,0,17,2
43927,4,10,2,0,8,2
43927,3,7,3,0,4,3
43927,2,5,2,0,3,2
169658,10,22,10,0,12,10
169658,9,11,3,1,8,2
169658,8,27,9,1,18,8
169658,7,18,5,0,13,5
169658,6,29,6,1,23,5
169658,5,10,1,0,9,1
169658,4,3,1,0,2,1
169658,3,3,1,0,2,1
248125,10,36,16,0,20,16
248125,9,37,15,4,22,11
248125,8,27,6,0,21,6
248125,7,12,2,1,10,1
248125,6,7,2,0,5,2
248125,5,2,1,0,1,1
248125,4,2,1,0,1,1
248125,3,1,1,0,0,1
88871,10,7,3,0,4,3
88871,9,14,3,0,11,3
88871,8,53,13,0,40,13
88871,7,29,4,0,25,4
88871,6,10,3,0,7,3
88871,4,6,4,0,2,4
88871,2,1,1,0,0,1
1706,8,5,1,0,4,1
1706,7,8,5,0,3,5
1706,6,32,10,0,22,10
1706,5,30,7,0,23,7
1706,4,23,3,0,20,3
1706,3,15,6,0,9,6
1706,2,9,3,0,6,3
1706,1,3,1,0,2,1
195742,10,3,1,0,2,1
195742,9,4,3,0,1,3
195742,8,33,5,0,28,5
195742,7,31,6,0,25,6
195742,6,30,7,0,23,7
195742,5,13,5,0,8,5
195742,3,2,1,0,1,1
199269,10,6,1,0,5,1
199269,9,9,3,0,6,3
199269,8,32,12,0,20,12
199269,7,23,9,0,14,9
199269,6,40,12,0,28,12
199269,5,5,2,0,3,2
199269,4,5,2,0,3,2
199269,2,4,2,0,2,2
90568,10,9,4,0,5,4
90568,9,24,8,0,16,8
90568,8,48,14,0,34,14
90568,7,18,4,0,14,4
90568,6,12,2,0,10,2
90568,5,6,2,0,4,2
90568,4,4,1,0,3,1
90568,3,2,2,0,0,2
13508,10,1,1,0,0,1
13508,8,2,1,0,1,1
13508,7,9,4,0,5,4
13508,6,23,6,0,17,6
13508,5,29,11,0,18,11
13508,4,27,12,0,15,12
13508,3,19,7,0,12,7
13508,2,8,3,0,5,3
13508,1,6,4,0,2,4
7922,9,9,4,0,5,4
7922,8,23,12,0,11,12
7922,7,40,13,0,27,13
7922,6,29,7,0,22,7
7922,5,14,5,0,9,5
7922,4,5,2,0,3,2
2780,10,17,6,0,11,6
2780,9,12,2,0,10,2
2780,8,32,12,0,20,12
2780,7,25,4,0,21,4
2780,6,19,7,0,12,7
2780,5,9,4,0,5,4
2780,4,4,3,0,1,3
2780,3,2,1,0,1,1
2780,2,2,1,0,1,1
66251,9,1,1,0,0,1
66251,8,5,1,0,4,1
66251,7,21,5,0,16,5
66251,6,35,6,0,29,6
66251,5,24,3,0,21,3
66251,4,19,5,0,14,5
66251,3,7,1,0,6,1
66251,1,2,1,0,1,1
191067,8,10,1,0,9,1
191067,7,36,5,0,31,5
191067,6,56,3,0,53,3
191067,5,13,3,0,10,3
13682,6,43,5,0,38,5
13682,5,35,5,0,30,5
13682,4,14,6,0,8,6
13682,2,4,3,0,1,3
60029,10,1,1,0,0,1
60029,9,8,3,0,5,3
60029,8,39,13,0,26,13
60029,7,44,18,0,26,18
60029,6,22,7,0,15,7
60029,5,6,3,0,3,3
60029,3,2,1,0,1,1
60029,1,1,1,0,0,1
7927,7,11,1,0,10,1
7927,6,30,3,0,27,3
7927,5,36,6,0,30,6
7927,4,21,4,0,17,4
7927,3,11,6,0,5,6
7927,2,10,2,0,8,2
209567,10,6,3,0,3,3
209567,9,8,2,0,6,2
209567,8,20,5,0,15,5
209567,7,40,9,0,31,9
209567,6,32,7,0,25,7
209567,5,12,1,0,11,1
209567,3,3,1,0,2,1
3515,8,3,2,0,1,2
3515,6,13,5,0,8,5
3515,5,23,4,0,19,4
3515,4,28,10,0,18,10
3515,3,23,3,0,20,3
3515,2,16,6,0,10,6
3515,1,14,5,0,9,5
217619,10,1,1,0,0,1
217619,9,4,1,0,3,1
217619,8,10,2,0,8,2
217619,7,27,2,0,25,2
217619,6,51,6,0,45,6
217619,5,23,3,0,20,3
217619,4,4,1,0,3,1
217619,2,1,1,0,0,1
217619,1,1,1,0,0,1
156458,8,17,2,0,15,2
156458,7,29,6,0,23,6
156458,6,49,7,0,42,7
156458,5,13,2,0,11,2
156458,4,11,4,0,7,4
2760,10,4,3,0,1,3
2760,8,9,3,0,6,3
2760,7,20,6,0,14,6
2760,6,36,12,0,24,12
2760,5,27,6,0,21,6
2760,4,15,3,0,12,3
2760,3,8,3,0,5,3
2760,2,2,2,0,0,2
2760,1,2,2,0,0,2
172559,10,2,1,0,1,1
172559,8,9,2,0,7,2
172559,7,24,1,0,23,1
172559,6,40,2,0,38,2
172559,5,25,2,0,23,2
172559,4,14,2,0,12,2
172559,3,6,2,0,4,2
172559,1,3,2,0,1,2
231027,10,3,1,0,2,1
231027,9,11,5,0,6,5
231027,8,30,7,0,23,7
231027,7,24,4,0,20,4
231027,6,43,11,0,32,11
231027,5,11,3,0,8,3
39020,9,4,1,0,3,1
39020,8,12,1,0,11,1
39020,7,30,5,0,25,5
39020,6,46,8,0,38,8
39020,5,20,2,0,18,2
39020,4,8,5,0,3,5
39020,2,2,1,0,1,1
234221,10,48,42,3,6,39
234221,9,16,12,3,4,9
234221,8,22,9,1,13,8
234221,7,17,5,1,12,4
234221,6,10,2,0,8,2
234221,5,7,3,1,4,2
218863,8,28,3,0,25,3
218863,7,32,6,0,26,6
218863,6,39,5,0,34,5
218863,5,14,1,0,13,1
218863,3,2,1,0,1,1
109657,8,17,4,0,13,4
109657,7,29,11,0,18,11
109657,6,51,18,0,33,18
109657,5,13,4,0,9,4
109657,4,8,2,0,6,2
109657,3,5,1,0,4,1
4694,9,1,1,0,0,1
4694,8,3,1,0,2,1
4694,7,12,5,0,7,5
4694,6,17,5,0,12,5
4694,5,30,8,0,22,8
4694,4,25,8,0,17,8
4694,3,17,6,0,11,6
4694,2,12,6,0,6,6
4694,1,7,4,0,3,4
178030,10,34,17,0,17,17
178030,9,15,8,0,7,8
178030,8,23,8,0,15,8
178030,7,18,4,1,14,3
178030,6,13,2,0,11,2
178030,5,3,2,0,1,2
178030,4,9,4,0,5,4
178030,3,4,3,0,1,3
178030,2,3,2,0,1,2
178030,1,2,1,0,1,1
8930,10,4,1,0,3,1
8930,9,1,1,0,0,1
8930,8,11,2,0,9,2
8930,7,9,5,0,4,5
8930,6,36,10,0,26,10
8930,5,37,11,0,26,11
8930,4,16,7,0,9,7
8930,3,6,1,0,5,1
8930,2,3,1,0,2,1
204576,9,5,1,0,4,1
204576,8,15,2,0,13,2
204576,7,33,6,0,27,6
204576,6,41,6,0,35,6
204576,5,12,4,0,8,4
204576,2,4,2,0,2,2
240744,10,9,5,1,4,4
240744,9,9,2,0,7,2
240744,8,31,6,0,25,6
240744,7,36,7,0,29,7
240744,6,31,6,1,25,5
240744,4,3,1,1,2,0
23025,8,6,2,0,4,2
23025,7,12,1,0,11,1
23025,6,33,10,0,23,10
23025,5,41,10,0,31,10
23025,4,23,6,0,17,6
23025,3,8,3,0,5,3
216985,8,15,2,0,13,2
216985,7,42,2,0,40,2
216985,6,46,6,0,40,6
216985,5,9,1,0,8,1
216985,4,7,1,0,6,1
198412,10,5,3,0,2,3
198412,9,12,1,0,11,1
198412,7,36,6,0,30,6
198412,6,27,6,0,21,6
3237,10,4,2,0,2,2
3237,9,11,3,0,8,3
3237,8,22,11,0,11,11
3237,7,43,12,0,31,12
3237,6,24,4,0,20,4
3237,5,11,3,0,8,3
3237,4,8,5,0,3,5
3237,3,1,1,0,0,1
11437,10,13,3,0,10,3
11437,9,23,2,0,21,2
11437,8,39,6,0,33,6
11437,7,32,8,0,24,8
11437,6,10,3,0,7,3
11437,5,2,1,0,1,1
11437,2,1,1,0,0,1
193417,10,12,6,0,6,6
193417,9,15,5,0,10,5
193417,8,25,3,1,22,2
193417,7,24,7,0,17,7
193417,6,27,2,0,25,2
193417,5,11,2,0,9,2
193417,4,6,2,0,4,2
193417,2,2,1,0,1,1
4219,8,7,4,0,3,4
4219,7,16,3,0,13,3
4219,6,46,8,0,38,8
4219,5,31,5,0,26,5
4219,4,16,1,0,15,1
4219,3,3,1,0,2,1
4219,2,3,1,0,2,1
100473,8,42,15,0,27,15
100473,7,33,5,0,28,5
100473,6,30,8,0,22,8
100473,5,6,2,0,4,2
100473,4,6,3,0,3,3
100473,3,1,1,0,0,1
100473,2,1,1,0,0,1
40819,10,3,3,0,0,3
40819,9,2,1,0,1,1
40819,8,15,7,0,8,7
40819,7,25,14,0,11,14
40819,6,54,25,0,29,25
40819,5,13,6,0,7,6
40819,4,7,4,0,3,4
40819,3,3,2,0,1,2
40819,2,2,2,0,0,2
209945,7,13,4,1,9,3
209945,6,29,6,0,23,6
209945,5,21,4,0,17,4
209945,4,17,5,0,12,5
209945,3,18,8,0,10,8
209945,2,8,1,0,7,1
209945,1,6,3,1,3,2
25470,8,6,4,0,2,4
25470,7,26,8,0,18,8
25470,6,42,10,0,32,10
25470,5,31,4,0,27,4
25470,4,11,1,0,10,1
25470,2,4,2,0,2,2
172543,9,1,1,1,0,0
172543,8,18,4,0,14,4
172543,7,27,9,0,18,9
172543,6,39,12,0,27,12
172543,5,24,4,0,20,4
172543,4,12,2,0,10,2
457,9,1,1,0,0,1
457,8,9,2,0,7,2
457,7,18,4,0,14,4
457,6,50,11,0,39,11
457,5,36,13,0,23,13
457,4,7,2,0,5,2
457,3,3,1,0,2,1
130685,7,24,4,0,20,4
130685,6,44,11,0,33,11
130685,5,31,6,0,25,6
130685,2,1,1,0,0,1
26211,9,2,1,0,1,1
26211,8,16,3,0,13,3
26211,7,29,10,0,19,10
26211,6,39,12,0,27,12
26211,5,21,6,0,15,6
26211,4,10,4,0,6,4
26211,3,3,1,0,2,1
26211,2,2,1,0,1,1
9509,8,9,3,0,6,3
9509,7,31,8,0,23,8
9509,6,49,14,0,35,14
9509,5,20,4,0,16,4
9509,4,13,6,0,7,6
9509,3,1,1,0,0,1
9392,7,9,2,0,7,2
9392,6,30,5,0,25,5
9392,5,19,7,0,12,7
9392,4,26,1,0,25,1
9392,3,26,8,0,18,8
9392,2,7,5,0,2,5
9392,1,2,1,0,1,1
25004,9,3,2,0,1,2
25004,8,7,2,0,5,2
25004,7,26,4,0,22,4
25004,6,43,14,0,29,14
25004,5,18,10,0,8,10
25004,4,12,4,0,8,4
25004,3,8,4,0,4,4
25004,2,4,2,0,2,2
1572,10,4,3,0,1,3
1572,9,3,1,0,2,1
1572,8,17,6,0,11,6
1572,7,34,14,0,20,14
1572,6,42,15,0,27,15
1572,5,16,9,0,7,9
1572,4,7,6,0,1,6
5831,9,6,4,0,2,4
5831,8,18,7,0,11,7
5831,7,40,13,0,27,13
5831,6,34,8,0,26,8
5831,4,5,4,0,1,4
1908,10,1,1,0,0,1
1908,8,7,4,0,3,4
1908,7,24,14,0,10,14
1908,6,36,10,0,26,10
1908,5,18,3,0,15,3
1908,4,14,6,0,8,6
1908,3,14,3,0,11,3
1908,2,5,2,0,3,2
93138,8,9,2,0,7,2
93138,7,40,8,0,32,8
93138,6,53,11,0,42,11
93138,5,10,3,0,7,3
93138,4,6,4,0,2,4
93138,3,5,1,0,4,1
2356,6,27,6,0,21,6
2356,5,33,8,0,25,8
2356,4,22,8,0,14,8
2356,3,15,4,0,11,4
2356,2,10,5,0,5,5
2356,1,5,2,0,3,2
184648,9,14,3,0,11,3
184648,8,21,5,1,16,4
184648,7,32,5,0,27,5
184648,6,23,6,0,17,6
184648,5,14,4,0,10,4
184648,4,9,4,1,5,3
184648,3,4,1,0,3,1
184648,2,1,1,0,0,1
40243,10,9,3,0,6,3
40243,9,10,5,0,5,5
40243,8,59,13,0,46,13
40243,7,33,15,0,18,15
40243,6,9,4,0,5,4
40243,5,2,1,0,1,1
40243,3,1,1,0,0,1
75360,9,8,4,0,4,4
75360,8,33,17,0,16,17
75360,7,40,13,0,27,13
75360,6,27,11,0,16,11
75360,5,6,3,0,3,3
75360,4,8,1,0,7,1
1721,10,1,1,0,0,1
1721,9,6,3,0,3,3
1721,8,13,4,0,9,4
1721,7,19,6,0,13,6
1721,6,39,12,0,27,12
1721,5,32,7,0,25,7
1721,4,11,9,0,2,9
7338,10,10,5,0,5,5
7338,9,11,3,0,8,3
7338,8,31,13,0,18,13
7338,7,30,13,0,17,13
7338,6,30,15,0,15,15
7338,5,5,2,0,3,2
7338,4,5,2,0,3,2
96765,10,14,5,0,9,5
96765,9,11,4,0,7,4
96765,8,8,3,0,5,3
96765,7,29,7,0,22,7
96765,6,27,3,0,24,3
96765,5,16,3,0,13,3
96765,4,9,3,0,6,3
96765,3,7,4,0,3,4
33785,10,9,6,0,3,6
33785,9,24,9,0,15,9
33785,8,36,10,0,26,10
33785,7,30,12,0,18,12
33785,6,16,4,0,12,4
33785,5,4,2,0,2,2
33785,1,3,1,0,2,1
4288,10,6,3,0,3,3
4288,9,18,7,0,11,7
4288,8,29,9,0,20,9
4288,7,38,10,0,28,10
4288,6,20,6,0,14,6
4288,5,5,2,0,3,2
4288,4,4,2,0,2,2
4288,3,2,1,0,1,1
42195,10,2,1,0,1,1
42195,8,13,4,0,9,4
42195,7,24,5,0,19,5
42195,6,42,6,0,36,6
42195,5,22,4,0,18,4
42195,4,9,2,0,7,2
42195,3,5,1,0,4,1
42195,2,2,1,0,1,1
2627,10,49,37,0,12,37
2627,9,9,7,0,2,7
2627,8,8,6,0,2,6
2627,7,8,7,0,1,7
2627,6,4,3,0,1,3
2627,5,5,5,0,0,5
2627,4,8,8,0,0,8
2627,3,7,7,0,0,7
2627,2,6,6,0,0,6
2627,1,19,18,0,1,18
39180,10,1,1,0,0,1
39180,8,5,2,0,3,2
39180,7,17,4,0,13,4
39180,6,44,6,0,38,6
39180,5,31,5,0,26,5
39180,4,14,4,0,10,4
39180,3,6,1,0,5,1
39180,2,2,1,0,1,1
39180,1,2,2,0,0,2
2717,8,3,2,0,1,2
2717,7,11,2,0,9,2
2717,6,29,6,0,23,6
2717,5,39,4,0,35,4
2717,4,14,3,0,11,3
2717,3,12,1,0,11,1
2717,1,5,1,0,4,1
6718,9,2,1,0,1,1
6718,8,6,4,0,2,4
6718,7,20,8,0,12,8
6718,6,44,17,0,27,17
6718,5,23,10,0,13,10
6718,4,12,5,0,7,5
6718,3,8,4,0,4,4
6718,2,6,2,0,4,2
138966,8,9,1,0,8,1
138966,7,31,3,0,28,3
138966,6,64,1,0,63,1
138966,5,12,1,0,11,1
138966,4,6,1,0,5,1
14812,8,9,5,0,4,5
14812,7,19,7,0,12,7
14812,6,27,10,0,17,10
14812,5,27,7,0,20,7
14812,4,15,8,0,7,8
14812,3,12,8,0,4,8
14812,2,7,2,0,5,2
14812,1,2,1,0,1,1
5554,9,1,1,0,0,1
5554,8,7,4,0,3,4
5554,7,8,8,0,0,8
5554,6,43,24,0,19,24
5554,5,22,9,0,13,9
5554,4,11,2,0,9,2
5554,3,4,3,0,1,3
40440,9,4,4,0,0,4
40440,8,12,4,0,8,4
40440,7,28,11,0,17,11
40440,6,40,9,0,31,9
40440,5,13,4,0,9,4
40440,4,10,2,0,8,2
40440,3,8,3,0,5,3
40440,2,5,1,0,4,1
40440,1,1,1,0,0,1
39415,8,6,2,0,4,2
39415,7,16,2,0,14,2
39415,6,33,5,0,28,5
39415,5,24,1,0,23,1
39415,4,19,3,0,16,3
39415,3,8,2,0,6,2
39415,2,6,3,0,3,3
39415,1,8,6,0,2,6
1953,9,3,1,0,2,1
1953,8,7,3,0,4,3
1953,7,22,5,0,17,5
1953,6,43,8,0,35,8
1953,5,35,12,0,23,12
1953,4,10,4,0,6,4
183626,9,6,3,0,3,3
183626,8,20,2,0,18,2
183626,7,33,8,0,25,8
183626,6,38,6,0,32,6
183626,5,14,3,0,11,3
183626,4,6,1,0,5,1
183626,3,4,1,0,3,1
183626,2,1,1,0,0,1
206091,10,4,2,0,2,2
206091,9,15,10,0,5,10
206091,8,36,9,0,27,9
206091,7,31,8,0,23,8
206091,6,26,4,0,22,4
206091,5,7,1,0,6,1
206091,4,4,2,0,2,2
209222,10,5,1,0,4,1
209222,9,5,2,0,3,2
209222,8,20,3,0,17,3
209222,7,27,6,0,21,6
209222,6,48,8,0,40,8
209222,5,11,3,0,8,3
209222,4,3,1,0,2,1
4979,9,3,2,0,1,2
4979,8,12,2,0,10,2
4979,7,21,5,0,16,5
4979,6,35,5,0,30,5
4979,5,25,2,0,23,2
4979,4,17,3,0,14,3
4979,2,3,2,0,1,2
4979,1,1,1,0,0,1
59335,10,18,5,0,13,5
59335,9,20,3,0,17,3
59335,8,28,2,0,26,2
59335,7,19,4,0,15,4
59335,6,19,2,0,17,2
59335,5,7,1,0,6,1
59335,4,4,1,0,3,1
504,8,14,4,0,10,4
504,7,22,7,0,15,7
504,6,51,9,0,42,9
504,5,19,2,0,17,2
504,4,10,4,0,6,4
504,3,4,1,0,3,1
199182,10,21,6,0,15,6
199182,9,43,13,0,30,13
199182,8,40,14,1,26,13
199182,7,14,6,0,8,6
199182,6,4,1,0,3,1
199182,4,1,1,0,0,1
66213,9,5,2,0,3,2
66213,8,6,1,0,5,1
66213,7,15,3,0,12,3
66213,6,21,2,0,19,2
66213,5,30,7,0,23,7
66213,4,24,4,0,20,4
66213,3,8,1,0,7,1
66213,2,10,3,0,7,3
44890,10,6,2,0,4,2
44890,9,14,3,0,11,3
44890,8,38,7,0,31,7
44890,7,30,12,0,18,12
44890,6,16,6,0,10,6
44890,5,9,4,0,5,4
44890,4,7,2,0,5,2
44890,3,2,2,0,0,2
44890,2,1,1,0,0,1
151456,8,33,2,0,31,2
151456,7,36,2,0,34,2
151456,6,25,4,0,21,4
151456,1,1,1,0,0,1
159087,8,9,2,2,7,0
159087,7,22,5,2,17,3
159087,6,40,9,1,31,8
159087,5,27,7,0,20,7
159087,4,10,5,0,5,5
159087,3,9,2,0,7,2
159087,2,5,2,1,3,1
17962,8,9,4,0,5,4
17962,7,18,5,0,13,5
17962,6,47,23,0,24,23
17962,5,23,12,0,11,12
17962,4,15,7,0,8,7
17962,3,6,3,0,3,3
13460,7,15,5,0,10,5
13460,6,44,16,0,28,16
13460,5,30,8,0,22,8
13460,4,21,7,0,14,7
13460,3,6,3,0,3,3
13460,2,2,1,0,1,1
68943,8,14,7,0,7,7
68943,7,23,11,0,12,11
68943,6,46,16,0,30,16
68943,5,23,8,0,15,8
68943,4,11,6,0,5,6
68943,2,4,1,0,3,1
3373,9,1,1,0,0,1
3373,8,7,1,0,6,1
3373,7,20,3,0,17,3
3373,6,45,11,0,34,11
3373,5,20,7,0,13,7
3373,4,18,5,0,13,5
3373,3,6,2,0,4,2
3373,2,4,2,0,2,2
3373,1,2,1,0,1,1
4485,10,12,5,0,7,5
4485,9,14,2,0,12,2
4485,8,35,12,0,23,12
4485,7,25,5,0,20,5
4485,6,21,9,0,12,9
4485,5,13,3,0,10,3
4485,4,1,1,0,0,1
2143,10,2,1,0,1,1
2143,9,3,2,0,1,2
2143,8,8,2,0,6,2
2143,7,18,10,0,8,10
2143,6,46,9,0,37,9
2143,5,20,5,0,15,5
2143,4,11,4,0,7,4
2143,3,10,3,0,7,3
2143,2,4,2,0,2,2
2143,1,1,1,0,0,1
35207,8,10,2,0,8,2
35207,7,21,5,0,16,5
35207,6,51,8,0,43,8
35207,5,19,4,0,15,4
35207,4,12,5,0,7,5
35207,3,9,1,0,8,1
84173,9,2,1,0,1,1
84173,7,19,3,0,16,3
84173,6,32,8,0,24,8
84173,5,24,1,0,23,1
84173,4,25,2,0,23,2
84173,3,6,2,0,4,2
84173,1,2,1,0,1,1
7970,10,5,3,0,2,3
7970,9,7,1,0,6,1
7970,8,18,9,0,9,9
7970,7,33,7,0,26,7
7970,6,42,10,0,32,10
7970,5,8,4,0,4,4
7970,4,5,2,0,3,2
7970,3,3,3,0,0,3
7970,1,1,1,0,0,1
2994,10,7,3,0,4,3
2994,9,10,2,0,8,2
2994,8,32,8,0,24,8
2994,7,31,5,0,26,5
2994,6,23,7,0,16,7
2994,4,8,1,0,7,1
2994,3,2,1,0,1,1
2994,2,3,1,0,2,1
235817,10,9,2,0,7,2
235817,9,18,3,0,15,3
235817,8,43,6,0,37,6
235817,6,21,1,0,20,1
235817,4,1,1,0,0,1
235817,2,3,1,0,2,1
235817,1,1,1,0,0,1
9288,10,7,5,0,2,5
9288,9,8,3,0,5,3
9288,8,26,8,0,18,8
9288,7,36,15,0,21,15
9288,6,32,10,0,22,10
9288,5,8,3,0,5,3
9288,4,1,1,0,0,1
9288,3,2,1,0,1,1
1414,9,1,1,0,0,1
1414,8,8,3,0,5,3
1414,7,16,4,0,12,4
1414,6,36,12,0,24,12
1414,5,28,8,0,20,8
1414,4,19,8,0,11,8
1414,3,6,3,0,3,3
1414,2,7,2,0,5,2
92876,8,16,3,0,13,3
92876,7,19,2,0,17,2
92876,6,54,5,0,49,5
92876,5,18,3,0,15,3
92876,4,9,2,0,7,2
25768,10,5,1,0,4,1
25768,8,21,4,0,17,4
25768,7,36,5,0,31,5
25768,6,24,6,0,18,6
25768,5,14,3,0,11,3
25768,4,8,5,0,3,5
25768,3,4,4,0,0,4
25768,2,1,1,0,0,1
174064,10,15,8,0,7,8
174064,9,14,6,0,8,6
174064,8,43,10,0,33,10
174064,7,23,1,0,22,1
174064,6,19,1,0,18,1
174064,5,5,1,0,4,1
174064,4,1,1,0,0,1
174064,3,1,1,0,0,1
174064,2,1,1,0,0,1
216865,10,4,2,0,2,2
216865,9,30,6,0,24,6
216865,8,52,7,3,45,4
216865,7,18,2,0,16,2
216865,6,10,1,0,9,1
216865,5,5,1,0,4,1
216865,4,2,1,0,1,1
216865,2,1,1,1,0,0
38390,10,2,1,0,1,1
38390,8,13,3,0,10,3
38390,7,24,8,0,16,8
38390,6,30,8,0,22,8
38390,5,22,5,0,17,5
38390,4,18,5,0,13,5
38390,3,7,2,0,5,2
40238,9,3,1,0,2,1
40238,8,7,2,0,5,2
40238,7,24,8,0,16,8
40238,6,45,8,0,37,8
40238,5,31,7,0,24,7
40238,4,6,1,0,5,1
40238,3,3,3,0,0,3
32995,9,2,1,0,1,1
32995,8,24,4,0,20,4
32995,7,41,9,0,32,9
32995,6,32,9,0,23,9
32995,5,13,6,0,7,6
32995,4,7,1,0,6,1
191790,10,9,3,0,6,3
191790,9,14,1,0,13,1
191790,8,51,13,0,38,13
191790,7,24,5,0,19,5
191790,6,17,4,0,13,4
191790,5,5,1,0,4,1
191790,4,1,1,0,0,1
147883,10,7,2,0,5,2
147883,9,7,2,0,5,2
147883,8,36,7,0,29,7
147883,7,41,10,0,31,10
147883,6,21,4,0,17,4
147883,4,2,2,0,0,2
40182,9,4,1,0,3,1
40182,8,23,3,0,20,3
40182,7,30,7,0,23,7
40182,6,36,10,0,26,10
40182,5,17,2,0,15,2
40182,4,5,1,0,4,1
40182,3,3,2,0,1,2
148424,9,5,1,0,4,1
148424,8,13,2,0,11,2
148424,6,47,7,0,40,7
148424,5,10,3,0,7,3
148424,4,13,2,0,11,2
148424,3,11,4,0,7,4
161620,10,14,2,0,12,2
161620,9,15,2,0,13,2
161620,8,31,1,0,30,1
161620,7,32,3,0,29,3
161620,4,3,1,0,2,1
161620,2,1,1,0,0,1
22947,10,9,3,0,6,3
22947,8,32,13,0,19,13
22947,7,25,6,0,19,6
22947,6,28,11,0,17,11
22947,5,10,5,0,5,5
22947,4,5,1,0,4,1
22947,3,4,3,0,1,3
142638,10,5,3,0,2,3
142638,9,3,1,0,2,1
142638,8,17,6,2,11,4
142638,7,22,7,0,15,7
142638,6,33,11,1,22,10
142638,5,15,3,1,12,2
142638,4,5,1,0,4,1
142638,3,8,3,1,5,2
142638,2,5,2,0,3,2
142638,1,9,8,2,1,6
205080,10,7,2,0,5,2
205080,7,26,4,0,22,4
205080,6,37,4,0,33,4
205080,5,18,3,0,15,3
205080,4,11,1,0,10,1
205080,3,7,2,0,5,2
17577,9,2,1,0,1,1
17577,7,17,1,0,16,1
17577,6,49,7,0,42,7
17577,5,32,4,0,28,4
17577,4,12,4,0,8,4
17577,2,2,1,0,1,1
7828,10,3,2,0,1,2
7828,9,8,4,0,4,4
7828,8,25,16,0,9,16
7828,7,32,14,0,18,14
7828,6,33,15,0,18,15
7828,5,11,6,0,5,6
7828,4,5,2,0,3,2
7828,3,3,1,0,2,1
7828,2,2,2,0,0,2
8567,7,14,6,0,8,6
8567,6,37,11,0,26,11
8567,5,30,9,0,21,9
8567,4,27,11,0,16,11
8567,3,12,4,0,8,4
8567,2,2,2,0,0,2
24786,8,4,2,0,2,2
24786,7,13,5,0,8,5
24786,6,41,15,0,26,15
24786,5,33,13,0,20,13
24786,4,20,8,0,12,8
24786,3,5,1,0,4,1
24786,2,6,2,0,4,2
25190,10,1,1,0,0,1
25190,9,10,7,0,3,7
25190,8,22,12,0,10,12
25190,7,26,6,0,20,6
25190,6,42,19,0,23,19
25190,5,11,3,0,8,3
25190,3,5,1,0,4,1
25190,1,1,1,0,0,1
2148,8,6,2,0,4,2
2148,7,15,5,0,10,5
2148,6,38,8,0,30,8
2148,5,35,12,0,23,12
2148,4,13,2,0,11,2
2148,3,7,4,0,3,4
2148,1,1,1,0,0,1
6215,10,5,1,0,4,1
6215,9,6,3,0,3,3
6215,8,12,5,0,7,5
6215,7,26,6,0,20,6
6215,6,39,10,0,29,10
6215,5,17,7,0,10,7
6215,4,12,3,0,9,3
6215,3,4,1,0,3,1
13805,10,1,1,0,0,1
13805,8,5,2,0,3,2
13805,7,3,1,0,2,1
13805,6,10,2,0,8,2
13805,5,20,5,0,15,5
13805,4,20,6,0,14,6
13805,3,30,9,0,21,9
13805,2,15,9,0,6,9
13805,1,17,8,0,9,8
223481,10,9,3,0,6,3
223481,9,7,4,0,3,4
223481,8,19,8,0,11,8
223481,7,38,8,1,30,7
223481,6,30,5,0,25,5
223481,5,12,2,0,10,2
223481,4,5,2,0,3,2
2482,8,1,1,0,0,1
2482,7,6,1,0,5,1
2482,6,23,6,0,17,6
2482,5,29,9,0,20,9
2482,4,26,8,0,18,8
2482,3,17,8,0,9,8
2482,2,15,5,0,10,5
2482,1,5,1,0,4,1
266965,10,22,2,0,20,2
266965,9,21,1,0,20,1
266965,8,48,2,0,46,2
266965,7,18,1,0,17,1
266965,6,10,4,0,6,4
266965,4,1,1,0,0,1
120886,9,5,2,0,3,2
120886,8,24,6,0,18,6
120886,7,29,8,0,21,8
120886,6,27,7,1,20,6
120886,5,17,5,0,12,5
120886,4,10,1,0,9,1
120886,3,3,2,0,1,2
120886,2,4,2,0,2,2
189925,8,31,1,0,30,1
189925,7,40,1,0,39,1
189925,6,33,1,0,32,1
189925,5,9,2,0,7,2
191989,10,26,6,0,20,6
191989,9,33,10,0,23,10
191989,8,32,3,0,29,3
191989,7,17,6,0,11,6
191989,6,6,4,0,2,4
191989,5,5,3,0,2,3
191989,1,2,1,0,1,1
2331,10,1,1,0,0,1
2331,8,4,1,0,3,1
2331,7,9,7,0,2,7
2331,6,43,12,0,31,12
2331,5,27,8,0,19,8
2331,4,19,4,0,15,4
2331,3,16,2,0,14,2
2331,2,1,1,0,0,1
2758,10,4,1,0,3,1
2758,9,7,2,0,5,2
2758,8,17,7,0,10,7
2758,7,20,8,0,12,8
2758,6,41,18,0,23,18
2758,5,20,9,0,11,9
2758,4,9,3,0,6,3
2758,3,3,3,0,0,3
198700,9,6,1,0,5,1
198700,8,25,4,0,21,4
198700,7,35,2,0,33,2
198700,6,39,2,0,37,2
198700,5,7,1,0,6,1
14032,8,8,3,0,5,3
14032,7,17,2,0,15,2
14032,6,51,9,0,42,9
14032,5,23,4,0,19,4
14032,4,18,3,0,15,3
142645,10,13,4,0,9,4
142645,9,8,2,0,6,2
142645,8,19,6,0,13,6
142645,7,26,7,1,19,6
142645,6,30,4,0,26,4
142645,5,15,4,0,11,4
142645,4,8,1,1,7,0
142645,3,2,1,0,1,1
142645,2,1,1,0,0,1
66665,9,20,2,0,18,2
66665,8,40,6,0,34,6
66665,7,27,6,0,21,6
66665,6,17,7,0,10,7
66665,5,5,1,0,4,1
66665,4,5,1,0,4,1
3159,8,3,1,0,2,1
3159,7,28,10,0,18,10
3159,6,51,19,0,32,19
3159,5,20,6,0,14,6
3159,4,15,3,0,12,3
3159,1,1,1,0,0,1
46746,6,34,6,0,28,6
46746,5,36,12,0,24,12
46746,4,19,3,0,16,3
46746,3,12,5,0,7,5
46746,2,4,2,0,2,2
155250,10,21,8,0,13,8
155250,8,3,1,0,2,1
155250,6,3,1,0,2,1
155250,5,4,2,0,2,2
155250,1,84,37,0,47,37
95449,8,14,2,0,12,2
95449,7,29,3,0,26,3
95449,6,40,8,0,32,8
95449,5,17,2,0,15,2
95449,3,6,2,0,4,2
565,8,5,2,0,3,2
565,7,23,1,0,22,1
565,6,27,5,0,22,5
565,5,17,5,0,12,5
565,4,5,1,0,4,1
565,2,1,1,0,0,1
479,9,3,3,0,0,3
479,8,8,1,0,7,1
479,7,38,11,0,27,11
479,6,35,13,0,22,13
479,5,18,3,0,15,3
479,4,12,2,0,10,2
479,3,7,2,0,5,2
198701,8,25,4,0,21,4
198701,7,36,3,0,33,3
198701,6,36,3,0,33,3
198701,5,7,1,0,6,1
46743,9,1,1,0,0,1
46743,8,6,3,0,3,3
46743,7,9,5,0,4,5
46743,6,40,7,0,33,7
46743,5,23,9,0,14,9
46743,4,22,7,0,15,7
46743,3,14,7,0,7,7
120814,10,3,1,0,2,1
120814,9,5,1,1,4,0
120814,8,22,6,1,16,5
120814,7,32,5,0,27,5
120814,6,29,4,1,25,3
120814,5,16,2,0,14,2
120814,4,8,4,0,4,4
120814,3,5,1,0,4,1
18246,9,6,3,0,3,3
18246,8,18,7,0,11,7
18246,7,24,5,0,19,5
18246,6,45,23,0,22,23
18246,5,15,5,0,10,5
18246,4,6,3,0,3,3
18246,3,3,2,0,1,2
18246,2,3,1,0,2,1
162071,8,18,5,0,13,5
162071,7,18,3,0,15,3
162071,6,33,7,1,26,6
162071,5,16,1,1,15,0
162071,4,5,1,0,4,1
162071,2,11,4,1,7,3
162071,1,4,2,0,2,2
138728,10,3,1,0,2,1
138728,9,4,1,0,3,1
138728,8,27,4,0,23,4
138728,7,31,4,0,27,4
138728,6,37,8,1,29,7
138728,5,11,3,0,8,3
5956,10,3,1,0,2,1
5956,9,2,1,0,1,1
5956,7,11,5,0,6,5
5956,6,25,8,0,17,8
5956,5,29,8,0,21,8
5956,4,22,4,0,18,4
5956,3,13,4,0,9,4
5956,2,8,2,0,6,2
5956,1,6,6,0,0,6
23959,9,1,1,0,0,1
23959,8,4,3,0,1,3
23959,7,6,3,0,3,3
23959,6,26,14,0,12,14
23959,5,30,9,0,21,9
23959,4,27,12,0,15,12
23959,3,16,5,0,11,5
23959,2,9,3,0,6,3
18115,10,6,2,0,4,2
18115,9,13,3,0,10,3
18115,8,47,17,0,30,17
18115,7,27,10,0,17,10
18115,6,13,4,0,9,4
18115,5,11,4,0,7,4
18115,4,3,1,0,2,1
18115,3,1,1,0,0,1
2121,9,7,3,0,4,3
2121,8,23,9,0,14,9
2121,7,23,4,0,19,4
2121,6,32,7,0,25,7
2121,5,23,9,0,14,9
2121,4,6,4,0,2,4
2121,3,3,1,0,2,1
2121,2,1,1,0,0,1
2121,1,1,1,0,0,1
5239,9,2,1,0,1,1
5239,8,10,5,0,5,5
5239,7,34,11,0,23,11
5239,6,43,7,0,36,7
5239,5,18,2,0,16,2
5239,4,7,2,0,5,2
5239,3,3,1,0,2,1
221805,10,14,5,0,9,5
221805,9,13,8,0,5,8
221805,8,15,4,0,11,4
221805,7,21,4,0,17,4
221805,6,28,4,0,24,4
221805,5,13,2,0,11,2
221805,4,6,1,0,5,1
63788,10,2,2,0,0,2
63788,9,10,4,0,6,4
63788,8,9,2,0,7,2
63788,7,12,5,0,7,5
63788,6,31,11,0,20,11
63788,5,25,4,0,21,4
63788,4,18,3,0,15,3
244171,9,19,4,0,15,4
244171,8,35,8,1,27,7
244171,7,29,7,0,22,7
244171,6,25,3,0,22,3
244171,5,6,3,0,3,3
2174,9,8,4,0,4,4
2174,8,17,4,0,13,4
2174,7,28,9,0,19,9
2174,6,39,16,0,23,16
2174,5,16,3,0,13,3
2174,4,5,1,0,4,1
254894,9,3,1,0,2,1
254894,8,19,1,0,18,1
254894,7,47,5,0,42,5
254894,6,35,6,0,29,6
254894,5,11,2,0,9,2
254894,4,3,1,0,2,1
23915,10,3,1,0,2,1
23915,9,6,5,0,1,5
23915,8,23,10,0,13,10
23915,7,25,16,0,9,16
23915,6,50,16,0,34,16
23915,5,7,4,0,3,4
23915,4,5,3,0,2,3
23915,3,2,1,0,1,1
954,7,14,2,0,12,2
954,6,32,3,0,29,3
954,5,32,8,0,24,8
954,4,17,7,0,10,7
954,3,5,3,0,2,3
954,1,1,1,0,0,1
2038,8,11,7,0,4,7
2038,7,17,6,0,11,6
2038,6,43,13,0,30,13
2038,5,27,7,0,20,7
2038,4,16,6,0,10,6
2038,3,6,3,0,3,3
2038,2,1,1,0,0,1
32682,10,3,2,0,1,2
32682,9,4,2,0,2,2
32682,8,10,1,0,9,1
32682,7,13,2,0,11,2
32682,6,36,2,0,34,2
32682,5,24,4,0,20,4
32682,4,20,2,0,18,2
32682,3,6,3,0,3,3
32682,2,4,2,0,2,2
144310,9,3,1,0,2,1
144310,8,16,6,0,10,6
144310,7,21,3,0,18,3
144310,6,30,8,0,22,8
144310,5,24,7,0,17,7
144310,4,12,4,0,8,4
144310,3,10,6,0,4,6
144310,2,3,1,0,2,1
2559,10,1,1,0,0,1
2559,8,18,9,0,9,9
2559,7,37,12,0,25,12
2559,6,29,7,0,22,7
2559,5,24,9,0,15,9
2559,4,8,4,0,4,4
2559,3,2,1,0,1,1
2559,2,1,1,0,0,1
126404,10,5,2,0,3,2
126404,9,8,2,0,6,2
126404,8,19,2,0,17,2
126404,7,37,6,0,31,6
126404,6,28,8,0,20,8
126404,5,14,4,0,10,4
126404,4,4,1,0,3,1
126404,2,5,1,0,4,1
126404,1,1,1,0,0,1
42685,9,2,1,0,1,1
42685,8,8,3,0,5,3
42685,7,18,5,0,13,5
42685,6,48,18,0,30,18
42685,5,25,5,0,20,5
42685,4,10,1,0,9,1
42685,3,4,2,0,2,2
42685,2,4,1,0,3,1
34221,10,2,1,0,1,1
34221,9,9,6,0,3,6
34221,8,13,7,0,6,7
34221,7,6,2,0,4,2
34221,6,39,12,0,27,12
34221,5,18,7,0,11,7
34221,4,19,3,0,16,3
34221,3,7,3,0,4,3
34221,2,7,2,0,5,2
7960,8,6,1,0,5,1
7960,7,19,2,0,17,2
7960,6,30,4,0,26,4
7960,4,23,4,0,19,4
7960,3,9,3,0,6,3
7960,2,5,2,0,3,2
3127,10,5,2,0,3,2
3127,8,11,2,0,9,2
3127,7,24,4,0,20,4
3127,6,29,11,0,18,11
3127,5,18,7,0,11,7
3127,4,13,7,0,6,7
3127,3,9,7,0,2,7
3127,2,7,4,0,3,4
31554,10,3,2,0,1,2
31554,9,12,7,0,5,7
31554,8,46,24,0,22,24
31554,7,33,9,0,24,9
31554,6,15,6,0,9,6
31554,5,3,1,0,2,1
31554,4,5,1,0,4,1
31554,3,2,2,0,0,2
31554,2,1,1,0,0,1
31554,1,1,1,0,0,1
198003,10,24,21,0,3,21
198003,9,16,5,0,11,5
198003,8,25,4,0,21,4
198003,6,18,1,0,17,1
198003,4,3,2,0,1,2
198003,3,3,2,0,1,2
58696,9,1,1,0,0,1
58696,8,10,5,0,5,5
58696,7,30,9,0,21,9
58696,6,37,6,0,31,6
58696,5,19,5,0,14,5
58696,4,17,9,0,8,9
58696,3,4,1,0,3,1
58696,2,2,1,0,1,1
187785,10,10,3,0,7,3
187785,9,7,2,0,5,2
187785,8,29,10,3,19,7
187785,7,25,8,1,17,7
187785,6,22,6,0,16,6
187785,5,6,2,0,4,2
187785,3,7,3,0,4,3
187785,2,7,3,0,4,3
187785,1,4,2,1,2,1
3696,8,3,2,0,1,2
3696,7,6,1,0,5,1
3696,6,16,5,0,11,5
3696,5,24,5,0,19,5
3696,4,33,4,0,29,4
3696,3,22,4,0,18,4
3696,2,12,3,0,9,3
35017,10,11,2,0,9,2
35017,9,4,3,0,1,3
35017,8,24,8,0,16,8
35017,7,16,4,0,12,4
35017,6,21,7,0,14,7
35017,5,15,6,0,9,6
35017,4,12,2,0,10,2
35017,3,7,3,0,4,3
35017,2,7,4,0,3,4
35017,1,3,2,0,1,2
153723,10,10,4,0,6,4
153723,9,7,7,1,0,6
153723,8,14,1,0,13,1
153723,7,24,3,1,21,2
153723,6,28,5,1,23,4
153723,5,20,2,1,18,1
153723,4,10,2,1,8,1
31586,10,6,1,0,5,1
31586,9,4,1,0,3,1
31586,8,16,3,0,13,3
31586,7,27,3,0,24,3
31586,6,41,2,0,39,2
31586,5,13,2,0,11,2
31586,3,4,2,0,2,2
1583,10,14,3,0,11,3
1583,9,26,9,0,17,9
1583,8,35,11,0,24,11
1583,7,27,7,0,20,7
1583,6,13,2,0,11,2
1583,5,5,1,0,4,1
27817,10,16,5,0,11,5
27817,9,28,11,0,17,11
27817,8,44,7,0,37,7
27817,7,19,8,0,11,8
27817,6,8,3,0,5,3
27817,5,2,1,0,1,1
21631,7,15,5,0,10,5
21631,6,38,9,0,29,9
21631,5,34,10,0,24,10
21631,4,14,3,0,11,3
21631,3,10,2,0,8,2
21631,1,1,1,0,0,1
8319,8,5,2,0,3,2
8319,7,17,6,0,11,6
8319,6,31,7,0,24,7
8319,5,13,2,0,11,2
8319,4,8,2,0,6,2
8319,3,4,3,0,1,3
8319,2,4,4,0,0,4
8319,1,1,1,0,0,1
213491,10,1,1,0,0,1
213491,8,16,2,0,14,2
213491,7,32,5,0,27,5
213491,6,46,10,0,36,10
213491,4,4,1,0,3,1
213491,3,3,1,0,2,1
213491,1,2,1,0,1,1
2280,9,1,1,0,0,1
2280,8,5,1,0,4,1
2280,7,10,2,0,8,2
2280,6,31,9,0,22,9
2280,5,30,7,0,23,7
2280,4,26,5,0,21,5
2280,3,10,2,0,8,2
2280,2,5,3,0,2,3
3568,10,1,1,0,0,1
3568,9,9,7,0,2,7
3568,8,15,3,0,12,3
3568,7,31,15,0,16,15
3568,6,29,13,0,16,13
3568,5,21,5,0,16,5
3568,4,8,1,0,7,1
3568,3,5,4,0,1,4
27624,10,4,1,0,3,1
27624,8,11,5,0,6,5
27624,7,24,6,0,18,6
27624,6,44,9,0,35,9
27624,5,23,10,0,13,10
27624,4,3,1,0,2,1
27624,3,3,1,0,2,1
27624,1,2,1,0,1,1
242149,9,9,1,0,8,1
242149,8,38,10,1,28,9
242149,7,40,7,0,33,7
242149,6,14,1,0,13,1
242149,5,11,4,0,7,4
242149,4,3,1,0,2,1
18880,8,15,8,0,7,8
18880,7,26,8,0,18,8
18880,6,46,15,0,31,15
18880,5,14,3,0,11,3
18880,4,10,1,0,9,1
18880,3,6,2,0,4,2
70653,8,9,1,0,8,1
70653,7,15,2,0,13,2
70653,6,26,4,0,22,4
70653,5,29,4,0,25,4
70653,4,22,5,0,17,5
70653,3,6,1,0,5,1
3271,8,5,3,0,2,3
3271,7,18,6,0,12,6
3271,6,31,8,0,23,8
3271,5,29,15,0,14,15
3271,4,18,6,0,12,6
3271,3,9,6,0,3,6
3271,2,7,5,0,2,5
26114,9,1,1,0,0,1
26114,8,11,3,0,8,3
26114,7,27,11,0,16,11
26114,6,46,11,0,35,11
26114,5,23,11,0,12,11
26114,4,8,2,0,6,2
26114,3,3,1,0,2,1
4165,7,3,2,0,1,2
4165,6,16,6,0,10,6
4165,5,23,4,0,19,4
4165,4,32,15,0,17,15
4165,3,20,12,0,8,12
4165,2,16,7,0,9,7
4165,1,9,8,0,1,8
57141,10,10,5,0,5,5
57141,9,39,18,0,21,18
57141,8,41,13,0,28,13
57141,7,15,4,0,11,4
57141,6,11,5,0,6,5
57141,5,1,1,0,0,1
57141,4,1,1,0,0,1
57141,3,1,1,0,0,1
193327,9,13,1,0,12,1
193327,8,24,8,0,16,8
193327,7,39,4,0,35,4
193327,6,30,8,0,22,8
193327,5,8,1,0,7,1
193327,3,1,1,0,0,1
158861,10,5,3,0,2,3
158861,8,38,11,0,27,11
158861,7,24,4,0,20,4
158861,6,24,5,0,19,5
158861,4,7,2,0,5,2
158861,1,5,4,0,1,4
17397,9,6,1,0,5,1
17397,8,22,8,0,14,8
17397,7,50,12,0,38,12
17397,6,26,6,0,20,6
17397,5,8,2,0,6,2
17397,3,2,1,0,1,1
17397,2,1,1,0,0,1
4884,10,8,5,0,3,5
4884,9,17,7,0,10,7
4884,8,55,20,0,35,20
4884,7,24,8,0,16,8
4884,6,11,2,0,9,2
4884,5,3,2,0,1,2
4884,4,2,2,0,0,2
32333,8,9,2,0,7,2
32333,7,22,5,0,17,5
32333,6,48,11,0,37,11
32333,5,18,2,0,16,2
32333,4,11,5,0,6,5
32333,3,6,2,0,4,2
95765,10,2,1,0,1,1
95765,8,7,1,0,6,1
95765,7,11,2,0,9,2
95765,6,44,12,0,32,12
95765,5,26,1,0,25,1
95765,4,10,3,0,7,3
95765,3,10,2,0,8,2
95765,2,4,1,0,3,1
95765,1,6,2,0,4,2
231327,10,16,1,0,15,1
231327,9,23,2,0,21,2
231327,8,53,12,0,41,12
231327,7,21,3,0,18,3
231327,6,8,3,0,5,3
231327,5,2,1,0,1,1
20253,9,6,1,0,5,1
20253,8,23,6,0,17,6
20253,7,28,9,0,19,9
20253,6,39,4,0,35,4
20253,5,11,3,0,8,3
20253,4,6,2,0,4,2
20253,3,4,1,0,3,1
36229,8,6,2,0,4,2
36229,7,4,2,0,2,2
36229,6,32,7,0,25,7
36229,5,24,4,0,20,4
36229,4,21,10,0,11,10
36229,3,15,7,0,8,7
36229,2,17,7,0,10,7
33801,8,10,1,0,9,1
33801,7,14,1,0,13,1
33801,6,40,7,0,33,7
33801,5,35,10,0,25,10
33801,4,14,5,0,9,5
33801,2,1,1,0,0,1
196392,8,30,5,0,25,5
196392,7,25,6,0,19,6
196392,6,35,10,0,25,10
196392,5,19,3,0,16,3
196392,4,5,2,0,3,2
196392,3,2,1,0,1,1
196392,2,1,1,0,0,1
7941,10,2,1,0,1,1
7941,9,1,1,0,0,1
7941,8,15,7,0,8,7
7941,7,29,11,0,18,11
7941,6,35,6,0,29,6
7941,5,27,10,0,17,10
7941,4,5,1,0,4,1
7941,3,4,1,0,3,1
7941,1,1,1,0,0,1
158236,8,10,3,0,7,3
158236,7,24,3,0,21,3
158236,6,44,4,0,40,4
158236,5,21,4,0,17,4
158236,4,6,2,0,4,2
161966,10,3,1,0,2,1
161966,8,22,6,0,16,6
161966,7,36,9,1,27,8
161966,6,35,4,1,31,3
161966,5,16,3,0,13,3
161966,4,5,1,0,4,1
59061,7,33,6,0,27,6
59061,6,45,11,0,34,11
59061,5,16,2,0,14,2
59061,4,8,4,0,4,4
59061,2,2,2,0,0,2
3365,10,11,2,0,9,2
3365,9,21,7,0,14,7
3365,8,28,4,0,24,4
3365,7,21,6,0,15,6
3365,6,27,11,0,16,11
3365,5,5,2,0,3,2
3365,4,3,1,0,2,1
3365,3,4,1,0,3,1
2200,8,19,7,0,12,7
2200,7,41,12,0,29,12
2200,6,31,8,0,23,8
2200,5,17,3,0,14,3
2200,4,7,5,0,2,5
2200,3,2,1,0,1,1
3664,8,6,2,0,4,2
3664,7,19,6,0,13,6
3664,6,40,6,0,34,6
3664,5,28,4,0,24,4
3664,4,17,4,0,13,4
3664,3,3,3,0,0,3
3664,2,3,2,0,1,2
999,8,8,3,0,5,3
999,7,9,3,0,6,3
999,6,46,16,0,30,16
999,5,26,6,0,20,6
999,4,22,7,0,15,7
999,3,7,1,0,6,1
193238,10,23,5,0,18,5
193238,9,46,11,0,35,11
193238,8,31,8,0,23,8
193238,7,15,1,0,14,1
193238,6,2,1,0,1,1
6926,10,4,1,0,3,1
6926,9,7,2,0,5,2
6926,8,31,6,0,25,6
6926,7,44,5,0,39,5
6926,6,19,3,0,16,3
6926,5,11,1,0,10,1
6926,4,2,2,0,0,2
8707,10,2,1,0,1,1
8707,9,5,2,0,3,2
8707,8,17,5,0,12,5
8707,7,32,7,0,25,7
8707,6,33,5,0,28,5
8707,5,16,2,0,14,2
8707,4,9,5,0,4,5
8707,2,4,2,0,2,2
247984,9,3,1,0,2,1
247984,8,19,1,0,18,1
247984,7,29,7,0,22,7
247984,6,42,7,0,35,7
247984,5,17,1,0,16,1
247984,4,4,1,0,3,1
217544,10,10,3,2,7,1
217544,9,19,8,1,11,7
217544,8,41,6,0,35,6
217544,7,31,9,3,22,6
217544,6,14,5,1,9,4
217544,2,1,1,0,0,1
217544,1,2,1,0,1,1
71837,7,14,4,0,10,4
71837,6,41,8,0,33,8
71837,5,30,4,0,26,4
71837,4,10,5,0,5,5
71837,2,5,2,0,3,2
103638,7,20,6,0,14,6
103638,6,50,16,0,34,16
103638,5,25,8,0,17,8
103638,4,13,1,0,12,1
103638,3,6,2,0,4,2
41763,9,9,2,0,7,2
41763,8,35,6,0,29,6
41763,7,29,7,0,22,7
41763,6,27,5,0,22,5
41763,5,13,1,0,12,1
41763,3,3,1,0,2,1
32679,8,4,1,0,3,1
32679,7,16,4,0,12,4
32679,6,40,8,0,32,8
32679,5,23,8,0,15,8
32679,4,17,4,0,13,4
32679,3,6,1,0,5,1
32679,1,4,2,0,2,2
649,9,5,4,0,1,4
649,8,12,5,0,7,5
649,7,23,7,0,16,7
649,6,38,7,0,31,7
649,5,21,7,0,14,7
649,4,16,8,0,8,8
649,3,3,2,0,1,2
649,2,1,1,0,0,1
240014,10,9,3,0,6,3
240014,9,17,5,0,12,5
240014,8,42,5,0,37,5
240014,7,24,7,0,17,7
240014,6,15,3,1,12,2
240014,5,6,3,0,3,3
240014,4,5,2,0,3,2
240014,3,2,2,0,0,2
240014,2,1,1,0,0,1
128098,9,3,2,0,1,2
128098,8,34,10,0,24,10
128098,7,38,16,0,22,16
128098,6,28,6,0,22,6
128098,5,8,2,0,6,2
128098,4,4,1,0,3,1
128098,3,3,2,0,1,2
5589,10,3,1,0,2,1
5589,8,14,8,0,6,8
5589,7,18,5,0,13,5
5589,6,38,10,0,28,10
5589,5,25,13,0,12,13
5589,4,3,2,0,1,2
5589,3,10,6,0,4,6
20266,10,10,5,0,5,5
20266,9,16,6,0,10,6
20266,8,33,11,0,22,11
20266,7,33,16,0,17,16
20266,6,18,8,0,10,8
20266,5,4,2,0,2,2
20266,4,2,1,0,1,1
20266,3,2,2,0,0,2
167715,10,3,1,0,2,1
167715,9,7,4,0,3,4
167715,8,14,2,0,12,2
167715,7,11,3,1,8,2
167715,6,21,2,0,19,2
167715,5,19,2,0,17,2
167715,4,17,3,1,14,2
167715,3,9,1,0,8,1
167715,2,6,1,0,5,1
167715,1,12,2,0,10,2
5724,10,3,2,0,1,2
5724,9,5,4,0,1,4
5724,8,13,5,0,8,5
5724,7,15,4,0,11,4
5724,6,37,13,0,24,13
5724,5,15,8,0,7,8
5724,4,17,6,0,11,6
5724,3,5,3,0,2,3
5724,2,6,4,0,2,4
5724,1,3,3,0,0,3
130008,8,18,8,0,10,8
130008,7,35,5,0,30,5
130008,6,35,6,0,29,6
130008,5,16,2,0,14,2
130008,4,5,2,0,3,2
130008,3,3,2,0,1,2
130008,2,5,1,0,4,1
67972,9,2,1,0,1,1
67972,8,23,8,0,15,8
67972,7,35,11,0,24,11
67972,6,43,16,0,27,16
67972,5,8,3,0,5,3
67972,4,7,6,0,1,6
67972,3,1,1,0,0,1
198059,7,16,1,0,15,1
198059,6,34,4,2,30,2
198059,5,26,4,1,22,3
198059,4,22,6,1,16,5
198059,3,12,2,0,10,2
198059,2,6,1,0,5,1
3958,9,4,2,0,2,2
3958,8,7,5,0,2,5
3958,7,16,3,0,13,3
3958,6,39,13,0,26,13
3958,5,26,8,0,18,8
3958,4,14,3,0,11,3
3958,3,9,4,0,5,4
3958,1,1,1,0,0,1
13314,9,6,4,0,2,4
13314,8,32,8,0,24,8
13314,7,36,10,0,26,10
13314,6,29,10,0,19,10
13314,5,8,1,0,7,1
13314,4,4,2,0,2,2
13314,2,1,1,0,0,1
19653,9,4,1,0,3,1
19653,8,19,8,0,11,8
19653,7,31,6,0,25,6
19653,6,37,7,0,30,7
19653,5,12,2,0,10,2
19653,3,2,1,0,1,1
162480,10,6,3,1,3,2
162480,9,6,4,1,2,3
162480,8,29,9,1,20,8
162480,7,32,6,1,26,5
162480,6,25,2,1,23,1
162480,5,10,1,0,9,1
162480,4,6,1,0,5,1
162480,2,2,2,0,0,2
120781,10,2,1,0,1,1
120781,8,14,6,0,8,6
120781,6,52,10,0,42,10
120781,5,16,4,0,12,4
120781,4,11,2,0,9,2
120781,3,4,1,0,3,1
120781,2,1,1,0,0,1
120781,1,2,1,0,1,1
2974,8,7,1,0,6,1
2974,7,15,5,0,10,5
2974,6,54,8,0,46,8
2974,5,25,9,0,16,9
2974,4,11,3,0,8,3
2974,3,3,1,0,2,1
2974,2,4,3,0,1,3
190232,10,5,2,0,3,2
190232,9,17,5,0,12,5
190232,8,47,13,0,34,13
190232,7,30,5,0,25,5
190232,6,16,5,0,11,5
190232,5,4,3,0,1,3
156750,10,3,3,0,0,3
156750,9,8,4,0,4,4
156750,8,30,8,0,22,8
156750,7,43,6,0,37,6
156750,6,20,5,0,15,5
156750,5,7,1,0,6,1
156750,4,3,1,0,2,1
156750,3,5,4,0,1,4
175742,10,1,1,0,0,1
175742,8,10,2,0,8,2
175742,7,26,7,0,19,7
175742,6,39,4,0,35,4
175742,5,23,2,0,21,2
175742,4,8,2,0,6,2
175742,3,9,1,0,8,1
18765,9,3,1,0,2,1
18765,7,29,2,0,27,2
18765,6,36,5,0,31,5
18765,5,18,1,0,17,1
18765,4,13,4,0,9,4
18765,2,5,1,0,4,1
18765,1,4,1,0,3,1
235017,10,6,1,0,5,1
235017,9,17,3,0,14,3
235017,8,36,9,0,27,9
235017,7,34,9,0,25,9
235017,6,17,3,0,14,3
235017,5,7,1,0,6,1
235017,4,2,2,0,0,2
19373,10,2,1,0,1,1
19373,9,2,1,0,1,1
19373,7,18,1,0,17,1
19373,6,30,8,0,22,8
19373,5,24,4,0,20,4
19373,4,14,2,0,12,2
19373,3,15,4,0,11,4
19373,2,6,2,0,4,2
19373,1,4,1,0,3,1
132407,9,3,3,0,0,3
132407,8,21,8,1,13,7
132407,7,31,10,1,21,9
132407,6,38,11,0,27,11
132407,5,17,6,0,11,6
132407,4,7,2,0,5,2
132407,3,2,2,1,0,1
6405,10,1,1,0,0,1
6405,9,4,1,0,3,1
6405,8,13,6,0,7,6
6405,7,28,9,0,19,9
6405,6,37,12,0,25,12
6405,5,19,6,0,13,6
6405,4,13,3,0,10,3
6405,3,3,2,0,1,2
6405,2,1,1,0,0,1
6253,10,12,4,0,8,4
6253,9,15,8,0,7,8
6253,8,44,16,0,28,16
6253,7,20,3,0,17,3
6253,6,15,3,0,12,3
6253,5,6,3,0,3,3
6253,4,5,1,0,4,1
6253,3,1,1,0,0,1
6253,1,1,1,0,0,1
188465,9,4,1,0,3,1
188465,8,11,1,0,10,1
188465,7,35,5,0,30,5
188465,6,33,6,0,27,6
188465,5,15,2,0,13,2
188465,4,11,3,0,8,3
188465,3,4,2,0,2,2
188465,2,4,2,0,2,2
235342,10,11,5,0,6,5
235342,9,30,15,0,15,15
235342,8,40,7,0,33,7
235342,7,21,5,1,16,4
235342,6,12,3,0,9,3
235342,5,2,1,0,1,1
235342,4,3,3,0,0,3
235342,3,1,1,0,0,1
235342,1,1,1,0,0,1
23499,9,1,1,0,0,1
23499,7,2,1,0,1,1
23499,6,18,4,0,14,4
23499,5,24,3,0,21,3
23499,4,18,3,0,15,3
23499,3,18,4,0,14,4
23499,2,19,8,0,11,8
23499,1,17,5,0,12,5
177823,10,34,27,0,7,27
177823,9,28,17,2,11,15
177823,8,27,16,2,11,14
177823,7,14,4,0,10,4
177823,3,3,1,0,2,1
177823,1,3,1,0,2,1
25972,10,2,1,0,1,1
25972,8,30,14,0,16,14
25972,7,42,13,0,29,13
25972,6,22,6,0,16,6
25972,5,10,5,0,5,5
25972,4,6,1,0,5,1
25972,3,1,1,0,0,1
193122,10,14,8,0,6,8
193122,9,13,5,0,8,5
193122,8,20,7,0,13,7
193122,7,23,5,0,18,5
193122,6,18,1,0,17,1
193122,5,17,6,0,11,6
193122,4,4,2,0,2,2
193122,3,5,2,0,3,2
256804,10,11,1,0,10,1
256804,9,24,2,0,22,2
256804,7,27,4,0,23,4
256804,6,20,1,0,19,1
256804,5,5,1,0,4,1
256804,4,3,1,0,2,1
2226,9,3,2,0,1,2
2226,8,10,1,0,9,1
2226,7,36,8,0,28,8
2226,6,47,17,0,30,17
2226,5,18,4,0,14,4
2226,3,2,2,0,0,2
174990,10,20,16,1,4,15
174990,9,19,13,1,6,12
174990,8,19,7,0,12,7
174990,7,16,4,0,12,4
174990,6,19,6,0,13,6
174990,5,12,2,0,10,2
174990,4,7,2,0,5,2
174990,2,3,1,0,2,1
24122,9,2,1,0,1,1
24122,8,20,12,0,8,12
24122,7,38,18,0,20,18
24122,6,32,7,0,25,7
24122,5,11,5,0,6,5
24122,4,8,5,0,3,5
24122,3,4,2,0,2,2
24122,2,4,2,0,2,2
187488,10,10,9,0,1,9
187488,9,13,7,2,6,5
187488,8,22,2,0,20,2
187488,7,18,3,0,15,3
187488,6,28,5,1,23,4
187488,5,11,4,0,7,4
187488,4,6,2,0,4,2
187488,3,8,2,0,6,2
187488,2,2,1,1,1,0
146094,9,3,1,0,2,1
146094,8,14,5,0,9,5
146094,7,25,5,0,20,5
146094,6,38,9,0,29,9
146094,5,12,5,0,7,5
146094,4,12,5,0,7,5
146094,3,9,3,0,6,3
230746,9,10,1,0,9,1
230746,8,31,7,0,24,7
230746,7,42,4,0,38,4
230746,6,25,2,0,23,2
230746,5,4,2,0,2,2
230746,3,1,1,0,0,1
201307,10,7,3,0,4,3
201307,9,2,1,0,1,1
201307,8,13,3,0,10,3
201307,7,29,4,0,25,4
201307,6,44,9,1,35,8
201307,5,17,2,0,15,2
201307,3,1,1,0,0,1
201307,2,1,1,0,0,1
20848,8,12,3,0,9,3
20848,7,13,4,0,9,4
20848,6,47,18,0,29,18
20848,5,31,7,0,24,7
20848,4,10,4,0,6,4
20848,2,3,1,0,2,1
102881,10,46,31,0,15,31
102881,9,13,5,0,8,5
102881,8,19,4,0,15,4
102881,7,18,5,0,13,5
102881,6,10,2,0,8,2
102881,5,4,1,0,3,1
102881,1,6,4,0,2,4
246900,10,58,15,3,43,12
246900,9,21,4,0,17,4
246900,8,16,3,1,13,2
246900,1,12,6,0,6,6
85338,8,5,1,0,4,1
85338,7,22,1,0,21,1
85338,6,50,10,0,40,10
85338,5,26,10,0,16,10
85338,4,12,2,0,10,2
1998,8,3,1,0,2,1
1998,6,37,8,0,29,8
1998,5,31,6,0,25,6
1998,3,12,2,0,10,2
1998,2,5,3,0,2,3
183,9,3,1,0,2,1
183,8,14,6,0,8,6
183,7,30,6,0,24,6
183,6,44,15,0,29,15
183,5,21,7,0,14,7
2483,10,5,2,0,3,2
2483,9,2,1,0,1,1
2483,8,18,6,0,12,6
2483,7,17,4,0,13,4
2483,6,36,10,0,26,10
2483,5,24,8,0,16,8
2483,4,9,2,0,7,2
2483,3,5,2,0,3,2
2483,2,2,1,0,1,1
149328,8,5,1,0,4,1
149328,7,11,1,0,10,1
149328,6,41,5,0,36,5
149328,5,29,4,0,25,4
149328,4,15,4,0,11,4
149328,3,7,3,0,4,3
149328,2,5,1,0,4,1
149328,1,3,1,0,2,1
18891,10,1,1,0,0,1
18891,8,7,3,0,4,3
18891,7,14,6,0,8,6
18891,6,50,25,0,25,25
18891,5,25,9,0,16,9
18891,4,13,7,0,6,7
18891,3,4,1,0,3,1
18891,2,3,2,0,1,2
27960,8,3,2,0,1,2
27960,7,14,3,0,11,3
27960,6,21,6,0,15,6
27960,5,18,5,0,13,5
27960,4,25,7,0,18,7
27960,3,7,1,0,6,1
27960,2,17,5,0,12,5
27960,1,11,6,0,5,6
60815,10,4,1,0,3,1
60815,9,17,4,0,13,4
60815,8,43,14,0,29,14
60815,7,28,7,0,21,7
60815,6,15,7,0,8,7
60815,5,7,2,0,5,2
8331,10,2,1,0,1,1
8331,8,9,6,0,3,6
8331,7,18,6,0,12,6
8331,6,36,12,0,24,12
8331,5,31,10,0,21,10
8331,4,11,2,0,9,2
8331,3,5,2,0,3,2
8331,2,3,2,0,1,2
8331,1,1,1,0,0,1
42968,7,12,4,0,8,4
42968,6,24,5,0,19,5
42968,5,22,5,0,17,5
42968,4,18,9,0,9,9
42968,3,16,4,0,12,4
42968,2,18,7,0,11,7
42968,1,5,3,0,2,3
159044,9,3,1,0,2,1
159044,8,8,2,0,6,2
159044,7,16,4,0,12,4
159044,6,46,7,0,39,7
159044,5,21,4,0,17,4
159044,4,7,1,0,6,1
159044,3,12,4,0,8,4
159044,2,5,2,0,3,2
184663,9,8,3,0,5,3
184663,8,24,1,1,23,0
184663,7,22,3,0,19,3
184663,6,32,9,1,23,8
184663,5,16,1,0,15,1
184663,4,7,3,0,4,3
184663,2,3,1,0,2,1
3247,9,2,2,0,0,2
3247,8,13,6,0,7,6
3247,7,25,10,0,15,10
3247,6,31,9,0,22,9
3247,5,23,6,0,17,6
3247,4,13,4,0,9,4
3247,3,5,3,0,2,3
3247,2,5,3,0,2,3
3499,10,6,1,0,5,1
3499,9,4,1,0,3,1
3499,8,11,3,0,8,3
3499,7,20,5,0,15,5
3499,6,29,10,0,19,10
3499,5,24,9,0,15,9
3499,4,10,2,0,8,2
3499,3,7,1,0,6,1
3499,2,6,2,0,4,2
142303,8,5,2,0,3,2
142303,7,11,3,2,8,1
142303,6,31,9,1,22,8
142303,5,28,4,0,24,4
142303,4,17,8,1,9,7
142303,3,10,4,0,6,4
142303,2,12,5,0,7,5
142303,1,4,2,0,2,2
216710,10,25,8,0,17,8
216710,9,32,10,0,22,10
216710,8,32,6,0,26,6
216710,7,16,4,0,12,4
216710,6,11,3,0,8,3
133713,8,17,3,0,14,3
133713,7,20,1,0,19,1
133713,6,42,5,0,37,5
133713,5,17,1,0,16,1
133713,4,11,2,0,9,2
133713,3,3,1,0,2,1
133713,1,3,1,0,2,1
85567,10,4,1,0,3,1
85567,9,13,7,0,6,7
85567,8,29,9,0,20,9
85567,7,26,6,0,20,6
85567,6,31,8,0,23,8
85567,4,5,1,0,4,1
155411,10,7,1,0,6,1
155411,9,14,2,0,12,2
155411,8,36,5,0,31,5
155411,7,33,4,0,29,4
155411,6,18,6,0,12,6
155411,5,8,1,0,7,1
62230,10,14,5,0,9,5
62230,9,20,6,0,14,6
62230,8,43,12,0,31,12
62230,7,28,8,0,20,8
62230,6,9,2,0,7,2
62230,4,2,1,0,1,1
72242,8,18,6,0,12,6
72242,7,25,3,0,22,3
72242,6,50,18,0,32,18
72242,5,12,5,0,7,5
72242,4,9,4,0,5,4
72242,3,2,1,0,1,1
15139,8,9,2,0,7,2
15139,7,16,8,0,8,8
15139,6,55,12,0,43,12
15139,5,17,3,0,14,3
15139,3,7,1,0,6,1
469,10,1,1,0,0,1
469,9,1,1,0,0,1
469,8,13,8,0,5,8
469,7,24,11,0,13,11
469,6,41,19,0,22,19
469,5,26,7,0,19,7
469,4,8,2,0,6,2
206943,10,3,1,0,2,1
206943,8,27,7,0,20,7
206943,7,37,8,0,29,8
206943,6,30,3,0,27,3
206943,5,9,1,0,8,1
191065,8,21,4,0,17,4
191065,7,26,4,0,22,4
191065,6,39,3,0,36,3
191065,5,19,6,0,13,6
191065,3,3,1,0,2,1
109105,10,2,1,0,1,1
109105,7,25,5,0,20,5
109105,6,35,12,0,23,12
109105,5,30,8,0,22,8
109105,4,15,5,0,10,5
109105,3,6,1,0,5,1
129971,9,1,1,0,0,1
129971,8,7,3,0,4,3
129971,7,33,12,0,21,12
129971,6,49,10,0,39,10
129971,5,16,3,0,13,3
80934,8,15,4,0,11,4
80934,7,24,4,0,20,4
80934,6,39,10,0,29,10
80934,5,18,1,0,17,1
80934,4,8,2,0,6,2
80934,3,5,1,0,4,1
80934,2,3,2,0,1,2
933,8,11,2,0,9,2
933,7,20,6,0,14,6
933,6,53,17,0,36,17
933,5,19,6,0,13,6
933,3,5,1,0,4,1
933,2,2,2,0,0,2
933,1,1,1,0,0,1
41243,9,8,1,0,7,1
41243,8,33,15,0,18,15
41243,7,35,7,0,28,7
41243,6,23,7,0,16,7
41243,5,6,3,0,3,3
41243,4,5,2,0,3,2
41243,3,2,2,0,0,2
6861,10,8,2,0,6,2
6861,9,10,1,0,9,1
6861,8,46,13,0,33,13
6861,7,30,6,0,24,6
6861,6,13,3,0,10,3
6861,5,7,4,0,3,4
6861,4,3,1,0,2,1
175739,8,7,1,0,6,1
175739,7,24,5,0,19,5
175739,6,39,6,0,33,6
175739,5,25,3,0,22,3
175739,4,12,1,0,11,1
175739,2,3,1,0,2,1
3560,8,13,5,0,8,5
3560,7,28,11,0,17,11
3560,6,34,12,0,22,12
3560,5,24,2,0,22,2
3560,3,9,1,0,8,1
3560,2,2,1,0,1,1
477,10,6,4,0,2,4
477,8,21,8,0,13,8
477,7,23,8,0,15,8
477,6,40,13,0,27,13
477,5,10,5,0,5,5
477,4,5,2,0,3,2
477,3,3,2,0,1,2
477,2,4,1,0,3,1
477,1,1,1,0,0,1
165748,10,11,6,1,5,5
165748,9,30,14,0,16,14
165748,8,50,15,0,35,15
165748,7,14,5,0,9,5
165748,6,8,3,0,5,3
165748,5,2,1,0,1,1
3677,10,2,1,0,1,1
3677,9,5,3,0,2,3
3677,8,6,3,0,3,3
3677,7,18,10,0,8,10
3677,6,37,11,0,26,11
3677,5,24,11,0,13,11
3677,4,12,6,0,6,6
3677,3,9,4,0,5,4
184145,10,9,4,0,5,4
184145,9,15,6,0,9,6
184145,8,32,6,0,26,6
184145,7,28,6,0,22,6
184145,6,19,6,0,13,6
184145,2,2,1,0,1,1
211128,10,14,3,1,11,2
211128,9,19,6,0,13,6
211128,8,25,3,0,22,3
211128,7,13,3,0,10,3
211128,6,20,5,0,15,5
211128,5,8,3,0,5,3
211128,4,8,2,0,6,2
211128,3,6,3,0,3,3
211128,2,4,2,0,2,2
130723,8,14,2,0,12,2
130723,7,19,4,0,15,4
130723,6,46,6,0,40,6
130723,5,21,3,0,18,3
130723,4,10,3,0,7,3
130723,3,4,1,0,3,1
144574,10,42,10,0,32,10
144574,9,37,9,0,28,9
144574,8,27,8,0,19,8
144574,7,6,4,0,2,4
144574,5,1,1,0,0,1
144574,1,2,1,0,1,1
4909,8,5,1,0,4,1
4909,7,15,3,0,12,3
4909,6,44,13,0,31,13
4909,5,25,9,0,16,9
4909,4,15,9,0,6,9
4909,3,8,3,0,5,3
4909,1,1,1,0,0,1
2383,10,2,1,0,1,1
2383,8,9,3,0,6,3
2383,7,16,2,0,14,2
2383,6,27,8,0,19,8
2383,5,29,10,0,19,10
2383,4,24,9,0,15,9
2383,3,5,2,0,3,2
2383,2,1,1,0,0,1
2383,1,2,1,0,1,1
230266,9,3,1,0,2,1
230266,8,20,7,0,13,7
230266,7,24,2,0,22,2
230266,6,39,6,0,33,6
230266,5,17,2,0,15,2
230266,4,8,1,0,7,1
3189,8,9,2,0,7,2
3189,7,16,7,0,9,7
3189,6,35,18,0,17,18
3189,5,27,12,0,15,12
3189,4,16,11,0,5,11
3189,3,7,2,0,5,2
3189,2,5,3,0,2,3
3189,1,1,1,0,0,1
20445,10,3,2,0,1,2
20445,9,6,3,0,3,3
20445,8,16,7,0,9,7
20445,7,27,9,0,18,9
20445,6,32,7,0,25,7
20445,5,13,2,0,11,2
20445,4,13,3,0,10,3
20445,3,6,4,0,2,4
20445,1,1,1,0,0,1
25749,7,17,2,0,15,2
25749,6,30,5,0,25,5
25749,5,10,2,0,8,2
25749,4,13,4,0,9,4
25749,2,3,1,0,2,1
39345,9,8,4,0,4,4
39345,8,42,11,0,31,11
39345,7,38,11,0,27,11
39345,6,18,9,0,9,9
39345,5,6,3,0,3,3
39345,4,1,1,0,0,1
228553,10,4,1,0,3,1
228553,9,6,1,0,5,1
228553,8,45,10,2,35,8
228553,7,32,5,0,27,5
228553,6,19,5,0,14,5
228553,5,7,2,0,5,2
228553,3,2,1,0,1,1
118330,9,4,2,0,2,2
118330,8,6,1,0,5,1
118330,7,25,7,0,18,7
118330,6,56,18,0,38,18
118330,5,14,4,0,10,4
118330,4,5,3,0,2,3
118330,3,4,1,0,3,1
118330,2,1,1,0,0,1
223201,8,15,3,0,12,3
223201,7,34,6,0,28,6
223201,6,31,1,0,30,1
223201,5,26,7,0,19,7
223201,4,7,1,0,6,1
3057,9,5,3,0,2,3
3057,8,22,8,0,14,8
3057,7,36,19,0,17,19
3057,6,28,9,0,19,9
3057,5,13,4,0,9,4
3057,4,11,4,0,7,4
3057,2,1,1,0,0,1
184267,10,40,9,1,31,8
184267,9,26,3,1,23,2
184267,8,32,10,2,22,8
184267,7,8,2,0,6,2
184267,5,5,1,0,4,1
184267,4,2,1,0,1,1
55842,8,21,12,0,9,12
55842,7,19,7,0,12,7
55842,6,47,20,0,27,20
55842,5,11,5,0,6,5
55842,4,8,1,0,7,1
55842,3,5,3,0,2,3
55842,2,1,1,0,0,1
24118,8,7,1,0,6,1
24118,7,24,5,0,19,5
24118,6,52,9,0,43,9
24118,5,13,4,0,9,4
24118,4,12,1,0,11,1
102859,10,2,1,0,1,1
102859,8,8,2,0,6,2
102859,7,16,3,0,13,3
102859,6,32,2,0,30,2
102859,5,18,2,0,16,2
102859,4,17,3,0,14,3
102859,3,9,3,0,6,3
102859,2,10,3,0,7,3
102859,1,5,2,0,3,2
214899,7,11,1,0,10,1
214899,6,30,4,0,26,4
214899,5,29,7,0,22,7
214899,4,23,1,0,22,1
214899,3,8,2,0,6,2
151645,9,2,1,0,1,1
151645,8,20,7,1,13,6
151645,7,36,7,0,29,7
151645,6,35,11,1,24,10
151645,5,11,4,0,7,4
151645,4,7,2,0,5,2
5784,8,2,1,0,1,1
5784,7,8,1,0,7,1
5784,6,17,5,0,12,5
5784,5,42,14,0,28,14
5784,4,26,12,0,14,12
5784,3,12,6,0,6,6
5784,2,8,6,0,2,6
7821,10,1,1,0,0,1
7821,8,7,4,0,3,4
7821,7,10,4,0,6,4
7821,6,34,18,0,16,18
7821,5,25,11,0,14,11
7821,4,21,10,0,11,10
7821,3,13,7,0,6,7
7821,1,3,2,0,1,2
19623,9,2,1,0,1,1
19623,8,8,4,0,4,4
19623,7,22,9,0,13,9
19623,6,39,11,0,28,11
19623,5,25,1,0,24,1
19623,4,12,5,0,7,5
19623,3,4,1,0,3,1
19623,2,1,1,0,0,1
119639,8,9,1,0,8,1
119639,7,25,5,0,20,5
119639,6,36,7,0,29,7
119639,5,21,3,0,18,3
119639,4,11,1,0,10,1
119639,3,11,5,0,6,5
176013,10,5,1,0,4,1
176013,9,3,1,0,2,1
176013,8,16,1,0,15,1
176013,7,32,7,0,25,7
176013,6,34,4,0,30,4
176013,5,13,1,0,12,1
176013,4,7,1,0,6,1
176013,3,5,1,0,4,1
176013,2,1,1,0,0,1
176013,1,1,1,0,0,1
4359,9,5,1,0,4,1
4359,8,12,3,0,9,3
4359,7,41,13,0,28,13
4359,6,29,9,0,20,9
4359,5,16,2,0,14,2
4359,4,9,3,0,6,3
4359,3,2,1,0,1,1
4359,1,2,1,0,1,1
5155,9,5,1,0,4,1
5155,7,33,5,0,28,5
5155,6,44,9,0,35,9
5155,5,21,4,0,17,4
5155,4,7,1,0,6,1
9516,9,2,2,0,0,2
9516,7,3,1,0,2,1
9516,6,21,3,0,18,3
9516,5,30,6,0,24,6
9516,4,25,6,0,19,6
9516,3,18,7,0,11,7
9516,2,16,11,0,5,11
149169,10,5,1,0,4,1
149169,9,9,1,0,8,1
149169,8,29,3,0,26,3
149169,7,33,6,0,27,6
149169,6,25,6,0,19,6
149169,5,12,5,0,7,5
3715,10,1,1,0,0,1
3715,8,4,1,0,3,1
3715,7,14,7,0,7,7
3715,6,21,8,0,13,8
3715,5,27,6,0,21,6
3715,4,27,9,0,18,9
3715,3,10,3,0,7,3
3715,2,7,2,0,5,2
3715,1,4,2,0,2,2
3576,8,15,2,0,13,2
3576,7,28,10,0,18,10
3576,6,38,10,0,28,10
3576,5,20,8,0,12,8
3576,4,6,1,0,5,1
3576,3,4,2,0,2,2
2668,8,12,3,0,9,3
2668,7,20,7,0,13,7
2668,6,41,12,0,29,12
2668,5,25,7,0,18,7
2668,4,10,3,0,7,3
2668,3,6,3,0,3,3
2668,2,1,1,0,0,1
3531,10,3,2,0,1,2
3531,9,3,1,0,2,1
3531,8,21,10,0,11,10
3531,7,35,10,0,25,10
3531,6,34,8,0,26,8
3531,5,15,4,0,11,4
3531,4,4,2,0,2,2
38923,10,5,1,0,4,1
38923,9,8,5,0,3,5
38923,8,21,3,0,18,3
38923,7,41,12,0,29,12
38923,6,24,10,0,14,10
38923,5,12,7,0,5,7
38923,4,2,2,0,0,2
38923,2,3,1,0,2,1
193062,10,1,1,0,0,1
193062,9,5,1,0,4,1
193062,8,23,5,0,18,5
193062,7,35,1,0,34,1
193062,6,33,3,0,30,3
193062,5,13,3,0,10,3
193062,4,5,2,0,3,2
224751,9,4,2,0,2,2
224751,8,7,3,0,4,3
224751,7,15,3,0,12,3
224751,6,41,6,0,35,6
224751,5,25,7,0,18,7
224751,4,9,1,0,8,1
224751,3,10,3,0,7,3
224751,2,3,1,0,2,1
224751,1,1,1,0,0,1
175209,10,2,1,0,1,1
175209,9,12,3,0,9,3
175209,8,25,10,0,15,10
175209,7,23,7,0,16,7
175209,6,34,5,0,29,5
175209,5,9,1,0,8,1
175209,4,4,1,0,3,1
175209,3,4,3,0,1,3
36611,7,12,2,0,10,2
36611,6,18,2,0,16,2
36611,5,29,3,0,26,3
36611,4,28,5,0,23,5
36611,3,11,3,0,8,3
36611,2,9,1,0,8,1
67123,10,1,1,0,0,1
67123,9,8,4,0,4,4
67123,8,27,11,0,16,11
67123,7,37,12,0,25,12
67123,6,31,10,0,21,10
67123,5,9,2,0,7,2
67123,3,1,1,0,0,1
67123,2,1,1,0,0,1
236143,10,12,1,0,11,1
236143,8,23,5,0,18,5
236143,7,39,8,1,31,7
236143,6,21,4,1,17,3
236143,5,7,1,0,6,1
236143,3,4,1,0,3,1
224303,10,3,2,0,1,2
224303,9,11,6,0,5,6
224303,8,41,12,0,29,12
224303,7,29,10,0,19,10
224303,6,25,8,0,17,8
224303,5,7,4,0,3,4
224303,2,1,1,0,0,1
1672,10,2,1,0,1,1
1672,8,9,3,0,6,3
1672,7,15,7,0,8,7
1672,6,30,4,0,26,4
1672,5,35,11,0,24,11
1672,4,11,5,0,6,5
1672,3,6,2,0,4,2
1672,2,5,4,0,1,4
1672,1,2,2,0,0,2
657,9,2,1,0,1,1
657,8,9,3,0,6,3
657,7,24,12,0,12,12
657,6,39,12,0,27,12
657,5,21,6,0,15,6
657,4,15,4,0,11,4
657,3,5,1,0,4,1
657,2,1,1,0,0,1
7502,10,7,1,0,6,1
7502,9,11,7,0,4,7
7502,8,35,11,0,24,11
7502,7,27,4,0,23,4
7502,6,19,5,0,14,5
7502,5,4,2,0,2,2
7502,4,7,2,0,5,2
7502,3,3,2,0,1,2
114863,8,15,4,0,11,4
114863,7,28,9,0,19,9
114863,6,42,11,0,31,11
114863,5,13,2,0,11,2
114863,4,10,1,0,9,1
114863,3,6,1,0,5,1
8101,8,8,2,0,6,2
8101,7,17,8,0,9,8
8101,6,42,9,0,33,9
8101,5,25,11,0,14,11
8101,4,11,6,0,5,6
8101,3,5,3,0,2,3
8101,2,1,1,0,0,1
5591,7,8,3,0,5,3
5591,6,24,12,0,12,12
5591,5,25,6,0,19,6
5591,4,31,14,0,17,14
5591,3,17,10,0,7,10
5591,2,8,2,0,6,2
5591,1,2,2,0,0,2
2716,8,12,3,0,9,3
2716,7,28,8,0,20,8
2716,6,38,4,0,34,4
2716,5,22,3,0,19,3
2716,4,14,3,0,11,3
2716,3,2,1,0,1,1
137500,9,12,4,0,8,4
137500,8,44,11,0,33,11
137500,7,30,6,0,24,6
137500,6,17,7,0,10,7
137500,4,6,1,0,5,1
126340,9,1,1,0,0,1
126340,8,14,5,1,9,4
126340,7,31,6,1,25,5
126340,6,43,10,1,33,9
126340,5,18,6,0,12,6
126340,4,5,1,0,4,1
126340,3,3,2,0,1,2
585,9,6,1,0,5,1
585,8,20,5,0,15,5
585,7,38,5,0,33,5
585,6,33,8,0,25,8
585,5,16,5,0,11,5
585,4,3,2,0,1,2
22477,9,4,2,0,2,2
22477,8,17,7,0,10,7
22477,7,27,8,0,19,8
22477,6,32,9,0,23,9
22477,5,19,4,0,15,4
22477,4,9,2,0,7,2
22477,3,5,1,0,4,1
22477,2,3,1,0,2,1
43041,8,12,1,0,11,1
43041,7,20,3,0,17,3
43041,6,32,4,0,28,4
43041,5,20,5,0,15,5
43041,4,11,2,0,9,2
43041,3,11,3,0,8,3
43041,2,2,1,0,1,1
43041,1,2,1,0,1,1
130763,10,5,2,0,3,2
130763,9,1,1,0,0,1
130763,8,10,6,0,4,6
130763,7,24,7,0,17,7
130763,6,41,13,0,28,13
130763,5,16,4,0,12,4
130763,4,10,4,0,6,4
130763,1,5,1,0,4,1
7114,10,4,2,0,2,2
7114,9,13,6,0,7,6
7114,8,37,8,0,29,8
7114,7,29,4,0,25,4
7114,6,18,8,0,10,8
7114,5,9,2,0,7,2
7114,4,1,1,0,0,1
7114,3,2,2,0,0,2
7114,2,3,1,0,2,1
125061,10,3,1,0,2,1
125061,9,2,1,0,1,1
125061,8,18,4,1,14,3
125061,7,22,2,0,20,2
125061,6,37,9,0,28,9
125061,5,15,3,0,12,3
125061,4,8,1,0,7,1
125061,3,8,2,0,6,2
125061,2,3,2,0,1,2
129280,10,3,1,0,2,1
129280,9,6,4,1,2,3
129280,8,32,6,2,26,4
129280,7,30,6,1,24,5
129280,6,29,6,1,23,5
129280,5,11,3,0,8,3
129280,4,3,2,0,1,2
7493,9,3,2,0,1,2
7493,8,12,10,0,2,10
7493,7,15,11,0,4,11
7493,6,31,16,0,15,16
7493,5,27,13,0,14,13
7493,4,15,9,0,6,9
7493,3,9,3,0,6,3
7493,2,3,1,0,2,1
31887,9,2,1,0,1,1
31887,8,14,3,0,11,3
31887,7,22,8,0,14,8
31887,6,36,15,0,21,15
31887,5,21,7,0,14,7
31887,4,14,6,0,8,6
31887,3,4,2,0,2,2
31887,2,3,2,0,1,2
19969,10,17,3,0,14,3
19969,9,11,4,0,7,4
19969,8,24,4,0,20,4
19969,7,25,4,0,21,4
19969,6,19,7,0,12,7
19969,5,9,3,0,6,3
19969,4,6,2,0,4,2
19969,3,2,1,0,1,1
19969,2,1,1,0,0,1
19969,1,2,1,0,1,1
84834,9,12,4,0,8,4
84834,8,50,17,0,33,17
84834,7,35,9,0,26,9
84834,6,9,2,0,7,2
84834,5,5,2,0,3,2
84834,3,1,1,0,0,1
144579,8,7,3,0,4,3
144579,7,23,9,0,14,9
144579,6,28,5,0,23,5
144579,5,23,3,0,20,3
144579,4,22,3,0,19,3
144579,2,3,1,0,2,1
217176,9,8,4,0,4,4
217176,8,16,8,0,8,8
217176,7,34,1,0,33,1
217176,6,38,5,0,33,5
217176,4,2,1,0,1,1
217176,2,1,1,0,0,1
1028,8,6,2,0,4,2
1028,7,27,6,0,21,6
1028,6,45,9,0,36,9
1028,5,27,6,0,21,6
1028,4,9,3,0,6,3
6732,10,3,2,0,1,2
6732,9,6,2,0,4,2
6732,8,11,2,0,9,2
6732,7,31,13,0,18,13
6732,6,44,9,0,35,9
6732,5,11,1,0,10,1
6732,4,5,2,0,3,2
6732,3,5,2,0,3,2
31057,9,3,1,0,2,1
31057,8,9,5,0,4,5
31057,7,15,3,0,12,3
31057,6,42,10,0,32,10
31057,5,22,8,0,14,8
31057,4,12,1,0,11,1
200247,10,25,12,0,13,12
200247,9,41,19,0,22,19
200247,8,32,11,0,21,11
200247,7,14,3,0,11,3
200247,6,3,1,0,2,1
200247,2,1,1,0,0,1
140468,8,12,3,0,9,3
140468,7,26,10,0,16,10
140468,6,41,11,0,30,11
140468,5,17,3,0,14,3
140468,4,7,5,0,2,5
140468,3,8,1,0,7,1
2502,5,4,1,0,3,1
2502,4,5,2,0,3,2
2502,3,11,3,0,8,3
2502,2,20,6,0,14,6
2502,1,70,30,0,40,30
249106,9,30,11,2,19,9
249106,8,35,6,1,29,5
249106,7,29,8,0,21,8
249106,6,14,6,0,8,6
249106,5,5,3,0,2,3
73365,9,4,1,0,3,1
73365,8,13,2,0,11,2
73365,7,33,5,0,28,5
73365,6,34,6,0,28,6
73365,5,14,2,0,12,2
73365,4,7,2,0,5,2
73365,3,5,1,0,4,1
519,8,12,6,0,6,6
519,7,22,10,0,12,10
519,6,34,8,0,26,8
519,5,33,16,0,17,16
519,4,7,4,0,3,4
519,3,2,2,0,0,2
519,2,4,2,0,2,2
76546,10,2,2,0,0,2
76546,8,6,1,0,5,1
76546,6,38,10,0,28,10
76546,5,27,6,0,21,6
76546,4,12,4,0,8,4
76546,3,4,1,0,3,1
76546,2,6,3,0,3,3
76546,1,2,1,0,1,1
165633,9,6,2,0,4,2
165633,8,22,6,1,16,5
165633,7,26,2,0,24,2
165633,6,29,4,0,25,4
165633,5,13,1,0,12,1
165633,4,10,2,0,8,2
165633,2,1,1,0,0,1
256159,10,13,6,0,7,6
256159,9,20,5,0,15,5
256159,8,35,6,0,29,6
256159,7,21,2,0,19,2
256159,6,12,2,0,10,2
256159,4,5,2,0,3,2
169459,7,25,5,1,20,4
169459,6,37,4,0,33,4
169459,5,23,4,0,19,4
169459,4,13,1,0,12,1
169459,3,2,1,0,1,1
169459,2,5,1,0,4,1
255034,9,8,1,0,7,1
255034,8,32,5,0,27,5
255034,7,34,2,0,32,2
255034,6,16,4,0,12,4
255034,5,12,3,0,9,3
19914,10,3,1,0,2,1
19914,8,7,3,0,4,3
19914,7,10,2,0,8,2
19914,6,47,15,0,32,15
19914,5,20,4,0,16,4
19914,4,15,4,0,11,4
19914,3,8,5,0,3,5
19914,2,5,2,0,3,2
254193,9,5,1,0,4,1
254193,8,28,3,0,25,3
254193,7,30,2,0,28,2
254193,6,23,2,0,21,2
254193,5,11,2,0,9,2
254193,4,5,1,0,4,1
254193,2,3,1,0,2,1
129492,9,5,1,0,4,1
129492,8,11,2,0,9,2
129492,7,41,8,0,33,8
129492,6,39,6,0,33,6
129492,4,5,1,0,4,1
1207,8,5,3,0,2,3
1207,7,20,2,0,18,2
1207,6,33,5,0,28,5
1207,5,33,7,0,26,7
1207,4,15,3,0,12,3
1207,3,4,1,0,3,1
1207,2,3,1,0,2,1
35476,10,12,3,0,9,3
35476,9,21,9,0,12,9
35476,8,46,8,0,38,8
35476,7,25,6,0,19,6
35476,6,7,2,0,5,2
35476,5,4,2,0,2,2
35476,4,1,1,0,0,1
14452,9,8,3,0,5,3
14452,8,27,10,0,17,10
14452,7,38,12,0,26,12
14452,6,23,4,0,19,4
14452,5,12,4,0,8,4
14452,4,2,1,0,1,1
219509,9,8,2,0,6,2
219509,8,15,5,0,10,5
219509,7,27,3,0,24,3
219509,6,32,1,0,31,1
219509,5,21,2,0,19,2
219509,4,5,1,0,4,1
219509,3,6,1,0,5,1
159405,10,9,2,0,7,2
159405,9,5,3,1,2,2
159405,8,24,6,0,18,6
159405,7,29,5,0,24,5
159405,6,27,7,0,20,7
159405,5,9,2,0,7,2
159405,4,7,4,0,3,4
159405,3,3,1,0,2,1
42731,10,16,8,0,8,8
42731,9,29,10,0,19,10
42731,8,37,12,0,25,12
42731,7,19,5,0,14,5
42731,6,9,3,0,6,3
42731,5,3,3,0,0,3
42731,4,1,1,0,0,1
182541,8,22,2,0,20,2
182541,7,30,5,0,25,5
182541,6,37,9,0,28,9
182541,4,4,2,0,2,2
182541,3,2,1,0,1,1
108554,9,3,1,0,2,1
108554,8,10,4,0,6,4
108554,7,22,11,0,11,11
108554,6,37,9,3,28,6
108554,5,18,5,0,13,5
108554,4,13,4,0,9,4
108554,3,7,4,0,3,4
108554,2,3,1,0,2,1
108554,1,2,2,0,0,2
192116,10,10,5,0,5,5
192116,9,11,3,0,8,3
192116,8,17,2,0,15,2
192116,7,21,7,2,14,5
192116,6,25,7,0,18,7
192116,5,11,3,0,8,3
192116,4,8,3,0,5,3
192116,3,4,2,0,2,2
192116,2,2,1,0,1,1
3517,10,11,4,0,7,4
3517,9,9,5,0,4,5
3517,8,21,6,0,15,6
3517,7,14,4,0,10,4
3517,6,28,9,0,19,9
3517,5,12,5,0,7,5
3517,4,13,4,0,9,4
3517,3,5,2,0,3,2
3517,2,2,1,0,1,1
209641,10,8,2,0,6,2
209641,9,21,6,0,15,6
209641,8,39,13,0,26,13
209641,7,25,5,0,20,5
209641,6,14,2,0,12,2
209641,5,5,1,0,4,1
113312,8,6,1,0,5,1
113312,7,14,2,0,12,2
113312,6,44,7,0,37,7
113312,5,15,1,0,14,1
113312,4,18,4,0,14,4
113312,3,9,6,0,3,6
113312,2,3,1,0,2,1
7218,10,5,2,0,3,2
7218,9,11,5,0,6,5
7218,8,40,12,0,28,12
7218,7,32,12,0,20,12
7218,6,14,10,0,4,10
7218,5,9,3,0,6,3
7218,4,2,1,0,1,1
7218,3,1,1,0,0,1
462,8,3,1,0,2,1
462,7,18,2,0,16,2
462,6,45,10,0,35,10
462,5,23,6,0,17,6
462,4,18,10,0,8,10
177927,8,14,3,1,11,2
177927,7,18,3,0,15,3
177927,6,35,4,0,31,4
177927,5,14,4,0,10,4
177927,4,8,3,0,5,3
177927,2,5,2,1,3,1
193695,10,1,1,0,0,1
193695,9,3,1,0,2,1
193695,8,19,4,0,15,4
193695,7,22,1,0,21,1
193695,6,29,1,0,28,1
193695,5,15,3,0,12,3
193695,3,11,3,0,8,3
193695,2,3,1,0,2,1
2916,8,5,2,0,3,2
2916,7,12,4,0,8,4
2916,6,38,12,0,26,12
2916,5,25,8,0,17,8
2916,4,18,9,0,9,9
2916,3,8,4,0,4,4
2916,2,8,6,0,2,6
131060,9,5,2,0,3,2
131060,8,10,1,0,9,1
131060,7,28,7,0,21,7
131060,6,43,5,0,38,5
131060,4,10,1,0,9,1
131060,3,3,1,0,2,1
131060,2,1,1,0,0,1
8329,10,3,2,0,1,2
8329,9,2,2,0,0,2
8329,8,5,2,0,3,2
8329,7,23,9,0,14,9
8329,6,40,14,0,26,14
8329,5,28,9,0,19,9
8329,4,10,6,0,4,6
8329,2,3,2,0,1,2
244191,9,14,5,0,9,5
244191,8,47,11,0,36,11
244191,7,28,2,0,26,2
244191,6,12,1,0,11,1
244191,5,6,2,0,4,2
244191,4,4,1,0,3,1
255674,8,41,4,0,37,4
255674,7,34,2,0,32,2
255674,6,24,4,0,20,4
255674,5,8,1,0,7,1
255674,4,2,1,0,1,1
18401,10,16,7,0,9,7
18401,9,16,2,0,14,2
18401,8,31,12,0,19,12
18401,7,25,8,0,17,8
18401,6,16,8,0,8,8
18401,3,3,3,0,0,3
18401,2,2,1,0,1,1
18401,1,4,3,0,1,3
3626,10,1,1,0,0,1
3626,9,2,1,0,1,1
3626,8,3,1,0,2,1
3626,7,14,1,0,13,1
3626,6,44,13,0,31,13
3626,5,29,12,0,17,12
3626,4,10,2,0,8,2
3626,3,8,3,0,5,3
176596,10,26,5,0,21,5
176596,9,35,9,0,26,9
176596,8,38,6,0,32,6
176596,7,9,2,0,7,2
176596,6,4,2,0,2,2
176596,5,1,1,0,0,1
176596,3,1,1,0,0,1
24845,8,10,1,0,9,1
24845,7,25,6,0,19,6
24845,6,54,12,0,42,12
24845,5,15,3,0,12,3
24845,4,6,1,0,5,1
24845,2,1,1,0,0,1
24845,1,2,1,0,1,1
226089,9,8,3,0,5,3
226089,8,35,8,0,27,8
226089,7,39,11,0,28,11
226089,6,23,6,0,17,6
226089,5,5,1,0,4,1
4516,10,2,1,0,1,1
4516,8,8,4,0,4,4
4516,7,16,5,0,11,5
4516,6,42,13,0,29,13
4516,5,27,10,0,17,10
4516,3,3,1,0,2,1
4516,1,2,2,0,0,2
62922,10,17,9,0,8,9
62922,9,37,9,0,28,9
62922,8,36,9,0,27,9
62922,7,14,6,0,8,6
62922,6,5,3,0,2,3
62922,5,1,1,0,0,1
62922,4,2,1,0,1,1
62922,2,1,1,0,0,1
2641,10,6,2,0,4,2
2641,9,13,7,0,6,7
2641,8,23,12,0,11,12
2641,7,32,12,0,20,12
2641,6,25,6,0,19,6
2641,5,9,3,0,6,3
2641,3,3,2,0,1,2
13503,9,2,2,0,0,2
13503,8,23,14,0,9,14
13503,7,36,16,0,20,16
13503,6,34,13,0,21,13
13503,5,12,3,0,9,3
13503,4,6,1,0,5,1
7774,9,6,2,0,4,2
7774,8,19,6,0,13,6
7774,7,32,11,0,21,11
7774,6,37,10,0,27,10
7774,5,13,2,0,11,2
7774,4,4,1,0,3,1
7774,3,2,1,0,1,1
4799,8,10,6,0,4,6
4799,7,27,9,0,18,9
4799,6,34,9,0,25,9
4799,5,19,4,0,15,4
4799,4,9,4,0,5,4
4799,3,7,2,0,5,2
4799,1,4,3,0,1,3
12622,10,12,8,0,4,8
12622,9,13,8,0,5,8
12622,8,26,13,0,13,13
12622,7,31,6,0,25,6
12622,6,21,8,0,13,8
12622,5,6,1,0,5,1
12622,4,3,2,0,1,2
12622,3,2,1,0,1,1
38462,9,5,1,0,4,1
38462,8,24,7,0,17,7
38462,7,34,8,0,26,8
38462,6,33,8,0,25,8
38462,5,13,7,0,6,7
38462,4,4,1,0,3,1
38462,3,1,1,0,0,1
180977,10,2,1,0,1,1
180977,9,10,4,1,6,3
180977,8,29,7,3,22,4
180977,7,27,5,0,22,5
180977,6,33,7,0,26,7
180977,5,7,2,0,5,2
180977,4,5,2,0,3,2
180977,3,1,1,0,0,1
8666,10,2,1,0,1,1
8666,9,4,3,0,1,3
8666,8,22,5,0,17,5
8666,7,26,7,0,19,7
8666,6,25,6,0,19,6
8666,5,24,7,0,17,7
8666,4,6,2,0,4,2
8666,3,1,1,0,0,1
8666,2,3,2,0,1,2
8666,1,1,1,0,0,1
20829,9,3,1,0,2,1
20829,8,17,6,0,11,6
20829,7,34,9,0,25,9
20829,6,32,8,0,24,8
20829,5,18,7,0,11,7
20829,4,5,3,0,2,3
20829,3,4,1,0,3,1
4914,9,7,2,0,5,2
4914,8,19,8,0,11,8
4914,7,35,10,0,25,10
4914,6,35,14,0,21,14
4914,5,9,3,0,6,3
4914,4,5,3,0,2,3
4914,2,1,1,0,0,1
4914,1,1,1,0,0,1
2566,8,4,1,0,3,1
2566,7,6,1,0,5,1
2566,6,35,9,0,26,9
2566,5,34,7,0,27,7
2566,4,24,9,0,15,9
2566,3,6,2,0,4,2
2566,2,2,1,0,1,1
2000,7,7,1,0,6,1
2000,6,22,3,0,19,3
2000,5,19,2,0,17,2
2000,4,26,6,0,20,6
2000,3,21,4,0,17,4
2000,2,11,4,0,7,4
2000,1,7,4,0,3,4
163119,10,10,4,0,6,4
163119,9,6,1,0,5,1
163119,8,15,4,0,11,4
163119,7,18,4,0,14,4
163119,6,17,5,1,12,4
163119,5,24,1,0,23,1
163119,4,9,1,0,8,1
163119,3,5,3,0,2,3
163119,2,9,4,1,5,3
16403,10,1,1,0,0,1
16403,9,3,1,0,2,1
16403,8,11,2,0,9,2
16403,7,21,7,0,14,7
16403,6,34,10,0,24,10
16403,5,20,8,0,12,8
16403,4,16,7,0,9,7
16403,3,4,1,0,3,1
16403,2,1,1,0,0,1
16403,1,3,2,0,1,2
232481,9,3,1,0,2,1
232481,8,19,3,0,16,3
232481,7,43,6,0,37,6
232481,6,31,2,0,29,2
232481,5,13,4,0,9,4
2809,10,3,1,0,2,1
2809,8,11,5,0,6,5
2809,7,30,13,0,17,13
2809,6,42,3,0,39,3
2809,5,16,5,0,11,5
2809,4,6,1,0,5,1
2809,2,2,1,0,1,1
1622,10,1,1,0,0,1
1622,9,2,1,0,1,1
1622,8,8,2,0,6,2
1622,7,24,6,0,18,6
1622,6,38,9,0,29,9
1622,5,23,4,0,19,4
1622,4,10,4,0,6,4
1622,3,5,2,0,3,2
1622,2,2,1,0,1,1
122399,10,2,1,0,1,1
122399,9,6,3,0,3,3
122399,8,21,8,0,13,8
122399,7,20,3,0,17,3
122399,6,37,8,0,29,8
122399,5,17,5,0,12,5
122399,4,8,3,0,5,3
122399,3,3,3,0,0,3
209542,10,2,1,0,1,1
209542,8,12,2,1,10,1
209542,7,33,5,1,28,4
209542,6,33,6,1,27,5
209542,5,14,2,0,12,2
209542,4,10,2,0,8,2
212487,10,9,5,0,4,5
212487,9,11,3,1,8,2
212487,8,35,7,0,28,7
212487,7,29,5,0,24,5
212487,6,23,3,0,20,3
212487,5,6,2,0,4,2
212487,4,1,1,0,0,1
175177,8,33,12,1,21,11
175177,7,31,8,0,23,8
175177,6,34,7,0,27,7
175177,5,6,3,0,3,3
175177,4,4,1,0,3,1
175177,3,2,1,0,1,1
32194,10,3,2,0,1,2
32194,9,1,1,0,0,1
32194,8,4,2,0,2,2
32194,7,23,6,0,17,6
32194,6,34,7,0,27,7
32194,5,21,4,0,17,4
32194,4,13,5,0,8,5
32194,3,8,5,0,3,5
32194,2,7,5,0,2,5
34173,7,12,1,0,11,1
34173,6,39,3,0,36,3
34173,5,28,3,0,25,3
34173,4,10,1,0,9,1
34173,3,6,1,0,5,1
34173,2,6,1,0,5,1
34173,1,3,1,0,2,1
200729,10,4,2,0,2,2
200729,9,8,3,0,5,3
200729,8,18,4,1,14,3
200729,7,29,10,0,19,10
200729,6,24,6,0,18,6
200729,5,16,2,0,14,2
200729,4,9,3,0,6,3
200729,3,3,2,0,1,2
200729,1,2,1,0,1,1
159375,10,6,2,0,4,2
159375,8,13,7,1,6,6
159375,7,28,5,0,23,5
159375,6,39,11,1,28,10
159375,5,12,1,1,11,0
159375,4,7,3,0,4,3
159375,3,4,1,0,3,1
140682,9,4,1,0,3,1
140682,8,17,3,0,14,3
140682,7,32,11,0,21,11
140682,6,38,6,0,32,6
140682,4,7,1,0,6,1
140682,3,1,1,0,0,1
255658,10,4,1,0,3,1
255658,8,12,1,0,11,1
255658,7,32,2,0,30,2
255658,6,32,4,0,28,4
255658,5,15,3,0,12,3
255658,4,8,2,0,6,2
255658,3,7,2,0,5,2
255658,2,1,1,0,0,1
181382,9,7,2,1,5,1
181382,8,37,9,2,28,7
181382,7,29,4,0,25,4
181382,6,23,4,0,19,4
181382,5,6,2,0,4,2
181382,4,6,1,0,5,1
181382,3,3,1,0,2,1
181382,2,2,2,0,0,2
171419,10,2,1,0,1,1
171419,9,9,4,0,5,4
171419,8,21,7,0,14,7
171419,7,31,6,0,25,6
171419,6,33,2,0,31,2
171419,5,11,2,0,9,2
171419,4,4,1,0,3,1
5183,8,26,10,0,16,10
5183,7,29,5,0,24,5
5183,6,39,10,0,29,10
5183,5,8,2,0,6,2
5183,4,4,2,0,2,2
2645,9,4,1,0,3,1
2645,8,7,2,0,5,2
2645,7,13,6,0,7,6
2645,6,36,11,0,25,11
2645,5,28,8,0,20,8
2645,4,18,6,0,12,6
2645,3,3,1,0,2,1
2645,1,1,1,0,0,1
26458,10,7,3,0,4,3
26458,9,16,5,0,11,5
26458,8,42,13,0,29,13
26458,7,32,8,0,24,8
26458,6,12,2,0,10,2
26458,5,3,2,0,1,2
3053,10,6,1,0,5,1
3053,9,12,5,0,7,5
3053,8,34,11,0,23,11
3053,7,26,11,0,15,11
3053,6,21,4,0,17,4
3053,5,6,1,0,5,1
3053,4,7,4,0,3,4
230265,10,7,1,0,6,1
230265,9,16,5,0,11,5
230265,8,47,9,1,38,8
230265,7,19,4,0,15,4
230265,6,21,5,1,16,4
230265,5,3,1,0,2,1
230265,1,1,1,0,0,1
12544,9,1,1,0,0,1
12544,8,8,3,0,5,3
12544,7,17,1,0,16,1
12544,6,29,3,0,26,3
12544,5,22,4,0,18,4
12544,4,20,5,0,15,5
12544,3,6,1,0,5,1
12544,2,6,3,0,3,3
5694,9,3,1,0,2,1
5694,8,11,4,0,7,4
5694,7,30,10,0,20,10
5694,6,41,12,0,29,12
5694,5,20,9,0,11,9
5694,4,9,5,0,4,5
15471,9,5,1,0,4,1
15471,8,12,3,0,9,3
15471,7,32,8,0,24,8
15471,6,39,9,0,30,9
15471,5,12,4,0,8,4
15471,4,9,1,0,8,1
15471,3,3,1,0,2,1
15471,2,2,1,0,1,1
17536,10,14,2,0,12,2
17536,9,20,4,0,16,4
17536,8,49,13,0,36,13
17536,7,20,4,0,16,4
17536,5,3,1,0,2,1
17536,3,3,1,0,2,1
244082,10,1,1,0,0,1
244082,8,15,2,0,13,2
244082,7,33,5,0,28,5
244082,6,33,6,0,27,6
244082,5,20,3,0,17,3
244082,4,8,2,0,6,2
244082,3,3,1,0,2,1
113931,10,11,3,0,8,3
113931,9,9,2,0,7,2
113931,8,55,9,0,46,9
113931,7,19,1,0,18,1
113931,6,14,1,0,13,1
1504,9,2,2,0,0,2
1504,8,15,3,0,12,3
1504,7,16,4,0,12,4
1504,6,35,5,0,30,5
1504,5,21,8,0,13,8
1504,4,17,6,0,11,6
5826,10,2,1,0,1,1
5826,9,11,4,0,7,4
5826,8,33,8,0,25,8
5826,7,24,5,0,19,5
5826,6,31,10,0,21,10
5826,3,1,1,0,0,1
234292,10,3,2,0,1,2
234292,9,2,1,0,1,1
234292,8,17,2,0,15,2
234292,7,33,6,0,27,6
234292,6,38,5,0,33,5
234292,5,9,1,0,8,1
234292,4,8,1,0,7,1
234292,3,2,1,0,1,1
214296,10,25,6,0,19,6
214296,9,42,14,0,28,14
214296,8,31,8,0,23,8
214296,7,12,4,0,8,4
6112,10,6,3,0,3,3
6112,9,2,2,0,0,2
6112,8,20,9,0,11,9
6112,7,21,6,0,15,6
6112,6,34,10,0,24,10
6112,5,13,1,0,12,1
6112,4,8,2,0,6,2
6112,3,8,2,0,6,2
6112,1,1,1,0,0,1
13016,10,8,4,0,4,4
13016,9,19,8,0,11,8
13016,8,39,13,0,26,13
13016,7,26,9,0,17,9
13016,6,16,1,0,15,1
13016,4,1,1,0,0,1
13016,3,2,1,0,1,1
7177,10,3,2,0,1,2
7177,9,5,2,0,3,2
7177,8,33,11,0,22,11
7177,7,26,9,0,17,9
7177,6,24,7,0,17,7
7177,5,8,2,0,6,2
7177,4,6,2,0,4,2
7177,3,4,2,0,2,2
7177,2,2,2,0,0,2
7177,1,2,1,0,1,1
246761,8,28,4,0,24,4
246761,7,41,6,0,35,6
246761,6,22,5,0,17,5
25617,9,5,2,0,3,2
25617,8,9,2,0,7,2
25617,7,31,8,0,23,8
25617,6,38,7,0,31,7
25617,5,12,2,0,10,2
25617,4,15,5,0,10,5
38328,10,13,8,0,5,8
38328,9,10,6,0,4,6
38328,8,14,8,0,6,8
38328,7,15,4,0,11,4
38328,6,24,6,0,18,6
38328,5,12,4,0,8,4
38328,4,7,1,0,6,1
38328,3,7,2,0,5,2
38328,1,5,3,0,2,3
1749,7,11,5,0,6,5
1749,6,20,7,0,13,7
1749,5,24,10,0,14,10
1749,4,30,12,0,18,12
1749,3,12,5,0,7,5
1749,2,10,5,0,5,5
1749,1,2,2,0,0,2
3162,10,2,2,0,0,2
3162,9,3,1,0,2,1
3162,8,11,3,0,8,3
3162,7,29,8,0,21,8
3162,6,36,14,0,22,14
3162,5,24,5,0,19,5
3162,4,7,3,0,4,3
6731,10,2,1,0,1,1
6731,8,7,1,0,6,1
6731,7,14,5,0,9,5
6731,6,26,3,0,23,3
6731,5,24,7,0,17,7
6731,4,19,3,0,16,3
6731,3,17,5,0,12,5
6731,2,3,3,0,0,3
181955,8,18,2,0,16,2
181955,7,30,6,0,24,6
181955,6,32,9,0,23,9
181955,5,14,5,0,9,5
181955,3,10,3,0,7,3
12134,10,14,7,0,7,7
12134,9,30,7,0,23,7
12134,8,38,11,0,27,11
12134,7,16,5,0,11,5
12134,6,6,3,0,3,3
12134,5,2,1,0,1,1
12134,4,1,1,0,0,1
12134,3,2,1,0,1,1
6916,10,3,1,0,2,1
6916,8,21,10,0,11,10
6916,7,35,18,0,17,18
6916,6,33,12,0,21,12
6916,5,11,1,0,10,1
31336,10,6,2,0,4,2
31336,9,13,2,0,11,2
31336,8,23,11,0,12,11
31336,7,21,5,0,16,5
31336,6,22,2,0,20,2
31336,5,17,4,0,13,4
31336,4,5,3,0,2,3
31336,2,4,2,0,2,2
1437,7,7,3,0,4,3
1437,6,32,9,0,23,9
1437,5,35,9,0,26,9
1437,4,23,10,0,13,10
1437,3,7,1,0,6,1
1437,2,4,1,0,3,1
1437,1,3,1,0,2,1
2262,10,7,6,0,1,6
2262,9,4,2,0,2,2
2262,8,20,8,0,12,8
2262,7,29,9,0,20,9
2262,6,28,5,0,23,5
2262,5,14,11,0,3,11
2262,4,6,4,0,2,4
2262,3,2,2,0,0,2
2262,2,3,1,0,2,1
11037,8,8,1,0,7,1
11037,7,13,2,0,11,2
11037,6,34,8,0,26,8
11037,5,20,5,0,15,5
11037,4,13,4,0,9,4
11037,3,10,2,0,8,2
11037,2,10,3,0,7,3
11037,1,4,1,0,3,1
83199,7,23,2,0,21,2
83199,6,38,8,0,30,8
83199,5,25,5,0,20,5
83199,4,13,4,0,9,4
8755,8,10,5,0,5,5
8755,7,15,6,0,9,6
8755,6,33,14,0,19,14
8755,5,31,12,0,19,12
8755,4,15,7,0,8,7
8755,3,2,1,0,1,1
8755,2,2,1,0,1,1
8755,1,1,1,0,0,1
148209,10,6,1,0,5,1
148209,9,15,4,0,11,4
148209,8,10,3,0,7,3
148209,7,30,3,0,27,3
148209,6,22,8,0,14,8
148209,5,15,1,0,14,1
148209,4,7,2,0,5,2
148209,2,3,2,0,1,2
8598,7,7,2,0,5,2
8598,6,21,7,0,14,7
8598,5,24,6,0,18,6
8598,4,19,3,0,16,3
8598,3,12,2,0,10,2
8598,2,16,6,0,10,6
8598,1,7,2,0,5,2
6928,9,17,2,0,15,2
6928,8,33,8,0,25,8
6928,7,30,6,0,24,6
6928,6,17,2,0,15,2
6928,5,7,3,0,4,3
6928,4,2,1,0,1,1
57458,8,10,3,0,7,3
57458,7,16,2,0,14,2
57458,6,44,8,0,36,8
57458,5,21,5,0,16,5
57458,4,13,5,0,8,5
57458,3,5,1,0,4,1
3246,10,3,2,0,1,2
3246,9,7,2,0,5,2
3246,8,18,6,0,12,6
3246,7,26,10,0,16,10
3246,6,39,17,0,22,17
3246,5,16,4,0,12,4
3246,4,2,1,0,1,1
3246,2,2,1,0,1,1
212450,10,16,3,0,13,3
212450,9,14,4,0,10,4
212450,8,35,13,2,22,11
212450,7,19,2,0,17,2
212450,6,19,3,0,16,3
212450,5,4,2,0,2,2
212450,3,1,1,0,0,1
8009,10,1,1,0,0,1
8009,7,8,1,0,7,1
8009,6,26,8,0,18,8
8009,5,25,5,0,20,5
8009,4,33,6,0,27,6
8009,3,13,2,0,11,2
8009,2,4,2,0,2,2
241724,10,12,3,1,9,2
241724,9,30,20,3,10,17
241724,8,38,12,3,26,9
241724,7,18,6,2,12,4
241724,6,13,5,0,8,5
241724,5,1,1,1,0,0
241724,4,2,1,0,1,1
4270,10,5,1,0,4,1
4270,9,10,8,0,2,8
4270,8,29,14,0,15,14
4270,7,29,10,0,19,10
4270,6,29,11,0,18,11
4270,5,8,3,0,5,3
4270,4,3,1,0,2,1
67695,10,1,1,0,0,1
67695,9,4,1,0,3,1
67695,8,5,1,0,4,1
67695,7,16,7,0,9,7
67695,6,39,4,0,35,4
67695,5,25,5,0,20,5
67695,4,13,3,0,10,3
67695,3,8,3,0,5,3
67695,2,2,2,0,0,2
3152,9,7,1,0,6,1
3152,8,11,2,0,9,2
3152,7,27,6,0,21,6
3152,6,47,14,0,33,14
3152,5,11,3,0,8,3
3152,4,4,1,0,3,1
3152,3,1,1,0,0,1
7831,10,4,3,0,1,3
7831,9,6,2,0,4,2
7831,8,28,12,0,16,12
7831,7,41,9,0,32,9
7831,6,24,11,0,13,11
7831,5,9,3,0,6,3
7831,4,1,1,0,0,1
181244,8,15,6,0,9,6
181244,7,37,12,0,25,12
181244,6,35,8,0,27,8
181244,5,12,1,0,11,1
181244,4,8,3,0,5,3
181244,3,2,1,0,1,1
181244,2,3,1,0,2,1
148375,10,14,4,0,10,4
148375,9,12,7,0,5,7
148375,8,14,6,0,8,6
148375,7,26,9,1,17,8
148375,6,22,3,0,19,3
148375,5,11,5,0,6,5
148375,4,6,2,0,4,2
148375,3,4,1,0,3,1
3476,8,5,1,0,4,1
3476,7,7,3,0,4,3
3476,6,31,3,0,28,3
3476,5,32,8,0,24,8
3476,4,18,4,0,14,4
3476,3,11,5,0,6,5
173337,9,5,1,0,4,1
173337,8,22,5,0,17,5
173337,7,32,6,0,26,6
173337,6,38,5,0,33,5
173337,5,10,2,0,8,2
12317,8,8,3,0,5,3
12317,7,11,2,0,9,2
12317,6,44,7,0,37,7
12317,5,25,2,0,23,2
12317,4,13,4,0,9,4
12317,3,7,2,0,5,2
180208,8,12,2,0,10,2
180208,7,20,3,0,17,3
180208,6,37,8,0,29,8
180208,5,15,2,0,13,2
180208,4,12,4,0,8,4
180208,3,7,1,0,6,1
180208,2,5,2,0,3,2
180208,1,2,1,0,1,1
207951,10,8,4,0,4,4
207951,9,25,8,0,17,8
207951,8,38,14,0,24,14
207951,7,30,7,0,23,7
207951,6,4,3,0,1,3
207951,5,4,3,0,1,3
7138,10,17,9,0,8,9
7138,9,24,7,0,17,7
7138,8,36,15,0,21,15
7138,7,21,8,0,13,8
7138,6,9,4,0,5,4
7138,5,2,2,0,0,2
7138,3,2,2,0,0,2
171278,10,12,4,0,8,4
171278,9,22,8,0,14,8
171278,8,51,15,0,36,15
171278,7,19,4,0,15,4
171278,5,1,1,0,0,1
171278,4,1,1,0,0,1
171278,2,1,1,0,0,1
5715,9,1,1,0,0,1
5715,8,4,1,0,3,1
5715,7,17,4,0,13,4
5715,6,36,5,0,31,5
5715,5,29,6,0,23,6
5715,4,11,4,0,7,4
5715,3,6,3,0,3,3
5715,2,6,1,0,5,1
1727,8,9,2,0,7,2
1727,7,17,9,0,8,9
1727,6,48,22,0,26,22
1727,5,15,5,0,10,5
1727,4,14,4,0,10,4
1727,3,8,5,0,3,5
64610,8,4,1,0,3,1
64610,7,8,3,0,5,3
64610,6,17,3,0,14,3
64610,5,35,8,0,27,8
64610,4,28,5,0,23,5
64610,3,9,2,0,7,2
64610,2,7,2,0,5,2
3670,10,3,1,0,2,1
3670,8,18,11,0,7,11
3670,7,29,12,0,17,12
3670,6,35,10,0,25,10
3670,5,14,4,0,10,4
3670,4,10,3,0,7,3
3670,3,2,2,0,0,2
83278,10,2,1,0,1,1
83278,8,12,2,0,10,2
83278,7,19,2,0,17,2
83278,6,32,4,0,28,4
83278,5,17,3,0,14,3
83278,4,19,3,0,16,3
83278,3,7,3,0,4,3
6742,9,4,2,0,2,2
6742,8,11,3,0,8,3
6742,7,27,12,0,15,12
6742,6,25,9,0,16,9
6742,5,28,7,0,21,7
6742,4,5,2,0,3,2
6742,3,4,2,0,2,2
6742,2,4,1,0,3,1
6742,1,2,1,0,1,1
164147,10,17,9,0,8,9
164147,9,7,3,0,4,3
164147,8,20,4,1,16,3
164147,7,23,5,0,18,5
164147,6,25,8,1,17,7
164147,5,6,2,1,4,1
164147,4,3,1,0,2,1
164147,3,8,3,0,5,3
126728,8,8,1,0,7,1
126728,7,27,3,0,24,3
126728,6,38,3,0,35,3
126728,5,17,3,0,14,3
126728,4,9,1,0,8,1
126728,3,6,1,0,5,1
126728,1,3,1,0,2,1
39029,8,9,6,0,3,6
39029,7,25,6,0,19,6
39029,6,36,14,0,22,14
39029,5,21,4,0,17,4
39029,4,13,5,0,8,5
180211,10,6,4,0,2,4
180211,9,10,2,0,8,2
180211,8,12,4,0,8,4
180211,7,29,4,0,25,4
180211,6,34,7,0,27,7
180211,5,8,2,0,6,2
180211,4,6,2,0,4,2
180211,3,3,1,0,2,1
180211,1,2,1,0,1,1
178166,9,13,4,0,9,4
178166,8,20,3,0,17,3
178166,7,29,5,0,24,5
178166,6,33,2,0,31,2
178166,5,5,1,0,4,1
152867,10,2,2,0,0,2
152867,9,3,3,0,0,3
152867,8,10,1,0,9,1
152867,7,17,2,0,15,2
152867,6,32,7,0,25,7
152867,5,18,3,0,15,3
152867,4,15,3,0,12,3
152867,2,4,1,0,3,1
152867,1,1,1,0,0,1
6046,10,6,2,0,4,2
6046,9,4,2,0,2,2
6046,8,13,9,0,4,9
6046,7,41,11,0,30,11
6046,6,26,10,0,16,10
6046,5,14,3,0,11,3
6046,4,7,2,0,5,2
185378,10,15,3,0,12,3
185378,9,27,5,0,22,5
185378,8,36,6,0,30,6
185378,7,18,3,0,15,3
185378,6,10,3,0,7,3
185378,5,3,2,0,1,2
66080,10,4,1,0,3,1
66080,9,16,6,0,10,6
66080,8,39,13,0,26,13
66080,7,23,7,0,16,7
66080,6,20,8,0,12,8
66080,5,8,6,0,2,6
66080,4,3,3,0,0,3
1503,8,7,3,0,4,3
1503,7,15,1,0,14,1
1503,6,22,2,0,20,2
1503,5,26,11,0,15,11
1503,4,21,5,0,16,5
1503,3,15,5,0,10,5
1503,2,2,1,0,1,1
1503,1,3,3,0,0,3
4107,9,1,1,0,0,1
4107,8,14,6,0,8,6
4107,7,25,11,0,14,11
4107,6,33,8,0,25,8
4107,5,28,11,0,17,11
4107,4,8,1,0,7,1
4107,3,1,1,0,0,1
1477,10,6,4,0,2,4
1477,9,4,2,0,2,2
1477,8,9,1,0,8,1
1477,7,25,4,0,21,4
1477,6,43,13,0,30,13
1477,5,13,1,0,12,1
1477,4,8,2,0,6,2
1477,3,3,1,0,2,1
1477,1,1,1,0,0,1
253379,9,8,2,0,6,2
253379,8,34,6,0,28,6
253379,7,34,5,0,29,5
253379,6,21,2,0,19,2
253379,5,7,2,0,5,2
253379,4,6,2,0,4,2
4770,10,3,1,0,2,1
4770,9,3,2,0,1,2
4770,8,9,6,0,3,6
4770,7,14,4,0,10,4
4770,6,25,5,0,20,5
4770,5,16,8,0,8,8
4770,4,16,6,0,10,6
4770,3,15,9,0,6,9
4770,2,9,2,0,7,2
170756,10,4,1,0,3,1
170756,9,10,5,0,5,5
170756,8,24,5,0,19,5
170756,7,38,8,1,30,7
170756,6,24,6,1,18,5
170756,5,8,4,0,4,4
170756,2,2,1,0,1,1
77361,9,9,2,0,7,2
77361,8,22,1,0,21,1
77361,7,24,5,0,19,5
77361,6,40,7,0,33,7
77361,4,3,1,0,2,1
232509,10,14,2,0,12,2
232509,9,8,1,0,7,1
232509,8,17,2,0,15,2
232509,7,28,2,0,26,2
232509,6,25,2,0,23,2
232509,4,6,1,0,5,1
232509,2,2,1,0,1,1
94571,10,3,2,0,1,2
94571,9,4,1,0,3,1
94571,8,11,4,0,7,4
94571,7,20,3,0,17,3
94571,6,33,9,0,24,9
94571,5,17,4,0,13,4
94571,4,11,3,0,8,3
94571,3,4,2,0,2,2
94571,2,7,3,0,4,3
20907,10,2,1,0,1,1
20907,9,4,1,0,3,1
20907,8,20,11,0,9,11
20907,7,33,14,0,19,14
20907,6,38,12,0,26,12
20907,5,12,3,0,9,3
20907,4,1,1,0,0,1
20907,3,1,1,0,0,1
7861,9,9,2,0,7,2
7861,8,15,10,0,5,10
7861,7,24,6,0,18,6
7861,6,29,7,0,22,7
7861,5,13,3,0,10,3
7861,4,12,1,0,11,1
7861,3,4,3,0,1,3
7861,2,5,4,0,1,4
31335,8,9,3,0,6,3
31335,7,19,6,0,13,6
31335,6,36,13,0,23,13
31335,5,23,10,0,13,10
31335,4,14,6,0,8,6
31335,3,5,3,0,2,3
31335,2,2,1,0,1,1
35865,10,2,1,0,1,1
35865,9,10,1,0,9,1
35865,8,34,8,0,26,8
35865,7,28,11,0,17,11
35865,6,27,9,0,18,9
35865,5,6,3,0,3,3
35865,4,4,2,0,2,2
15069,8,32,9,0,23,9
15069,7,31,5,0,26,5
15069,6,28,5,0,23,5
15069,5,8,4,0,4,4
15069,4,5,3,0,2,3
15069,3,3,1,0,2,1
245931,10,15,4,0,11,4
245931,9,17,6,1,11,5
245931,8,41,3,0,38,3
245931,7,31,6,0,25,6
245931,6,15,1,0,14,1
245931,1,3,1,0,2,1
20499,8,14,3,0,11,3
20499,7,15,2,0,13,2
20499,6,31,3,0,28,3
20499,5,16,2,0,14,2
20499,4,20,3,0,17,3
20499,3,8,1,0,7,1
20499,2,3,1,0,2,1
20499,1,2,2,0,0,2
2841,9,1,1,0,0,1
2841,7,9,4,0,5,4
2841,6,27,8,0,19,8
2841,5,29,12,0,17,12
2841,4,20,3,0,17,3
2841,3,16,7,0,9,7
2841,2,8,3,0,5,3
2841,1,1,1,0,0,1
161782,10,8,1,0,7,1
161782,8,36,6,2,30,4
161782,7,33,3,0,30,3
161782,6,15,2,0,13,2
161782,5,8,1,0,7,1
161782,4,3,2,0,1,2
161782,2,1,1,0,0,1
161782,1,1,1,0,0,1
235544,9,23,4,0,19,4
235544,8,38,5,0,33,5
235544,7,26,5,0,21,5
235544,6,9,2,0,7,2
235544,5,3,1,0,2,1
235544,2,1,1,0,0,1
230273,9,16,3,0,13,3
230273,8,37,4,0,33,4
230273,7,29,6,0,23,6
230273,6,14,3,0,11,3
230273,5,4,2,0,2,2
230273,4,2,1,0,1,1
230273,3,3,3,0,0,3
4696,7,10,3,0,7,3
4696,6,33,8,0,25,8
4696,5,27,6,0,21,6
4696,4,23,11,0,12,11
4696,3,10,8,0,2,8
4696,2,5,2,0,3,2
4696,1,1,1,0,0,1
228378,10,11,3,0,8,3
228378,9,6,4,0,2,4
228378,8,39,10,0,29,10
228378,7,20,3,0,17,3
228378,6,22,6,0,16,6
228378,5,7,1,0,6,1
228378,4,4,2,0,2,2
228378,3,3,2,0,1,2
146496,7,19,2,0,17,2
146496,6,30,5,0,25,5
146496,5,18,2,0,16,2
146496,4,14,1,0,13,1
146496,2,9,4,0,5,4
16538,10,7,2,0,5,2
16538,9,11,4,0,7,4
16538,8,24,9,0,15,9
16538,7,29,10,0,19,10
16538,6,13,2,0,11,2
16538,5,8,1,0,7,1
16538,2,1,1,0,0,1
16538,1,4,1,0,3,1
29118,9,1,1,0,0,1
29118,8,5,4,0,1,4
29118,7,18,4,0,14,4
29118,6,45,9,0,36,9
29118,5,24,8,0,16,8
29118,4,9,2,0,7,2
29118,3,5,3,0,2,3
29118,2,3,2,0,1,2
136609,8,4,1,0,3,1
136609,6,29,3,0,26,3
136609,5,33,3,0,30,3
136609,4,13,2,0,11,2
136609,3,16,3,0,13,3
136609,2,7,1,0,6,1
5650,10,2,1,0,1,1
5650,8,4,2,0,2,2
5650,6,8,3,0,5,3
5650,5,15,5,0,10,5
5650,4,18,6,0,12,6
5650,3,22,5,0,17,5
5650,2,19,9,0,10,9
5650,1,19,6,0,13,6
19114,10,2,1,0,1,1
19114,9,1,1,0,0,1
19114,8,12,4,0,8,4
19114,7,18,7,0,11,7
19114,6,26,9,0,17,9
19114,5,20,8,0,12,8
19114,4,17,7,0,10,7
19114,3,11,4,0,7,4
19114,2,4,1,0,3,1
173666,10,8,5,1,3,4
173666,9,12,8,1,4,7
173666,8,21,13,2,8,11
173666,7,17,6,0,11,6
173666,6,22,4,0,18,4
173666,5,13,5,0,8,5
173666,4,11,3,0,8,3
173666,3,4,2,0,2,2
173666,2,4,1,0,3,1
257164,8,23,2,0,21,2
257164,7,45,4,0,41,4
257164,6,22,2,0,20,2
257164,5,7,1,0,6,1
117549,9,1,1,0,0,1
117549,8,12,5,0,7,5
117549,7,32,7,0,25,7
117549,6,32,11,0,21,11
117549,5,20,4,0,16,4
117549,3,2,1,0,1,1
117549,2,1,1,0,0,1
3357,8,5,2,0,3,2
3357,7,28,9,0,19,9
3357,6,30,6,0,24,6
3357,5,18,5,0,13,5
3357,4,19,5,0,14,5
3357,3,7,2,0,5,2
29383,10,13,4,0,9,4
29383,9,19,2,0,17,2
29383,8,35,7,0,28,7
29383,7,25,8,0,17,8
29383,6,10,2,0,8,2
29383,5,7,2,0,5,2
40853,10,1,1,0,0,1
40853,9,5,1,0,4,1
40853,8,10,1,0,9,1
40853,6,36,3,0,33,3
40853,5,17,2,0,15,2
40853,4,17,3,0,14,3
40853,3,6,2,0,4,2
2854,8,8,3,0,5,3
2854,7,13,5,0,8,5
2854,6,40,14,0,26,14
2854,5,24,4,0,20,4
2854,4,17,9,0,8,9
2854,2,3,1,0,2,1
2854,1,2,1,0,1,1
22085,8,2,1,0,1,1
22085,7,19,7,0,12,7
22085,6,36,8,0,28,8
22085,5,24,3,0,21,3
22085,4,11,5,0,6,5
22085,3,9,1,0,8,1
22085,2,6,1,0,5,1
103883,10,1,1,0,0,1
103883,9,5,3,0,2,3
103883,8,18,7,0,11,7
103883,7,24,7,0,17,7
103883,6,42,3,0,39,3
103883,5,15,4,0,11,4
103883,4,3,1,0,2,1
4242,8,5,2,0,3,2
4242,7,12,7,0,5,7
4242,6,28,9,0,19,9
4242,5,20,6,0,14,6
4242,4,23,10,0,13,10
4242,3,18,5,0,13,5
4242,2,3,3,0,0,3
1390,9,3,1,0,2,1
1390,8,14,5,0,9,5
1390,7,28,8,0,20,8
1390,6,30,7,0,23,7
1390,5,19,8,0,11,8
1390,4,10,3,0,7,3
2095,9,4,1,0,3,1
2095,8,13,4,0,9,4
2095,7,27,5,0,22,5
2095,6,37,11,0,26,11
2095,5,19,7,0,12,7
2095,4,8,2,0,6,2
2095,3,2,1,0,1,1
13436,10,1,1,0,0,1
13436,9,2,1,0,1,1
13436,8,12,6,0,6,6
13436,7,19,7,0,12,7
13436,6,38,8,0,30,8
13436,5,17,3,0,14,3
13436,4,13,5,0,8,5
13436,2,4,1,0,3,1
13436,1,3,1,0,2,1
91010,10,3,2,0,1,2
91010,9,9,5,0,4,5
91010,8,46,19,0,27,19
91010,7,32,8,0,24,8
91010,6,18,10,0,8,10
11396,7,29,7,0,22,7
11396,6,41,9,0,32,9
11396,5,19,6,0,13,6
11396,4,7,3,0,4,3
11396,3,3,1,0,2,1
169436,8,12,3,0,9,3
169436,7,29,2,0,27,2
169436,6,41,4,0,37,4
169436,5,15,3,0,12,3
169436,3,3,1,0,2,1
169436,2,2,1,0,1,1
228425,10,3,1,0,2,1
228425,9,4,1,0,3,1
228425,8,18,5,0,13,5
228425,7,36,6,0,30,6
228425,6,31,2,0,29,2
228425,5,12,2,0,10,2
191110,8,15,2,0,13,2
191110,7,14,1,0,13,1
191110,6,30,4,0,26,4
191110,5,18,3,0,15,3
191110,4,12,1,0,11,1
191110,3,11,1,0,10,1
191110,2,2,1,0,1,1
66695,10,2,1,0,1,1
66695,8,9,1,0,8,1
66695,7,25,3,0,22,3
66695,6,40,10,0,30,10
66695,5,19,5,0,14,5
66695,4,11,3,0,8,3
66695,3,1,1,0,0,1
5991,10,5,3,0,2,3
5991,9,16,7,0,9,7
5991,8,25,7,0,18,7
5991,7,36,12,0,24,12
5991,6,21,8,0,13,8
5991,5,5,3,0,2,3
5991,3,1,1,0,0,1
752,8,4,2,0,2,2
752,7,9,3,0,6,3
752,6,27,9,0,18,9
752,5,19,4,0,15,4
752,4,22,11,0,11,11
752,3,13,6,0,7,6
752,2,11,6,0,5,6
752,1,5,3,0,2,3
260298,10,2,1,0,1,1
260298,9,5,2,0,3,2
260298,8,17,4,0,13,4
260298,7,19,1,0,18,1
260298,6,40,7,0,33,7
260298,5,17,4,0,13,4
260298,4,4,1,0,3,1
202564,10,3,1,0,2,1
202564,8,14,2,0,12,2
202564,7,29,3,0,26,3
202564,6,45,7,0,38,7
244320,10,4,2,0,2,2
244320,9,3,1,0,2,1
244320,8,24,6,0,18,6
244320,7,30,4,0,26,4
244320,6,39,2,0,37,2
244320,5,6,2,0,4,2
244320,4,4,1,0,3,1
42131,10,13,4,0,9,4
42131,9,10,3,0,7,3
42131,8,30,6,0,24,6
42131,7,22,6,0,16,6
42131,6,13,3,0,10,3
42131,5,7,1,0,6,1
42131,4,2,1,0,1,1
42131,3,3,1,0,2,1
42131,2,1,1,0,0,1
22399,9,2,1,0,1,1
22399,8,18,7,0,11,7
22399,7,18,8,0,10,8
22399,6,52,20,0,32,20
22399,5,14,5,0,9,5
22399,4,7,4,0,3,4
6516,9,11,3,0,8,3
6516,8,25,7,0,18,7
6516,7,26,4,0,22,4
6516,5,10,5,0,5,5
6516,3,3,1,0,2,1
6516,2,2,1,0,1,1
471,8,5,1,0,4,1
471,6,36,6,0,30,6
471,5,27,10,0,17,10
471,4,14,2,0,12,2
471,3,6,2,0,4,2
471,2,3,2,0,1,2
147445,10,4,2,0,2,2
147445,9,3,1,0,2,1
147445,8,12,1,0,11,1
147445,7,15,2,0,13,2
147445,6,32,7,0,25,7
147445,4,15,3,1,12,2
147445,3,5,2,0,3,2
147445,1,3,1,0,2,1
247724,9,11,1,0,10,1
247724,8,40,8,0,32,8
247724,7,32,3,0,29,3
247724,6,13,2,0,11,2
247724,5,3,1,0,2,1
247724,3,2,2,0,0,2
247724,2,1,1,0,0,1
28004,9,9,1,0,8,1
28004,8,22,3,0,19,3
28004,7,29,3,0,26,3
28004,6,31,3,0,28,3
28004,5,13,3,0,10,3
28004,4,4,1,0,3,1
28004,2,1,1,0,0,1
3324,9,2,1,0,1,1
3324,8,6,2,0,4,2
3324,7,12,4,0,8,4
3324,6,25,9,0,16,9
3324,5,30,7,0,23,7
3324,4,27,13,0,14,13
3324,3,6,3,0,3,3
3324,2,2,1,0,1,1
12071,10,18,8,0,10,8
12071,9,23,8,0,15,8
12071,8,39,15,0,24,15
12071,7,21,6,0,15,6
12071,6,5,1,0,4,1
177877,10,5,3,0,2,3
177877,9,15,7,0,8,7
177877,8,29,7,0,22,7
177877,7,31,7,0,24,7
177877,6,22,6,1,16,5
177877,5,7,2,0,5,2
180906,9,8,4,0,4,4
180906,8,27,5,0,22,5
180906,7,30,5,0,25,5
180906,6,19,3,0,16,3
180906,5,11,1,0,10,1
180906,4,4,1,0,3,1
180906,3,4,1,0,3,1
180906,1,1,1,0,0,1
67199,10,10,2,0,8,2
67199,9,24,10,0,14,10
67199,8,49,20,0,29,20
67199,7,16,8,0,8,8
67199,6,7,2,0,5,2
67199,5,4,1,0,3,1
67199,4,1,1,0,0,1
173452,9,9,4,0,5,4
173452,8,27,5,0,22,5
173452,7,30,5,0,25,5
173452,6,26,5,0,21,5
173452,5,13,2,0,11,2
23654,9,3,1,0,2,1
23654,8,9,2,0,7,2
23654,7,25,10,0,15,10
23654,6,44,10,0,34,10
23654,5,19,2,0,17,2
23654,4,9,2,0,7,2
23654,3,1,1,0,0,1
23654,2,1,1,0,0,1
4613,10,4,1,0,3,1
4613,9,20,6,0,14,6
4613,8,35,13,0,22,13
4613,7,31,11,0,20,11
4613,6,11,2,0,9,2
4613,5,5,1,0,4,1
4613,3,2,1,0,1,1
132532,9,2,2,0,0,2
132532,8,12,4,0,8,4
132532,7,17,3,0,14,3
132532,6,40,9,0,31,9
132532,5,20,3,0,17,3
132532,4,8,2,0,6,2
132532,3,7,2,0,5,2
132532,2,2,1,0,1,1
4126,8,5,3,0,2,3
4126,7,6,1,0,5,1
4126,6,19,11,0,8,11
4126,5,25,6,0,19,6
4126,4,23,7,0,16,7
4126,3,17,4,0,13,4
4126,2,9,6,0,3,6
4126,1,5,3,0,2,3
171548,10,1,1,0,0,1
171548,9,3,1,0,2,1
171548,8,12,4,0,8,4
171548,7,20,1,0,19,1
171548,6,42,5,0,37,5
171548,5,17,3,0,14,3
171548,3,3,1,0,2,1
171548,2,1,1,0,0,1
141102,10,2,2,0,0,2
141102,8,5,3,0,2,3
141102,7,29,10,0,19,10
141102,6,30,6,1,24,5
141102,5,24,4,0,20,4
141102,4,10,1,0,9,1
30505,9,4,2,0,2,2
30505,8,27,7,0,20,7
30505,7,36,13,0,23,13
30505,6,25,11,0,14,11
30505,5,9,1,0,8,1
30505,4,6,2,0,4,2
2637,8,10,4,0,6,4
2637,7,19,3,0,16,3
2637,6,31,8,0,23,8
2637,5,26,11,0,15,11
2637,4,7,3,0,4,3
2637,3,9,4,0,5,4
2637,2,8,4,0,4,4
144587,9,4,2,0,2,2
144587,8,13,5,0,8,5
144587,7,21,2,0,19,2
144587,6,43,9,0,34,9
144587,5,15,3,0,12,3
144587,4,8,4,0,4,4
144587,3,5,3,0,2,3
95756,9,8,3,0,5,3
95756,8,21,2,0,19,2
95756,7,17,3,0,14,3
95756,6,42,4,0,38,4
95756,5,10,2,0,8,2
6037,9,5,4,0,1,4
6037,8,13,7,0,6,7
6037,7,37,14,0,23,14
6037,6,34,12,0,22,12
6037,5,13,2,0,11,2
6037,4,3,1,0,2,1
6037,3,4,2,0,2,2
165521,10,7,2,0,5,2
165521,9,5,1,0,4,1
165521,8,16,1,0,15,1
165521,7,38,4,0,34,4
165521,6,25,4,0,21,4
165521,5,14,2,0,12,2
165521,3,2,1,0,1,1
102275,10,4,3,0,1,3
102275,9,8,3,0,5,3
102275,8,24,10,0,14,10
102275,7,30,13,0,17,13
102275,6,32,12,0,20,12
102275,5,8,4,0,4,4
102275,4,2,1,0,1,1
46147,9,4,1,0,3,1
46147,8,12,2,0,10,2
46147,7,15,1,0,14,1
46147,6,24,5,0,19,5
46147,5,21,2,0,19,2
46147,4,16,4,0,12,4
46147,3,10,1,0,9,1
46147,1,5,4,0,1,4
164760,10,11,5,0,6,5
164760,9,13,11,0,2,11
164760,8,20,4,0,16,4
164760,7,24,7,0,17,7
164760,6,23,4,2,19,2
164760,5,11,1,0,10,1
164760,4,5,2,0,3,2
164760,3,3,1,0,2,1
7638,8,19,10,0,9,10
7638,7,21,5,0,16,5
7638,6,41,13,0,28,13
7638,5,14,3,0,11,3
7638,4,5,2,0,3,2
7638,2,2,2,0,0,2
7106,7,31,4,0,27,4
7106,6,25,4,0,21,4
7106,5,20,2,0,18,2
7106,4,8,2,0,6,2
7106,3,8,1,0,7,1
6918,10,3,2,0,1,2
6918,9,4,1,0,3,1
6918,8,14,5,0,9,5
6918,7,25,8,0,17,8
6918,6,42,18,0,24,18
6918,5,17,4,0,13,4
6918,4,4,2,0,2,2
297,7,20,5,0,15,5
297,6,33,2,0,31,2
297,5,20,5,0,15,5
297,4,17,7,0,10,7
297,3,13,3,0,10,3
297,2,2,2,0,0,2
136415,10,2,1,0,1,1
136415,8,5,3,0,2,3
136415,7,18,5,0,13,5
136415,6,43,10,0,33,10
136415,5,27,6,0,21,6
136415,4,8,2,0,6,2
136415,3,6,1,0,5,1
1322,8,6,3,0,3,3
1322,7,21,8,0,13,8
1322,6,28,9,0,19,9
1322,5,32,7,0,25,7
1322,4,10,3,0,7,3
1322,3,8,3,0,5,3
1322,1,1,1,0,0,1
165302,10,3,1,0,2,1
165302,9,4,2,0,2,2
165302,8,7,2,1,5,1
165302,7,13,2,1,11,1
165302,6,21,4,1,17,3
165302,5,21,3,0,18,3
165302,4,16,2,0,14,2
165302,3,6,2,0,4,2
165302,2,7,3,2,4,1
165302,1,12,8,1,4,7
2836,10,3,1,0,2,1
2836,9,2,1,0,1,1
2836,8,14,5,0,9,5
2836,7,20,2,0,18,2
2836,6,30,1,0,29,1
2836,5,21,6,0,15,6
2836,4,13,6,0,7,6
2836,3,5,3,0,2,3
8350,10,3,2,0,1,2
8350,9,4,1,0,3,1
8350,8,16,8,0,8,8
8350,7,28,8,0,20,8
8350,6,40,15,0,25,15
8350,5,14,5,0,9,5
8350,4,3,2,0,1,2
8350,3,2,2,0,0,2
525,10,1,1,0,0,1
525,8,12,2,0,10,2
525,7,33,8,0,25,8
525,6,40,11,0,29,11
525,5,16,6,0,10,6
525,4,6,1,0,5,1
159507,9,2,1,0,1,1
159507,8,6,2,0,4,2
159507,6,39,3,0,36,3
159507,5,20,1,0,19,1
159507,4,14,3,0,11,3
159507,3,6,3,0,3,3
159507,2,3,2,0,1,2
9629,10,10,4,0,6,4
9629,9,6,4,0,2,4
9629,8,27,9,0,18,9
9629,7,26,8,0,18,8
9629,6,24,7,0,17,7
9629,5,11,3,0,8,3
9629,4,5,1,0,4,1
9629,2,1,1,0,0,1
35662,10,3,2,0,1,2
35662,9,13,6,0,7,6
35662,8,23,11,0,12,11
35662,7,36,20,0,16,20
35662,6,21,8,0,13,8
35662,5,8,7,0,1,7
35662,4,4,3,0,1,3
187121,10,5,2,0,3,2
187121,9,3,1,0,2,1
187121,8,37,9,1,28,8
187121,7,34,7,1,27,6
187121,6,20,5,0,15,5
187121,4,4,1,0,3,1
167283,10,5,1,0,4,1
167283,9,6,1,0,5,1
167283,8,24,6,0,18,6
167283,7,23,5,0,18,5
167283,6,32,6,0,26,6
167283,5,10,2,0,8,2
167283,4,6,1,0,5,1
167283,2,3,1,0,2,1
10946,9,4,2,0,2,2
10946,8,7,1,0,6,1
10946,7,21,8,0,13,8
10946,6,34,8,0,26,8
10946,5,24,14,0,10,14
10946,4,8,6,0,2,6
10946,2,3,2,0,1,2
26778,7,12,2,0,10,2
26778,6,36,5,0,31,5
26778,5,23,2,0,21,2
26778,4,16,1,0,15,1
26778,3,11,1,0,10,1
3100,8,16,8,0,8,8
3100,7,22,7,0,15,7
3100,6,41,15,0,26,15
3100,5,21,7,0,14,7
3100,4,5,1,0,4,1
3100,3,4,3,0,1,3
108012,10,8,2,0,6,2
108012,8,19,5,0,14,5
108012,7,30,7,0,23,7
108012,6,31,7,0,24,7
108012,4,4,1,0,3,1
131457,8,26,9,2,17,7
131457,7,33,8,1,25,7
131457,6,23,5,0,18,5
131457,5,8,2,0,6,2
131457,4,9,2,0,7,2
131457,2,3,2,1,1,1
69316,10,4,2,0,2,2
69316,9,8,3,0,5,3
69316,8,20,6,0,14,6
69316,7,19,4,0,15,4
69316,6,36,4,0,32,4
69316,5,11,4,0,7,4
69316,4,6,2,0,4,2
69316,3,3,1,0,2,1
69316,2,2,2,0,0,2
238090,9,15,2,0,13,2
238090,8,35,7,1,28,6
238090,7,26,3,0,23,3
238090,6,24,3,0,21,3
238090,5,4,1,0,3,1
238090,4,2,1,1,1,0
9049,8,3,1,0,2,1
9049,7,12,3,0,9,3
9049,6,34,17,0,17,17
9049,5,33,8,0,25,8
9049,4,17,7,0,10,7
9049,3,6,3,0,3,3
3147,10,4,2,0,2,2
3147,8,17,1,0,16,1
3147,7,24,6,0,18,6
3147,6,36,11,0,25,11
3147,5,15,5,0,10,5
3147,4,7,3,0,4,3
3147,3,5,3,0,2,3
234105,8,6,1,0,5,1
234105,7,29,6,0,23,6
234105,6,46,5,0,41,5
234105,5,14,2,0,12,2
234105,4,7,3,0,4,3
234105,3,4,2,0,2,2
64656,8,9,1,0,8,1
64656,7,21,1,0,20,1
64656,6,41,7,0,34,7
64656,5,27,6,0,21,6
64656,4,7,1,0,6,1
64656,3,3,1,0,2,1
64656,2,2,1,0,1,1
13995,10,6,1,0,5,1
13995,8,26,4,0,22,4
13995,7,40,10,0,30,10
13995,6,20,1,0,19,1
13995,5,5,1,0,4,1
13995,4,4,4,0,0,4
13995,2,2,1,0,1,1
13512,10,8,1,0,7,1
13512,9,6,2,0,4,2
13512,8,21,2,0,19,2
13512,7,24,1,0,23,1
13512,6,31,4,0,27,4
13512,4,9,3,0,6,3
14137,8,13,4,0,9,4
14137,7,18,5,0,13,5
14137,6,39,2,0,37,2
14137,5,22,2,0,20,2
14137,4,11,3,0,8,3
14137,3,5,1,0,4,1
14137,2,1,1,0,0,1
4362,10,2,1,0,1,1
4362,9,6,4,0,2,4
4362,8,41,16,0,25,16
4362,7,35,8,0,27,8
4362,6,16,5,0,11,5
4362,5,7,1,0,6,1
4362,3,1,1,0,0,1
207911,7,26,2,0,24,2
207911,6,37,2,0,35,2
207911,5,12,2,0,10,2
207911,4,14,4,0,10,4
207911,2,6,3,0,3,3
207911,1,1,1,0,0,1
234093,10,7,3,0,4,3
234093,9,10,4,0,6,4
234093,8,22,3,0,19,3
234093,7,24,3,0,21,3
234093,6,27,4,0,23,4
234093,5,12,2,0,10,2
234093,3,4,1,0,3,1
2824,9,8,4,0,4,4
2824,8,10,3,0,7,3
2824,7,28,8,0,20,8
2824,6,34,9,0,25,9
2824,5,13,5,0,8,5
2824,4,8,3,0,5,3
2824,3,6,4,0,2,4
2824,1,1,1,0,0,1
4794,9,5,2,0,3,2
4794,8,9,2,0,7,2
4794,7,29,9,0,20,9
4794,6,21,7,0,14,7
4794,5,26,7,0,19,7
4794,4,10,4,0,6,4
4794,3,3,1,0,2,1
4794,2,1,1,0,0,1
4794,1,3,3,0,0,3
9803,8,25,10,0,15,10
9803,7,45,12,0,33,12
9803,6,22,8,0,14,8
9803,5,6,1,0,5,1
9803,4,5,3,0,2,3
9803,2,1,1,0,0,1
4289,10,6,2,0,4,2
4289,9,10,3,0,7,3
4289,8,39,14,0,25,14
4289,7,24,4,0,20,4
4289,6,18,1,0,17,1
4289,5,11,5,0,6,5
4289,4,1,1,0,0,1
93472,7,24,5,0,19,5
93472,6,47,8,0,39,8
93472,5,14,4,0,10,4
93472,4,10,2,0,8,2
2105,10,4,1,0,3,1
2105,9,7,3,0,4,3
2105,8,19,6,0,13,6
2105,7,23,5,0,18,5
2105,6,41,15,0,26,15
2105,4,7,4,0,3,4
145381,8,19,4,0,15,4
145381,7,24,6,0,18,6
145381,6,35,3,0,32,3
145381,4,7,1,0,6,1
145381,3,2,1,0,1,1
145381,1,2,1,0,1,1
5827,9,14,5,0,9,5
5827,8,26,9,0,17,9
5827,7,33,10,0,23,10
5827,6,15,1,0,14,1
5827,5,11,3,0,8,3
5827,4,3,1,0,2,1
378,9,6,1,0,5,1
378,8,30,9,0,21,9
378,7,41,12,0,29,12
378,6,20,9,0,11,9
378,5,5,3,0,2,3
378,4,6,1,0,5,1
212027,8,6,3,0,3,3
212027,7,20,3,0,17,3
212027,6,41,9,0,32,9
212027,5,30,7,0,23,7
212027,4,5,1,0,4,1
212027,3,6,3,0,3,3
212027,2,1,1,0,0,1
93733,8,7,2,0,5,2
93733,7,30,4,0,26,4
93733,6,55,8,0,47,8
93733,4,3,2,0,1,2
16067,10,1,1,0,0,1
16067,8,9,2,0,7,2
16067,7,16,5,0,11,5
16067,6,34,9,0,25,9
16067,5,27,6,0,21,6
16067,4,16,7,0,9,7
16067,2,2,2,0,0,2
16067,1,3,1,0,2,1
235511,9,4,1,0,3,1
235511,8,16,2,0,14,2
235511,6,38,4,0,34,4
235511,5,10,1,0,9,1
197409,9,6,1,0,5,1
197409,8,16,1,0,15,1
197409,7,40,5,0,35,5
197409,6,32,5,0,27,5
197409,5,8,3,0,5,3
197409,4,6,2,0,4,2
197409,3,1,1,0,0,1
197409,2,1,1,0,0,1
1267,10,1,1,0,0,1
1267,9,1,1,0,0,1
1267,8,3,1,0,2,1
1267,7,18,11,0,7,11
1267,6,37,23,0,14,23
1267,5,23,10,0,13,10
1267,4,21,11,0,10,11
1267,3,3,2,0,1,2
6814,10,4,1,0,3,1
6814,9,3,2,0,1,2
6814,8,20,12,0,8,12
6814,7,35,11,0,24,11
6814,6,32,5,0,27,5
6814,5,12,4,0,8,4
6814,4,3,1,0,2,1
1969,9,1,1,0,0,1
1969,8,1,1,0,0,1
1969,7,8,2,0,6,2
1969,6,19,6,0,13,6
1969,5,32,9,0,23,9
1969,4,27,3,0,24,3
1969,3,11,2,0,9,2
1969,2,6,2,0,4,2
1969,1,4,2,0,2,2
178154,10,3,1,0,2,1
178154,9,5,2,0,3,2
178154,8,10,1,0,9,1
178154,7,19,2,1,17,1
178154,6,43,8,1,35,7
178154,5,17,4,0,13,4
178154,3,5,1,0,4,1
178154,2,3,1,0,2,1
136146,10,1,1,0,0,1
136146,9,12,5,0,7,5
136146,8,22,8,0,14,8
136146,7,37,14,0,23,14
136146,6,27,9,0,18,9
136146,5,7,3,0,4,3
136146,4,1,1,0,0,1
136146,3,2,1,0,1,1
6513,8,6,3,0,3,3
6513,7,10,4,0,6,4
6513,6,45,9,0,36,9
6513,5,27,8,0,19,8
6513,3,10,3,0,7,3
194964,10,19,5,0,14,5
194964,9,12,1,0,11,1
194964,8,25,7,2,18,5
194964,7,19,3,1,16,2
194964,6,17,4,0,13,4
194964,4,4,1,0,3,1
194964,3,4,2,0,2,2
264239,8,23,2,0,21,2
264239,7,32,2,0,30,2
264239,6,36,3,0,33,3
264239,5,11,1,0,10,1
264239,4,4,1,0,3,1
25772,8,7,1,0,6,1
25772,7,32,11,0,21,11
25772,6,36,11,0,25,11
25772,5,14,5,0,9,5
25772,4,15,7,0,8,7
25772,3,3,1,0,2,1
25772,2,1,1,0,0,1
6503,9,4,1,0,3,1
6503,8,12,1,0,11,1
6503,7,19,2,0,17,2
6503,6,28,14,0,14,14
6503,5,21,6,0,15,6
6503,4,13,5,0,8,5
6503,3,6,2,0,4,2
6503,2,2,1,0,1,1
2707,7,9,1,0,8,1
2707,6,29,5,0,24,5
2707,5,26,4,0,22,4
2707,4,16,3,0,13,3
2707,3,9,2,0,7,2
2707,2,5,1,0,4,1
28121,9,1,1,0,0,1
28121,8,9,2,0,7,2
28121,7,18,2,0,16,2
28121,6,39,9,0,30,9
28121,5,22,3,0,19,3
28121,4,10,3,0,7,3
28121,3,1,1,0,0,1
28121,2,5,2,0,3,2
28121,1,3,1,0,2,1
4477,7,10,1,0,9,1
4477,6,42,15,0,27,15
4477,5,30,6,0,24,6
4477,4,18,6,0,12,6
4477,3,7,5,0,2,5
4477,1,1,1,0,0,1
4384,8,3,1,0,2,1
4384,7,12,2,0,10,2
4384,6,37,11,0,26,11
4384,5,29,6,0,23,6
4384,4,14,4,0,10,4
4384,3,7,2,0,5,2
4384,2,7,2,0,5,2
148586,10,1,1,0,0,1
148586,9,3,1,0,2,1
148586,8,13,5,0,8,5
148586,7,24,3,0,21,3
148586,6,35,4,0,31,4
148586,5,10,1,0,9,1
148586,4,17,4,0,13,4
148586,3,4,2,0,2,2
221977,10,10,1,0,9,1
221977,9,14,3,0,11,3
221977,8,20,7,3,13,4
221977,7,27,2,2,25,0
221977,6,25,1,0,24,1
221977,4,4,1,0,3,1
221977,3,1,1,0,0,1
221977,2,2,2,0,0,2
221977,1,3,1,0,2,1
5839,8,6,1,0,5,1
5839,7,13,2,0,11,2
5839,6,29,6,0,23,6
5839,5,29,5,0,24,5
5839,4,12,2,0,10,2
5839,3,10,7,0,3,7
5839,1,3,1,0,2,1
40602,8,11,2,0,9,2
40602,7,28,8,0,20,8
40602,6,42,8,0,34,8
40602,5,15,5,0,10,5
40602,4,7,1,0,6,1
40602,3,4,2,0,2,2
4110,7,4,1,0,3,1
4110,6,13,1,0,12,1
4110,5,19,5,0,14,5
4110,4,28,8,0,20,8
4110,3,16,3,0,13,3
4110,2,17,8,0,9,8
4110,1,7,5,0,2,5
228234,9,4,3,0,1,3
228234,8,26,8,0,18,8
228234,7,29,8,0,21,8
228234,6,28,3,0,25,3
228234,5,11,1,0,10,1
228234,4,10,1,0,9,1
228234,1,1,1,0,0,1
6045,10,3,1,0,2,1
6045,9,4,1,0,3,1
6045,8,14,6,0,8,6
6045,7,27,10,0,17,10
6045,6,38,12,0,26,12
6045,5,14,6,0,8,6
6045,4,5,3,0,2,3
6045,3,3,1,0,2,1
178515,9,3,2,0,1,2
178515,8,19,8,0,11,8
178515,7,34,11,0,23,11
178515,6,28,12,0,16,12
178515,4,9,1,0,8,1
178515,3,5,1,0,4,1
232800,10,6,2,0,4,2
232800,9,5,2,0,3,2
232800,8,15,5,0,10,5
232800,7,24,3,0,21,3
232800,6,29,3,0,26,3
232800,5,8,2,0,6,2
232800,4,9,2,0,7,2
232800,2,2,2,0,0,2
23284,10,3,2,0,1,2
23284,9,2,2,0,0,2
23284,8,29,14,0,15,14
23284,7,29,15,0,14,15
23284,6,27,13,0,14,13
23284,5,10,6,0,4,6
23284,4,6,4,0,2,4
23284,3,2,1,0,1,1
23284,2,1,1,0,0,1
221368,9,22,4,0,18,4
221368,8,40,7,0,33,7
221368,7,30,6,0,24,6
221368,6,7,2,0,5,2
180938,10,3,1,0,2,1
180938,9,4,1,0,3,1
180938,8,25,4,0,21,4
180938,7,32,4,0,28,4
180938,6,29,4,0,25,4
180938,5,9,2,0,7,2
180938,2,1,1,0,0,1
18781,10,5,2,0,3,2
18781,9,11,5,0,6,5
18781,8,33,12,0,21,12
18781,7,36,10,0,26,10
18781,6,14,2,0,12,2
18781,5,7,5,0,2,5
185381,10,13,2,0,11,2
185381,9,27,3,0,24,3
185381,8,31,4,0,27,4
185381,7,22,5,0,17,5
185381,5,5,2,0,3,2
185381,3,2,2,0,0,2
41783,7,17,3,0,14,3
41783,6,45,7,0,38,7
41783,5,20,6,0,14,6
41783,4,12,2,0,10,2
41783,1,2,1,0,1,1
13478,10,1,1,0,0,1
13478,7,7,2,0,5,2
13478,6,39,17,0,22,17
13478,5,38,16,0,22,16
13478,4,15,3,0,12,3
13478,3,5,2,0,3,2
13478,2,3,2,0,1,2
180459,8,6,1,0,5,1
180459,6,36,5,0,31,5
180459,4,14,2,0,12,2
180459,3,9,4,0,5,4
180459,2,4,2,0,2,2
2531,10,1,1,0,0,1
2531,9,3,2,0,1,2
2531,8,10,3,0,7,3
2531,7,18,5,0,13,5
2531,6,34,9,0,25,9
2531,5,30,3,0,27,3
2531,4,6,1,0,5,1
2531,3,4,1,0,3,1
242740,10,4,1,0,3,1
242740,9,9,3,0,6,3
242740,8,32,5,0,27,5
242740,7,28,3,0,25,3
242740,6,23,3,0,20,3
242740,5,10,3,0,7,3
242740,4,2,1,0,1,1
200351,10,9,9,1,0,8
200351,9,5,2,1,3,1
200351,8,25,11,1,14,10
200351,7,33,6,0,27,6
200351,6,20,3,0,17,3
200351,5,6,1,0,5,1
200351,4,5,1,0,4,1
200351,3,3,1,0,2,1
200351,2,1,1,0,0,1
143509,9,5,2,0,3,2
143509,8,20,7,0,13,7
143509,7,22,4,0,18,4
143509,6,35,9,0,26,9
143509,5,12,6,0,6,6
143509,4,7,2,0,5,2
396,9,2,1,0,1,1
396,8,17,5,0,12,5
396,7,20,7,0,13,7
396,6,33,7,0,26,7
396,5,25,12,0,13,12
396,3,5,4,0,1,4
396,2,2,1,0,1,1
151367,10,1,1,0,0,1
151367,9,1,1,0,0,1
151367,8,14,3,0,11,3
151367,7,16,1,0,15,1
151367,6,23,6,0,17,6
151367,5,20,6,0,14,6
151367,4,18,5,0,13,5
151367,3,9,4,0,5,4
2364,8,8,1,0,7,1
2364,7,16,2,0,14,2
2364,6,40,11,0,29,11
2364,5,25,5,0,20,5
2364,4,11,4,0,7,4
2364,3,3,3,0,0,3
214123,9,6,2,0,4,2
214123,8,26,3,0,23,3
214123,7,33,8,1,25,7
214123,6,27,7,0,20,7
214123,5,10,2,0,8,2
214123,4,3,1,0,2,1
214123,2,1,1,0,0,1
21572,9,6,1,0,5,1
21572,8,13,3,0,10,3
21572,7,21,6,0,15,6
21572,6,24,12,0,12,12
21572,5,23,8,0,15,8
21572,4,12,5,0,7,5
21572,3,5,1,0,4,1
21572,2,2,1,0,1,1
21572,1,1,1,0,0,1
10829,9,13,5,0,8,5
10829,8,15,1,0,14,1
10829,7,29,6,0,23,6
10829,6,28,9,0,19,9
10829,5,10,5,0,5,5
10829,4,6,2,0,4,2
10829,3,3,1,0,2,1
10829,2,3,1,0,2,1
234700,8,21,5,0,16,5
234700,7,40,7,0,33,7
234700,6,26,8,0,18,8
234700,5,6,3,0,3,3
234700,4,4,1,0,3,1
234700,3,1,1,0,0,1
234700,2,3,3,0,0,3
139769,10,8,1,0,7,1
139769,8,17,3,0,14,3
139769,7,17,5,1,12,4
139769,6,15,5,1,10,4
139769,5,6,2,0,4,2
139769,4,7,3,1,4,2
139769,3,6,4,1,2,3
139769,2,9,5,3,4,2
139769,1,21,11,3,10,8
23387,10,13,4,0,9,4
23387,9,12,4,0,8,4
23387,8,24,13,0,11,13
23387,7,18,7,0,11,7
23387,6,23,8,0,15,8
23387,5,9,2,0,7,2
23387,2,3,3,0,0,3
166298,10,3,1,0,2,1
166298,9,6,2,1,4,1
166298,8,19,5,2,14,3
166298,7,24,5,0,19,5
166298,6,28,3,0,25,3
166298,5,13,4,0,9,4
166298,4,11,1,0,10,1
157586,10,6,2,1,4,1
157586,9,5,4,1,1,3
157586,8,15,3,1,12,2
157586,7,12,3,0,9,3
157586,6,28,5,0,23,5
157586,5,18,4,2,14,2
157586,4,10,2,0,8,2
157586,3,7,1,0,6,1
157586,2,7,2,0,5,2
204734,10,6,3,0,3,3
204734,9,1,1,0,0,1
204734,8,28,6,0,22,6
204734,7,29,3,0,26,3
204734,6,32,3,0,29,3
204734,5,7,2,0,5,2
204734,3,2,1,0,1,1
9090,8,4,1,0,3,1
9090,7,5,4,0,1,4
9090,6,22,9,0,13,9
9090,5,35,11,0,24,11
9090,4,28,14,0,14,14
9090,3,9,3,0,6,3
9090,2,4,1,0,3,1
188908,10,5,1,0,4,1
188908,9,4,1,0,3,1
188908,8,21,2,0,19,2
188908,7,32,3,0,29,3
188908,6,34,4,0,30,4
188908,5,6,2,0,4,2
188908,3,3,1,0,2,1
188908,2,2,1,0,1,1
19560,10,4,3,0,1,3
19560,9,2,1,0,1,1
19560,8,2,1,0,1,1
19560,7,7,1,0,6,1
19560,6,13,6,0,7,6
19560,5,22,9,0,13,9
19560,4,27,7,0,20,7
19560,3,17,8,0,9,8
19560,2,10,3,0,7,3
19560,1,4,1,0,3,1
257077,9,11,4,0,7,4
257077,8,42,11,0,31,11
257077,7,30,4,0,26,4
257077,6,20,7,0,13,7
6495,10,11,8,0,3,8
6495,9,27,15,0,12,15
6495,8,39,12,0,27,12
6495,7,14,8,0,6,8
6495,6,9,4,0,5,4
6495,5,3,3,0,0,3
6495,3,1,1,0,0,1
19392,9,3,1,0,2,1
19392,8,7,5,0,2,5
19392,7,17,9,0,8,9
19392,6,34,10,0,24,10
19392,5,28,11,0,17,11
19392,4,12,6,0,6,6
19392,3,3,1,0,2,1
19392,2,2,1,0,1,1
40961,8,2,1,0,1,1
40961,7,19,5,0,14,5
40961,6,47,16,0,31,16
40961,5,17,2,0,15,2
40961,4,17,9,0,8,9
13520,10,9,2,0,7,2
13520,9,9,3,0,6,3
13520,8,32,8,0,24,8
13520,7,30,8,0,22,8
13520,6,17,5,0,12,5
13520,4,2,1,0,1,1
13520,2,2,2,0,0,2
247143,8,23,5,0,18,5
247143,7,37,4,0,33,4
247143,6,26,7,0,19,7
247143,5,10,2,0,8,2
247143,4,3,1,0,2,1
247143,3,3,1,0,2,1
34376,8,11,4,0,7,4
34376,7,20,9,0,11,9
34376,6,53,19,0,34,19
34376,5,14,4,0,10,4
34376,4,8,3,0,5,3
34376,3,1,1,0,0,1
45020,8,23,9,0,14,9
45020,7,22,10,0,12,10
45020,6,37,12,0,25,12
45020,5,18,6,0,12,6
45020,4,5,2,0,3,2
45020,3,2,1,0,1,1
45020,2,1,1,0,0,1
119109,10,1,1,0,0,1
119109,9,3,1,0,2,1
119109,8,12,8,0,4,8
119109,7,11,3,0,8,3
119109,6,48,9,0,39,9
119109,5,17,3,0,14,3
119109,4,8,3,0,5,3
119109,3,5,1,0,4,1
119109,1,2,1,0,1,1
5788,6,4,1,0,3,1
5788,5,21,2,0,19,2
5788,4,21,5,0,16,5
5788,3,27,13,0,14,13
5788,2,19,7,0,12,7
5788,1,14,6,0,8,6
31926,9,4,2,0,2,2
31926,8,20,2,0,18,2
31926,7,22,10,0,12,10
31926,6,39,8,0,31,8
31926,5,14,5,0,9,5
31926,4,6,2,0,4,2
31926,1,1,1,0,0,1
5264,9,4,3,0,1,3
5264,8,16,8,0,8,8
5264,7,32,9,0,23,9
5264,6,31,15,0,16,15
5264,5,15,4,0,11,4
5264,4,6,2,0,4,2
65581,9,2,2,0,0,2
65581,7,17,2,0,15,2
65581,6,31,3,0,28,3
65581,5,19,3,0,16,3
65581,4,18,2,0,16,2
65581,3,9,1,0,8,1
65581,1,3,2,0,1,2
191077,9,2,1,0,1,1
191077,6,35,1,0,34,1
170909,10,15,1,0,14,1
170909,9,14,1,0,13,1
170909,8,43,4,0,39,4
170909,7,15,1,0,14,1
170909,6,14,2,0,12,2
170909,5,4,2,0,2,2
170909,2,1,1,0,0,1
227110,10,2,1,0,1,1
227110,9,4,1,0,3,1
227110,8,29,6,0,23,6
227110,7,37,7,0,30,7
227110,6,29,6,0,23,6
227110,5,4,1,0,3,1
151683,10,6,1,0,5,1
151683,9,13,3,0,10,3
151683,8,27,5,0,22,5
151683,7,26,4,0,22,4
151683,6,23,1,0,22,1
151683,5,8,1,0,7,1
151683,4,5,1,0,4,1
128662,8,13,3,0,10,3
128662,7,23,1,0,22,1
128662,6,42,7,0,35,7
128662,5,11,2,0,9,2
128662,4,7,1,0,6,1
128662,3,4,3,0,1,3
178754,10,20,9,0,11,9
178754,9,25,9,0,16,9
178754,8,33,7,1,26,6
178754,7,11,2,0,9,2
178754,6,8,2,0,6,2
109077,9,4,1,0,3,1
109077,8,15,3,0,12,3
109077,7,25,7,0,18,7
109077,6,34,7,0,27,7
109077,5,14,3,0,11,3
109077,4,9,1,0,8,1
130556,9,4,1,0,3,1
130556,8,13,2,0,11,2
130556,7,27,5,0,22,5
130556,6,36,9,0,27,9
130556,5,16,4,0,12,4
130556,4,6,1,0,5,1
130556,3,5,1,0,4,1
10999,9,1,1,0,0,1
10999,7,8,4,0,4,4
10999,6,42,4,0,38,4
10999,5,30,8,0,22,8
10999,4,19,6,0,13,6
10999,3,3,2,0,1,2
10999,2,2,1,0,1,1
98203,10,4,1,0,3,1
98203,9,4,2,0,2,2
98203,8,9,1,0,8,1
98203,7,16,6,0,10,6
98203,6,31,9,0,22,9
98203,5,15,6,0,9,6
98203,4,11,4,0,7,4
98203,3,9,2,0,7,2
98203,2,6,2,0,4,2
98203,1,3,1,0,2,1
13254,10,4,1,0,3,1
13254,9,7,1,0,6,1
13254,8,34,4,0,30,4
13254,7,33,6,0,27,6
13254,6,21,4,0,17,4
13254,5,4,1,0,3,1
13254,4,1,1,0,0,1
13254,2,2,1,0,1,1
13254,1,1,1,0,0,1
5423,8,6,4,0,2,4
5423,7,12,3,0,9,3
5423,6,22,6,0,16,6
5423,5,22,5,0,17,5
5423,4,25,11,0,14,11
5423,3,12,8,0,4,8
5423,2,4,1,0,3,1
175121,9,7,3,0,4,3
175121,8,16,3,0,13,3
175121,7,26,1,0,25,1
175121,6,30,6,0,24,6
175121,5,14,1,0,13,1
175121,4,6,1,0,5,1
175121,3,1,1,0,0,1
39342,7,9,2,0,7,2
39342,6,28,4,0,24,4
39342,5,27,3,0,24,3
39342,4,19,2,0,17,2
39342,3,12,2,0,10,2
39342,2,11,2,0,9,2
39342,1,2,2,0,0,2
180256,9,7,1,0,6,1
180256,8,36,5,0,31,5
180256,7,31,4,0,27,4
180256,6,19,1,0,18,1
180256,5,7,3,0,4,3
55706,8,11,3,0,8,3
55706,7,13,2,0,11,2
55706,6,30,4,0,26,4
55706,5,13,3,0,10,3
55706,4,14,3,0,11,3
55706,3,9,3,0,6,3
55706,2,12,3,0,9,3
55706,1,3,3,0,0,3
54221,10,12,3,0,9,3
54221,9,20,9,0,11,9
54221,8,25,5,0,20,5
54221,7,21,5,0,16,5
54221,6,19,7,0,12,7
54221,5,9,3,0,6,3
144506,8,38,4,0,34,4
144506,7,22,2,0,20,2
144506,6,26,1,0,25,1
144506,5,8,1,0,7,1
144506,2,1,1,0,0,1
208670,10,3,1,0,2,1
208670,9,9,1,0,8,1
208670,8,23,3,0,20,3
208670,6,19,2,0,17,2
208670,5,14,2,0,12,2
208670,3,8,2,0,6,2
208670,2,3,1,0,2,1
73228,10,2,1,0,1,1
73228,7,11,5,0,6,5
73228,6,23,3,0,20,3
73228,5,20,2,0,18,2
73228,4,22,4,0,18,4
73228,3,7,4,0,3,4
73228,2,8,2,0,6,2
202589,10,4,2,0,2,2
202589,9,5,1,0,4,1
202589,8,9,3,0,6,3
202589,7,14,1,0,13,1
202589,6,36,6,0,30,6
202589,5,21,5,0,16,5
202589,4,9,6,0,3,6
202589,3,6,2,0,4,2
153509,7,22,1,0,21,1
153509,6,36,6,0,30,6
153509,5,19,3,0,16,3
153509,4,11,2,0,9,2
2195,10,1,1,0,0,1
2195,9,1,1,0,0,1
2195,8,11,1,0,10,1
2195,7,20,4,0,16,4
2195,6,34,14,0,20,14
2195,5,19,5,0,14,5
2195,4,11,5,0,6,5
2195,3,7,3,0,4,3
2195,2,3,1,0,2,1
19811,8,5,2,0,3,2
19811,7,7,3,0,4,3
19811,6,18,5,0,13,5
19811,5,19,6,0,13,6
19811,4,29,5,0,24,5
19811,3,20,4,0,16,4
19811,2,5,1,0,4,1
155700,9,2,1,0,1,1
155700,8,11,5,0,6,5
155700,7,25,5,0,20,5
155700,6,42,11,1,31,10
155700,4,9,1,0,8,1
155700,3,2,1,0,1,1
155700,2,4,2,0,2,2
112692,9,3,1,0,2,1
112692,7,16,3,0,13,3
112692,6,37,7,0,30,7
112692,5,14,2,0,12,2
112692,4,10,3,0,7,3
112692,3,15,4,0,11,4
112692,2,5,2,0,3,2
23249,8,2,1,0,1,1
23249,7,6,2,0,4,2
23249,6,34,4,0,30,4
23249,5,23,2,0,21,2
23249,4,19,6,0,13,6
23249,3,14,6,0,8,6
23249,2,5,2,0,3,2
23249,1,4,1,0,3,1
3194,8,3,2,0,1,2
3194,7,10,2,0,8,2
3194,6,26,7,0,19,7
3194,5,34,10,0,24,10
3194,4,16,2,0,14,2
3194,3,9,3,0,6,3
3194,2,6,5,0,1,5
3194,1,2,2,0,0,2
5107,10,4,2,0,2,2
5107,9,4,2,0,2,2
5107,8,20,12,0,8,12
5107,7,12,3,0,9,3
5107,6,32,8,0,24,8
5107,5,13,4,0,9,4
5107,4,10,3,0,7,3
5107,2,6,3,0,3,3
2092,9,2,1,0,1,1
2092,8,13,2,0,11,2
2092,7,20,6,0,14,6
2092,6,36,10,0,26,10
2092,5,22,6,0,16,6
2092,4,8,5,0,3,5
2092,3,4,2,0,2,2
7710,9,2,2,0,0,2
7710,8,2,1,0,1,1
7710,7,12,4,0,8,4
7710,6,17,4,0,13,4
7710,5,38,11,0,27,11
7710,4,22,8,0,14,8
7710,2,4,3,0,1,3
7710,1,1,1,0,0,1
1517,10,2,2,0,0,2
1517,9,2,1,0,1,1
1517,8,9,4,0,5,4
1517,7,9,1,0,8,1
1517,6,24,6,0,18,6
1517,5,24,11,0,13,11
1517,4,18,6,0,12,6
1517,3,14,5,0,9,5
1517,2,4,2,0,2,2
19120,9,4,1,0,3,1
19120,8,6,4,0,2,4
19120,7,20,11,0,9,11
19120,6,28,9,0,19,9
19120,5,21,9,0,12,9
19120,4,13,7,0,6,7
19120,3,11,5,0,6,5
19120,2,4,1,0,3,1
9084,8,11,3,0,8,3
9084,7,29,3,0,26,3
9084,6,29,3,0,26,3
9084,5,23,2,0,21,2
9084,4,8,4,0,4,4
20801,9,2,2,0,0,2
20801,6,31,4,0,27,4
20801,5,20,3,0,17,3
20801,4,13,1,0,12,1
20801,3,16,4,0,12,4
20801,1,8,6,0,2,6
116978,9,3,2,0,1,2
116978,8,9,2,0,7,2
116978,7,15,2,0,13,2
116978,6,41,4,0,37,4
116978,5,24,7,0,17,7
116978,4,6,2,0,4,2
116978,3,5,1,0,4,1
232437,7,23,5,0,18,5
232437,6,48,9,0,39,9
232437,5,18,5,0,13,5
232437,4,4,1,0,3,1
19990,7,9,2,0,7,2
19990,6,26,9,0,17,9
19990,5,22,3,0,19,3
19990,4,21,5,0,16,5
19990,3,15,5,0,10,5
19990,2,8,4,0,4,4
19990,1,5,2,0,3,2
22268,7,16,5,0,11,5
22268,6,37,11,0,26,11
22268,5,26,5,0,21,5
22268,4,14,5,0,9,5
22268,3,7,2,0,5,2
22268,2,3,1,0,2,1
3815,10,2,1,0,1,1
3815,8,16,5,0,11,5
3815,7,14,7,0,7,7
3815,6,31,11,0,20,11
3815,5,22,6,0,16,6
3815,4,12,4,0,8,4
3815,3,6,1,0,5,1
3815,1,1,1,0,0,1
1598,10,2,2,0,0,2
1598,9,5,3,0,2,3
1598,8,13,5,0,8,5
1598,7,27,8,0,19,8
1598,6,26,9,0,17,9
1598,5,21,4,0,17,4
1598,4,6,1,0,5,1
1598,3,4,1,0,3,1
1598,1,1,1,0,0,1
165041,9,3,1,0,2,1
165041,8,11,2,0,9,2
165041,7,28,3,0,25,3
165041,6,37,12,0,25,12
165041,5,15,2,0,13,2
165041,3,3,1,0,2,1
165041,2,2,1,0,1,1
235360,9,3,1,0,2,1
235360,8,17,3,0,14,3
235360,7,30,6,1,24,5
235360,6,31,5,0,26,5
235360,5,12,1,0,11,1
235360,4,8,3,0,5,3
235360,3,1,1,0,0,1
235328,10,8,4,1,4,3
235328,9,6,2,0,4,2
235328,8,13,2,0,11,2
235328,7,30,8,2,22,6
235328,6,28,6,0,22,6
235328,5,9,4,0,5,4
235328,4,3,2,0,1,2
235328,3,8,3,0,5,3
235328,2,2,1,0,1,1
235328,1,1,1,0,0,1
41837,9,21,5,0,16,5
41837,8,39,8,0,31,8
41837,7,20,3,0,17,3
41837,6,13,3,0,10,3
41837,4,6,2,0,4,2
144,8,14,5,0,9,5
144,7,27,5,0,22,5
144,6,45,11,0,34,11
144,5,12,5,0,7,5
144,4,5,3,0,2,3
144,3,3,1,0,2,1
3925,10,2,1,0,1,1
3925,9,4,2,0,2,2
3925,8,15,9,0,6,9
3925,7,23,8,0,15,8
3925,6,34,14,0,20,14
3925,5,18,9,0,9,9
3925,4,7,4,0,3,4
3925,3,1,1,0,0,1
114784,9,5,1,0,4,1
114784,8,20,3,0,17,3
114784,7,25,6,0,19,6
114784,6,35,4,0,31,4
114784,5,11,1,0,10,1
114784,4,7,2,0,5,2
114784,2,2,2,0,0,2
183405,10,8,5,1,3,4
183405,9,19,12,3,7,9
183405,8,15,7,3,8,4
183405,7,20,5,0,15,5
183405,6,27,4,0,23,4
183405,4,5,2,0,3,2
183405,3,4,4,0,0,4
2334,10,4,3,0,1,3
2334,9,4,2,0,2,2
2334,8,15,4,0,11,4
2334,7,36,17,0,19,17
2334,6,28,12,0,16,12
2334,5,13,5,0,8,5
2334,4,4,1,0,3,1
2334,3,1,1,0,0,1
99698,10,2,1,0,1,1
99698,9,3,3,0,0,3
99698,8,18,11,0,7,11
99698,7,30,14,0,16,14
99698,6,39,15,0,24,15
99698,5,10,4,0,6,4
99698,3,4,1,0,3,1
11330,10,8,1,0,7,1
11330,9,12,4,0,8,4
11330,8,22,5,0,17,5
11330,7,25,7,0,18,7
11330,6,19,5,0,14,5
11330,5,9,4,0,5,4
11330,4,7,3,0,4,3
11330,3,3,2,0,1,2
1317,9,3,1,0,2,1
1317,8,22,10,0,12,10
1317,7,31,15,0,16,15
1317,6,32,13,0,19,13
1317,5,12,4,0,8,4
1317,4,6,5,0,1,5
188325,10,5,2,0,3,2
188325,9,14,7,0,7,7
188325,8,53,14,3,39,11
188325,7,24,6,0,18,6
188325,6,5,2,0,3,2
188325,5,1,1,0,0,1
188325,4,3,3,0,0,3
6641,10,2,1,0,1,1
6641,9,13,5,0,8,5
6641,8,29,11,0,18,11
6641,7,28,7,0,21,7
6641,6,18,2,0,16,2
6641,5,13,3,0,10,3
6641,4,2,1,0,1,1
6641,2,2,1,0,1,1
43023,9,5,1,0,4,1
43023,8,13,2,0,11,2
43023,7,33,8,0,25,8
43023,6,36,11,0,25,11
43023,5,11,5,0,6,5
43023,2,1,1,0,0,1
198775,10,6,2,0,4,2
198775,9,9,2,0,7,2
198775,8,25,2,0,23,2
198775,7,28,2,0,26,2
198775,6,27,2,0,25,2
198775,4,5,2,0,3,2
43245,9,14,6,0,8,6
43245,8,28,10,0,18,10
43245,7,34,8,0,26,8
43245,6,12,3,0,9,3
43245,5,5,4,0,1,4
43245,4,1,1,0,0,1
43245,3,2,1,0,1,1
43245,2,5,1,0,4,1
4449,10,2,1,0,1,1
4449,9,5,4,0,1,4
4449,8,17,8,0,9,8
4449,7,32,13,0,19,13
4449,6,34,8,0,26,8
4449,5,10,2,0,8,2
4449,4,5,1,0,4,1
4449,3,2,1,0,1,1
205766,8,19,4,0,15,4
205766,7,29,6,0,23,6
205766,6,37,4,0,33,4
205766,3,3,2,0,1,2
205766,2,1,1,0,0,1
2902,9,9,5,0,4,5
2902,8,29,9,0,20,9
2902,7,22,7,0,15,7
2902,6,32,4,0,28,4
2902,5,9,2,0,7,2
2902,3,3,1,0,2,1
7771,9,6,1,0,5,1
7771,8,19,4,0,15,4
7771,7,21,11,0,10,11
7771,6,28,6,0,22,6
7771,5,11,1,0,10,1
7771,4,3,3,0,0,3
7771,3,3,3,0,0,3
144290,10,7,1,0,6,1
144290,9,11,2,0,9,2
144290,8,23,4,0,19,4
144290,7,20,4,0,16,4
144290,6,24,4,0,20,4
144290,5,12,3,0,9,3
144290,4,7,3,0,4,3
144290,3,1,1,0,0,1
144290,2,1,1,0,0,1
35311,9,2,1,0,1,1
35311,8,14,6,0,8,6
35311,7,25,8,0,17,8
35311,6,44,12,0,32,12
35311,5,11,6,0,5,6
35311,4,5,2,0,3,2
35311,3,3,1,0,2,1
196105,10,4,1,0,3,1
196105,9,4,1,0,3,1
196105,8,24,10,0,14,10
196105,7,29,2,0,27,2
196105,6,28,3,0,25,3
196105,5,12,1,0,11,1
196105,2,1,1,0,0,1
163481,10,2,2,0,0,2
163481,9,2,1,0,1,1
163481,8,13,3,0,10,3
163481,7,29,4,0,25,4
163481,6,31,2,0,29,2
163481,5,14,2,0,12,2
163481,4,13,6,0,7,6
163481,3,2,1,0,1,1
62143,9,4,2,0,2,2
62143,8,29,12,0,17,12
62143,7,40,19,0,21,19
62143,6,21,8,0,13,8
62143,5,3,2,0,1,2
62143,4,3,1,0,2,1
62143,3,2,2,0,0,2
62143,2,1,1,0,0,1
142551,10,9,4,0,5,4
142551,9,12,3,0,9,3
142551,8,19,4,0,15,4
142551,7,25,6,0,19,6
142551,6,20,3,0,17,3
142551,5,13,2,0,11,2
142551,4,5,1,0,4,1
142551,3,2,1,0,1,1
1960,8,5,2,0,3,2
1960,7,12,4,0,8,4
1960,6,40,13,0,27,13
1960,5,22,7,0,15,7
1960,4,9,4,0,5,4
1960,3,3,3,0,0,3
1960,2,1,1,0,0,1
32992,9,1,1,0,0,1
32992,8,8,1,0,7,1
32992,7,12,3,0,9,3
32992,6,35,10,0,25,10
32992,5,25,3,0,22,3
32992,4,14,4,0,10,4
32992,3,4,3,0,1,3
32992,2,6,1,0,5,1
146922,10,31,10,0,21,10
146922,9,18,5,0,13,5
146922,8,40,6,0,34,6
146922,7,8,1,0,7,1
146922,6,6,1,0,5,1
146922,4,1,1,0,0,1
146922,3,1,1,0,0,1
7662,10,5,2,0,3,2
7662,9,14,6,0,8,6
7662,8,37,20,0,17,20
7662,7,24,10,0,14,10
7662,6,15,2,0,13,2
7662,5,8,2,0,6,2
1325,9,2,1,0,1,1
1325,8,6,1,0,5,1
1325,7,11,2,0,9,2
1325,6,49,13,0,36,13
1325,5,20,5,0,15,5
1325,4,11,4,0,7,4
1325,3,5,2,0,3,2
1325,2,1,1,0,0,1
1325,1,1,1,0,0,1
1757,10,6,3,0,3,3
1757,9,6,4,0,2,4
1757,8,31,16,0,15,16
1757,7,25,7,0,18,7
1757,6,24,10,0,14,10
1757,5,11,1,0,10,1
15827,10,8,2,0,6,2
15827,9,6,3,0,3,3
15827,8,51,14,0,37,14
15827,7,22,4,0,18,4
15827,6,10,1,0,9,1
15827,5,5,1,0,4,1
15827,4,2,2,0,0,2
15827,2,2,2,0,0,2
10472,10,3,1,0,2,1
10472,9,5,3,0,2,3
10472,8,7,1,0,6,1
10472,7,14,3,0,11,3
10472,6,35,10,0,25,10
10472,5,20,4,0,16,4
10472,4,13,4,0,9,4
10472,3,7,2,0,5,2
10472,2,2,1,0,1,1
247106,10,3,1,0,2,1
247106,9,7,3,0,4,3
247106,8,45,10,0,35,10
247106,7,37,6,0,31,6
247106,6,6,2,0,4,2
247106,5,5,1,0,4,1
39084,8,12,2,0,10,2
39084,7,21,2,0,19,2
39084,6,35,6,0,29,6
39084,5,28,4,0,24,4
39084,4,4,2,0,2,2
39084,3,5,2,0,3,2
3657,8,8,7,0,1,7
3657,7,27,8,0,19,8
3657,6,34,10,0,24,10
3657,5,20,12,0,8,12
3657,4,11,2,0,9,2
3657,2,2,1,0,1,1
7470,7,20,4,0,16,4
7470,6,37,7,0,30,7
7470,5,25,4,0,21,4
7470,3,1,1,0,0,1
7470,2,2,1,0,1,1
1647,8,1,1,0,0,1
1647,7,8,1,0,7,1
1647,6,11,2,0,9,2
1647,5,26,4,0,22,4
1647,4,28,7,0,21,7
1647,3,13,5,0,8,5
1647,2,11,6,0,5,6
1647,1,8,3,0,5,3
89575,8,13,2,0,11,2
89575,7,25,6,0,19,6
89575,6,41,8,0,33,8
89575,5,9,2,0,7,2
89575,4,10,1,0,9,1
163097,10,32,7,0,25,7
163097,9,25,10,0,15,10
163097,8,31,9,0,22,9
163097,7,12,3,0,9,3
163097,6,4,1,0,3,1
111379,10,4,3,0,1,3
111379,9,3,2,0,1,2
111379,8,20,10,0,10,10
111379,7,27,5,0,22,5
111379,6,31,3,0,28,3
111379,5,13,3,0,10,3
111379,4,6,3,0,3,3
111379,2,1,1,0,0,1
111299,8,8,2,0,6,2
111299,7,15,5,0,10,5
111299,6,30,4,0,26,4
111299,5,19,3,0,16,3
111299,4,17,2,0,15,2
111299,3,9,1,0,8,1
111299,2,4,2,0,2,2
768,8,22,6,0,16,6
768,7,26,3,0,23,3
768,6,34,5,0,29,5
768,5,10,3,0,7,3
768,4,8,5,0,3,5
768,3,2,1,0,1,1
9227,7,20,7,0,13,7
9227,6,38,14,0,24,14
9227,5,17,3,0,14,3
9227,4,14,3,0,11,3
9227,3,8,3,0,5,3
9227,2,3,1,0,2,1
9227,1,3,2,0,1,2
47408,9,4,1,0,3,1
47408,8,8,1,0,7,1
47408,7,23,9,0,14,9
47408,6,39,11,0,28,11
47408,5,22,4,0,18,4
47408,4,7,2,0,5,2
47408,3,2,1,0,1,1
47408,2,1,1,0,0,1
769,10,4,2,0,2,2
769,9,4,3,0,1,3
769,8,19,11,0,8,11
769,7,20,8,0,12,8
769,6,34,9,0,25,9
769,5,14,5,0,9,5
769,4,9,2,0,7,2
82572,9,1,1,0,0,1
82572,8,23,8,0,15,8
82572,7,21,4,0,17,4
82572,6,34,11,0,23,11
82572,5,15,1,0,14,1
82572,4,7,3,0,4,3
82572,2,2,1,0,1,1
20906,10,1,1,0,0,1
20906,9,4,1,0,3,1
20906,8,20,8,0,12,8
20906,7,26,8,0,18,8
20906,6,35,13,0,22,13
20906,5,12,3,0,9,3
20906,4,2,2,0,0,2
20906,3,4,1,0,3,1
41898,9,2,1,0,1,1
41898,8,10,2,0,8,2
41898,7,15,7,0,8,7
41898,6,32,4,0,28,4
41898,5,19,9,0,10,9
41898,4,20,5,0,15,5
41898,3,7,2,0,5,2
235982,10,12,3,0,9,3
235982,9,13,5,0,8,5
235982,8,29,4,0,25,4
235982,7,27,5,1,22,4
235982,6,17,5,1,12,4
235982,5,5,1,0,4,1
235982,2,1,1,0,0,1
34958,9,3,2,0,1,2
34958,7,10,5,0,5,5
34958,6,40,15,0,25,15
34958,5,23,5,0,18,5
34958,4,12,2,0,10,2
34958,3,3,1,0,2,1
34958,1,3,1,0,2,1
164917,9,6,2,0,4,2
164917,8,18,2,0,16,2
164917,7,29,3,0,26,3
164917,6,26,7,0,19,7
164917,5,15,2,0,13,2
164917,4,8,2,0,6,2
89222,8,14,2,0,12,2
89222,7,19,3,0,16,3
89222,6,27,4,0,23,4
89222,5,16,4,0,12,4
89222,4,14,7,0,7,7
89222,3,6,1,0,5,1
89222,2,5,2,0,3,2
89222,1,3,3,0,0,3
204577,10,2,1,0,1,1
204577,9,6,1,0,5,1
204577,8,25,6,0,19,6
204577,7,22,5,0,17,5
204577,6,33,3,0,30,3
204577,5,8,1,0,7,1
204577,4,6,2,0,4,2
204887,5,10,4,0,6,4
204887,4,15,2,0,13,2
204887,3,26,4,0,22,4
204887,2,29,4,0,25,4
204887,1,8,2,0,6,2
202204,9,12,5,0,7,5
202204,8,18,5,0,13,5
202204,7,24,4,0,20,4
202204,6,27,5,0,22,5
202204,5,12,4,0,8,4
202204,3,4,1,0,3,1
202204,2,3,1,0,2,1
34277,7,15,6,0,9,6
34277,6,41,12,0,29,12
34277,5,21,2,0,19,2
34277,4,20,6,0,14,6
131530,8,6,2,0,4,2
131530,7,15,3,0,12,3
131530,6,35,6,0,29,6
131530,5,27,4,0,23,4
131530,4,11,3,0,8,3
131530,2,3,3,0,0,3
161290,10,4,1,0,3,1
161290,9,8,3,0,5,3
161290,8,19,9,2,10,7
161290,7,22,9,2,13,7
161290,6,36,7,3,29,4
161290,4,3,2,0,1,2
161290,3,2,1,0,1,1
161290,2,2,2,0,0,2
247314,8,33,7,0,26,7
247314,7,29,4,0,25,4
247314,6,25,2,0,23,2
247314,5,6,2,0,4,2
247314,4,4,2,0,2,2
70767,10,5,3,0,2,3
70767,9,2,1,0,1,1
70767,8,26,8,0,18,8
70767,7,25,6,1,19,5
70767,6,30,10,0,20,10
70767,5,6,3,0,3,3
70767,3,4,1,0,3,1
70767,2,2,1,0,1,1
70767,1,2,1,1,1,0
142653,8,14,5,0,9,5
142653,7,14,1,0,13,1
142653,6,37,9,2,28,7
142653,5,18,4,1,14,3
142653,4,14,4,0,10,4
235902,10,4,1,0,3,1
235902,8,29,6,0,23,6
235902,7,31,4,0,27,4
235902,6,31,2,0,29,2
185380,10,16,3,0,13,3
185380,9,30,5,0,25,5
185380,8,31,6,0,25,6
185380,7,17,5,0,12,5
185380,5,3,1,0,2,1
185380,3,1,1,0,0,1
2496,6,35,5,0,30,5
2496,5,30,6,0,24,6
2496,4,15,5,0,10,5
2496,3,9,2,0,7,2
2496,2,9,1,0,8,1
103937,10,4,3,0,1,3
103937,9,1,1,0,0,1
103937,8,12,5,1,7,4
103937,7,19,5,1,14,4
103937,6,38,11,0,27,11
103937,5,19,6,0,13,6
103937,4,7,2,0,5,2
103937,3,4,2,0,2,2
103937,1,1,1,0,0,1
107829,7,8,1,0,7,1
107829,6,26,3,0,23,3
107829,5,19,1,0,18,1
107829,4,23,3,0,20,3
107829,3,11,5,1,6,4
107829,2,6,5,0,1,5
107829,1,5,1,0,4,1
177160,9,2,1,0,1,1
177160,8,30,8,0,22,8
177160,7,29,5,0,24,5
177160,6,33,7,0,26,7
177160,5,9,1,0,8,1
177160,4,2,1,0,1,1
155258,8,24,4,0,20,4
155258,7,33,3,0,30,3
155258,6,30,7,0,23,7
155258,5,11,2,0,9,2
155258,4,2,1,0,1,1
15274,10,14,2,0,12,2
15274,9,16,8,0,8,8
15274,8,37,16,0,21,16
15274,7,22,4,0,18,4
15274,6,12,1,0,11,1
15274,5,3,1,0,2,1
147145,10,4,1,0,3,1
147145,8,15,2,0,13,2
147145,7,13,2,0,11,2
147145,6,37,5,0,32,5
147145,4,9,1,0,8,1
4983,8,5,2,0,3,2
4983,7,22,7,0,15,7
4983,6,46,12,0,34,12
4983,5,18,3,0,15,3
4983,4,8,1,0,7,1
4983,3,5,1,0,4,1
196217,10,18,6,0,12,6
196217,9,18,6,0,12,6
196217,8,42,12,0,30,12
196217,7,12,3,0,9,3
196217,6,8,1,0,7,1
196217,5,4,2,0,2,2
196217,4,1,1,0,0,1
196217,3,2,1,0,1,1
1140,8,5,1,0,4,1
1140,7,20,8,0,12,8
1140,6,45,7,0,38,7
1140,5,24,8,0,16,8
1140,4,7,3,0,4,3
1140,3,4,1,0,3,1
1377,8,1,1,0,0,1
1377,7,6,3,0,3,3
1377,6,16,5,0,11,5
1377,5,29,4,0,25,4
1377,4,21,1,0,20,1
1377,3,12,6,0,6,6
1377,2,13,2,0,11,2
1377,1,7,4,0,3,4
111387,9,7,3,0,4,3
111387,8,18,6,0,12,6
111387,7,28,8,0,20,8
111387,6,14,4,0,10,4
111387,5,18,4,0,14,4
111387,4,8,3,0,5,3
111387,3,4,3,0,1,3
111387,2,1,1,0,0,1
111387,1,4,3,0,1,3
7637,10,6,3,0,3,3
7637,9,9,4,0,5,4
7637,8,19,5,0,14,5
7637,7,28,7,0,21,7
7637,6,26,6,0,20,6
7637,5,12,4,0,8,4
7637,2,3,2,0,1,2
8702,9,8,3,0,5,3
8702,8,23,6,0,17,6
8702,7,37,13,0,24,13
8702,6,21,4,0,17,4
8702,5,3,2,0,1,2
8702,4,7,2,0,5,2
8702,3,2,1,0,1,1
70532,10,10,3,0,7,3
70532,9,23,6,0,17,6
70532,8,36,14,0,22,14
70532,7,20,5,0,15,5
70532,6,12,5,0,7,5
70532,4,2,2,0,0,2
178349,10,5,2,0,3,2
178349,9,8,2,0,6,2
178349,8,24,6,2,18,4
178349,7,25,3,0,22,3
178349,6,23,8,1,15,7
178349,5,8,2,0,6,2
178349,4,7,2,0,5,2
178349,3,5,2,1,3,1
18041,7,9,3,0,6,3
18041,6,11,2,0,9,2
18041,5,11,3,0,8,3
18041,4,12,2,0,10,2
18041,3,13,5,0,8,5
18041,2,12,7,0,5,7
18041,1,34,22,0,12,22
18041,0,1,1,0,0,1
5308,8,8,5,0,3,5
5308,7,17,3,0,14,3
5308,6,38,14,0,24,14
5308,5,20,7,0,13,7
5308,4,16,6,0,10,6
5308,3,4,1,0,3,1
213648,10,7,3,0,4,3
213648,9,22,5,0,17,5
213648,8,36,12,0,24,12
213648,7,28,6,0,22,6
213648,6,10,1,0,9,1
213648,4,1,1,0,0,1
246366,10,6,3,0,3,3
246366,9,6,3,0,3,3
246366,8,31,6,0,25,6
246366,7,30,5,0,25,5
246366,6,20,4,0,16,4
246366,5,6,2,0,4,2
246366,4,3,1,0,2,1
246366,3,3,1,0,2,1
175867,7,26,3,0,23,3
175867,6,30,4,0,26,4
175867,5,18,4,0,14,4
175867,4,9,4,0,5,4
175867,3,2,1,0,1,1
175867,2,4,2,0,2,2
175867,1,1,1,0,0,1
18085,8,30,1,0,29,1
18085,7,32,3,0,29,3
18085,6,28,1,0,27,1
18085,5,8,2,0,6,2
60574,9,4,1,0,3,1
60574,8,9,3,0,6,3
60574,7,20,8,0,12,8
60574,6,42,9,0,33,9
60574,5,14,4,0,10,4
60574,4,9,1,0,8,1
60574,1,2,1,0,1,1
158316,9,6,1,0,5,1
158316,8,17,3,0,14,3
158316,7,21,1,0,20,1
158316,6,31,8,0,23,8
158316,5,17,4,0,13,4
158316,4,6,1,0,5,1
158316,3,5,1,0,4,1
158316,2,3,2,0,1,2
43393,10,1,1,0,0,1
43393,9,3,2,0,1,2
43393,8,15,9,0,6,9
43393,7,27,7,0,20,7
43393,6,40,22,0,18,22
43393,5,12,6,0,6,6
43393,4,6,2,0,4,2
93522,7,9,1,0,8,1
93522,6,25,5,0,20,5
93522,5,15,3,0,12,3
93522,4,11,4,0,7,4
93522,3,18,4,0,14,4
93522,2,16,2,0,14,2
93522,1,7,4,0,3,4
2706,10,3,1,0,2,1
2706,9,4,1,0,3,1
2706,8,8,4,0,4,4
2706,7,20,7,0,13,7
2706,6,42,18,0,24,18
2706,5,20,9,0,11,9
2706,4,6,5,0,1,5
2706,3,1,1,0,0,1
2706,2,1,1,0,0,1
185331,8,9,1,0,8,1
185331,6,32,3,0,29,3
185331,5,20,4,0,16,4
185331,4,14,4,0,10,4
269199,8,31,4,0,27,4
269199,7,41,6,0,35,6
269199,6,21,2,0,19,2
269199,4,3,1,0,2,1
195275,10,12,2,0,10,2
195275,8,25,4,2,21,2
195275,7,21,5,0,16,5
195275,6,19,1,0,18,1
195275,5,8,4,0,4,4
195275,4,6,2,0,4,2
195275,3,2,1,0,1,1
195275,2,3,3,1,0,2
195275,1,4,1,0,3,1
38038,10,2,1,0,1,1
38038,9,4,1,0,3,1
38038,8,7,2,0,5,2
38038,7,23,4,0,19,4
38038,6,39,10,0,29,10
38038,5,16,6,0,10,6
38038,3,7,2,0,5,2
184383,7,17,5,0,12,5
184383,6,36,8,0,28,8
184383,5,21,3,0,18,3
184383,4,16,6,0,10,6
184383,3,7,2,0,5,2
653,8,10,1,0,9,1
653,7,14,4,0,10,4
653,6,34,10,0,24,10
653,5,20,1,0,19,1
653,4,7,2,0,5,2
653,3,10,2,0,8,2
653,2,5,2,0,3,2
653,1,3,1,0,2,1
30485,9,1,1,0,0,1
30485,8,2,1,0,1,1
30485,7,6,1,0,5,1
30485,6,17,3,0,14,3
30485,5,27,4,0,23,4
30485,4,26,7,0,19,7
30485,3,15,1,0,14,1
30485,2,7,1,0,6,1
30485,1,3,2,0,1,2
7259,7,15,5,0,10,5
7259,6,34,10,0,24,10
7259,5,27,8,0,19,8
7259,4,9,3,0,6,3
7259,3,5,2,0,3,2
7259,2,4,1,0,3,1
7259,1,2,1,0,1,1
72941,10,3,1,0,2,1
72941,9,10,9,0,1,9
72941,8,35,11,0,24,11
72941,7,32,9,0,23,9
72941,6,16,8,0,8,8
72941,5,7,3,0,4,3
72941,4,1,1,0,0,1
72941,3,1,1,0,0,1
28817,8,7,2,0,5,2
28817,7,25,4,0,21,4
28817,6,41,8,0,33,8
28817,5,19,6,0,13,6
28817,4,7,1,0,6,1
28817,3,4,3,0,1,3
127048,8,8,2,0,6,2
127048,7,19,4,0,15,4
127048,6,32,9,0,23,9
127048,5,18,3,0,15,3
127048,4,14,3,0,11,3
127048,3,10,2,0,8,2
127048,2,2,1,0,1,1
29415,8,11,4,0,7,4
29415,7,20,6,0,14,6
29415,6,36,6,0,30,6
29415,5,18,5,0,13,5
29415,4,9,3,0,6,3
29415,2,4,1,0,3,1
29415,1,1,1,0,0,1
154642,8,9,1,0,8,1
154642,7,13,2,0,11,2
154642,6,41,10,0,31,10
154642,5,22,6,0,16,6
154642,4,10,1,0,9,1
154642,2,3,1,0,2,1
154642,1,3,2,0,1,2
151972,9,6,1,0,5,1
151972,8,13,1,1,12,0
151972,7,22,5,0,17,5
151972,6,29,3,1,26,2
151972,4,9,3,1,6,2
151972,3,6,2,2,4,0
179723,8,23,3,0,20,3
179723,7,18,3,0,15,3
179723,6,36,6,0,30,6
179723,5,15,3,0,12,3
179723,4,3,2,0,1,2
179723,3,4,1,0,3,1
31274,8,6,2,0,4,2
31274,7,18,2,0,16,2
31274,6,39,5,0,34,5
31274,5,25,4,0,21,4
31274,4,10,1,0,9,1
2002,8,7,3,0,4,3
2002,7,6,2,0,4,2
2002,6,39,14,0,25,14
2002,5,21,3,0,18,3
2002,4,13,7,0,6,7
2002,3,10,4,0,6,4
2002,2,8,3,0,5,3
230064,10,9,1,0,8,1
230064,9,4,3,1,1,2
230064,8,19,3,0,16,3
230064,7,34,7,1,27,6
230064,6,28,6,1,22,5
230064,3,3,1,0,2,1
132320,7,8,1,0,7,1
132320,6,29,5,0,24,5
132320,5,27,7,0,20,7
132320,4,20,4,0,16,4
132320,3,6,2,0,4,2
132320,2,4,1,0,3,1
132320,1,1,1,0,0,1
24258,8,2,1,0,1,1
24258,7,6,2,0,4,2
24258,6,25,8,0,17,8
24258,5,37,7,0,30,7
24258,4,19,5,0,14,5
24258,3,9,4,0,5,4
24258,2,6,5,0,1,5
24258,1,1,1,0,0,1
29599,8,5,3,0,2,3
29599,7,18,8,0,10,8
29599,6,22,3,0,19,3
29599,5,19,7,0,12,7
29599,4,20,9,0,11,9
29599,3,12,5,0,7,5
29599,2,5,3,0,2,3
29599,1,2,1,0,1,1
165046,9,6,1,0,5,1
165046,8,23,2,0,21,2
165046,7,35,4,0,31,4
165046,6,23,1,0,22,1
165046,5,12,2,0,10,2
6610,9,4,1,0,3,1
6610,8,8,5,0,3,5
6610,7,19,8,0,11,8
6610,6,31,13,0,18,13
6610,5,13,5,0,8,5
6610,4,19,6,0,13,6
6610,3,6,1,0,5,1
6610,2,3,1,0,2,1
255708,10,9,5,0,4,5
255708,9,7,2,0,5,2
255708,8,40,9,0,31,9
255708,7,34,8,0,26,8
255708,6,12,3,0,9,3
255708,5,4,1,0,3,1
255708,3,1,1,0,0,1
1902,8,2,1,0,1,1
1902,7,2,2,0,0,2
1902,6,18,7,0,11,7
1902,5,26,6,0,20,6
1902,4,21,7,0,14,7
1902,3,16,3,0,13,3
1902,2,15,8,0,7,8
1902,1,4,2,0,2,2
194228,9,4,1,0,3,1
194228,8,6,1,0,5,1
194228,7,17,2,0,15,2
194228,6,21,1,0,20,1
194228,5,21,2,0,19,2
194228,4,12,2,0,10,2
194228,3,12,1,0,11,1
194228,2,7,2,0,5,2
194228,1,3,1,0,2,1
56246,10,4,3,0,1,3
56246,9,2,2,0,0,2
56246,8,6,1,0,5,1
56246,7,7,1,0,6,1
56246,6,35,4,0,31,4
56246,5,18,3,0,15,3
56246,4,13,3,0,10,3
56246,3,13,8,0,5,8
56246,2,4,2,0,2,2
168544,9,1,1,0,0,1
168544,8,13,6,0,7,6
168544,7,25,9,0,16,9
168544,6,38,7,0,31,7
168544,4,9,4,0,5,4
168544,2,1,1,0,0,1
900,7,18,4,0,14,4
900,6,44,13,0,31,13
900,5,23,5,0,18,5
900,4,11,1,0,10,1
900,3,1,1,0,0,1
900,2,3,1,0,2,1
68199,10,5,2,0,3,2
68199,9,24,14,0,10,14
68199,8,36,15,0,21,15
68199,7,23,12,0,11,12
68199,6,12,5,0,7,5
68199,5,3,3,0,0,3
68199,4,2,1,0,1,1
19991,10,1,1,0,0,1
19991,8,13,2,0,11,2
19991,7,18,1,0,17,1
19991,6,23,4,0,19,4
19991,5,15,2,0,13,2
19991,3,10,1,0,9,1
19991,2,8,4,0,4,4
19991,1,3,3,0,0,3
2699,10,7,2,0,5,2
2699,9,15,8,0,7,8
2699,8,19,10,0,9,10
2699,7,20,4,0,16,4
2699,6,22,5,0,17,5
2699,4,11,1,0,10,1
2699,3,1,1,0,0,1
171475,8,14,1,0,13,1
171475,7,25,2,0,23,2
171475,6,23,4,0,19,4
171475,5,21,3,0,18,3
171475,4,14,2,0,12,2
171475,2,2,1,0,1,1
11195,8,2,1,0,1,1
11195,7,19,8,0,11,8
11195,6,49,20,0,29,20
11195,5,22,6,0,16,6
11195,4,12,5,0,7,5
7556,10,2,1,0,1,1
7556,8,8,3,0,5,3
7556,7,4,1,0,3,1
7556,6,32,9,0,23,9
7556,5,21,5,0,16,5
7556,4,20,6,0,14,6
7556,3,8,6,0,2,6
7556,2,5,2,0,3,2
7556,1,4,2,0,2,2
18615,10,8,2,0,6,2
18615,9,13,5,0,8,5
18615,8,22,4,0,18,4
18615,7,32,6,0,26,6
18615,6,15,4,0,11,4
18615,5,9,3,0,6,3
18615,4,3,1,0,2,1
18615,2,1,1,0,0,1
7563,10,1,1,0,0,1
7563,9,1,1,0,0,1
7563,8,3,2,0,1,2
7563,7,13,8,0,5,8
7563,6,30,14,0,16,14
7563,5,20,7,0,13,7
7563,4,20,12,0,8,12
7563,3,13,5,0,8,5
7563,2,3,1,0,2,1
192346,8,16,3,0,13,3
192346,6,27,3,0,24,3
192346,5,11,3,0,8,3
192346,4,8,1,0,7,1
192346,2,1,1,0,0,1
231032,8,11,2,0,9,2
231032,7,23,1,0,22,1
231032,6,42,7,0,35,7
231032,5,16,3,0,13,3
231032,4,8,1,0,7,1
4202,9,13,4,0,9,4
4202,8,24,3,0,21,3
4202,7,34,6,0,28,6
4202,6,18,2,0,16,2
4202,5,9,1,0,8,1
4202,4,5,1,0,4,1
246146,10,6,3,0,3,3
246146,9,5,1,0,4,1
246146,8,23,9,0,14,9
246146,7,26,6,0,20,6
246146,6,26,4,0,22,4
246146,5,11,3,0,8,3
8037,9,3,1,0,2,1
8037,8,12,3,0,9,3
8037,7,24,7,0,17,7
8037,6,38,12,0,26,12
8037,5,19,4,0,15,4
8037,3,2,1,0,1,1
8037,2,1,1,0,0,1
163399,10,24,2,0,22,2
163399,9,27,5,0,22,5
163399,8,30,3,0,27,3
163399,7,15,2,0,13,2
163399,6,5,1,0,4,1
163482,10,5,1,0,4,1
163482,9,15,3,0,12,3
163482,8,23,2,0,21,2
163482,6,21,2,0,19,2
163482,5,10,3,0,7,3
163482,4,5,1,0,4,1
163482,3,9,6,0,3,6
163482,2,3,1,0,2,1
163482,1,1,1,0,0,1
4215,9,4,2,0,2,2
4215,8,9,4,0,5,4
4215,7,30,12,0,18,12
4215,6,31,10,0,21,10
4215,5,15,4,0,11,4
4215,4,7,2,0,5,2
4215,3,4,1,0,3,1
4215,2,3,1,0,2,1
164236,10,31,14,0,17,14
164236,9,15,1,0,14,1
164236,8,15,5,0,10,5
164236,7,12,3,0,9,3
164236,6,17,2,0,15,2
164236,4,1,1,0,0,1
164236,2,2,1,0,1,1
152902,8,5,2,0,3,2
152902,7,10,2,0,8,2
152902,6,26,6,0,20,6
152902,5,25,6,0,19,6
152902,4,20,3,0,17,3
152902,3,14,1,0,13,1
152902,2,1,1,0,0,1
152902,1,1,1,0,0,1
232403,10,5,3,0,2,3
232403,9,11,3,0,8,3
232403,8,28,6,1,22,5
232403,7,34,9,2,25,7
232403,6,18,5,0,13,5
198985,10,53,6,1,47,5
198985,9,24,4,0,20,4
198985,8,12,4,1,8,3
198985,6,3,1,0,2,1
198985,5,4,1,0,3,1
198985,4,1,1,0,0,1
198985,3,2,1,1,1,0
35546,10,1,1,0,0,1
35546,9,4,2,0,2,2
35546,8,9,1,0,8,1
35546,7,22,10,0,12,10
35546,6,31,11,0,20,11
35546,5,16,3,0,13,3
35546,4,15,4,0,11,4
35546,3,4,3,0,1,3
43231,10,3,1,0,2,1
43231,9,5,2,0,3,2
43231,8,8,1,0,7,1
43231,7,20,3,0,17,3
43231,6,25,2,0,23,2
43231,5,11,3,0,8,3
43231,4,12,7,0,5,7
43231,3,10,4,0,6,4
43231,2,7,2,0,5,2
21123,6,24,2,0,22,2
21123,5,28,6,0,22,6
21123,4,18,6,0,12,6
21123,3,11,3,0,8,3
21123,2,9,1,0,8,1
21123,1,3,1,0,2,1
142903,8,23,7,2,16,5
142903,7,26,8,0,18,8
142903,6,41,6,1,35,5
142903,5,10,2,0,8,2
142903,4,2,1,0,1,1
142903,3,1,1,0,0,1
241477,10,2,1,0,1,1
241477,9,8,1,0,7,1
241477,8,22,5,0,17,5
241477,7,31,5,0,26,5
241477,6,27,5,0,22,5
241477,5,8,1,0,7,1
241477,4,5,1,0,4,1
241477,3,2,1,0,1,1
164259,10,2,1,0,1,1
164259,9,5,1,0,4,1
164259,8,33,6,0,27,6
164259,7,25,3,0,22,3
164259,6,22,2,0,20,2
164259,5,6,2,0,4,2
164259,4,3,1,0,2,1
164259,3,4,2,0,2,2
164259,2,3,1,0,2,1
226592,10,6,4,0,2,4
226592,9,5,1,0,4,1
226592,8,23,4,0,19,4
226592,7,28,2,0,26,2
226592,6,22,2,0,20,2
226592,5,9,1,0,8,1
226592,4,9,1,0,8,1
143255,9,4,1,1,3,0
143255,8,20,7,1,13,6
143255,7,29,8,1,21,7
143255,6,34,13,0,21,13
143255,5,11,2,0,9,2
3590,10,6,1,0,5,1
3590,9,8,4,0,4,4
3590,8,17,11,0,6,11
3590,7,21,7,0,14,7
3590,6,27,7,0,20,7
3590,5,13,5,0,8,5
3590,4,9,6,0,3,6
3590,1,1,1,0,0,1
244144,10,7,1,0,6,1
244144,9,9,2,0,7,2
244144,8,24,6,0,18,6
244144,7,23,5,0,18,5
244144,6,26,6,0,20,6
244144,4,3,2,0,1,2
244144,3,2,2,0,0,2
6873,7,17,2,0,15,2
6873,6,27,7,0,20,7
6873,5,24,7,0,17,7
6873,4,20,4,0,16,4
6873,3,8,2,0,6,2
3766,10,13,3,0,10,3
3766,9,12,3,0,9,3
3766,8,27,9,0,18,9
3766,7,22,8,0,14,8
3766,5,8,1,0,7,1
3766,4,6,2,0,4,2
3766,3,2,1,0,1,1
3766,2,1,1,0,0,1
252877,10,14,9,2,5,7
252877,9,20,8,2,12,6
252877,8,53,13,2,40,11
252877,7,11,2,0,9,2
252877,6,10,1,0,9,1
2203,8,9,2,0,7,2
2203,7,17,3,0,14,3
2203,6,34,14,0,20,14
2203,5,25,4,0,21,4
2203,4,8,2,0,6,2
2203,3,9,5,0,4,5
2203,1,1,1,0,0,1
178212,10,15,6,1,9,5
178212,9,20,6,1,14,5
178212,8,38,9,2,29,7
178212,7,15,1,1,14,0
178212,6,12,3,0,9,3
178212,4,2,1,1,1,0
2510,10,1,1,0,0,1
2510,9,3,1,0,2,1
2510,8,21,1,0,20,1
2510,7,16,2,0,14,2
2510,6,31,3,0,28,3
2510,5,19,1,0,18,1
2510,4,8,3,0,5,3
18791,8,11,5,0,6,5
18791,7,21,5,0,16,5
18791,6,32,7,0,25,7
18791,5,25,4,0,21,4
18791,4,9,5,0,4,5
18791,3,2,1,0,1,1
18791,2,1,1,0,0,1
138016,7,23,5,0,18,5
138016,6,49,5,0,44,5
138016,5,10,2,0,8,2
138016,4,9,2,0,7,2
138016,2,3,1,0,2,1
152172,10,14,3,1,11,2
152172,9,19,2,0,17,2
152172,8,29,6,0,23,6
152172,7,18,2,0,16,2
152172,6,15,4,1,11,3
152172,5,4,1,0,3,1
152172,1,4,3,0,1,3
267568,8,11,4,0,7,4
267568,7,38,6,0,32,6
267568,6,37,3,0,34,3
267568,5,14,2,0,12,2
267568,3,1,1,0,0,1
42493,10,1,1,0,0,1
42493,8,9,3,0,6,3
42493,7,21,7,0,14,7
42493,6,36,9,0,27,9
42493,5,16,8,0,8,8
42493,4,13,2,0,11,2
42493,3,3,1,0,2,1
42493,2,2,1,0,1,1
42493,1,2,1,0,1,1
218576,9,3,2,0,1,2
218576,8,11,2,0,9,2
218576,7,31,4,0,27,4
218576,6,41,4,0,37,4
218576,5,11,4,0,7,4
218576,4,7,2,0,5,2
145209,9,3,2,0,1,2
145209,8,17,8,0,9,8
145209,7,21,3,0,18,3
145209,6,30,8,0,22,8
145209,5,10,6,0,4,6
145209,4,8,3,1,5,2
145209,3,11,3,0,8,3
145209,2,3,1,0,2,1
37875,9,8,4,0,4,4
37875,8,31,13,0,18,13
37875,7,35,15,0,20,15
37875,6,18,6,0,12,6
37875,5,10,5,0,5,5
37875,4,2,2,0,0,2
96672,10,4,1,0,3,1
96672,8,8,1,0,7,1
96672,7,17,1,0,16,1
96672,6,34,6,0,28,6
96672,5,27,8,0,19,8
96672,4,6,3,0,3,3
96672,3,3,1,0,2,1
96672,2,2,1,0,1,1
96672,1,2,1,0,1,1
131183,10,11,3,0,8,3
131183,9,18,1,0,17,1
131183,8,36,5,0,31,5
131183,7,18,3,0,15,3
131183,6,15,1,0,14,1
131183,5,5,1,0,4,1
159011,10,8,4,0,4,4
159011,9,10,4,0,6,4
159011,8,20,2,2,18,0
159011,7,21,4,0,17,4
159011,6,21,3,0,18,3
159011,5,8,2,0,6,2
159011,3,7,4,0,3,4
159011,2,5,3,0,2,3
159011,1,2,1,0,1,1
1530,10,2,1,0,1,1
1530,9,8,3,0,5,3
1530,8,11,4,0,7,4
1530,7,24,4,0,20,4
1530,6,29,10,0,19,10
1530,5,17,7,0,10,7
1530,4,9,4,0,5,4
1530,3,3,2,0,1,2
33359,9,3,1,0,2,1
33359,8,12,5,0,7,5
33359,7,17,5,0,12,5
33359,6,32,12,0,20,12
33359,5,21,10,0,11,10
33359,4,8,4,0,4,4
33359,2,7,3,0,4,3
33359,1,1,1,0,0,1
1987,8,13,8,0,5,8
1987,7,18,9,0,9,9
1987,6,37,19,0,18,19
1987,5,22,8,0,14,8
1987,4,4,1,0,3,1
1987,3,7,5,0,2,5
1987,2,1,1,0,0,1
3528,9,4,1,0,3,1
3528,8,15,3,0,12,3
3528,7,24,9,0,15,9
3528,6,23,1,0,22,1
3528,5,20,3,0,17,3
3528,4,9,5,0,4,5
3528,3,5,1,0,4,1
3528,2,2,2,0,0,2
3528,1,2,2,0,0,2
6399,8,13,4,0,9,4
6399,7,32,12,0,20,12
6399,6,31,12,0,19,12
6399,5,16,5,0,11,5
6399,4,4,1,0,3,1
6399,1,2,1,0,1,1
132452,10,2,1,0,1,1
132452,8,9,2,0,7,2
132452,7,22,11,0,11,11
132452,6,42,16,0,26,16
132452,5,16,2,0,14,2
132452,4,8,3,0,5,3
132452,3,3,1,0,2,1
132452,2,2,1,0,1,1
109296,9,6,1,0,5,1
109296,7,28,4,0,24,4
109296,6,36,4,0,32,4
109296,5,15,1,0,14,1
109296,4,8,4,0,4,4
10234,10,3,1,0,2,1
10234,9,5,3,0,2,3
10234,8,12,3,0,9,3
10234,7,37,15,0,22,15
10234,6,24,10,0,14,10
10234,5,13,7,0,6,7
10234,4,5,1,0,4,1
10234,2,1,1,0,0,1
10234,1,1,1,0,0,1
158886,10,11,5,0,6,5
158886,9,27,6,0,21,6
158886,8,43,13,0,30,13
158886,7,11,7,0,4,7
158886,6,6,1,0,5,1
158886,4,2,2,0,0,2
94123,10,1,1,0,0,1
94123,8,15,3,0,12,3
94123,6,31,4,0,27,4
94123,5,17,3,0,14,3
94123,4,13,3,0,10,3
94123,2,3,2,0,1,2
31767,9,1,1,0,0,1
31767,7,15,3,0,12,3
31767,6,33,5,0,28,5
31767,5,27,5,0,22,5
31767,3,6,2,0,4,2
31767,1,1,1,0,0,1
42396,10,10,6,0,4,6
42396,9,18,5,0,13,5
42396,8,34,9,0,25,9
42396,7,27,8,0,19,8
42396,6,8,1,0,7,1
17687,8,4,1,0,3,1
17687,7,8,2,0,6,2
17687,6,35,7,0,28,7
17687,5,30,8,0,22,8
17687,4,12,3,0,9,3
17687,2,4,2,0,2,2
17924,8,33,3,0,30,3
17924,7,26,2,0,24,2
17924,6,26,2,0,24,2
17924,5,11,2,0,9,2
248763,10,3,3,0,0,3
248763,8,26,1,0,25,1
248763,7,29,9,0,20,9
248763,6,19,6,0,13,6
248763,5,8,1,0,7,1
248763,4,8,2,0,6,2
248763,3,1,1,0,0,1
248763,1,3,1,0,2,1
252402,9,4,2,1,2,1
252402,8,42,4,0,38,4
252402,7,31,3,2,28,1
252402,6,21,2,0,19,2
252402,4,1,1,0,0,1
6474,8,5,1,0,4,1
6474,7,10,2,0,8,2
6474,6,27,14,0,13,14
6474,5,27,13,0,14,13
6474,4,11,7,0,4,7
6474,3,11,7,0,4,7
6474,2,7,2,0,5,2
6474,1,3,1,0,2,1
22378,9,9,2,0,7,2
22378,8,43,18,0,25,18
22378,7,31,8,0,23,8
22378,6,10,4,0,6,4
22378,5,4,1,0,3,1
2098,9,2,1,0,1,1
2098,8,9,4,0,5,4
2098,7,18,4,0,14,4
2098,6,36,12,0,24,12
2098,5,16,6,0,10,6
2098,4,12,7,0,5,7
2098,3,8,5,0,3,5
2098,2,1,1,0,0,1
60126,9,8,3,0,5,3
60126,8,29,11,0,18,11
60126,7,29,6,0,23,6
60126,6,23,7,0,16,7
60126,5,8,2,0,6,2
60126,4,5,2,0,3,2
9238,8,16,4,0,12,4
9238,7,24,8,0,16,8
9238,6,30,8,0,22,8
9238,5,16,3,0,13,3
9238,4,6,3,0,3,3
1133,10,2,2,0,0,2
1133,8,11,8,0,3,8
1133,7,10,3,0,7,3
1133,6,27,5,0,22,5
1133,5,28,9,0,19,9
1133,4,14,5,0,9,5
1133,3,8,6,0,2,6
2674,10,2,2,0,0,2
2674,9,2,2,0,0,2
2674,8,10,6,0,4,6
2674,7,19,7,0,12,7
2674,6,27,8,0,19,8
2674,5,20,9,0,11,9
2674,4,10,5,0,5,5
2674,3,10,3,0,7,3
2674,2,2,1,0,1,1
2674,1,1,1,0,0,1
5166,7,8,4,0,4,4
5166,6,24,4,0,20,4
5166,5,30,5,0,25,5
5166,4,17,4,0,13,4
5166,3,6,2,0,4,2
5166,2,7,1,0,6,1
5166,1,3,1,0,2,1
157838,8,11,1,0,10,1
157838,7,14,1,0,13,1
157838,6,34,6,0,28,6
157838,5,21,4,0,17,4
157838,4,12,2,0,10,2
157838,3,3,1,0,2,1
157838,2,2,2,0,0,2
22254,8,11,5,0,6,5
22254,7,15,9,0,6,9
22254,6,26,8,0,18,8
22254,5,15,3,0,12,3
22254,4,16,1,0,15,1
22254,3,13,3,0,10,3
22254,1,2,1,0,1,1
5990,9,1,1,0,0,1
5990,8,15,10,0,5,10
5990,7,32,11,0,21,11
5990,6,34,6,0,28,6
5990,5,10,1,0,9,1
5990,4,8,2,0,6,2
5990,3,1,1,0,0,1
5990,1,1,1,0,0,1
192352,8,8,2,0,6,2
192352,7,25,6,0,19,6
192352,6,35,9,0,26,9
192352,5,17,3,0,14,3
192352,4,6,3,0,3,3
192352,3,5,1,0,4,1
42057,9,4,2,0,2,2
42057,8,27,20,0,7,20
42057,7,23,8,0,15,8
42057,6,37,14,0,23,14
42057,5,5,1,0,4,1
42057,4,3,1,0,2,1
10679,10,6,2,0,4,2
10679,9,17,7,0,10,7
10679,8,38,6,0,32,6
10679,7,25,8,0,17,8
10679,6,13,5,0,8,5
10679,4,1,1,0,0,1
10679,3,1,1,0,0,1
5394,10,7,1,0,6,1
5394,9,19,5,0,14,5
5394,8,41,7,0,34,7
5394,7,24,8,0,16,8
5394,6,5,1,0,4,1
5394,5,6,1,0,5,1
7410,8,6,2,0,4,2
7410,7,6,1,0,5,1
7410,6,22,7,0,15,7
7410,5,19,7,0,12,7
7410,4,23,8,0,15,8
7410,3,14,5,0,9,5
7410,2,9,3,0,6,3
7410,1,3,1,0,2,1
226312,10,8,1,0,7,1
226312,9,5,2,0,3,2
226312,8,25,5,0,20,5
226312,7,24,3,1,21,2
226312,6,29,7,0,22,7
226312,5,9,1,0,8,1
226312,2,2,1,0,1,1
2518,7,7,3,0,4,3
2518,6,17,7,0,10,7
2518,5,23,14,0,9,14
2518,4,25,8,0,17,8
2518,3,6,3,0,3,3
2518,2,9,3,0,6,3
129348,10,3,2,0,1,2
129348,9,12,6,0,6,6
129348,8,52,15,0,37,15
129348,7,22,4,0,18,4
129348,5,1,1,0,0,1
129348,4,3,1,0,2,1
129348,3,2,2,0,0,2
40258,10,8,4,0,4,4
40258,9,27,9,0,18,9
40258,8,38,15,0,23,15
40258,7,19,4,0,15,4
40258,6,8,5,0,3,5
40258,5,2,1,0,1,1
204892,10,1,1,0,0,1
204892,9,3,1,0,2,1
204892,8,11,2,0,9,2
204892,7,20,4,0,16,4
204892,6,34,5,0,29,5
204892,5,20,3,0,17,3
204892,4,6,2,0,4,2
204892,3,8,2,0,6,2
5522,8,12,5,0,7,5
5522,7,16,4,0,12,4
5522,6,39,8,0,31,8
5522,5,23,4,0,19,4
5522,4,5,2,0,3,2
143416,10,3,1,0,2,1
143416,9,16,3,0,13,3
143416,8,23,5,2,18,3
143416,7,22,3,0,19,3
143416,6,24,7,0,17,7
143416,5,7,2,0,5,2
143416,4,3,2,0,1,2
143416,2,2,1,0,1,1
158535,10,7,1,0,6,1
158535,9,8,1,0,7,1
158535,8,25,6,1,19,5
158535,7,21,3,0,18,3
158535,6,26,3,0,23,3
158535,5,9,2,0,7,2
158535,4,3,1,0,2,1
158535,3,4,1,0,3,1
257073,10,3,3,0,0,3
257073,8,10,2,0,8,2
257073,7,21,4,0,17,4
257073,6,29,5,0,24,5
257073,5,20,5,0,15,5
257073,4,7,2,0,5,2
257073,3,7,4,0,3,4
257073,2,2,1,0,1,1
741,10,3,1,0,2,1
741,9,5,3,0,2,3
741,8,19,8,0,11,8
741,7,28,9,0,19,9
741,6,24,5,0,19,5
21219,8,6,2,0,4,2
21219,7,17,3,0,14,3
21219,6,45,9,0,36,9
21219,5,19,5,0,14,5
21219,4,8,4,0,4,4
21219,3,5,1,0,4,1
35294,9,3,1,0,2,1
35294,8,8,2,0,6,2
35294,7,10,4,0,6,4
35294,6,16,5,0,11,5
35294,5,20,6,0,14,6
35294,4,24,6,0,18,6
35294,2,12,6,0,6,6
35294,1,2,1,0,1,1
130600,9,1,1,0,0,1
130600,8,13,2,0,11,2
130600,7,16,4,0,12,4
130600,6,53,5,0,48,5
130600,5,11,1,0,10,1
130600,4,5,2,0,3,2
130600,3,2,1,0,1,1
4915,9,3,1,0,2,1
4915,8,33,13,0,20,13
4915,7,30,9,0,21,9
4915,6,19,10,0,9,10
4915,5,7,3,0,4,3
4915,4,3,1,0,2,1
4915,3,4,2,0,2,2
177921,10,15,5,0,10,5
177921,9,10,2,1,8,1
177921,8,15,5,0,10,5
177921,7,24,5,1,19,4
177921,6,20,1,0,19,1
177921,5,9,1,0,8,1
177921,4,6,2,0,4,2
177921,3,3,1,0,2,1
172164,9,3,1,0,2,1
172164,8,22,3,0,19,3
172164,7,29,5,0,24,5
172164,6,30,6,0,24,6
172164,5,9,1,0,8,1
172164,4,8,2,0,6,2
172164,2,1,1,0,0,1
5640,7,16,3,0,13,3
5640,6,39,16,0,23,16
5640,5,25,9,0,16,9
5640,4,11,3,0,8,3
5640,2,2,1,0,1,1
5640,1,1,1,0,0,1
70597,8,5,1,0,4,1
70597,7,27,2,0,25,2
70597,6,36,4,0,32,4
70597,5,13,2,0,11,2
70597,4,11,4,0,7,4
70597,3,3,1,0,2,1
1087,10,1,1,0,0,1
1087,8,7,1,0,6,1
1087,7,13,1,0,12,1
1087,6,33,7,0,26,7
1087,5,23,2,0,21,2
1087,4,14,2,0,12,2
1087,3,8,3,0,5,3
1087,2,1,1,0,0,1
1162,9,3,1,0,2,1
1162,8,6,2,0,4,2
1162,7,13,3,0,10,3
1162,6,41,17,0,24,17
1162,5,13,5,0,8,5
1162,4,16,4,0,12,4
1162,3,8,3,0,5,3
1162,2,3,2,0,1,2
243964,8,18,6,0,12,6
243964,7,23,5,0,18,5
243964,6,33,3,0,30,3
243964,5,14,2,0,12,2
243964,4,10,1,0,9,1
159437,10,1,1,0,0,1
159437,8,7,1,0,6,1
159437,7,13,1,0,12,1
159437,5,17,2,0,15,2
159437,3,10,1,0,9,1
143780,9,3,1,0,2,1
143780,8,9,3,0,6,3
143780,7,17,3,0,14,3
143780,6,32,6,0,26,6
143780,5,20,5,0,15,5
143780,4,7,2,0,5,2
143780,3,8,4,0,4,4
143780,2,3,1,0,2,1
143780,1,4,1,0,3,1
5129,6,12,2,0,10,2
5129,5,18,1,0,17,1
5129,4,20,4,0,16,4
5129,3,19,4,0,15,4
5129,2,19,10,0,9,10
5129,1,8,3,0,5,3
197909,10,5,2,0,3,2
197909,9,4,2,0,2,2
197909,8,10,4,0,6,4
197909,7,20,1,0,19,1
197909,6,18,6,0,12,6
197909,5,15,2,0,13,2
197909,4,10,3,0,7,3
197909,3,14,6,0,8,6
197909,2,4,3,0,1,3
166210,10,2,1,0,1,1
166210,9,3,2,1,1,1
166210,8,19,5,0,14,5
166210,7,23,8,1,15,7
166210,6,35,11,0,24,11
166210,5,13,2,0,11,2
166210,3,4,1,0,3,1
24999,10,1,1,0,0,1
24999,9,4,2,0,2,2
24999,8,10,3,0,7,3
24999,7,26,5,0,21,5
24999,6,32,5,0,27,5
24999,5,14,2,0,12,2
24999,4,12,1,0,11,1
24999,3,3,1,0,2,1
34014,8,8,4,0,4,4
34014,7,11,5,0,6,5
34014,6,37,18,0,19,18
34014,5,25,6,0,19,6
34014,4,14,5,0,9,5
34014,3,3,2,0,1,2
34014,2,4,2,0,2,2
58713,9,1,1,0,0,1
58713,8,9,3,0,6,3
58713,7,11,4,0,7,4
58713,6,30,5,0,25,5
58713,5,23,2,0,21,2
58713,4,15,3,0,12,3
58713,3,12,2,0,10,2
269725,10,3,1,0,2,1
269725,9,4,2,0,2,2
269725,8,29,3,0,26,3
269725,7,30,3,0,27,3
269725,6,35,7,0,28,7
269725,5,3,1,0,2,1
269725,4,3,1,0,2,1
7639,10,5,1,0,4,1
7639,9,7,4,0,3,4
7639,8,12,4,0,8,4
7639,7,28,7,0,21,7
7639,6,31,3,0,28,3
7639,5,13,4,0,9,4
7639,4,6,3,0,3,3
7639,3,1,1,0,0,1
5182,10,2,1,0,1,1
5182,9,8,4,0,4,4
5182,8,12,6,0,6,6
5182,7,27,12,0,15,12
5182,6,35,12,0,23,12
5182,5,11,4,0,7,4
5182,4,7,3,0,4,3
5182,3,1,1,0,0,1
146034,8,22,10,0,12,10
146034,7,29,10,0,19,10
146034,6,29,11,0,18,11
146034,5,11,5,0,6,5
146034,4,5,3,0,2,3
146034,3,4,2,0,2,2
146034,2,1,1,0,0,1
112102,8,9,1,0,8,1
112102,7,21,3,0,18,3
112102,6,35,5,0,30,5
112102,5,20,2,0,18,2
226009,10,16,4,0,12,4
226009,8,33,3,0,30,3
226009,7,24,5,0,19,5
226009,6,10,1,0,9,1
226009,4,4,1,0,3,1
1397,8,4,2,0,2,2
1397,7,14,9,0,5,9
1397,6,37,5,0,32,5
1397,5,25,4,0,21,4
1397,4,11,3,0,8,3
1397,3,9,3,0,6,3
1397,2,2,2,0,0,2
177248,10,2,2,0,0,2
177248,9,17,9,0,8,9
177248,8,37,13,0,24,13
177248,7,24,7,0,17,7
177248,6,16,3,1,13,2
177248,5,6,1,0,5,1
177248,4,1,1,0,0,1
214224,10,4,1,0,3,1
214224,7,14,2,0,12,2
214224,6,32,5,0,27,5
214224,5,13,1,0,12,1
214224,4,10,3,0,7,3
214224,3,9,3,0,6,3
214224,2,9,1,0,8,1
214224,1,4,1,0,3,1
178099,10,6,1,0,5,1
178099,9,11,2,0,9,2
178099,8,37,2,0,35,2
178099,7,30,1,0,29,1
178099,6,6,1,0,5,1
178099,5,7,1,0,6,1
174013,9,1,1,0,0,1
174013,8,22,6,1,16,5
174013,7,33,7,3,26,4
174013,6,28,6,1,22,5
174013,5,7,4,0,3,4
174013,4,5,1,0,4,1
174013,2,2,1,0,1,1
220672,9,2,1,0,1,1
220672,8,22,6,0,16,6
220672,7,20,2,0,18,2
220672,6,44,7,0,37,7
220672,5,6,1,0,5,1
220672,4,6,3,0,3,3
220672,3,2,1,0,1,1
7993,8,13,3,0,10,3
7993,7,33,4,0,29,4
7993,6,38,14,0,24,14
7993,5,10,1,0,9,1
7993,4,6,2,0,4,2
7993,2,1,1,0,0,1
2910,6,7,2,0,5,2
2910,4,15,3,0,12,3
2910,3,19,4,0,15,4
2910,2,31,9,0,22,9
2910,1,24,11,0,13,11
223096,10,6,1,0,5,1
223096,8,17,4,0,13,4
223096,7,34,5,0,29,5
223096,6,26,3,0,23,3
223096,5,13,5,0,8,5
223096,4,2,1,0,1,1
223096,1,1,1,0,0,1
139627,7,18,4,0,14,4
139627,6,41,5,0,36,5
139627,5,21,2,0,19,2
84088,9,4,1,0,3,1
84088,8,16,4,0,12,4
84088,7,38,6,0,32,6
84088,6,32,4,0,28,4
175516,10,8,6,0,2,6
175516,9,11,6,0,5,6
175516,8,29,16,0,13,16
175516,7,6,2,0,4,2
175516,6,19,4,0,15,4
175516,5,7,4,0,3,4
175516,4,11,2,0,9,2
175516,3,8,3,0,5,3
175516,2,2,1,0,1,1
175516,1,1,1,0,0,1
23576,10,2,1,0,1,1
23576,9,3,1,0,2,1
23576,8,7,3,0,4,3
23576,7,10,4,0,6,4
23576,6,27,10,0,17,10
23576,5,23,11,0,12,11
23576,4,21,10,0,11,10
23576,3,5,3,0,2,3
23576,2,3,1,0,2,1
8626,10,3,1,0,2,1
8626,9,7,3,0,4,3
8626,8,22,7,0,15,7
8626,7,18,6,0,12,6
8626,6,29,8,0,21,8
8626,5,9,5,0,4,5
8626,4,6,2,0,4,2
8626,3,4,2,0,2,2
160413,9,1,1,0,0,1
160413,8,9,1,1,8,0
160413,7,18,4,1,14,3
160413,6,29,11,0,18,11
160413,5,20,5,0,15,5
160413,4,9,2,0,7,2
160413,3,10,5,1,5,4
160413,2,4,1,0,3,1
160413,1,1,1,0,0,1
4020,10,2,1,0,1,1
4020,9,2,1,0,1,1
4020,8,18,5,0,13,5
4020,7,28,10,0,18,10
4020,6,30,5,0,25,5
4020,5,12,1,0,11,1
4020,4,9,4,0,5,4
4020,3,1,1,0,0,1
1991,10,2,2,0,0,2
1991,8,17,6,0,11,6
1991,7,18,4,0,14,4
1991,6,36,8,0,28,8
1991,5,16,3,0,13,3
1991,4,10,6,0,4,6
1991,3,2,1,0,1,1
647,10,2,1,0,1,1
647,9,10,3,0,7,3
647,8,12,5,0,7,5
647,7,33,16,0,17,16
647,6,17,8,0,9,8
647,5,17,4,0,13,4
647,4,6,1,0,5,1
647,3,4,1,0,3,1
122868,8,7,4,0,3,4
122868,7,8,1,0,7,1
122868,6,41,7,0,34,7
122868,5,25,4,0,21,4
122868,4,11,5,0,6,5
122868,2,4,2,0,2,2
35305,9,5,2,0,3,2
35305,8,16,6,0,10,6
35305,7,29,11,0,18,11
35305,6,29,7,0,22,7
35305,5,12,2,0,10,2
35305,4,7,2,0,5,2
35305,3,3,2,0,1,2
35305,2,1,1,0,0,1
121995,10,4,2,0,2,2
121995,9,4,2,0,2,2
121995,8,16,3,0,13,3
121995,7,18,4,0,14,4
121995,6,36,7,0,29,7
121995,5,12,3,0,9,3
121995,4,3,2,0,1,2
121995,2,4,3,0,1,3
265683,10,1,1,0,0,1
265683,9,8,3,0,5,3
265683,8,19,3,0,16,3
265683,7,25,2,0,23,2
265683,6,36,5,0,31,5
265683,5,10,3,0,7,3
265683,3,4,1,0,3,1
20130,10,2,1,0,1,1
20130,9,4,1,0,3,1
20130,8,17,5,0,12,5
20130,7,18,9,0,9,9
20130,6,24,6,0,18,6
20130,5,20,2,0,18,2
20130,4,6,4,0,2,4
20130,3,6,1,0,5,1
20130,2,5,3,0,2,3
21729,8,3,2,0,1,2
21729,7,9,3,0,6,3
21729,6,48,9,0,39,9
21729,5,24,7,0,17,7
21729,4,9,5,0,4,5
21729,3,6,2,0,4,2
21729,2,2,1,0,1,1
164930,9,3,1,0,2,1
164930,8,15,4,0,11,4
164930,7,18,3,0,15,3
164930,6,35,3,0,32,3
164930,5,14,4,0,10,4
164930,4,7,3,0,4,3
164930,3,6,1,0,5,1
164930,2,3,1,0,2,1
4436,10,2,2,0,0,2
4436,9,8,5,0,3,5
4436,8,23,11,0,12,11
4436,7,31,10,0,21,10
4436,6,18,3,0,15,3
4436,5,12,2,0,10,2
4436,4,6,2,0,4,2
4021,9,4,2,0,2,2
4021,8,7,1,0,6,1
4021,7,11,3,0,8,3
4021,6,45,19,0,26,19
4021,5,24,12,0,12,12
4021,4,7,2,0,5,2
4021,3,2,1,0,1,1
5039,9,4,1,0,3,1
5039,8,7,4,0,3,4
5039,7,23,5,0,18,5
5039,6,22,6,0,16,6
5039,5,19,7,0,12,7
5039,4,17,5,0,12,5
5039,3,3,1,0,2,1
5039,2,4,4,0,0,4
5039,1,3,3,0,0,3
2406,7,9,5,0,4,5
2406,6,38,10,0,28,10
2406,5,30,5,0,25,5
2406,4,10,4,0,6,4
2406,3,7,2,0,5,2
2406,2,2,1,0,1,1
2406,1,2,1,0,1,1
182801,8,19,3,0,16,3
182801,7,28,3,0,25,3
182801,6,34,7,0,27,7
182801,4,6,1,0,5,1
15020,10,1,1,0,0,1
15020,8,6,1,0,5,1
15020,7,11,2,0,9,2
15020,6,26,7,0,19,7
15020,5,19,3,0,16,3
15020,4,18,4,0,14,4
15020,3,13,2,0,11,2
15020,2,7,3,0,4,3
15020,1,1,1,0,0,1
57201,10,3,2,0,1,2
57201,9,4,2,0,2,2
57201,8,19,8,0,11,8
57201,7,32,10,0,22,10
57201,6,28,4,0,24,4
57201,5,12,3,0,9,3
204141,8,12,2,0,10,2
204141,7,16,1,0,15,1
204141,6,38,10,0,28,10
204141,5,10,2,0,8,2
204141,4,12,3,0,9,3
204141,2,2,1,0,1,1
27626,9,5,1,0,4,1
27626,8,12,2,0,10,2
27626,7,19,4,0,15,4
27626,6,33,3,0,30,3
27626,5,20,3,0,17,3
27626,2,1,1,0,0,1
171779,8,17,5,1,12,4
171779,7,26,7,1,19,6
171779,6,26,5,0,21,5
171779,5,11,1,0,10,1
171779,4,4,2,0,2,2
171779,3,5,1,0,4,1
5590,8,12,9,0,3,9
5590,7,21,6,0,15,6
5590,6,40,12,0,28,12
5590,5,18,4,0,14,4
5590,4,8,1,0,7,1
119472,8,8,1,0,7,1
119472,7,24,3,0,21,3
119472,6,31,2,0,29,2
119472,5,14,3,0,11,3
119472,4,13,3,0,10,3
119472,3,7,2,0,5,2
119472,1,1,1,0,0,1
39,9,1,1,0,0,1
39,8,7,6,0,1,6
39,7,17,9,0,8,9
39,6,28,10,0,18,10
39,5,17,4,0,13,4
39,4,10,3,0,7,3
39,3,15,6,0,9,6
39,2,5,4,0,1,4
39,1,2,2,0,0,2
1247,9,4,2,0,2,2
1247,8,8,1,0,7,1
1247,7,9,5,0,4,5
1247,6,32,8,0,24,8
1247,5,30,4,0,26,4
1247,4,11,4,0,7,4
1247,3,2,2,0,0,2
1247,2,4,3,0,1,3
16985,8,2,1,0,1,1
16985,7,13,2,0,11,2
16985,6,28,4,0,24,4
16985,5,18,3,0,15,3
16985,4,16,4,0,12,4
16985,3,16,3,0,13,3
16985,2,5,1,0,4,1
16985,1,4,2,0,2,2
59576,10,5,1,0,4,1
59576,9,12,4,0,8,4
59576,8,23,5,0,18,5
59576,7,26,7,0,19,7
59576,6,22,2,0,20,2
59576,5,7,1,0,6,1
245446,8,12,2,0,10,2
245446,7,19,1,0,18,1
245446,6,35,4,0,31,4
245446,5,19,3,0,16,3
245446,4,6,3,0,3,3
245446,3,7,3,0,4,3
247324,8,8,1,0,7,1
247324,7,19,5,0,14,5
247324,6,35,9,0,26,9
247324,5,21,1,0,20,1
247324,4,11,3,0,8,3
247324,3,8,3,0,5,3
4918,9,8,4,0,4,4
4918,8,28,12,0,16,12
4918,7,22,7,0,15,7
4918,6,25,8,0,17,8
4918,5,9,2,0,7,2
4918,4,6,3,0,3,3
4918,1,1,1,0,0,1
36554,8,10,6,0,4,6
36554,7,20,5,0,15,5
36554,6,34,11,1,23,10
36554,5,25,7,0,18,7
36554,4,10,4,0,6,4
3360,9,4,1,0,3,1
3360,8,6,4,0,2,4
3360,7,18,6,0,12,6
3360,6,30,9,0,21,9
3360,5,25,10,0,15,10
3360,4,14,3,0,11,3
217890,8,12,1,0,11,1
217890,7,24,3,0,21,3
217890,6,27,4,0,23,4
217890,5,17,1,0,16,1
217890,4,9,1,0,8,1
217890,3,6,1,0,5,1
2986,9,3,3,0,0,3
2986,8,19,11,1,8,10
2986,7,20,6,0,14,6
2986,6,36,10,0,26,10
2986,5,11,4,0,7,4
2986,4,3,1,0,2,1
2986,3,5,1,0,4,1
2986,2,2,1,0,1,1
218200,9,5,1,0,4,1
218200,8,28,6,0,22,6
218200,7,40,6,0,34,6
218200,6,23,4,0,19,4
218200,5,2,1,0,1,1
31198,9,7,3,0,4,3
31198,8,28,6,0,22,6
31198,7,37,16,0,21,16
31198,6,17,3,0,14,3
31198,5,8,3,0,5,3
31198,3,5,2,0,3,2
254017,9,6,1,0,5,1
254017,8,34,9,0,25,9
254017,7,40,1,0,39,1
254017,6,13,1,0,12,1
254017,5,6,1,0,5,1
29653,8,1,1,0,0,1
29653,6,8,1,0,7,1
29653,5,21,12,0,9,12
29653,4,18,6,0,12,6
29653,3,27,12,0,15,12
29653,2,15,9,0,6,9
29653,1,11,6,0,5,6
5242,10,5,4,0,1,4
5242,9,15,7,0,8,7
5242,8,21,11,0,10,11
5242,7,25,7,0,18,7
5242,6,25,9,0,16,9
5242,5,5,1,0,4,1
5242,4,4,1,0,3,1
5242,3,1,1,0,0,1
118950,9,6,1,0,5,1
118950,8,13,2,0,11,2
118950,7,25,1,0,24,1
118950,6,28,4,0,24,4
118950,5,11,1,0,10,1
118950,4,12,2,0,10,2
118950,1,1,1,0,0,1
14191,8,10,1,0,9,1
14191,6,19,2,0,17,2
14191,5,14,1,0,13,1
14191,4,15,3,0,12,3
14191,3,16,4,0,12,4
14191,2,12,5,0,7,5
14191,1,9,5,0,4,5
160436,10,7,1,0,6,1
160436,9,8,2,0,6,2
160436,8,26,7,0,19,7
160436,7,33,12,0,21,12
160436,6,18,4,0,14,4
160436,4,2,1,0,1,1
246855,10,6,2,0,4,2
246855,9,7,2,0,5,2
246855,8,32,3,0,29,3
246855,7,39,6,0,33,6
246855,5,5,1,0,4,1
86406,10,3,3,0,0,3
86406,9,7,5,0,2,5
86406,8,31,16,0,15,16
86406,7,29,10,0,19,10
86406,6,20,8,0,12,8
86406,5,7,3,0,4,3
86406,3,1,1,0,0,1
179661,10,14,7,0,7,7
179661,9,13,6,0,7,6
179661,8,28,5,0,23,5
179661,7,20,2,0,18,2
179661,6,19,1,0,18,1
179661,5,7,3,0,4,3
223033,10,17,12,0,5,12
223033,9,14,8,0,6,8
223033,8,33,9,0,24,9
223033,7,16,2,0,14,2
223033,6,12,3,0,9,3
223033,5,3,1,0,2,1
223033,4,2,1,0,1,1
223033,3,2,1,0,1,1
223033,2,3,1,0,2,1
14361,9,2,1,0,1,1
14361,7,9,1,0,8,1
14361,6,28,6,0,22,6
14361,5,26,7,0,19,7
14361,4,11,3,0,8,3
14361,3,7,3,0,4,3
14361,1,2,2,0,0,2
217447,8,6,1,0,5,1
217447,7,24,2,0,22,2
217447,6,44,7,0,37,7
217447,5,14,2,0,12,2
217447,4,5,2,0,3,2
217447,3,4,1,0,3,1
6251,10,15,11,0,4,11
6251,9,17,7,0,10,7
6251,8,34,14,0,20,14
6251,7,16,7,0,9,7
6251,6,9,4,0,5,4
6251,5,4,2,0,2,2
6251,3,3,1,0,2,1
6251,1,1,1,0,0,1
19616,10,6,2,0,4,2
19616,7,10,2,0,8,2
19616,6,21,3,0,18,3
19616,5,24,2,0,22,2
19616,4,18,1,0,17,1
19616,3,10,2,0,8,2
153113,10,24,8,0,16,8
153113,9,17,6,0,11,6
153113,8,32,9,0,23,9
153113,7,11,1,0,10,1
153113,6,10,2,0,8,2
153113,4,1,1,0,0,1
153113,2,1,1,0,0,1
221369,9,9,2,0,7,2
221369,8,28,5,0,23,5
221369,7,30,6,0,24,6
221369,6,29,5,0,24,5
3513,9,3,1,0,2,1
3513,8,17,6,0,11,6
3513,7,22,4,0,18,4
3513,6,36,16,0,20,16
3513,5,13,3,0,10,3
3513,4,5,2,0,3,2
3513,3,3,1,0,2,1
194505,8,9,4,0,5,4
194505,7,21,4,0,17,4
194505,6,42,10,0,32,10
194505,5,13,4,0,9,4
194505,4,8,3,0,5,3
20138,8,2,2,0,0,2
20138,7,11,3,0,8,3
20138,6,53,14,0,39,14
20138,5,20,8,0,12,8
20138,4,11,4,0,7,4
20138,2,2,1,0,1,1
17965,10,2,1,0,1,1
17965,7,8,3,0,5,3
17965,6,19,6,0,13,6
17965,5,20,4,0,16,4
17965,4,17,3,0,14,3
17965,3,21,7,0,14,7
17965,2,6,2,0,4,2
17965,1,4,3,0,1,3
4646,8,4,1,0,3,1
4646,7,21,8,0,13,8
4646,6,29,10,0,19,10
4646,5,22,6,0,16,6
4646,4,15,6,0,9,6
4646,3,4,1,0,3,1
4646,2,3,1,0,2,1
5768,9,6,2,0,4,2
5768,8,16,4,0,12,4
5768,7,33,6,0,27,6
5768,6,27,4,0,23,4
5768,5,15,3,0,12,3
205346,9,8,4,2,4,2
205346,8,21,6,1,15,5
205346,7,25,3,0,22,3
205346,6,24,6,0,18,6
205346,5,11,1,0,10,1
205346,4,6,5,0,1,5
205346,2,3,3,0,0,3
10579,10,8,5,0,3,5
10579,9,10,2,0,8,2
10579,8,21,2,0,19,2
10579,7,23,10,0,13,10
10579,6,29,7,0,22,7
10579,5,5,2,0,3,2
10579,4,2,1,0,1,1
10579,2,1,1,0,0,1
4413,10,3,1,0,2,1
4413,9,2,2,0,0,2
4413,8,11,5,0,6,5
4413,7,20,8,0,12,8
4413,6,34,10,0,24,10
4413,4,11,2,0,9,2
4413,3,3,1,0,2,1
4413,2,3,1,0,2,1
1468,9,3,2,0,1,2
1468,8,5,3,0,2,3
1468,7,19,6,0,13,6
1468,6,35,13,0,22,13
1468,5,26,10,0,16,10
1468,4,6,2,0,4,2
1468,3,6,1,0,5,1
3028,10,2,1,0,1,1
3028,8,8,2,0,6,2
3028,7,6,1,0,5,1
3028,6,20,9,0,11,9
3028,5,25,2,0,23,2
3028,4,20,10,0,10,10
3028,3,14,3,0,11,3
3028,2,5,2,0,3,2
157779,10,5,1,0,4,1
157779,9,9,3,0,6,3
157779,8,32,5,0,27,5
157779,7,26,2,0,24,2
157779,6,25,4,0,21,4
157779,5,2,1,0,1,1
206715,10,14,3,0,11,3
206715,8,33,3,0,30,3
206715,7,16,3,0,13,3
206715,6,16,4,0,12,4
206715,5,6,1,0,5,1
206715,4,4,3,0,1,3
206715,3,3,1,0,2,1
56241,10,1,1,0,0,1
56241,9,16,3,0,13,3
56241,8,32,9,0,23,9
56241,7,23,7,0,16,7
56241,6,18,3,0,15,3
56241,5,5,3,0,2,3
56241,4,3,1,0,2,1
56241,3,2,2,0,0,2
56241,2,1,1,0,0,1
212370,10,7,1,0,6,1
212370,9,19,4,0,15,4
212370,8,33,10,0,23,10
212370,7,23,4,0,19,4
212370,6,13,2,0,11,2
212370,5,1,1,0,0,1
212370,4,2,1,0,1,1
212370,3,2,1,0,1,1
88931,9,6,1,0,5,1
88931,8,15,3,0,12,3
88931,7,24,4,0,20,4
88931,6,30,3,0,27,3
88931,5,13,2,0,11,2
88931,4,7,1,0,6,1
88931,3,3,1,0,2,1
88931,1,1,1,0,0,1
10613,8,3,2,0,1,2
10613,7,9,5,0,4,5
10613,6,22,9,0,13,9
10613,5,23,6,0,17,6
10613,4,15,2,0,13,2
10613,3,18,7,0,11,7
10613,2,7,3,0,4,3
10613,1,3,2,0,1,2
1972,10,1,1,0,0,1
1972,7,7,1,0,6,1
1972,6,23,8,0,15,8
1972,5,28,11,0,17,11
1972,4,17,3,0,14,3
1972,3,12,3,0,9,3
1972,2,8,3,0,5,3
1972,1,3,2,0,1,2
224319,10,6,2,0,4,2
224319,9,9,7,1,2,6
224319,8,22,4,0,18,4
224319,7,25,2,0,23,2
224319,6,16,2,0,14,2
224319,5,12,3,0,9,3
224319,4,8,2,0,6,2
224319,3,2,1,0,1,1
2284,10,3,1,0,2,1
2284,9,2,1,0,1,1
2284,8,8,4,0,4,4
2284,7,22,9,0,13,9
2284,6,30,9,0,21,9
2284,5,22,7,0,15,7
2284,4,11,5,0,6,5
3081,10,2,2,0,0,2
3081,9,3,2,0,1,2
3081,8,5,3,0,2,3
3081,7,20,6,0,14,6
3081,6,40,14,0,26,14
3081,5,19,4,0,15,4
3081,4,8,2,0,6,2
3081,3,3,1,0,2,1
35674,9,1,1,0,0,1
35674,8,10,6,0,4,6
35674,7,10,5,0,5,5
35674,6,35,7,0,28,7
35674,5,26,7,0,19,7
35674,4,12,4,0,8,4
35674,3,4,1,0,3,1
33964,8,11,2,0,9,2
33964,7,20,3,0,17,3
33964,6,35,13,0,22,13
33964,5,18,2,0,16,2
33964,4,7,2,0,5,2
556,9,2,1,0,1,1
556,7,7,1,0,6,1
556,6,34,10,0,24,10
556,5,29,11,0,18,11
556,4,18,6,0,12,6
556,3,4,2,0,2,2
24207,10,7,2,0,5,2
24207,9,5,1,0,4,1
24207,8,18,2,0,16,2
24207,7,22,1,0,21,1
24207,6,30,1,0,29,1
10831,8,4,1,0,3,1
10831,7,7,3,0,4,3
10831,6,23,9,0,14,9
10831,5,26,5,0,21,5
10831,4,18,7,0,11,7
10831,3,16,8,0,8,8
10831,2,6,4,0,2,4
13164,8,4,2,0,2,2
13164,7,13,5,0,8,5
13164,6,34,13,0,21,13
13164,5,29,9,0,20,9
13164,4,8,4,0,4,4
13164,3,7,3,0,4,3
13164,2,4,2,0,2,2
14010,8,11,1,0,10,1
14010,7,23,4,0,19,4
14010,6,34,2,0,32,2
14010,5,9,1,0,8,1
14010,4,12,1,0,11,1
14010,3,5,2,0,3,2
14010,2,2,1,0,1,1
108737,9,4,2,0,2,2
108737,8,15,4,0,11,4
108737,7,40,10,0,30,10
108737,6,26,5,0,21,5
108737,5,13,6,0,7,6
108737,4,2,1,0,1,1
56685,9,6,5,0,1,5
56685,8,14,4,0,10,4
56685,7,17,2,0,15,2
56685,6,33,4,0,29,4
56685,5,13,4,0,9,4
56685,4,6,1,0,5,1
56685,3,5,2,0,3,2
56685,2,3,3,0,0,3
173648,10,5,1,0,4,1
173648,8,24,5,0,19,5
173648,7,30,6,0,24,6
173648,6,25,7,0,18,7
173648,5,11,1,0,10,1
120265,10,6,4,0,2,4
120265,9,16,5,0,11,5
120265,8,36,13,0,23,13
120265,7,30,6,0,24,6
120265,6,10,4,0,6,4
120265,5,2,1,0,1,1
144631,8,12,2,0,10,2
144631,7,13,2,0,11,2
144631,6,33,5,0,28,5
144631,5,23,6,0,17,6
144631,4,6,2,0,4,2
144631,3,7,1,0,6,1
144631,2,2,1,0,1,1
239845,10,7,1,0,6,1
239845,9,8,4,0,4,4
239845,8,27,9,0,18,9
239845,7,30,7,1,23,6
239845,6,19,1,0,18,1
239845,5,4,1,0,3,1
239845,2,3,3,1,0,2
25567,8,8,4,0,4,4
25567,7,13,4,0,9,4
25567,6,37,8,0,29,8
25567,5,18,3,0,15,3
25567,4,13,3,0,10,3
25567,2,1,1,0,0,1
151684,10,2,1,0,1,1
151684,8,19,4,0,15,4
151684,7,14,1,0,13,1
151684,6,30,5,1,25,4
151684,5,17,5,0,12,5
151684,4,9,1,0,8,1
151684,3,5,2,0,3,2
216694,9,4,1,0,3,1
216694,8,12,5,0,7,5
216694,7,43,13,0,30,13
216694,6,32,8,0,24,8
55222,8,5,1,0,4,1
55222,7,13,4,0,9,4
55222,6,40,4,0,36,4
55222,5,25,3,0,22,3
55222,4,7,3,0,4,3
55222,2,5,1,0,4,1
14781,9,3,2,0,1,2
14781,8,11,4,0,7,4
14781,7,34,11,0,23,11
14781,6,36,6,0,30,6
14781,5,10,3,0,7,3
14781,3,1,1,0,0,1
27291,10,4,1,0,3,1
27291,8,10,1,0,9,1
27291,7,14,5,0,9,5
27291,6,33,8,0,25,8
27291,5,15,5,0,10,5
27291,4,13,3,0,10,3
27291,3,8,1,0,7,1
27291,2,2,1,0,1,1
246567,10,9,3,0,6,3
246567,8,32,5,0,27,5
246567,7,23,3,0,20,3
246567,6,17,1,0,16,1
6938,10,4,2,0,2,2
6938,9,3,3,0,0,3
6938,8,10,3,0,7,3
6938,7,20,6,0,14,6
6938,6,27,8,0,19,8
6938,5,15,7,0,8,7
6938,4,8,4,0,4,4
6938,3,6,1,0,5,1
6938,2,5,4,0,1,4
6938,1,2,2,0,0,2
2503,9,4,3,0,1,3
2503,8,4,2,0,2,2
2503,7,17,3,0,14,3
2503,6,39,14,0,25,14
2503,5,13,5,0,8,5
2503,4,13,1,0,12,1
5502,10,10,4,0,6,4
5502,9,3,2,0,1,2
5502,8,12,4,0,8,4
5502,6,22,5,0,17,5
5502,5,16,8,0,8,8
5502,4,12,5,0,7,5
5502,3,5,2,0,3,2
113656,8,17,2,0,15,2
113656,7,30,8,0,22,8
113656,6,32,3,0,29,3
113656,5,12,1,0,11,1
113656,2,1,1,0,0,1
1620,10,2,1,0,1,1
1620,9,5,2,0,3,2
1620,8,17,5,0,12,5
1620,7,30,11,0,19,11
1620,6,28,8,0,20,8
1620,5,13,5,0,8,5
1620,3,1,1,0,0,1
8843,9,4,2,0,2,2
8843,8,18,9,0,9,9
8843,7,39,9,0,30,9
8843,6,19,6,0,13,6
8843,5,9,2,0,7,2
8843,4,4,3,0,1,3
8843,3,3,3,0,0,3
8843,1,1,1,0,0,1
32157,7,11,3,0,8,3
32157,6,38,8,0,30,8
32157,5,16,6,0,10,6
32157,4,15,2,0,13,2
32157,3,10,3,0,7,3
32157,2,4,2,0,2,2
7501,9,6,2,0,4,2
7501,8,15,4,0,11,4
7501,7,34,7,0,27,7
7501,6,20,6,0,14,6
7501,5,12,1,0,11,1
7501,3,3,3,0,0,3
5662,10,4,2,0,2,2
5662,9,1,1,0,0,1
5662,7,6,1,0,5,1
5662,6,24,7,0,17,7
5662,5,28,5,0,23,5
5662,4,16,2,0,14,2
5662,3,13,8,0,5,8
5662,2,6,3,0,3,3
5662,1,1,1,0,0,1
4509,8,8,3,0,5,3
4509,7,14,6,0,8,6
4509,6,22,5,0,17,5
4509,5,28,9,0,19,9
4509,4,10,1,0,9,1
4509,3,9,3,0,6,3
4509,2,6,2,0,4,2
4509,1,2,1,0,1,1
177513,9,4,3,0,1,3
177513,8,16,4,0,12,4
177513,7,33,9,3,24,6
177513,6,34,7,1,27,6
230898,10,3,1,0,2,1
230898,8,31,4,0,27,4
230898,7,38,2,0,36,2
230898,6,18,2,0,16,2
230898,5,3,1,0,2,1
8727,10,3,2,0,1,2
8727,9,7,1,0,6,1
8727,8,13,2,0,11,2
8727,7,18,10,0,8,10
8727,6,30,5,0,25,5
8727,5,16,4,0,12,4
8727,4,8,1,0,7,1
8727,3,4,2,0,2,2
16873,10,1,1,0,0,1
16873,9,1,1,0,0,1
16873,8,8,2,0,6,2
16873,7,11,2,0,9,2
16873,6,35,12,0,23,12
16873,5,18,8,0,10,8
16873,4,14,4,0,10,4
16873,3,6,3,0,3,3
16873,2,5,2,0,3,2
7958,9,1,1,0,0,1
7958,8,5,1,0,4,1
7958,7,10,1,0,9,1
7958,6,22,6,0,16,6
7958,5,25,7,0,18,7
7958,4,17,6,0,11,6
7958,2,9,4,0,5,4
2110,7,19,2,0,17,2
2110,6,31,6,0,25,6
2110,5,16,2,0,14,2
2110,4,17,2,0,15,2
2110,3,11,2,0,9,2
15031,8,3,2,0,1,2
15031,7,11,3,0,8,3
15031,6,42,17,0,25,17
15031,5,23,8,0,15,8
15031,4,9,3,0,6,3
15031,3,7,2,0,5,2
15031,2,5,5,0,0,5
32236,9,1,1,0,0,1
32236,8,2,1,0,1,1
32236,6,9,2,0,7,2
32236,5,18,3,0,15,3
32236,4,13,1,0,12,1
32236,1,16,6,0,10,6
18881,10,2,2,0,0,2
18881,9,1,1,0,0,1
18881,8,23,8,0,15,8
18881,7,23,5,0,18,5
18881,6,29,12,0,17,12
18881,5,13,4,0,9,4
18881,4,5,1,0,4,1
18881,3,4,1,0,3,1
3273,8,2,1,0,1,1
3273,7,17,6,0,11,6
3273,6,40,12,0,28,12
3273,5,17,8,0,9,8
3273,4,8,3,0,5,3
3273,3,6,2,0,4,2
3273,2,7,4,0,3,4
383,10,2,1,0,1,1
383,8,13,4,0,9,4
383,7,28,7,0,21,7
383,6,39,6,0,33,6
383,5,11,3,0,8,3
121076,8,8,1,0,7,1
121076,7,28,7,0,21,7
121076,6,41,7,0,34,7
121076,5,17,5,0,12,5
60158,9,4,1,0,3,1
60158,8,9,4,0,5,4
60158,7,22,6,0,16,6
60158,6,37,7,0,30,7
164590,10,8,3,0,5,3
164590,8,13,4,0,9,4
164590,7,26,5,0,21,5
164590,6,25,6,0,19,6
164590,5,12,1,0,11,1
164590,4,10,4,0,6,4
164590,3,2,1,0,1,1
90919,7,19,6,0,13,6
90919,6,33,7,0,26,7
90919,5,22,1,0,21,1
90919,4,6,1,0,5,1
90919,3,7,2,0,5,2
716,9,3,1,0,2,1
716,8,3,1,0,2,1
716,7,5,1,0,4,1
716,6,25,6,0,19,6
716,5,20,5,0,15,5
716,4,15,7,0,8,7
716,3,15,6,0,9,6
716,2,7,1,0,6,1
134524,10,12,6,0,6,6
134524,9,14,3,0,11,3
134524,8,49,13,0,36,13
134524,7,16,1,0,15,1
134524,6,6,2,0,4,2
4445,8,6,2,0,4,2
4445,7,32,6,0,26,6
4445,6,26,6,0,20,6
4445,5,15,4,0,11,4
4445,4,12,4,0,8,4
4445,3,3,3,0,0,3
4445,2,5,4,0,1,4
242227,10,27,10,0,17,10
242227,9,27,8,0,19,8
242227,8,22,10,0,12,10
242227,7,12,6,0,6,6
242227,6,7,2,0,5,2
242227,5,2,1,0,1,1
242227,3,1,1,0,0,1
161109,9,1,1,0,0,1
161109,8,12,2,0,10,2
161109,7,32,4,0,28,4
161109,6,35,5,0,30,5
161109,4,7,2,0,5,2
161109,3,3,1,0,2,1
161109,2,1,1,0,0,1
191374,8,31,11,0,20,11
191374,7,33,4,0,29,4
191374,6,16,2,0,14,2
191374,5,4,2,0,2,2
191374,4,5,1,0,4,1
191374,2,2,1,0,1,1
182681,8,15,1,0,14,1
182681,7,35,1,0,34,1
182681,6,27,2,0,25,2
182681,3,3,1,0,2,1
255675,10,10,5,0,5,5
255675,9,27,3,0,24,3
255675,7,20,1,0,19,1
255675,6,10,1,0,9,1
255675,5,7,1,0,6,1
505,8,3,2,0,1,2
505,7,23,12,0,11,12
505,6,42,14,0,28,14
505,5,15,4,0,11,4
505,4,9,2,0,7,2
12533,10,14,10,0,4,10
12533,9,21,14,0,7,14
12533,8,33,16,0,17,16
12533,7,17,5,0,12,5
12533,6,12,4,0,8,4
12533,5,3,2,0,1,2
10043,6,26,9,0,17,9
10043,5,28,7,0,21,7
10043,4,23,9,0,14,9
10043,3,14,5,0,9,5
10043,2,3,2,0,1,2
206904,10,11,2,1,9,1
206904,9,16,2,1,14,1
206904,8,27,8,0,19,8
206904,7,22,4,0,18,4
206904,6,12,2,0,10,2
206904,5,3,1,0,2,1
206904,4,5,2,0,3,2
1474,9,1,1,0,0,1
1474,8,9,4,0,5,4
1474,7,24,10,0,14,10
1474,6,31,11,0,20,11
1474,5,17,6,0,11,6
1474,4,14,6,0,8,6
1474,3,3,2,0,1,2
1474,2,1,1,0,0,1
15268,8,4,2,0,2,2
15268,7,3,1,0,2,1
15268,6,19,7,0,12,7
15268,5,21,3,0,18,3
15268,4,18,7,0,11,7
15268,3,19,6,0,13,6
15268,2,7,2,0,5,2
15268,1,7,3,0,4,3
208428,10,17,6,0,11,6
208428,9,15,5,0,10,5
208428,8,35,7,0,28,7
208428,7,17,2,0,15,2
208428,6,14,4,0,10,4
208428,3,1,1,0,0,1
118177,8,19,3,0,16,3
118177,7,29,9,0,20,9
118177,6,30,11,0,19,11
118177,5,8,1,0,7,1
118177,4,6,4,0,2,4
89972,8,6,3,0,3,3
89972,7,18,3,0,15,3
89972,6,49,7,0,42,7
89972,5,17,2,0,15,2
89972,3,3,2,0,1,2
89972,2,2,1,0,1,1
5410,10,19,9,0,10,9
5410,9,26,8,0,18,8
5410,8,23,4,0,19,4
5410,7,11,3,0,8,3
5410,6,10,3,0,7,3
5410,5,2,2,0,0,2
5410,4,2,1,0,1,1
5410,3,3,3,0,0,3
5410,2,2,1,0,1,1
5410,1,2,1,0,1,1
176286,10,4,2,0,2,2
176286,9,6,2,0,4,2
176286,8,17,6,1,11,5
176286,7,15,3,0,12,3
176286,6,22,4,0,18,4
176286,4,10,3,0,7,3
176286,3,6,2,0,4,2
176286,2,12,6,0,6,6
62214,10,11,3,0,8,3
62214,9,17,2,0,15,2
62214,8,38,18,0,20,18
62214,7,18,8,0,10,8
62214,6,13,5,0,8,5
8909,10,2,1,0,1,1
8909,8,13,4,0,9,4
8909,7,15,1,0,14,1
8909,6,34,3,0,31,3
8909,5,17,3,0,14,3
8909,4,8,2,0,6,2
8909,3,7,5,0,2,5
220141,10,7,1,0,6,1
220141,9,13,4,2,9,2
220141,8,26,3,1,23,2
220141,7,23,2,1,21,1
220141,6,15,3,1,12,2
220141,5,10,1,0,9,1
220141,3,3,1,0,2,1
220141,2,2,1,0,1,1
231302,8,9,2,0,7,2
231302,7,22,4,0,18,4
231302,6,29,6,0,23,6
231302,5,23,1,0,22,1
231302,4,8,4,0,4,4
231302,3,5,2,0,3,2
137968,10,3,1,0,2,1
137968,8,10,1,0,9,1
137968,7,21,6,0,15,6
137968,6,39,10,0,29,10
137968,5,10,1,0,9,1
137968,4,5,1,0,4,1
137968,3,6,2,0,4,2
116596,9,1,1,0,0,1
116596,7,8,4,0,4,4
116596,6,39,11,0,28,11
116596,5,28,8,0,20,8
116596,4,15,6,0,9,6
116596,3,6,1,0,5,1
40004,10,8,3,0,5,3
40004,9,7,2,0,5,2
40004,8,13,3,0,10,3
40004,7,22,3,0,19,3
40004,6,24,8,0,16,8
40004,5,13,3,0,10,3
40004,4,8,3,0,5,3
40004,3,2,1,0,1,1
17895,9,9,3,0,6,3
17895,8,27,7,0,20,7
17895,7,24,8,0,16,8
17895,6,26,5,0,21,5
17895,5,8,3,0,5,3
17895,2,2,1,0,1,1
94002,10,1,1,0,0,1
94002,9,2,1,0,1,1
94002,8,6,3,0,3,3
94002,7,12,5,0,7,5
94002,6,32,9,0,23,9
94002,5,20,6,0,14,6
94002,4,18,5,0,13,5
94002,3,6,2,0,4,2
199530,9,4,1,0,3,1
199530,7,28,3,0,25,3
199530,6,38,4,0,34,4
199530,5,8,1,0,7,1
199530,4,3,2,0,1,2
10687,8,2,1,0,1,1
10687,7,7,3,0,4,3
10687,6,30,9,0,21,9
10687,5,27,5,0,22,5
10687,4,21,6,0,15,6
10687,3,8,2,0,6,2
219217,10,75,15,1,60,14
219217,9,12,1,0,11,1
219217,8,6,3,1,3,2
219217,7,2,1,1,1,0
219217,1,2,2,1,0,1
230751,10,4,1,0,3,1
230751,9,11,3,0,8,3
230751,8,25,3,0,22,3
230751,7,35,10,0,25,10
230751,6,20,2,0,18,2
230751,3,1,1,0,0,1
230751,2,1,1,0,0,1
21249,8,4,4,0,0,4
21249,7,11,6,0,5,6
21249,6,37,11,0,26,11
21249,5,12,6,0,6,6
21249,4,13,6,0,7,6
21249,3,13,4,0,9,4
21249,2,6,4,0,2,4
21249,1,2,1,0,1,1
26138,10,10,3,0,7,3
26138,9,19,1,0,18,1
26138,8,31,3,0,28,3
26138,7,18,3,0,15,3
26138,6,16,1,0,15,1
26138,4,2,1,0,1,1
1006,9,2,1,0,1,1
1006,8,4,1,0,3,1
1006,7,12,1,0,11,1
1006,6,33,7,0,26,7
1006,5,22,6,0,16,6
1006,4,15,5,0,10,5
1006,3,8,3,0,5,3
144790,10,2,1,1,1,0
144790,9,4,2,0,2,2
144790,8,3,1,0,2,1
144790,7,17,4,0,13,4
144790,6,30,6,0,24,6
144790,5,16,3,0,13,3
144790,4,13,4,1,9,3
144790,3,6,3,0,3,3
144790,1,6,5,0,1,5
1654,7,8,4,0,4,4
1654,6,37,12,0,25,12
1654,5,25,7,0,18,7
1654,4,12,5,0,7,5
1654,3,8,3,0,5,3
31936,7,6,3,0,3,3
31936,6,22,8,0,14,8
31936,5,23,12,0,11,12
31936,4,18,8,0,10,8
31936,3,15,9,0,6,9
31936,2,13,8,0,5,8
31936,1,1,1,0,0,1
163771,10,6,2,0,4,2
163771,9,13,3,0,10,3
163771,8,26,6,0,20,6
163771,7,20,5,0,15,5
163771,6,22,8,2,14,6
163771,5,10,3,0,7,3
181616,8,3,2,0,1,2
181616,7,16,6,0,10,6
181616,6,29,5,0,24,5
181616,5,21,5,0,16,5
181616,4,14,5,0,9,5
181616,3,9,1,0,8,1
181616,2,2,2,0,0,2
181616,1,2,1,0,1,1
5248,8,3,1,0,2,1
5248,7,5,2,0,3,2
5248,6,22,3,0,19,3
5248,5,26,10,0,16,10
5248,4,18,8,0,10,8
5248,3,7,3,0,4,3
5248,2,10,2,0,8,2
5248,1,7,4,0,3,4
38337,9,2,1,0,1,1
38337,7,12,2,0,10,2
38337,6,30,5,0,25,5
38337,5,25,7,0,18,7
38337,4,9,3,0,6,3
38337,3,9,3,0,6,3
38337,2,4,2,0,2,2
220878,9,3,1,0,2,1
220878,8,11,2,0,9,2
220878,7,34,9,0,25,9
220878,6,26,1,0,25,1
220878,4,10,2,0,8,2
220878,3,2,1,0,1,1
220878,2,2,2,0,0,2
20590,9,8,3,0,5,3
20590,8,36,10,0,26,10
20590,7,22,5,0,17,5
20590,6,21,4,0,17,4
20590,5,5,2,0,3,2
20590,3,2,2,0,0,2
20590,2,2,2,0,0,2
172932,8,12,3,0,9,3
172932,7,25,5,0,20,5
172932,6,37,10,0,27,10
172932,5,10,1,0,9,1
172932,4,7,1,0,6,1
172932,3,6,2,0,4,2
8121,8,4,3,0,1,3
8121,7,9,2,0,7,2
8121,6,18,4,0,14,4
8121,5,20,2,0,18,2
8121,4,15,4,0,11,4
8121,3,16,4,0,12,4
8121,2,12,6,0,6,6
8121,1,5,2,0,3,2
3305,8,7,4,0,3,4
3305,7,16,4,0,12,4
3305,6,31,8,0,23,8
3305,5,25,3,0,22,3
3305,4,10,2,0,8,2
3305,3,4,2,0,2,2
22666,10,2,1,0,1,1
22666,9,7,2,0,5,2
22666,8,20,5,0,15,5
22666,7,31,5,0,26,5
22666,6,26,2,0,24,2
22666,5,11,1,0,10,1
22666,4,1,1,0,0,1
22666,3,1,1,0,0,1
234834,10,3,1,0,2,1
234834,9,6,4,0,2,4
234834,8,18,4,0,14,4
234834,7,19,1,0,18,1
234834,6,22,4,0,18,4
234834,5,14,4,0,10,4
234834,3,7,2,0,5,2
3265,10,3,1,0,2,1
3265,9,3,2,0,1,2
3265,8,11,6,0,5,6
3265,7,16,5,0,11,5
3265,6,34,7,0,27,7
3265,5,17,3,0,14,3
3265,4,11,2,0,9,2
3265,3,3,1,0,2,1
3265,2,1,1,0,0,1
127028,10,1,1,0,0,1
127028,9,3,2,0,1,2
127028,7,25,6,0,19,6
127028,6,38,9,0,29,9
127028,5,16,1,0,15,1
127028,4,7,1,0,6,1
7838,9,4,1,0,3,1
7838,8,10,5,0,5,5
7838,7,19,6,0,13,6
7838,6,32,6,0,26,6
7838,4,8,2,0,6,2
7838,3,5,1,0,4,1
7838,1,3,1,0,2,1
7860,7,11,4,0,7,4
7860,6,25,11,0,14,11
7860,5,20,3,0,17,3
7860,4,18,7,0,11,7
7860,3,12,3,0,9,3
7860,2,4,1,0,3,1
13498,10,5,2,0,3,2
13498,9,8,1,0,7,1
13498,8,11,3,0,8,3
13498,7,24,8,0,16,8
13498,6,17,7,0,10,7
13498,5,10,4,0,6,4
13498,4,12,7,0,5,7
13498,3,6,6,0,0,6
13498,2,4,3,0,1,3
13498,1,2,2,0,0,2
41860,8,5,1,0,4,1
41860,7,20,6,0,14,6
41860,6,34,5,0,29,5
41860,5,21,4,0,17,4
41860,4,12,5,0,7,5
41860,3,4,1,0,3,1
17971,10,5,2,0,3,2
17971,9,15,3,0,12,3
17971,8,33,7,0,26,7
17971,7,25,7,0,18,7
17971,6,14,1,0,13,1
17971,4,1,1,0,0,1
17971,2,2,1,0,1,1
15431,8,10,2,0,8,2
15431,7,24,3,0,21,3
15431,6,24,1,0,23,1
15431,5,19,5,0,14,5
15431,3,7,3,0,4,3
211047,10,10,3,0,7,3
211047,7,10,3,0,7,3
211047,6,30,7,2,23,5
211047,5,21,5,1,16,4
211047,4,11,2,0,9,2
211047,2,5,2,0,3,2
3007,8,2,1,0,1,1
3007,7,8,2,0,6,2
3007,6,16,2,0,14,2
3007,5,20,8,0,12,8
3007,4,32,13,0,19,13
3007,3,13,3,0,10,3
3007,2,5,3,0,2,3
3007,1,3,1,0,2,1
3636,7,14,4,0,10,4
3636,6,28,9,0,19,9
3636,5,23,6,0,17,6
3636,4,15,4,0,11,4
3636,3,8,5,0,3,5
3636,2,7,2,0,5,2
3636,1,1,1,0,0,1
204003,10,12,3,0,9,3
204003,9,10,1,0,9,1
204003,8,22,4,1,18,3
204003,7,23,6,0,17,6
204003,6,13,6,1,7,5
204003,5,4,1,0,3,1
204003,4,3,2,0,1,2
381,10,2,1,0,1,1
381,8,8,1,0,7,1
381,7,35,3,0,32,3
381,6,31,2,0,29,2
381,5,12,1,0,11,1
381,4,5,1,0,4,1
381,3,5,1,0,4,1
16110,9,6,1,0,5,1
16110,8,11,2,0,9,2
16110,7,26,5,0,21,5
16110,6,28,3,0,25,3
16110,5,13,1,0,12,1
16110,4,8,2,0,6,2
16110,3,2,1,0,1,1
16110,2,3,2,0,1,2
16110,1,1,1,0,0,1
1559,8,7,1,0,6,1
1559,7,12,2,0,10,2
1559,6,40,10,0,30,10
1559,5,17,3,0,14,3
1559,4,14,6,0,8,6
1559,3,7,1,0,6,1
17863,10,13,7,0,6,7
17863,9,22,6,0,16,6
17863,8,41,6,0,35,6
17863,7,8,3,0,5,3
17863,6,9,2,0,7,2
17863,4,3,2,0,1,2
17863,3,1,1,0,0,1
158968,10,3,1,0,2,1
158968,9,8,1,0,7,1
158968,8,14,5,2,9,3
158968,7,19,2,0,17,2
158968,6,27,8,1,19,7
158968,5,15,3,1,12,2
158968,4,6,2,0,4,2
131321,9,5,3,0,2,3
131321,8,30,12,1,18,11
131321,7,27,6,0,21,6
131321,6,16,5,0,11,5
131321,5,13,4,0,9,4
131321,3,2,1,1,1,0
131321,2,2,1,0,1,1
66986,10,9,1,0,8,1
66986,9,16,4,1,12,3
66986,8,28,5,0,23,5
66986,7,24,6,0,18,6
66986,6,9,2,0,7,2
66986,5,9,1,0,8,1
66986,3,2,2,0,0,2
21677,8,5,1,0,4,1
21677,7,21,4,0,17,4
21677,6,27,4,0,23,4
21677,5,24,5,0,19,5
21677,4,11,4,0,7,4
21677,3,4,2,0,2,2
21677,2,2,1,0,1,1
21677,1,2,1,0,1,1
2775,9,5,3,0,2,3
2775,8,12,3,0,9,3
2775,7,15,6,0,9,6
2775,6,30,11,0,19,11
2775,5,12,3,0,9,3
2775,3,3,1,0,2,1
64955,8,4,1,0,3,1
64955,7,23,4,0,19,4
64955,6,42,4,0,38,4
64955,5,19,3,0,16,3
64955,3,2,1,0,1,1
219670,10,3,2,0,1,2
219670,9,4,2,0,2,2
219670,8,5,1,0,4,1
219670,7,18,3,0,15,3
219670,6,23,1,0,22,1
219670,5,16,4,0,12,4
219670,3,11,1,0,10,1
219670,2,7,1,0,6,1
219670,1,5,2,0,3,2
3482,10,5,4,0,1,4
3482,8,10,5,0,5,5
3482,7,5,2,0,3,2
3482,6,7,1,0,6,1
3482,5,7,2,0,5,2
3482,4,26,7,0,19,7
3482,3,15,9,0,6,9
3482,2,10,6,0,4,6
3482,1,10,5,0,5,5
136238,9,3,1,0,2,1
136238,8,17,6,0,11,6
136238,7,22,4,0,18,4
136238,6,30,6,0,24,6
136238,5,12,1,0,11,1
136238,4,8,2,0,6,2
1082,9,2,1,0,1,1
1082,8,8,1,0,7,1
1082,7,21,7,0,14,7
1082,6,37,11,0,26,11
1082,5,18,6,0,12,6
1082,4,5,1,0,4,1
1082,2,3,1,0,2,1
7943,8,7,2,0,5,2
7943,7,22,3,0,19,3
7943,6,39,8,0,31,8
7943,5,18,2,0,16,2
7943,3,3,2,0,1,2
7943,1,1,1,0,0,1
211175,9,3,1,0,2,1
211175,8,10,2,0,8,2
211175,7,18,3,1,15,2
211175,6,34,1,0,33,1
211175,5,20,3,1,17,2
211175,4,6,1,0,5,1
211175,1,1,1,0,0,1
10186,10,3,1,0,2,1
10186,9,4,1,0,3,1
10186,8,30,12,0,18,12
10186,7,23,6,0,17,6
10186,6,26,5,0,21,5
10186,5,4,1,0,3,1
10186,4,3,1,0,2,1
10186,2,3,2,0,1,2
10186,1,1,1,0,0,1
28905,9,5,2,0,3,2
28905,8,8,1,0,7,1
28905,6,21,5,0,16,5
28905,5,19,1,0,18,1
28905,4,19,3,0,16,3
28905,3,7,3,0,4,3
123587,7,25,2,0,23,2
123587,6,32,2,0,30,2
123587,5,19,1,0,18,1
123587,4,12,2,0,10,2
123587,3,5,1,0,4,1
176887,9,2,1,0,1,1
176887,8,17,8,1,9,7
176887,7,19,1,0,18,1
176887,6,29,6,1,23,5
176887,5,16,4,0,12,4
176887,4,9,3,1,6,2
176887,3,4,1,0,3,1
154298,10,7,1,0,6,1
154298,9,6,2,1,4,1
154298,8,10,2,0,8,2
154298,7,14,1,0,13,1
154298,6,16,4,1,12,3
154298,5,20,2,0,18,2
154298,4,7,2,0,5,2
154298,3,9,1,0,8,1
154298,2,5,3,0,2,3
154298,1,4,1,0,3,1
169513,9,7,1,0,6,1
169513,8,15,4,0,11,4
169513,7,28,6,0,22,6
169513,6,22,2,0,20,2
169513,5,11,2,0,9,2
169513,4,5,1,0,4,1
169513,3,4,2,0,2,2
169513,2,1,1,0,0,1
33962,10,4,1,0,3,1
33962,9,5,1,0,4,1
33962,8,10,3,0,7,3
33962,7,19,4,0,15,4
33962,6,25,4,0,21,4
33962,5,17,2,0,15,2
33962,4,5,1,0,4,1
33962,3,7,1,0,6,1
33962,2,4,3,0,1,3
4292,10,9,1,0,8,1
4292,9,14,5,0,9,5
4292,8,24,8,0,16,8
4292,7,29,8,0,21,8
4292,6,14,4,0,10,4
4292,5,6,1,0,5,1
167892,10,3,3,0,0,3
167892,9,4,2,1,2,1
167892,8,8,1,0,7,1
167892,7,19,2,0,17,2
167892,6,34,4,0,30,4
167892,5,9,1,0,8,1
167892,4,8,2,0,6,2
167892,3,8,3,0,5,3
167892,2,4,3,0,1,3
5172,9,4,1,0,3,1
5172,8,21,9,0,12,9
5172,7,23,4,0,19,4
5172,6,23,6,0,17,6
5172,5,8,4,0,4,4
5172,4,12,3,0,9,3
5172,3,4,1,0,3,1
5172,2,2,2,0,0,2
145766,10,4,1,0,3,1
145766,9,6,1,0,5,1
145766,8,18,1,0,17,1
145766,7,21,1,0,20,1
145766,5,7,1,0,6,1
3435,8,12,2,0,10,2
3435,7,12,5,0,7,5
3435,6,36,7,0,29,7
3435,5,23,3,0,20,3
3435,4,9,2,0,7,2
3435,3,5,1,0,4,1
3435,2,1,1,0,0,1
76322,9,2,1,0,1,1
76322,8,18,1,0,17,1
76322,7,36,5,0,31,5
76322,6,29,9,0,20,9
76322,5,8,1,0,7,1
76322,4,2,1,0,1,1
76322,3,1,1,0,0,1
27687,8,13,4,0,9,4
27687,7,26,9,0,17,9
27687,6,33,8,0,25,8
27687,5,11,4,0,7,4
27687,4,10,5,0,5,5
27687,3,3,2,0,1,2
27687,2,2,1,0,1,1
181235,9,3,1,0,2,1
181235,8,30,5,0,25,5
181235,7,38,8,0,30,8
181235,6,18,3,0,15,3
148581,10,4,2,0,2,2
148581,9,4,2,1,2,1
148581,8,14,5,2,9,3
148581,7,20,4,2,16,2
148581,6,28,4,0,24,4
148581,5,9,1,0,8,1
148581,4,11,4,2,7,2
11093,10,9,2,0,7,2
11093,9,13,1,0,12,1
11093,8,34,11,0,23,11
11093,7,17,3,0,14,3
11093,6,15,3,0,12,3
11093,5,6,3,0,3,3
11093,4,4,3,0,1,3
7048,8,6,4,0,2,4
7048,7,21,10,0,11,10
7048,6,31,11,0,20,11
7048,5,23,11,0,12,11
7048,4,12,6,0,6,6
7048,3,2,2,0,0,2
4196,10,5,3,0,2,3
4196,9,2,1,0,1,1
4196,8,12,9,0,3,9
4196,7,8,4,0,4,4
4196,6,38,12,0,26,12
4196,5,15,6,0,9,6
4196,4,11,6,0,5,6
4196,3,4,2,0,2,2
117823,9,2,1,0,1,1
117823,8,3,1,0,2,1
117823,7,18,2,0,16,2
117823,6,44,7,0,37,7
117823,5,20,4,0,16,4
117823,4,7,1,0,6,1
11446,10,2,1,0,1,1
11446,7,25,1,0,24,1
11446,6,31,8,0,23,8
11446,5,15,6,0,9,6
11446,4,6,2,0,4,2
11446,3,7,3,0,4,3
11446,2,6,4,0,2,4
11446,1,1,1,0,0,1
182049,8,6,2,0,4,2
182049,7,9,1,0,8,1
182049,6,39,7,0,32,7
182049,5,18,5,0,13,5
182049,4,17,4,0,13,4
6021,10,4,3,0,1,3
6021,9,3,1,0,2,1
6021,8,11,4,0,7,4
6021,7,32,8,0,24,8
6021,6,32,7,0,25,7
6021,5,9,4,0,5,4
6021,4,4,2,0,2,2
6021,2,1,1,0,0,1
6021,1,1,1,0,0,1
173336,8,14,3,0,11,3
173336,7,16,3,0,13,3
173336,6,26,3,0,23,3
173336,5,14,1,0,13,1
173336,4,10,2,0,8,2
173336,3,8,2,0,6,2
160606,10,6,2,0,4,2
160606,9,19,6,0,13,6
160606,8,32,12,0,20,12
160606,7,25,13,0,12,13
160606,6,10,3,0,7,3
160606,5,3,3,0,0,3
160606,3,2,1,0,1,1
7051,10,2,1,0,1,1
7051,8,5,2,0,3,2
7051,7,16,6,0,10,6
7051,6,35,17,0,18,17
7051,5,11,5,0,6,5
7051,4,14,6,0,8,6
7051,3,9,5,0,4,5
131006,10,3,1,0,2,1
131006,9,5,2,0,3,2
131006,8,12,4,1,8,3
131006,7,12,3,0,9,3
131006,6,25,7,2,18,5
131006,5,15,1,0,14,1
131006,4,15,4,0,11,4
131006,3,4,1,0,3,1
131006,2,5,4,0,1,4
22799,8,10,3,0,7,3
22799,7,15,4,0,11,4
22799,6,32,7,0,25,7
22799,5,16,4,0,12,4
22799,3,9,2,0,7,2
22799,2,2,1,0,1,1
22799,1,2,1,0,1,1
11436,10,10,2,0,8,2
11436,9,18,4,0,14,4
11436,8,32,4,0,28,4
11436,7,27,5,0,22,5
11436,3,2,1,0,1,1
113937,9,2,1,0,1,1
113937,8,16,4,0,12,4
113937,7,26,5,0,21,5
113937,6,35,4,0,31,4
113937,5,11,2,0,9,2
113937,4,4,1,0,3,1
113937,3,3,1,0,2,1
9833,10,7,3,0,4,3
9833,9,8,1,0,7,1
9833,8,36,11,0,25,11
9833,7,25,7,0,18,7
9833,6,14,2,0,12,2
9833,2,2,1,0,1,1
191475,10,9,1,0,8,1
191475,9,15,3,0,12,3
191475,8,32,6,0,26,6
191475,7,23,2,0,21,2
191475,6,13,3,0,10,3
191475,5,4,1,0,3,1
191475,1,1,1,0,0,1
259537,10,11,1,0,10,1
259537,9,10,1,0,9,1
259537,8,24,5,0,19,5
259537,7,30,1,0,29,1
259537,6,14,1,0,13,1
259537,5,5,1,0,4,1
9681,10,2,1,0,1,1
9681,7,8,2,0,6,2
9681,6,41,10,0,31,10
9681,5,23,7,0,16,7
9681,4,9,2,0,7,2
9681,3,7,1,0,6,1
32670,7,7,2,0,5,2
32670,6,21,2,0,19,2
32670,5,20,6,0,14,6
32670,4,17,9,0,8,9
32670,3,11,4,0,7,4
32670,2,11,2,0,9,2
32670,1,10,7,0,3,7
10272,10,2,1,0,1,1
10272,9,7,3,0,4,3
10272,8,19,8,0,11,8
10272,7,32,12,0,20,12
10272,6,22,9,0,13,9
10272,5,11,3,0,8,3
10272,3,1,1,0,0,1
10272,1,1,1,0,0,1
182953,10,5,1,0,4,1
182953,9,8,2,0,6,2
182953,8,17,3,0,14,3
182953,7,30,2,0,28,2
182953,6,27,2,0,25,2
182953,3,1,1,0,0,1
204733,10,5,2,0,3,2
204733,9,7,2,0,5,2
204733,8,24,4,0,20,4
204733,7,33,8,0,25,8
204733,6,18,5,0,13,5
204733,5,7,1,0,6,1
204733,4,4,2,0,2,2
43171,6,25,3,0,22,3
43171,5,26,3,0,23,3
43171,4,12,4,0,8,4
43171,2,10,2,0,8,2
43171,1,5,1,0,4,1
226631,10,23,9,0,14,9
226631,9,18,6,0,12,6
226631,8,26,4,2,22,2
226631,7,13,1,1,12,0
226631,6,10,4,0,6,4
226631,5,6,2,0,4,2
226631,1,3,1,0,2,1
209290,10,6,1,0,5,1
209290,9,10,2,0,8,2
209290,8,26,4,0,22,4
209290,7,20,3,0,17,3
209290,6,23,3,0,20,3
209290,5,9,3,0,6,3
209290,4,5,1,0,4,1
3004,8,6,1,0,5,1
3004,7,5,2,0,3,2
3004,6,22,7,0,15,7
3004,5,28,9,0,19,9
3004,4,24,4,0,20,4
3004,3,4,2,0,2,2
3004,2,7,3,0,4,3
209672,8,21,5,0,16,5
209672,7,36,2,0,34,2
209672,6,27,5,0,22,5
34390,9,2,2,0,0,2
34390,8,4,2,0,2,2
34390,7,4,2,0,2,2
34390,6,16,7,0,9,7
34390,5,21,14,0,7,14
34390,4,27,10,0,17,10
34390,3,10,8,0,2,8
34390,2,5,4,0,1,4
34390,1,5,2,0,3,2
137201,10,3,1,0,2,1
137201,8,8,1,1,7,0
137201,7,11,2,1,9,1
137201,6,31,5,2,26,3
137201,5,11,2,0,9,2
137201,4,20,6,0,14,6
137201,3,8,3,0,5,3
137201,2,2,2,1,0,1
137201,1,1,1,0,0,1
13830,8,4,1,0,3,1
13830,7,24,3,0,21,3
13830,6,29,7,0,22,7
13830,5,25,5,0,20,5
13830,4,12,2,0,10,2
13830,3,2,1,0,1,1
12608,10,17,3,0,14,3
12608,9,12,7,0,5,7
12608,8,23,11,0,12,11
12608,7,24,7,0,17,7
12608,6,9,4,0,5,4
12608,5,7,3,0,4,3
12608,3,2,2,0,0,2
192924,10,2,1,0,1,1
192924,9,5,2,0,3,2
192924,8,12,2,0,10,2
192924,7,18,3,0,15,3
192924,6,28,6,0,22,6
192924,5,18,2,0,16,2
192924,4,6,1,0,5,1
192924,3,7,1,0,6,1
70488,8,6,2,0,4,2
70488,7,13,1,0,12,1
70488,6,44,2,0,42,2
70488,5,18,3,0,15,3
70488,4,9,1,0,8,1
70488,3,5,2,0,3,2
179973,9,6,1,0,5,1
179973,8,9,4,0,5,4
179973,7,16,1,0,15,1
179973,6,37,7,0,30,7
179973,5,14,1,0,13,1
179973,4,11,6,0,5,6
179973,1,1,1,0,0,1
1464,8,8,3,0,5,3
1464,7,7,3,0,4,3
1464,6,33,9,0,24,9
1464,5,21,10,0,11,10
1464,4,12,4,0,8,4
1464,3,12,5,0,7,5
1464,1,1,1,0,0,1
5778,9,1,1,0,0,1
5778,8,9,2,0,7,2
5778,7,22,9,0,13,9
5778,6,37,10,0,27,10
5778,5,16,4,0,12,4
5778,4,8,2,0,6,2
5778,2,3,3,0,0,3
231450,10,4,2,0,2,2
231450,9,16,7,1,9,6
231450,8,35,8,1,27,7
231450,7,19,3,0,16,3
231450,6,17,3,0,14,3
231450,4,2,1,0,1,1
2709,10,2,1,0,1,1
2709,8,8,4,0,4,4
2709,7,20,7,0,13,7
2709,6,26,8,0,18,8
2709,5,21,5,0,16,5
2709,4,12,4,0,8,4
2709,3,3,1,0,2,1
2709,1,1,1,0,0,1
32465,8,14,3,0,11,3
32465,7,20,3,0,17,3
32465,6,36,7,0,29,7
32465,5,15,5,0,10,5
32465,4,7,3,0,4,3
2666,10,3,2,0,1,2
2666,8,12,4,0,8,4
2666,7,25,9,0,16,9
2666,6,32,6,0,26,6
2666,5,12,4,0,8,4
2666,4,6,4,0,2,4
2666,2,2,1,0,1,1
2666,1,1,1,0,0,1
4234,10,3,1,0,2,1
4234,9,5,2,0,3,2
4234,8,18,8,0,10,8
4234,7,26,12,0,14,12
4234,6,28,8,0,20,8
4234,5,8,4,0,4,4
4234,4,5,1,0,4,1
240094,10,3,1,0,2,1
240094,9,4,1,0,3,1
240094,8,13,3,0,10,3
240094,7,24,2,0,22,2
240094,6,35,4,0,31,4
240094,5,7,1,0,6,1
240094,4,4,1,0,3,1
143680,10,11,1,0,10,1
143680,9,14,2,0,12,2
143680,8,30,3,0,27,3
143680,7,17,1,0,16,1
143680,6,22,3,0,19,3
143508,10,1,1,0,0,1
143508,8,3,1,0,2,1
143508,7,4,2,0,2,2
143508,6,27,4,0,23,4
143508,5,21,3,0,18,3
143508,4,11,3,0,8,3
143508,3,14,3,0,11,3
143508,2,9,5,0,4,5
143508,1,7,3,0,4,3
21324,10,3,1,0,2,1
21324,9,5,3,0,2,3
21324,8,33,13,0,20,13
21324,7,23,11,0,12,11
21324,6,22,7,0,15,7
21324,5,9,3,0,6,3
93895,8,20,5,0,15,5
93895,7,30,8,0,22,8
93895,6,25,6,0,19,6
93895,3,4,1,0,3,1
225000,10,5,1,0,4,1
225000,9,2,1,0,1,1
225000,8,18,2,0,16,2
225000,7,23,6,0,17,6
225000,6,27,4,0,23,4
225000,5,17,3,0,14,3
225000,4,3,2,0,1,2
5897,9,5,3,0,2,3
5897,8,6,3,0,3,3
5897,7,15,8,0,7,8
5897,6,39,16,0,23,16
5897,5,12,1,0,11,1
5897,4,9,2,0,7,2
5897,3,9,5,0,4,5
5897,2,1,1,0,0,1
160234,10,4,1,0,3,1
160234,9,8,3,2,5,1
160234,8,31,12,3,19,9
160234,7,25,5,0,20,5
160234,6,18,2,0,16,2
160234,5,7,3,0,4,3
160234,4,2,2,0,0,2
160234,3,2,1,0,1,1
151887,8,6,1,0,5,1
151887,7,17,2,0,15,2
151887,6,22,6,0,16,6
151887,5,16,5,0,11,5
151887,3,6,2,0,4,2
151887,2,8,2,0,6,2
151887,1,11,5,0,6,5
186435,10,15,10,0,5,10
186435,9,10,5,0,5,5
186435,8,21,7,0,14,7
186435,7,17,4,0,13,4
186435,6,13,1,0,12,1
186435,5,4,1,0,3,1
186435,4,6,1,0,5,1
186435,3,6,1,0,5,1
186435,2,3,2,0,1,2
258309,9,12,4,0,8,4
258309,8,37,7,0,30,7
258309,7,27,7,0,20,7
258309,6,14,1,0,13,1
20050,8,11,4,0,7,4
20050,7,22,10,0,12,10
20050,6,31,7,0,24,7
20050,5,19,5,0,14,5
20050,4,7,5,0,2,5
20050,3,6,2,0,4,2
7255,10,5,1,0,4,1
7255,9,3,1,0,2,1
7255,8,20,7,0,13,7
7255,7,31,9,0,22,9
7255,6,25,4,0,21,4
7255,5,7,2,0,5,2
7255,4,4,2,0,2,2
7255,1,1,1,0,0,1
171950,9,3,3,0,0,3
171950,8,18,4,0,14,4
171950,7,23,2,0,21,2
171950,6,35,7,0,28,7
171950,5,14,2,0,12,2
171950,4,4,1,0,3,1
5886,8,6,4,0,2,4
5886,7,10,2,0,8,2
5886,6,30,6,0,24,6
5886,5,27,4,0,23,4
5886,4,14,2,0,12,2
5886,3,7,1,0,6,1
5886,2,3,3,0,0,3
82976,8,13,3,0,10,3
82976,7,25,4,0,21,4
82976,6,30,7,0,23,7
82976,5,18,6,0,12,6
82976,4,5,1,0,4,1
82976,3,4,2,0,2,2
37686,8,14,2,0,12,2
37686,7,18,3,0,15,3
37686,6,29,4,0,25,4
37686,5,15,1,0,14,1
37686,4,12,5,0,7,5
37686,3,4,2,0,2,2
37686,1,3,1,0,2,1
7184,10,5,2,0,3,2
7184,8,12,1,0,11,1
7184,7,19,6,0,13,6
7184,6,33,9,0,24,9
7184,5,16,6,0,10,6
7184,4,3,2,0,1,2
7184,3,6,1,0,5,1
7184,2,1,1,0,0,1
256438,8,17,2,0,15,2
256438,7,25,2,0,23,2
256438,6,31,5,0,26,5
256438,5,11,3,0,8,3
256438,3,3,1,0,2,1
256438,2,2,2,0,0,2
53840,9,7,4,0,3,4
53840,8,29,13,0,16,13
53840,7,26,8,0,18,8
53840,6,15,7,0,8,7
53840,5,11,4,0,7,4
53840,3,1,1,0,0,1
53840,2,3,1,0,2,1
53840,1,1,1,0,0,1
223514,10,2,1,0,1,1
223514,9,4,1,1,3,0
223514,8,25,6,0,19,6
223514,7,35,3,0,32,3
223514,6,19,3,1,16,2
223514,5,9,2,0,7,2
223514,4,3,1,0,2,1
6725,9,3,2,0,1,2
6725,8,8,5,0,3,5
6725,7,12,2,0,10,2
6725,6,38,6,0,32,6
6725,5,19,4,0,15,4
6725,4,8,3,0,5,3
6725,3,4,2,0,2,2
234842,10,2,1,0,1,1
234842,9,5,2,0,3,2
234842,8,23,3,0,20,3
234842,7,26,2,0,24,2
234842,6,32,5,0,27,5
234842,5,7,2,0,5,2
234842,4,1,1,0,0,1
234842,3,1,1,0,0,1
9812,8,4,1,0,3,1
9812,7,2,1,0,1,1
9812,6,13,5,0,8,5
9812,5,17,6,0,11,6
9812,4,20,10,0,10,10
9812,3,24,11,0,13,11
9812,2,9,3,0,6,3
157673,10,3,1,0,2,1
157673,9,3,1,0,2,1
157673,8,8,2,0,6,2
157673,7,18,3,0,15,3
157673,6,30,4,0,26,4
157673,4,8,3,0,5,3
157673,3,4,1,0,3,1
157673,2,4,1,0,3,1
157673,1,1,1,0,0,1
118953,8,7,3,0,4,3
118953,7,25,2,0,23,2
118953,6,46,9,0,37,9
118953,4,3,1,0,2,1
39704,10,2,2,0,0,2
39704,8,21,9,0,12,9
39704,7,28,11,0,17,11
39704,6,27,10,0,17,10
39704,5,8,4,1,4,3
39704,4,8,6,0,2,6
39704,2,1,1,0,0,1
40801,10,1,1,0,0,1
40801,8,7,3,0,4,3
40801,7,17,3,0,14,3
40801,6,30,5,0,25,5
40801,5,22,3,0,19,3
40801,4,10,3,0,7,3
66643,10,2,1,0,1,1
66643,9,4,4,0,0,4
66643,8,24,7,0,17,7
66643,7,20,4,0,16,4
66643,6,22,8,0,14,8
66643,5,11,4,1,7,3
66643,4,6,2,0,4,2
66643,3,4,1,0,3,1
66643,2,2,1,0,1,1
66643,1,2,1,0,1,1
6750,9,3,2,0,1,2
6750,8,16,6,0,10,6
6750,7,24,5,0,19,5
6750,6,31,8,0,23,8
6750,5,8,5,0,3,5
6750,4,8,3,0,5,3
6750,3,2,1,0,1,1
6750,2,1,1,0,0,1
165628,8,18,3,0,15,3
165628,6,28,2,0,26,2
165628,4,4,1,0,3,1
236239,10,12,3,0,9,3
236239,9,28,6,0,22,6
236239,8,42,12,0,30,12
236239,7,10,4,0,6,4
236239,6,2,1,0,1,1
236239,3,1,1,0,0,1
13341,9,4,2,0,2,2
13341,8,9,5,0,4,5
13341,7,23,11,0,12,11
13341,6,35,8,0,27,8
13341,5,16,8,0,8,8
13341,4,6,4,0,2,4
13341,3,3,3,0,0,3
231942,10,20,2,0,18,2
231942,9,29,8,0,21,8
231942,8,28,8,0,20,8
231942,7,11,2,0,9,2
231942,6,4,1,0,3,1
231942,1,1,1,0,0,1
5488,9,3,2,0,1,2
5488,8,21,9,0,12,9
5488,7,27,7,0,20,7
5488,6,27,7,0,20,7
5488,5,12,1,0,11,1
5488,3,3,2,0,1,2
209282,10,2,1,0,1,1
209282,8,14,1,0,13,1
209282,7,21,5,0,16,5
209282,6,33,3,0,30,3
209282,5,9,1,0,8,1
209282,4,13,2,0,11,2
249673,9,6,1,0,5,1
249673,8,23,5,0,18,5
249673,7,26,5,0,21,5
249673,6,31,2,0,29,2
249673,5,5,1,0,4,1
148264,10,3,2,0,1,2
148264,9,9,6,0,3,6
148264,8,36,12,0,24,12
148264,7,33,13,0,20,13
148264,6,8,4,0,4,4
13357,8,8,3,0,5,3
13357,7,16,6,0,10,6
13357,6,36,6,0,30,6
13357,5,21,4,0,17,4
13357,3,6,1,0,5,1
18887,10,5,3,0,2,3
18887,9,14,7,0,7,7
18887,8,27,14,0,13,14
18887,7,23,12,0,11,12
18887,6,14,9,0,5,9
18887,5,6,1,0,5,1
18887,4,3,2,0,1,2
18887,3,1,1,0,0,1
165523,10,4,1,0,3,1
165523,8,14,1,0,13,1
165523,7,33,3,0,30,3
165523,6,25,4,0,21,4
165523,5,12,1,0,11,1
165523,2,1,1,0,0,1
174065,6,28,1,0,27,1
174065,5,20,2,0,18,2
174065,4,14,1,0,13,1
174065,2,4,1,0,3,1
154677,8,19,3,0,16,3
154677,7,33,7,0,26,7
154677,6,30,6,0,24,6
154677,5,6,1,0,5,1
3465,8,3,2,0,1,2
3465,7,24,9,0,15,9
3465,6,28,12,0,16,12
3465,5,21,6,0,15,6
3465,4,13,5,0,8,5
3465,3,6,1,0,5,1
2918,10,4,2,0,2,2
2918,9,6,2,0,4,2
2918,8,20,7,0,13,7
2918,7,23,8,0,15,8
2918,6,24,6,0,18,6
2918,5,10,3,0,7,3
2918,4,2,1,0,1,1
2918,3,5,1,0,4,1
2918,1,1,1,0,0,1
63928,10,3,1,0,2,1
63928,9,12,2,0,10,2
63928,8,31,8,0,23,8
63928,7,20,7,0,13,7
63928,6,22,8,0,14,8
63928,5,6,1,0,5,1
149794,9,9,2,0,7,2
149794,8,37,13,1,24,12
149794,7,27,9,0,18,9
149794,6,12,4,0,8,4
149794,5,2,1,0,1,1
149794,4,1,1,0,0,1
149794,3,4,2,0,2,2
149794,2,3,1,0,2,1
155020,10,1,1,0,0,1
155020,9,3,1,0,2,1
155020,8,18,5,0,13,5
155020,7,21,4,0,17,4
155020,6,28,6,0,22,6
155020,5,14,2,0,12,2
155020,4,6,2,0,4,2
224149,10,31,10,4,21,6
224149,9,21,7,1,14,6
224149,8,25,5,2,20,3
224149,7,13,3,0,10,3
224149,6,3,1,0,2,1
68931,9,3,1,0,2,1
68931,8,19,6,2,13,4
68931,7,34,9,3,25,6
68931,6,32,9,1,23,8
68931,5,5,3,1,2,2
68931,4,2,2,0,0,2
194229,10,3,2,0,1,2
194229,9,9,4,0,5,4
194229,8,9,1,0,8,1
194229,7,28,10,0,18,10
194229,6,28,3,0,25,3
194229,5,11,1,0,10,1
173637,10,2,1,0,1,1
173637,8,7,2,0,5,2
173637,7,19,4,0,15,4
173637,6,30,2,0,28,2
173637,3,6,1,0,5,1
56759,9,1,1,0,0,1
56759,8,6,4,0,2,4
56759,7,20,7,0,13,7
56759,6,44,8,0,36,8
56759,5,13,4,0,9,4
56759,4,6,3,0,3,3
56759,3,3,2,0,1,2
56759,1,2,1,0,1,1
674,9,1,1,0,0,1
674,8,9,4,0,5,4
674,7,8,1,0,7,1
674,6,29,10,0,19,10
674,5,23,7,0,16,7
674,4,15,5,0,10,5
674,3,7,3,0,4,3
674,2,3,2,0,1,2
674,1,2,1,0,1,1
8134,10,4,3,0,1,3
8134,9,2,1,0,1,1
8134,8,11,3,0,8,3
8134,7,16,2,0,14,2
8134,6,31,4,0,27,4
8134,5,14,6,0,8,6
8134,4,12,3,0,9,3
8134,3,1,1,0,0,1
8134,2,4,1,0,3,1
5882,8,4,1,0,3,1
5882,7,19,7,0,12,7
5882,6,28,7,0,21,7
5882,5,17,3,0,14,3
5882,4,10,5,0,5,5
5882,3,11,6,0,5,6
5882,2,6,3,0,3,3
8737,9,5,2,0,3,2
8737,8,14,5,0,9,5
8737,7,29,11,0,18,11
8737,6,32,8,0,24,8
8737,5,8,1,0,7,1
8737,4,4,1,0,3,1
8737,2,1,1,0,0,1
18876,8,13,6,0,7,6
18876,7,24,9,0,15,9
18876,6,32,11,0,21,11
18876,5,11,4,0,7,4
18876,4,10,4,0,6,4
18876,3,1,1,0,0,1
18876,1,1,1,0,0,1
200170,10,6,2,0,4,2
200170,9,19,6,0,13,6
200170,8,32,6,0,26,6
200170,7,12,3,1,9,2
200170,6,11,4,0,7,4
200170,5,8,2,0,6,2
200170,4,2,1,1,1,0
198147,8,8,2,0,6,2
198147,7,12,1,0,11,1
198147,6,24,4,0,20,4
198147,5,19,4,2,15,2
198147,4,15,2,0,13,2
198147,3,6,1,0,5,1
198147,2,4,3,0,1,3
198147,1,2,1,0,1,1
4657,10,16,7,0,9,7
4657,9,23,10,0,13,10
4657,8,26,10,0,16,10
4657,7,17,7,0,10,7
4657,6,9,5,0,4,5
22847,10,9,3,0,6,3
22847,9,8,3,0,5,3
22847,8,19,8,0,11,8
22847,7,25,7,0,18,7
22847,6,18,5,0,13,5
22847,5,9,2,0,7,2
22847,4,3,2,0,1,2
22847,3,4,2,0,2,2
149112,10,1,1,0,0,1
149112,9,6,2,0,4,2
149112,8,15,9,0,6,9
149112,7,17,6,0,11,6
149112,6,20,6,1,14,5
149112,5,14,6,1,8,5
149112,4,8,5,1,3,4
149112,3,7,1,0,6,1
149112,2,3,1,0,2,1
149112,1,5,4,1,1,3
15267,10,4,3,0,1,3
15267,9,2,1,0,1,1
15267,7,11,1,0,10,1
15267,6,36,5,0,31,5
15267,5,21,2,0,19,2
15267,4,9,3,0,6,3
15267,2,2,1,0,1,1
6660,10,2,2,0,0,2
6660,8,7,3,0,4,3
6660,7,15,5,0,10,5
6660,6,27,7,0,20,7
6660,5,27,6,0,21,6
6660,4,11,3,0,8,3
6660,3,3,1,0,2,1
6660,1,1,1,0,0,1
188051,8,19,3,0,16,3
188051,7,28,7,0,21,7
188051,6,30,5,0,25,5
188051,5,8,1,0,7,1
188051,4,5,1,0,4,1
8317,10,3,1,0,2,1
8317,9,6,3,0,3,3
8317,8,15,2,0,13,2
8317,7,31,9,0,22,9
8317,6,16,4,0,12,4
8317,5,18,9,0,9,9
8317,4,5,3,0,2,3
8317,1,1,1,0,0,1
157083,7,10,2,0,8,2
157083,6,33,4,2,29,2
157083,5,23,5,0,18,5
157083,4,12,3,0,9,3
157083,3,5,1,0,4,1
5428,7,6,2,0,4,2
5428,6,27,6,0,21,6
5428,5,25,5,0,20,5
5428,4,23,2,0,21,2
5428,3,11,4,0,7,4
5428,2,2,2,0,0,2
5428,1,1,1,0,0,1
22476,8,12,4,0,8,4
22476,7,24,11,0,13,11
22476,6,27,8,0,19,8
22476,5,15,7,0,8,7
22476,4,4,2,0,2,2
22476,3,4,2,0,2,2
22476,2,1,1,0,0,1
23870,10,1,1,0,0,1
23870,8,6,2,0,4,2
23870,7,12,4,0,8,4
23870,6,22,11,0,11,11
23870,5,22,9,0,13,9
23870,4,12,7,0,5,7
23870,3,11,5,0,6,5
23870,2,6,5,0,1,5
23870,1,3,1,0,2,1
212581,10,11,4,0,7,4
212581,8,34,7,1,27,6
212581,7,29,1,1,28,0
212581,6,9,1,0,8,1
212581,5,7,1,0,6,1
161923,8,13,4,0,9,4
161923,7,30,6,0,24,6
161923,6,39,8,1,31,7
161923,5,9,2,0,7,2
161923,4,3,2,1,1,1
159633,10,7,2,0,5,2
159633,9,5,3,1,2,2
159633,8,19,5,0,14,5
159633,7,23,3,0,20,3
159633,6,16,5,0,11,5
159633,5,15,5,0,10,5
159633,4,7,2,1,5,1
159633,3,1,1,0,0,1
11438,10,7,2,0,5,2
11438,8,36,7,0,29,7
11438,7,27,6,0,21,6
11438,6,11,3,0,8,3
11438,5,5,1,0,4,1
11438,4,3,2,0,1,2
154890,8,9,3,0,6,3
154890,7,23,9,0,14,9
154890,6,38,8,0,30,8
154890,5,16,2,0,14,2
154890,4,6,1,0,5,1
1278,9,3,2,0,1,2
1278,8,26,10,0,16,10
1278,7,25,9,0,16,9
1278,6,30,15,0,15,15
1278,5,5,2,0,3,2
1278,4,4,1,0,3,1
1278,3,2,1,0,1,1
74596,9,1,1,0,0,1
74596,8,28,5,0,23,5
74596,7,34,4,0,30,4
74596,6,28,7,0,21,7
561,9,2,1,0,1,1
561,8,15,5,0,10,5
561,7,16,2,0,14,2
561,6,34,10,0,24,10
561,5,13,4,0,9,4
561,4,5,2,0,3,2
561,3,7,3,0,4,3
5541,10,5,2,0,3,2
5541,9,4,2,0,2,2
5541,8,10,1,0,9,1
5541,7,24,13,0,11,13
5541,6,30,8,0,22,8
5541,5,13,11,0,2,11
5541,4,6,2,0,4,2
5541,3,4,2,0,2,2
152471,10,3,2,0,1,2
152471,9,7,2,0,5,2
152471,8,21,7,1,14,6
152471,7,18,3,1,15,2
152471,6,29,7,0,22,7
152471,5,12,3,0,9,3
152471,4,4,1,0,3,1
152471,3,1,1,0,0,1
152471,2,1,1,1,0,0
224212,9,3,1,0,2,1
224212,8,5,1,0,4,1
224212,6,29,8,0,21,8
224212,5,20,2,0,18,2
224212,4,17,4,0,13,4
224212,3,11,6,0,5,6
224212,1,2,1,0,1,1
153757,9,6,4,1,2,3
153757,8,18,7,1,11,6
153757,7,20,3,1,17,2
153757,6,35,12,0,23,12
153757,5,7,3,0,4,3
153757,4,5,2,0,3,2
153757,3,3,2,0,1,2
34450,8,22,1,0,21,1
34450,7,22,3,0,19,3
34450,6,29,1,0,28,1
34450,2,2,1,0,1,1
19351,9,3,1,0,2,1
19351,8,10,4,0,6,4
19351,7,23,5,0,18,5
19351,6,32,9,0,23,9
19351,5,8,2,0,6,2
19351,4,5,2,0,3,2
19351,3,4,1,0,3,1
246960,10,9,4,0,5,4
246960,9,9,2,0,7,2
246960,8,19,6,0,13,6
246960,7,31,9,0,22,9
246960,6,13,4,0,9,4
246960,4,4,2,0,2,2
246960,3,4,1,0,3,1
246960,2,1,1,0,0,1
246960,1,4,2,0,2,2
174646,10,6,2,0,4,2
174646,9,4,1,0,3,1
174646,8,22,4,0,18,4
174646,7,25,5,0,20,5
174646,6,21,6,2,15,4
174646,5,11,1,0,10,1
174646,4,4,1,1,3,0
174646,2,2,1,0,1,1
174646,1,1,1,0,0,1
170274,9,4,1,0,3,1
170274,6,23,4,0,19,4
170274,5,18,2,0,16,2
170274,4,17,3,0,14,3
170274,2,6,4,0,2,4
170274,1,3,1,0,2,1
13373,8,4,2,0,2,2
13373,7,2,1,0,1,1
13373,6,10,2,0,8,2
13373,5,31,9,0,22,9
13373,4,23,7,0,16,7
13373,3,14,8,0,6,8
13373,2,8,1,0,7,1
8337,8,6,3,0,3,3
8337,7,8,2,0,6,2
8337,6,25,8,0,17,8
8337,5,20,8,0,12,8
8337,4,17,5,0,12,5
8337,3,13,4,0,9,4
8337,2,6,4,0,2,4
250878,9,7,2,0,5,2
250878,8,13,1,0,12,1
250878,7,19,2,0,17,2
250878,6,27,2,0,25,2
250878,5,14,2,0,12,2
250878,4,7,1,0,6,1
250878,3,2,2,0,0,2
250878,2,2,1,0,1,1
193295,10,2,1,0,1,1
193295,8,4,3,0,1,3
193295,6,18,1,1,17,0
193295,5,11,2,0,9,2
193295,4,24,3,0,21,3
193295,2,7,1,0,6,1
193295,1,13,7,0,6,7
173003,7,29,3,0,26,3
173003,6,36,7,0,29,7
173003,5,13,4,0,9,4
12451,10,1,1,0,0,1
12451,8,7,1,0,6,1
12451,7,18,4,0,14,4
12451,6,33,5,0,28,5
12451,5,17,1,0,16,1
12451,4,9,1,0,8,1
12451,2,4,3,0,1,3
24254,8,6,1,0,5,1
24254,7,13,3,0,10,3
24254,6,22,4,0,18,4
24254,5,27,3,0,24,3
24254,4,17,4,0,13,4
24254,3,7,1,0,6,1
24254,2,2,1,0,1,1
24254,1,2,1,0,1,1
6540,10,7,1,0,6,1
6540,9,14,4,0,10,4
6540,8,33,7,0,26,7
6540,7,20,8,0,12,8
6540,6,8,2,0,6,2
6540,5,8,3,0,5,3
6540,4,3,1,0,2,1
6540,3,3,3,0,0,3
88147,9,2,2,0,0,2
88147,8,6,2,0,4,2
88147,7,26,13,0,13,13
88147,6,37,14,0,23,14
88147,5,16,8,0,8,8
88147,4,6,3,0,3,3
88147,3,1,1,0,0,1
88147,2,2,2,0,0,2
916,9,3,1,0,2,1
916,8,8,4,0,4,4
916,7,20,9,0,11,9
916,6,34,13,0,21,13
916,5,14,4,0,10,4
916,4,9,3,0,6,3
916,3,6,3,0,3,3
146707,9,5,1,1,4,0
146707,7,13,4,0,9,4
146707,6,27,5,1,22,4
146707,5,22,5,0,17,5
146707,4,10,3,0,7,3
146707,1,2,2,0,0,2
39939,10,25,8,0,17,8
39939,9,32,10,0,22,10
39939,8,29,8,0,21,8
39939,7,4,1,0,3,1
39939,6,3,1,0,2,1
5777,9,6,3,0,3,3
5777,8,10,4,0,6,4
5777,7,21,5,0,16,5
5777,6,28,8,0,20,8
5777,5,16,5,0,11,5
5777,4,6,4,0,2,4
5777,3,4,2,0,2,2
28857,7,7,3,0,4,3
28857,6,19,8,0,11,8
28857,5,32,7,0,25,7
28857,4,22,5,0,17,5
28857,3,8,2,0,6,2
28857,2,5,2,0,3,2
28857,1,1,1,0,0,1
20053,10,2,1,0,1,1
20053,8,13,5,0,8,5
20053,7,22,9,0,13,9
20053,6,31,12,0,19,12
20053,5,10,5,0,5,5
20053,4,8,4,0,4,4
20053,2,4,4,0,0,4
2743,9,4,2,0,2,2
2743,8,13,6,0,7,6
2743,7,19,7,0,12,7
2743,6,32,10,0,22,10
2743,5,14,7,0,7,7
2743,4,8,3,0,5,3
2743,3,3,1,0,2,1
2743,2,1,1,0,0,1
5862,8,9,4,0,5,4
5862,7,15,4,0,11,4
5862,6,22,5,0,17,5
5862,5,27,9,0,18,9
5862,4,9,5,0,4,5
5862,3,5,3,0,2,3
153103,9,2,1,0,1,1
153103,8,11,2,0,9,2
153103,7,15,1,0,14,1
153103,6,42,6,0,36,6
153103,5,17,3,0,14,3
153103,3,4,2,0,2,2
161880,10,10,3,0,7,3
161880,9,16,3,0,13,3
161880,8,34,7,0,27,7
161880,7,17,3,0,14,3
161880,6,15,2,0,13,2
161880,5,3,1,0,2,1
7463,8,3,1,0,2,1
7463,7,10,1,0,9,1
7463,6,26,9,0,17,9
7463,5,21,7,0,14,7
7463,4,16,7,0,9,7
7463,3,8,4,0,4,4
7463,2,4,2,0,2,2
7463,1,3,3,0,0,3
219122,8,28,3,0,25,3
219122,7,31,4,0,27,4
219122,6,24,1,0,23,1
219122,5,6,4,0,2,4
219122,4,2,1,0,1,1
230200,9,5,4,0,1,4
230200,8,41,8,1,33,7
230200,7,26,5,1,21,4
230200,6,14,1,0,13,1
230200,5,2,1,0,1,1
1208,10,2,1,0,1,1
1208,9,4,1,0,3,1
1208,8,25,7,0,18,7
1208,7,30,10,0,20,10
1208,6,21,4,0,17,4
1208,5,6,4,0,2,4
1208,4,5,2,0,3,2
138026,10,4,1,0,3,1
138026,9,11,3,0,8,3
138026,7,23,3,0,20,3
138026,6,12,1,0,11,1
138026,5,8,3,0,5,3
138026,3,2,1,0,1,1
138026,2,1,1,0,0,1
66888,7,17,2,0,15,2
66888,6,34,9,0,25,9
66888,5,16,4,0,12,4
66888,4,9,5,0,4,5
66888,3,5,1,0,4,1
66888,2,5,1,0,4,1
194387,9,1,1,0,0,1
194387,8,13,4,0,9,4
194387,7,21,3,0,18,3
194387,6,35,3,0,32,3
148744,10,7,4,0,3,4
148744,9,7,4,0,3,4
148744,8,16,8,0,8,8
148744,7,24,4,0,20,4
148744,6,28,6,0,22,6
148744,5,5,1,0,4,1
148744,3,2,1,0,1,1
148744,1,2,1,0,1,1
3561,9,1,1,0,0,1
3561,8,8,5,0,3,5
3561,7,18,7,0,11,7
3561,6,40,13,0,27,13
3561,5,17,5,0,12,5
3561,4,7,1,0,6,1
3561,1,1,1,0,0,1
197,9,1,1,0,0,1
197,8,10,3,0,7,3
197,7,18,3,0,15,3
197,6,42,9,0,33,9
197,5,19,7,0,12,7
197,4,2,1,0,1,1
180939,8,12,2,0,10,2
180939,7,15,1,0,14,1
180939,6,34,2,0,32,2
180939,4,11,2,0,9,2
180939,1,4,2,0,2,2
155464,8,3,1,0,2,1
155464,7,6,1,0,5,1
155464,6,36,12,0,24,12
155464,5,22,5,0,17,5
155464,4,15,2,0,13,2
155464,3,3,1,0,2,1
155464,2,7,2,0,5,2
6041,8,12,10,0,2,10
6041,7,35,13,0,22,13
6041,6,27,3,0,24,3
6041,5,8,3,0,5,3
6041,4,5,1,0,4,1
6041,3,3,2,0,1,2
217934,10,14,7,0,7,7
217934,9,28,10,0,18,10
217934,8,43,11,2,32,9
217934,7,8,2,0,6,2
217934,6,2,1,0,1,1
91394,7,18,6,0,12,6
91394,6,41,10,0,31,10
91394,5,15,3,0,12,3
91394,4,12,2,0,10,2
91394,3,3,1,0,2,1
72083,8,17,5,0,12,5
72083,7,32,11,0,21,11
72083,6,28,7,0,21,7
72083,5,10,2,0,8,2
72083,3,4,1,0,3,1
11967,10,6,2,0,4,2
11967,9,19,8,0,11,8
11967,8,30,11,0,19,11
11967,7,19,3,0,16,3
11967,6,17,2,0,15,2
11967,5,2,1,0,1,1
11967,3,2,1,0,1,1
67426,9,9,3,0,6,3
67426,8,25,5,0,20,5
67426,7,26,3,0,23,3
67426,6,20,4,0,16,4
67426,5,12,4,0,8,4
172166,10,1,1,0,0,1
172166,9,3,1,0,2,1
172166,8,17,4,0,13,4
172166,7,22,4,0,18,4
172166,6,29,7,0,22,7
172166,5,16,2,0,14,2
2736,10,2,2,0,0,2
2736,9,5,3,0,2,3
2736,8,14,3,0,11,3
2736,7,29,7,0,22,7
2736,6,28,6,0,22,6
2736,5,9,3,0,6,3
2736,4,7,3,0,4,3
2147,8,4,1,0,3,1
2147,7,18,1,0,17,1
2147,6,29,6,0,23,6
2147,5,24,7,0,17,7
2147,4,8,3,0,5,3
2147,3,7,1,0,6,1
2147,2,4,3,0,1,3
4764,9,4,2,0,2,2
4764,8,9,3,0,6,3
4764,7,11,7,0,4,7
4764,6,41,11,0,30,11
4764,5,19,6,0,13,6
4764,4,7,2,0,5,2
5532,8,5,2,0,3,2
5532,7,9,2,0,7,2
5532,6,29,9,0,20,9
5532,5,24,11,0,13,11
5532,4,16,5,0,11,5
5532,3,9,4,0,5,4
24280,10,8,6,0,2,6
24280,9,1,1,0,0,1
24280,8,8,5,0,3,5
24280,7,17,4,0,13,4
24280,6,34,9,0,25,9
24280,5,16,6,0,10,6
24280,4,4,2,0,2,2
24280,3,4,2,0,2,2
24280,1,1,1,0,0,1
17654,10,2,1,0,1,1
17654,9,15,4,0,11,4
17654,8,36,14,0,22,14
17654,7,26,6,0,20,6
17654,6,9,2,0,7,2
17654,5,6,1,0,5,1
180238,9,4,4,0,0,4
180238,8,9,4,0,5,4
180238,7,14,3,0,11,3
180238,6,32,4,0,28,4
180238,5,15,4,0,11,4
180238,4,14,4,0,10,4
180238,3,6,1,0,5,1
36236,10,1,1,0,0,1
36236,8,7,1,0,6,1
36236,7,18,3,0,15,3
36236,6,23,5,0,18,5
36236,5,19,5,0,14,5
36236,4,13,7,0,6,7
36236,3,3,1,0,2,1
36236,2,7,2,0,5,2
36236,1,2,2,0,0,2
5354,10,1,1,0,0,1
5354,8,4,2,0,2,2
5354,7,13,7,0,6,7
5354,6,23,9,0,14,9
5354,5,23,9,0,14,9
5354,4,20,6,0,14,6
5354,3,6,1,0,5,1
5354,2,3,1,0,2,1
5354,1,1,1,0,0,1
153498,9,6,2,0,4,2
153498,8,37,8,0,29,8
153498,7,23,4,0,19,4
153498,6,16,2,0,14,2
153498,5,6,3,0,3,3
153498,4,1,1,0,0,1
207167,10,3,2,0,1,2
207167,8,13,3,0,10,3
207167,7,19,4,0,15,4
207167,6,25,1,0,24,1
207167,5,9,2,0,7,2
207167,4,10,3,0,7,3
207167,3,8,1,0,7,1
207167,1,1,1,0,0,1
8335,8,7,4,0,3,4
8335,7,14,5,0,9,5
8335,6,31,8,0,23,8
8335,5,22,7,0,15,7
8335,4,8,1,0,7,1
8335,3,9,3,0,6,3
8335,2,2,2,0,0,2
8335,1,2,1,0,1,1
185302,10,5,4,0,1,4
185302,9,7,4,0,3,4
185302,8,17,3,0,14,3
185302,7,18,6,0,12,6
185302,6,15,4,0,11,4
185302,5,15,2,1,13,1
185302,4,13,9,0,4,9
185302,3,3,1,0,2,1
87288,8,10,1,0,9,1
87288,7,11,3,0,8,3
87288,6,43,5,0,38,5
87288,5,13,1,0,12,1
87288,4,10,3,0,7,3
87288,3,4,1,0,3,1
181319,9,2,1,0,1,1
181319,8,26,8,0,18,8
181319,7,35,8,0,27,8
181319,6,22,7,0,15,7
181319,4,3,1,0,2,1
124000,9,4,2,0,2,2
124000,8,15,1,0,14,1
124000,6,26,4,0,22,4
124000,4,9,2,0,7,2
179574,10,2,1,0,1,1
179574,9,1,1,0,0,1
179574,8,12,5,2,7,3
179574,7,14,3,0,11,3
179574,6,34,9,1,25,8
179574,5,11,5,0,6,5
179574,4,9,2,0,7,2
179574,3,5,1,0,4,1
179574,2,4,2,0,2,2
179574,1,3,1,0,2,1
218395,10,63,9,0,54,9
218395,9,19,1,1,18,0
218395,8,6,2,2,4,0
218395,7,2,2,0,0,2
218395,1,2,1,0,1,1
55031,9,2,1,0,1,1
55031,8,17,7,0,10,7
55031,7,26,9,0,17,9
55031,6,27,10,0,17,10
55031,4,5,4,0,1,4
55031,2,2,1,0,1,1
34419,8,10,2,0,8,2
34419,7,15,3,0,12,3
34419,6,42,9,0,33,9
34419,5,18,4,0,14,4
34419,4,5,4,0,1,4
27387,8,9,3,0,6,3
27387,7,18,2,0,16,2
27387,6,25,3,0,22,3
27387,5,16,3,0,13,3
27387,4,16,2,0,14,2
27387,3,8,4,0,4,4
27387,2,3,1,0,2,1
10904,10,10,7,0,3,7
10904,9,16,8,0,8,8
10904,8,27,13,0,14,13
10904,7,15,10,0,5,10
10904,6,17,7,0,10,7
10904,5,5,1,0,4,1
10904,4,1,1,0,0,1
217338,8,10,2,0,8,2
217338,6,29,3,0,26,3
217338,5,9,3,0,6,3
217338,2,2,1,0,1,1
10575,9,2,1,0,1,1
10575,8,10,6,0,4,6
10575,7,14,4,0,10,4
10575,6,24,12,0,12,12
10575,5,12,6,0,6,6
10575,4,12,3,0,9,3
10575,3,10,8,0,2,8
10575,2,3,1,0,2,1
10575,1,5,3,0,2,3
153002,8,11,1,0,10,1
153002,7,22,6,0,16,6
153002,6,35,10,0,25,10
153002,5,8,2,0,6,2
153002,4,6,1,0,5,1
153002,3,5,3,0,2,3
179548,10,3,1,0,2,1
179548,8,19,5,0,14,5
179548,7,36,6,0,30,6
179548,6,19,6,0,13,6
179548,4,10,3,0,7,3
105265,9,4,1,0,3,1
105265,8,8,3,0,5,3
105265,7,28,4,0,24,4
105265,6,36,5,0,31,5
105265,5,12,4,0,8,4
105265,4,5,2,0,3,2
2499,8,7,3,0,4,3
2499,7,9,1,0,8,1
2499,6,31,13,0,18,13
2499,5,25,8,0,17,8
2499,4,13,3,0,10,3
4217,10,2,1,0,1,1
4217,9,2,1,0,1,1
4217,8,8,3,0,5,3
4217,7,24,12,0,12,12
4217,6,32,12,0,20,12
4217,5,13,2,0,11,2
4217,4,8,5,0,3,5
4217,1,1,1,0,0,1
4342,10,6,3,0,3,3
4342,9,9,2,0,7,2
4342,8,35,6,0,29,6
4342,7,23,3,0,20,3
4342,6,16,4,0,12,4
4342,5,4,1,0,3,1
195,8,8,5,0,3,5
195,7,11,6,0,5,6
195,6,27,12,0,15,12
195,5,26,5,0,21,5
195,4,13,9,0,4,9
195,3,3,1,0,2,1
195,2,6,2,0,4,2
1760,9,6,3,0,3,3
1760,8,14,3,0,11,3
1760,7,16,3,0,13,3
1760,6,30,8,0,22,8
1760,5,9,3,0,6,3
1760,4,11,3,0,8,3
236178,10,9,5,0,4,5
236178,9,4,3,0,1,3
236178,8,18,3,0,15,3
236178,7,22,4,0,18,4
236178,6,20,1,0,19,1
236178,5,13,2,0,11,2
236178,4,4,1,0,3,1
236178,3,4,1,0,3,1
1815,10,3,1,0,2,1
1815,8,18,6,0,12,6
1815,7,19,5,0,14,5
1815,6,31,12,0,19,12
1815,5,10,3,0,7,3
1815,4,5,2,0,3,2
1815,3,3,2,0,1,2
1815,2,1,1,0,0,1
1138,8,6,3,0,3,3
1138,7,17,6,0,11,6
1138,6,24,8,0,16,8
1138,5,23,6,0,17,6
1138,4,12,8,0,4,8
1138,3,5,3,0,2,3
1138,2,4,2,0,2,2
6529,9,3,1,0,2,1
6529,8,16,3,0,13,3
6529,7,25,5,0,20,5
6529,6,25,4,0,21,4
6529,5,10,4,0,6,4
6529,4,7,4,0,3,4
6529,3,4,3,0,1,3
6529,2,3,2,0,1,2
179386,10,3,1,0,2,1
179386,8,10,4,1,6,3
179386,7,23,7,1,16,6
179386,6,32,8,0,24,8
179386,5,13,2,0,11,2
179386,3,6,3,0,3,3
2138,9,6,2,0,4,2
2138,8,15,4,0,11,4
2138,7,26,8,0,18,8
2138,6,28,5,0,23,5
2138,5,9,4,0,5,4
2138,4,6,4,0,2,4
162614,10,1,1,0,0,1
162614,9,9,4,0,5,4
162614,8,7,2,0,5,2
162614,7,21,4,0,17,4
162614,6,29,8,0,21,8
162614,5,16,3,0,13,3
162614,4,4,1,0,3,1
162614,3,3,1,0,2,1
11060,8,9,3,0,6,3
11060,7,18,7,0,11,7
11060,6,26,6,0,20,6
11060,5,22,5,0,17,5
11060,4,9,3,0,6,3
11060,2,3,1,0,2,1
11060,1,2,1,0,1,1
77344,9,2,1,0,1,1
77344,8,5,2,0,3,2
77344,7,14,5,0,9,5
77344,6,34,4,0,30,4
77344,5,15,3,0,12,3
77344,4,12,3,0,9,3
77344,3,8,1,0,7,1
77344,2,2,1,0,1,1
28010,7,8,3,0,5,3
28010,6,22,5,0,17,5
28010,5,16,8,0,8,8
28010,4,23,7,0,16,7
28010,3,9,4,0,5,4
28010,2,8,3,0,5,3
28010,1,2,1,0,1,1
125936,9,12,5,0,7,5
125936,8,20,1,0,19,1
125936,7,32,11,0,21,11
125936,6,16,3,0,13,3
125936,5,8,2,0,6,2
125936,2,1,1,0,0,1
125936,1,1,1,0,0,1
12822,8,4,2,0,2,2
12822,7,7,1,0,6,1
12822,6,18,3,0,15,3
12822,5,28,5,0,23,5
12822,4,21,3,0,18,3
12822,3,10,4,0,6,4
12822,2,4,1,0,3,1
2161,10,1,1,0,0,1
2161,9,4,1,0,3,1
2161,8,12,1,0,11,1
2161,7,22,4,0,18,4
2161,6,22,6,0,16,6
2161,5,18,5,0,13,5
2161,4,8,2,0,6,2
2161,3,4,2,0,2,2
2161,2,3,2,0,1,2
10878,8,9,1,0,8,1
10878,7,17,1,0,16,1
10878,6,42,5,0,37,5
10878,5,17,4,0,13,4
10878,4,6,1,0,5,1
34098,10,1,1,0,0,1
34098,9,18,10,0,8,10
34098,8,45,16,0,29,16
34098,7,24,11,0,13,11
34098,6,3,2,0,1,2
34098,5,2,1,0,1,1
3064,10,3,1,0,2,1
3064,9,2,1,0,1,1
3064,8,10,3,0,7,3
3064,7,17,10,0,7,10
3064,6,31,13,0,18,13
3064,5,17,8,0,9,8
3064,4,6,3,0,3,3
3064,3,5,3,0,2,3
3064,2,3,2,0,1,2
3762,7,13,3,0,10,3
3762,6,29,7,0,22,7
3762,5,18,4,0,14,4
3762,4,13,4,0,9,4
3762,3,10,3,0,7,3
3762,2,2,1,0,1,1
3762,1,3,2,0,1,2
35452,9,7,5,0,2,5
35452,8,27,9,0,18,9
35452,7,24,8,0,16,8
35452,6,12,4,0,8,4
35452,5,6,2,0,4,2
35452,4,6,3,0,3,3
35452,3,4,2,0,2,2
35452,2,3,3,1,0,2
35452,1,3,2,0,1,2
1130,9,4,1,0,3,1
1130,8,10,1,0,9,1
1130,7,22,9,0,13,9
1130,5,14,1,0,13,1
1130,4,6,3,0,3,3
1130,3,3,1,0,2,1
1130,2,2,2,0,0,2
997,8,4,3,0,1,3
997,7,8,2,0,6,2
997,6,28,6,0,22,6
997,5,33,7,0,26,7
997,3,5,2,0,3,2
997,2,2,1,0,1,1
21634,9,4,3,0,1,3
21634,8,9,4,0,5,4
21634,7,18,2,0,16,2
21634,6,31,3,0,28,3
21634,5,23,4,0,19,4
21634,4,6,1,0,5,1
21634,3,2,1,0,1,1
21634,2,1,1,0,0,1
8721,9,5,3,0,2,3
8721,8,22,4,0,18,4
8721,7,31,9,0,22,9
8721,6,20,1,0,19,1
8721,5,8,2,0,6,2
8721,4,1,1,0,0,1
8721,1,1,1,0,0,1
252314,8,19,5,0,14,5
252314,7,23,5,0,18,5
252314,6,26,4,0,22,4
252314,5,15,1,0,14,1
252314,4,6,2,0,4,2
3160,8,3,3,0,0,3
3160,7,8,5,0,3,5
3160,6,21,6,0,15,6
3160,5,32,9,0,23,9
3160,4,14,2,0,12,2
3160,3,12,3,0,9,3
223777,9,11,4,0,7,4
223777,8,35,5,0,30,5
223777,7,22,7,0,15,7
223777,6,19,4,0,15,4
223777,4,2,1,0,1,1
192283,10,5,3,0,2,3
192283,9,2,1,0,1,1
192283,8,9,3,0,6,3
192283,7,19,2,0,17,2
192283,6,26,1,0,25,1
192283,5,12,4,0,8,4
192283,4,12,4,0,8,4
192283,3,5,1,0,4,1
192283,2,2,1,0,1,1
217974,10,15,11,0,4,11
217974,9,8,5,0,3,5
217974,8,18,7,0,11,7
217974,7,21,6,0,15,6
217974,6,19,3,0,16,3
217974,4,4,2,0,2,2
217974,3,4,3,0,1,3
217974,2,2,1,0,1,1
54239,7,6,1,0,5,1
54239,6,26,9,0,17,9
54239,5,23,10,0,13,10
54239,4,19,7,0,12,7
54239,3,10,4,0,6,4
54239,2,6,2,0,4,2
12746,10,1,1,0,0,1
12746,8,2,1,0,1,1
12746,7,5,4,0,1,4
12746,6,8,2,0,6,2
12746,5,11,1,0,10,1
12746,4,25,7,0,18,7
12746,3,18,7,0,11,7
12746,2,12,5,0,7,5
12746,1,12,7,0,5,7
23707,10,1,1,0,0,1
23707,8,11,4,0,7,4
23707,7,23,8,0,15,8
23707,6,32,12,0,20,12
23707,5,15,9,0,6,9
23707,4,10,5,0,5,5
23707,3,1,1,0,0,1
206780,10,3,1,0,2,1
206780,8,26,3,0,23,3
206780,7,22,2,0,20,2
206780,6,19,2,0,17,2
206780,5,9,1,0,8,1
206780,4,2,1,0,1,1
3054,9,5,3,0,2,3
3054,8,13,7,0,6,7
3054,7,21,6,0,15,6
3054,6,28,11,0,17,11
3054,5,10,5,0,5,5
3054,4,7,2,0,5,2
3054,3,4,1,0,3,1
3054,2,2,2,0,0,2
3054,1,2,1,0,1,1
8658,8,3,1,0,2,1
8658,7,8,1,0,7,1
8658,6,18,3,0,15,3
8658,4,16,6,0,10,6
8658,3,16,5,0,11,5
8658,2,6,1,0,5,1
8658,1,6,1,0,5,1
234846,8,11,2,0,9,2
234846,7,20,3,0,17,3
234846,6,29,3,0,26,3
234846,5,19,4,0,15,4
234846,4,5,2,0,3,2
234846,3,4,2,0,2,2
8056,8,10,5,0,5,5
8056,7,19,5,0,14,5
8056,6,39,7,0,32,7
8056,5,12,2,0,10,2
8056,4,5,2,0,3,2
8056,2,2,2,0,0,2
7840,10,2,1,0,1,1
7840,9,6,2,0,4,2
7840,8,15,4,0,11,4
7840,7,28,8,0,20,8
7840,6,30,5,0,25,5
7840,5,10,5,0,5,5
7840,4,1,1,0,0,1
7840,3,1,1,0,0,1
6868,9,3,2,0,1,2
6868,8,8,1,0,7,1
6868,7,6,2,0,4,2
6868,6,21,4,0,17,4
6868,5,20,6,0,14,6
6868,4,17,7,0,10,7
6868,3,12,7,0,5,7
6868,2,3,2,0,1,2
6868,1,3,2,0,1,2
168895,9,3,2,0,1,2
168895,8,7,3,0,4,3
168895,7,21,7,2,14,5
168895,6,27,2,0,25,2
168895,5,17,4,0,13,4
168895,4,6,3,0,3,3
168895,3,10,4,0,6,4
168895,2,3,1,0,2,1
8571,8,9,5,0,4,5
8571,7,21,3,0,18,3
8571,6,30,12,0,18,12
8571,5,13,5,0,8,5
8571,4,6,4,0,2,4
8571,3,5,5,0,0,5
8571,2,3,2,0,1,2
8571,1,2,2,0,0,2
2492,8,4,2,0,2,2
2492,7,12,3,0,9,3
2492,6,22,4,0,18,4
2492,5,28,4,0,24,4
2492,4,17,1,0,16,1
21702,9,1,1,0,0,1
21702,6,23,8,0,15,8
21702,5,19,5,0,14,5
21702,4,27,9,0,18,9
21702,3,12,4,0,8,4
21702,2,6,4,0,2,4
21702,1,3,1,0,2,1
146146,8,3,1,0,2,1
146146,7,7,2,0,5,2
146146,6,32,11,0,21,11
146146,5,21,4,0,17,4
146146,4,17,5,0,12,5
146146,3,6,1,0,5,1
258104,8,19,4,0,15,4
258104,7,37,3,0,34,3
258104,3,1,1,0,0,1
19766,10,2,2,0,0,2
19766,9,5,3,0,2,3
19766,8,17,8,0,9,8
19766,7,23,9,0,14,9
19766,6,20,4,0,16,4
19766,5,11,2,0,9,2
19766,4,7,4,0,3,4
19766,3,6,1,0,5,1
19766,2,2,1,0,1,1
38,8,14,5,0,9,5
38,7,23,6,0,17,6
38,6,32,8,0,24,8
38,5,12,2,0,10,2
38,4,7,3,0,4,3
38,3,2,1,0,1,1
38,2,2,1,0,1,1
195533,10,7,3,0,4,3
195533,9,10,4,0,6,4
195533,8,33,9,0,24,9
195533,7,21,8,0,13,8
195533,6,16,5,0,11,5
195533,4,1,1,0,0,1
195533,3,1,1,0,0,1
221848,10,25,6,1,19,5
221848,9,29,6,0,23,6
221848,8,20,2,0,18,2
221848,7,13,3,0,10,3
221848,6,3,1,0,2,1
221848,4,1,1,0,0,1
221848,2,1,1,0,0,1
239,10,3,1,0,2,1
239,9,3,2,0,1,2
239,8,16,12,0,4,12
239,7,29,8,0,21,8
239,6,29,7,0,22,7
239,5,10,2,0,8,2
194640,9,2,1,0,1,1
194640,8,13,5,2,8,3
194640,7,16,2,0,14,2
194640,6,34,10,2,24,8
194640,5,17,2,0,15,2
194640,4,8,2,0,6,2
194640,3,1,1,0,0,1
35665,8,10,1,0,9,1
35665,7,22,2,0,20,2
35665,6,30,5,0,25,5
35665,5,16,2,0,14,2
35665,4,8,1,0,7,1
5001,8,15,4,0,11,4
5001,7,19,4,0,15,4
5001,6,26,8,0,18,8
5001,5,12,3,0,9,3
5001,4,8,3,0,5,3
5001,3,6,1,0,5,1
8652,8,4,2,0,2,2
8652,7,18,4,0,14,4
8652,6,31,8,0,23,8
8652,5,22,4,0,18,4
8652,4,11,2,0,9,2
8652,3,3,3,0,0,3
8652,2,4,1,0,3,1
231309,10,8,3,0,5,3
231309,8,26,10,0,16,10
231309,7,31,4,0,27,4
231309,6,11,4,0,7,4
231309,5,5,2,0,3,2
231309,3,1,1,0,0,1
2303,9,1,1,0,0,1
2303,7,10,6,0,4,6
2303,6,21,8,0,13,8
2303,5,25,9,0,16,9
2303,4,25,12,0,13,12
2303,3,3,2,0,1,2
2303,2,5,3,0,2,3
2303,1,3,2,0,1,2
36560,8,7,4,0,3,4
36560,7,9,4,0,5,4
36560,6,38,15,0,23,15
36560,5,19,11,0,8,11
36560,4,14,6,0,8,6
36560,3,2,1,0,1,1
36560,2,2,2,0,0,2
3839,8,2,2,0,0,2
3839,7,8,4,0,4,4
3839,6,21,6,0,15,6
3839,5,19,5,0,14,5
3839,4,25,7,0,18,7
3839,3,8,3,0,5,3
3839,2,6,2,0,4,2
660,8,6,3,0,3,3
660,7,28,8,0,20,8
660,6,35,5,0,30,5
660,5,12,4,0,8,4
660,4,5,4,0,1,4
660,3,3,1,0,2,1
660,2,3,1,0,2,1
2721,9,6,5,0,1,5
2721,8,5,1,0,4,1
2721,7,19,7,0,12,7
2721,6,35,10,0,25,10
2721,5,15,7,0,8,7
2721,4,9,1,0,8,1
2721,3,3,2,0,1,2
118732,10,2,1,0,1,1
118732,9,6,1,0,5,1
118732,8,15,6,2,9,4
118732,7,32,8,1,24,7
118732,6,16,2,0,14,2
118732,5,12,5,1,7,4
118732,4,6,3,0,3,3
214898,7,30,4,0,26,4
214898,6,25,6,0,19,6
214898,5,7,1,0,6,1
2885,10,7,5,0,2,5
2885,9,10,4,0,6,4
2885,8,21,7,0,14,7
2885,7,29,7,0,22,7
2885,6,15,4,0,11,4
2885,4,3,2,0,1,2
12135,10,5,3,0,2,3
12135,9,7,6,0,1,6
12135,8,25,10,0,15,10
12135,7,25,14,0,11,14
12135,6,19,6,0,13,6
12135,5,4,1,0,3,1
12135,4,4,2,0,2,2
12135,2,1,1,0,0,1
12135,1,1,1,0,0,1
136954,8,5,1,0,4,1
136954,7,21,4,0,17,4
136954,6,41,9,0,32,9
136954,5,15,4,0,11,4
136954,4,7,1,0,6,1
136954,2,1,1,0,0,1
17773,9,1,1,0,0,1
17773,8,8,5,0,3,5
17773,7,13,5,0,8,5
17773,6,30,14,0,16,14
17773,5,17,12,0,5,12
17773,4,18,12,0,6,12
17773,3,2,2,0,0,2
17773,2,2,1,0,1,1
17773,1,2,2,0,0,2
103236,9,2,1,0,1,1
103236,8,8,1,0,7,1
103236,7,19,4,0,15,4
103236,6,38,4,0,34,4
17022,10,6,3,0,3,3
17022,9,6,1,0,5,1
17022,8,28,10,0,18,10
17022,7,22,9,0,13,9
17022,6,17,5,0,12,5
17022,5,3,2,0,1,2
17022,4,4,2,0,2,2
17022,3,6,4,0,2,4
17022,2,1,1,0,0,1
34948,8,8,4,0,4,4
34948,7,23,2,0,21,2
34948,6,40,16,0,24,16
34948,5,7,3,0,4,3
34948,4,6,2,0,4,2
34948,2,2,1,0,1,1
12501,9,7,1,0,6,1
12501,8,15,7,0,8,7
12501,7,29,5,0,24,5
12501,6,27,5,0,22,5
12501,5,10,1,0,9,1
2099,6,27,5,0,22,5
2099,5,26,8,0,18,8
2099,4,12,3,0,9,3
2099,3,11,1,0,10,1
27408,10,3,1,0,2,1
27408,9,2,1,0,1,1
27408,8,8,2,0,6,2
27408,7,14,3,0,11,3
27408,6,28,6,0,22,6
27408,5,21,2,0,19,2
27408,3,8,1,0,7,1
27408,2,4,2,0,2,2
125395,8,6,2,0,4,2
125395,7,13,5,0,8,5
125395,6,26,1,0,25,1
125395,5,18,1,0,17,1
125395,3,8,2,0,6,2
125395,2,7,2,0,5,2
125395,1,8,1,0,7,1
246316,9,1,1,0,0,1
246316,8,17,6,0,11,6
246316,7,26,10,0,16,10
246316,6,33,6,0,27,6
246316,4,5,1,0,4,1
246316,3,3,1,0,2,1
246316,2,1,1,0,0,1
10291,9,2,1,0,1,1
10291,8,2,2,0,0,2
10291,7,12,5,0,7,5
10291,6,26,10,0,16,10
10291,5,24,1,0,23,1
10291,4,17,3,0,14,3
10291,3,3,3,0,0,3
10291,2,4,1,0,3,1
151396,8,8,2,0,6,2
151396,7,9,2,0,7,2
151396,6,45,10,0,35,10
151396,5,15,3,0,12,3
151396,4,9,2,1,7,1
151396,3,7,3,0,4,3
217353,10,6,3,1,3,2
217353,9,14,6,1,8,5
217353,8,34,5,0,29,5
217353,7,18,4,2,14,2
217353,6,10,1,0,9,1
217353,5,9,1,0,8,1
183361,9,2,1,0,1,1
183361,8,11,5,0,6,5
183361,7,37,4,0,33,4
183361,6,23,5,0,18,5
183361,5,12,3,0,9,3
183361,4,5,1,0,4,1
183361,2,1,1,0,0,1
549,10,8,3,0,5,3
549,9,13,3,0,10,3
549,8,35,11,0,24,11
549,7,21,5,0,16,5
549,6,10,1,0,9,1
549,5,4,3,0,1,3
549,4,1,1,0,0,1
549,2,1,1,0,0,1
40480,8,4,2,0,2,2
40480,7,14,1,0,13,1
40480,6,33,3,0,30,3
40480,5,21,2,0,19,2
40480,4,9,1,0,8,1
40480,3,7,1,0,6,1
9132,10,7,2,0,5,2
9132,9,17,5,0,12,5
9132,8,29,14,0,15,14
9132,7,23,10,0,13,10
9132,6,9,5,0,4,5
9132,5,3,2,0,1,2
9132,3,2,1,0,1,1
232216,10,3,1,0,2,1
232216,9,5,2,0,3,2
232216,8,22,3,0,19,3
232216,7,23,4,0,19,4
232216,6,25,8,0,17,8
232216,4,3,1,0,2,1
200371,10,9,4,1,5,3
200371,9,12,4,0,8,4
200371,8,15,3,1,12,2
200371,7,24,3,0,21,3
200371,6,16,2,0,14,2
200371,4,6,2,0,4,2
200371,3,2,1,0,1,1
21734,8,6,2,0,4,2
21734,7,6,3,0,3,3
21734,6,20,4,0,16,4
21734,5,17,5,0,12,5
21734,4,20,9,0,11,9
21734,3,15,4,0,11,4
21734,2,3,1,0,2,1
21734,1,5,3,0,2,3
198328,8,8,3,0,5,3
198328,7,28,3,0,25,3
198328,6,27,4,0,23,4
126168,7,15,5,0,10,5
126168,6,39,4,0,35,4
126168,5,15,4,0,11,4
126168,4,6,2,0,4,2
126168,3,5,1,0,4,1
126168,2,2,1,0,1,1
134279,10,14,8,0,6,8
134279,9,3,1,0,2,1
134279,8,10,3,0,7,3
134279,7,18,8,0,10,8
134279,5,12,2,0,10,2
134279,4,8,1,0,7,1
134279,1,3,2,0,1,2
3525,7,8,2,0,6,2
3525,6,29,8,0,21,8
3525,5,22,5,0,17,5
3525,4,21,8,0,13,8
3525,3,5,3,0,2,3
7081,10,1,1,0,0,1
7081,9,1,1,0,0,1
7081,8,7,3,0,4,3
7081,7,16,9,0,7,9
7081,6,36,11,0,25,11
7081,5,17,5,0,12,5
7081,4,9,2,0,7,2
7081,3,4,2,0,2,2
7081,2,2,1,0,1,1
177976,9,4,1,0,3,1
177976,8,12,4,1,8,3
177976,7,24,4,0,20,4
177976,6,32,12,3,20,9
177976,5,11,4,0,7,4
177976,3,2,1,0,1,1
177976,2,2,1,0,1,1
177976,1,2,2,0,0,2
6891,9,3,1,0,2,1
6891,8,7,5,0,2,5
6891,7,9,3,0,6,3
6891,6,34,10,0,24,10
6891,5,24,10,0,14,10
6891,4,9,5,0,4,5
6891,3,4,2,0,2,2
6891,1,1,1,0,0,1
180489,9,3,2,0,1,2
180489,8,5,2,0,3,2
180489,7,23,3,0,20,3
180489,6,30,7,0,23,7
180489,5,13,2,0,11,2
180489,4,8,1,0,7,1
180489,3,4,2,0,2,2
270314,9,9,1,0,8,1
270314,8,28,1,0,27,1
270314,7,32,4,0,28,4
270314,6,20,4,0,16,4
20217,8,2,1,0,1,1
20217,6,38,7,0,31,7
20217,5,20,6,0,14,6
20217,4,17,6,0,11,6
20217,3,4,2,0,2,2
5733,8,8,2,0,6,2
5733,7,25,8,0,17,8
5733,6,25,5,0,20,5
5733,5,19,6,0,13,6
5733,4,6,2,0,4,2
5733,3,5,1,0,4,1
4252,10,3,1,0,2,1
4252,9,4,1,0,3,1
4252,8,14,5,0,9,5
4252,7,19,10,0,9,10
4252,6,31,12,0,19,12
4252,5,9,4,0,5,4
4252,4,6,4,0,2,4
4252,3,5,2,0,3,2
4252,2,1,1,0,0,1
4252,1,1,1,0,0,1
26233,8,13,4,0,9,4
26233,7,19,2,0,17,2
26233,6,38,6,0,32,6
26233,5,13,2,0,11,2
26233,4,5,1,0,4,1
6038,10,4,1,0,3,1
6038,9,2,1,0,1,1
6038,8,11,8,0,3,8
6038,7,30,8,0,22,8
6038,6,26,7,0,19,7
6038,5,14,4,0,10,4
6038,4,3,2,0,1,2
6038,3,3,1,0,2,1
148074,9,4,3,0,1,3
148074,8,12,2,0,10,2
148074,6,29,4,0,25,4
148074,5,11,2,0,9,2
148074,2,2,1,0,1,1
130841,8,8,1,0,7,1
130841,7,17,3,0,14,3
130841,6,32,6,0,26,6
130841,5,20,3,0,17,3
130841,4,7,1,0,6,1
130841,3,6,3,0,3,3
1699,10,5,2,0,3,2
1699,9,4,3,0,1,3
1699,8,12,3,0,9,3
1699,7,24,8,0,16,8
1699,6,23,8,0,15,8
1699,5,14,4,0,10,4
1699,4,3,2,0,1,2
1699,3,6,3,0,3,3
214343,8,9,2,0,7,2
214343,7,15,3,0,12,3
214343,6,32,8,0,24,8
214343,5,16,3,0,13,3
214343,4,6,1,0,5,1
214343,3,4,2,0,2,2
214343,2,6,2,0,4,2
214343,1,2,1,0,1,1
131389,8,7,1,0,6,1
131389,7,9,4,0,5,4
131389,6,32,9,0,23,9
131389,5,17,3,0,14,3
131389,4,10,4,0,6,4
131389,3,5,2,0,3,2
131389,2,5,4,0,1,4
131389,1,5,3,0,2,3
157979,10,4,4,1,0,3
157979,9,7,1,1,6,0
157979,8,17,5,1,12,4
157979,7,12,3,1,9,2
157979,6,15,3,0,12,3
157979,5,9,5,2,4,3
157979,4,11,6,0,5,6
157979,3,7,5,0,2,5
157979,2,5,2,0,3,2
157979,1,5,3,1,2,2
211734,10,2,1,0,1,1
211734,9,7,1,0,6,1
211734,8,29,7,1,22,6
211734,6,15,2,0,13,2
211734,5,4,1,0,3,1
8089,10,1,1,0,0,1
8089,9,2,2,0,0,2
8089,8,19,10,0,9,10
8089,7,17,13,0,4,13
8089,6,22,8,0,14,8
8089,5,15,3,0,12,3
8089,4,10,7,0,3,7
8089,2,2,2,0,0,2
8089,1,3,3,0,0,3
139042,10,11,3,0,8,3
139042,9,12,5,0,7,5
139042,8,25,2,0,23,2
139042,7,20,3,0,17,3
139042,6,13,2,0,11,2
955,9,5,3,0,2,3
955,8,8,3,0,5,3
955,7,16,6,0,10,6
955,6,32,7,0,25,7
955,5,15,6,0,9,6
955,4,10,7,1,3,6
955,3,2,1,0,1,1
955,2,3,3,0,0,3
232944,8,6,2,0,4,2
232944,7,14,2,0,12,2
232944,6,32,8,0,24,8
232944,5,20,4,0,16,4
232944,4,8,4,0,4,4
232944,3,6,2,0,4,2
232944,2,3,1,0,2,1
69175,9,4,1,0,3,1
69175,8,3,1,0,2,1
69175,7,8,5,0,3,5
69175,6,26,8,0,18,8
69175,5,21,6,0,15,6
69175,3,8,4,0,4,4
38866,7,24,6,0,18,6
38866,6,42,14,0,28,14
38866,5,15,2,0,13,2
38866,4,3,1,0,2,1
38866,3,2,1,0,1,1
38866,2,1,1,0,0,1
5143,10,2,2,0,0,2
5143,9,4,2,0,2,2
5143,8,26,10,0,16,10
5143,7,25,7,0,18,7
5143,6,22,5,0,17,5
5143,5,4,2,0,2,2
5143,4,7,3,0,4,3
5143,3,1,1,0,0,1
5143,2,1,1,0,0,1
76728,10,7,4,0,3,4
76728,9,8,1,0,7,1
76728,8,24,5,0,19,5
76728,7,27,7,0,20,7
76728,6,14,2,0,12,2
76728,5,7,4,0,3,4
24693,9,4,2,0,2,2
24693,8,18,9,0,9,9
24693,7,27,12,0,15,12
24693,6,27,10,0,17,10
24693,5,9,5,0,4,5
24693,4,5,2,0,3,2
24693,2,1,1,0,0,1
41247,10,4,2,0,2,2
41247,9,5,3,0,2,3
41247,8,8,2,0,6,2
41247,7,18,4,0,14,4
41247,6,27,7,0,20,7
41247,5,14,2,0,12,2
41247,4,11,4,0,7,4
41247,3,2,1,0,1,1
41247,2,2,1,0,1,1
232242,10,7,2,0,5,2
232242,9,7,1,0,6,1
232242,8,16,3,0,13,3
232242,7,20,1,0,19,1
232242,6,26,4,0,22,4
232242,5,11,1,0,10,1
232242,4,4,1,0,3,1
193121,8,15,5,0,10,5
193121,7,33,4,0,29,4
193121,6,21,5,0,16,5
193121,5,15,5,0,10,5
193121,4,5,3,0,2,3
108832,8,13,2,0,11,2
108832,7,21,7,0,14,7
108832,6,37,6,0,31,6
108832,5,10,2,0,8,2
108832,4,7,1,0,6,1
25944,9,1,1,0,0,1
25944,7,21,6,0,15,6
25944,6,36,6,0,30,6
25944,5,19,7,0,12,7
25944,4,6,1,0,5,1
25944,2,1,1,0,0,1
25944,1,1,1,0,0,1
140314,10,15,9,2,6,7
140314,9,14,6,2,8,4
140314,8,26,3,2,23,1
140314,7,11,1,0,10,1
140314,6,16,3,1,13,2
140314,4,4,1,0,3,1
215066,9,4,1,0,3,1
215066,8,18,1,0,17,1
215066,7,26,2,0,24,2
215066,6,24,2,0,22,2
215066,4,6,3,0,3,3
89478,10,1,1,0,0,1
89478,8,14,4,0,10,4
89478,7,15,1,0,14,1
89478,6,35,6,0,29,6
89478,4,8,1,0,7,1
89478,3,4,1,0,3,1
4889,10,1,1,0,0,1
4889,9,1,1,0,0,1
4889,8,6,2,0,4,2
4889,7,12,6,0,6,6
4889,6,16,6,0,10,6
4889,5,23,6,0,17,6
4889,4,17,5,0,12,5
4889,3,9,3,0,6,3
4889,2,6,5,0,1,5
4889,1,1,1,0,0,1
174243,10,4,2,0,2,2
174243,9,8,5,1,3,4
174243,8,21,6,1,15,5
174243,7,27,8,1,19,7
174243,6,23,3,1,20,2
174243,5,8,1,0,7,1
104527,7,11,2,0,9,2
104527,6,28,3,0,25,3
104527,5,20,2,0,18,2
104527,4,19,2,0,17,2
104527,3,5,1,0,4,1
104527,2,5,2,0,3,2
104527,1,2,1,0,1,1
5775,7,8,2,0,6,2
5775,6,20,7,0,13,7
5775,5,20,9,0,11,9
5775,4,22,5,0,17,5
5775,3,14,5,0,9,5
5775,2,4,3,0,1,3
5775,1,3,1,0,2,1
406,8,4,1,0,3,1
406,7,13,3,0,10,3
406,6,31,3,0,28,3
406,5,25,4,0,21,4
406,4,12,5,0,7,5
73312,9,3,1,0,2,1
73312,8,14,3,0,11,3
73312,7,24,4,0,20,4
73312,6,30,4,0,26,4
73312,5,12,2,0,10,2
73312,3,3,1,0,2,1
165552,8,5,2,0,3,2
165552,7,13,5,0,8,5
165552,6,34,4,0,30,4
165552,5,17,2,0,15,2
165552,4,13,3,0,10,3
165552,3,6,2,0,4,2
207568,10,18,6,0,12,6
207568,9,32,10,0,22,10
207568,8,21,9,0,12,9
207568,7,13,5,0,8,5
207568,5,2,1,0,1,1
207568,4,1,1,0,0,1
14186,10,5,3,0,2,3
14186,9,6,2,0,4,2
14186,8,14,2,0,12,2
14186,7,26,6,0,20,6
14186,6,25,8,0,17,8
14186,5,9,1,0,8,1
14186,4,7,2,0,5,2
129417,8,7,1,0,6,1
129417,7,32,4,0,28,4
129417,6,30,6,0,24,6
129417,5,8,1,0,7,1
129417,3,3,1,0,2,1
42881,9,5,2,0,3,2
42881,8,13,4,0,9,4
42881,7,22,8,0,14,8
42881,6,32,15,0,17,15
42881,5,12,7,0,5,7
42881,4,5,5,0,0,5
42881,1,1,1,0,0,1
231824,10,4,1,0,3,1
231824,9,7,1,0,6,1
231824,8,19,2,0,17,2
231824,7,14,2,0,12,2
231824,6,27,7,0,20,7
231824,5,9,2,0,7,2
231824,4,5,1,0,4,1
231824,3,4,3,0,1,3
231824,2,3,1,0,2,1
36895,10,1,1,0,0,1
36895,8,5,1,0,4,1
36895,6,21,4,0,17,4
36895,5,25,6,0,19,6
36895,4,18,4,0,14,4
36895,3,6,1,0,5,1
36895,2,6,4,0,2,4
36895,1,2,2,0,0,2
240464,9,13,3,0,10,3
240464,8,42,10,1,32,9
240464,7,24,1,0,23,1
6976,10,4,1,0,3,1
6976,9,17,4,0,13,4
6976,8,18,4,0,14,4
6976,7,26,6,0,20,6
6976,6,18,3,0,15,3
6976,4,3,1,0,2,1
6976,3,1,1,0,0,1
6976,1,1,1,0,0,1
198305,10,8,3,0,5,3
198305,9,2,1,0,1,1
198305,8,2,2,0,0,2
198305,6,34,3,0,31,3
198305,5,13,1,0,12,1
198305,2,4,1,0,3,1
198305,1,1,1,0,0,1
244170,9,8,2,0,6,2
244170,8,30,3,0,27,3
244170,7,22,6,0,16,6
244170,6,19,3,0,16,3
223996,9,10,2,0,8,2
223996,8,32,4,0,28,4
223996,7,21,2,0,19,2
223996,4,6,2,0,4,2
99935,10,7,4,0,3,4
99935,9,9,4,0,5,4
99935,8,25,10,0,15,10
99935,7,20,8,0,12,8
99935,6,22,9,0,13,9
99935,5,6,3,0,3,3
99935,4,3,2,0,1,2
4967,9,4,1,0,3,1
4967,8,12,2,0,10,2
4967,7,20,5,0,15,5
4967,6,27,7,0,20,7
4967,5,17,7,0,10,7
4967,4,6,2,0,4,2
4967,3,3,2,0,1,2
4967,2,3,2,0,1,2
154008,9,1,1,0,0,1
154008,7,10,2,0,8,2
154008,6,33,1,0,32,1
154008,5,17,2,0,15,2
154008,4,17,2,0,15,2
154008,3,5,2,0,3,2
154008,2,4,2,0,2,2
6813,10,3,1,0,2,1
6813,9,4,2,0,2,2
6813,8,17,6,0,11,6
6813,7,25,11,0,14,11
6813,6,30,11,0,19,11
6813,5,5,1,0,4,1
6813,4,7,4,0,3,4
6813,3,1,1,0,0,1
137152,8,2,1,0,1,1
137152,7,19,4,0,15,4
137152,6,23,3,0,20,3
137152,5,22,1,0,21,1
137152,4,15,4,0,11,4
137152,3,7,2,0,5,2
137152,2,2,2,0,0,2
180204,10,4,3,0,1,3
180204,9,9,1,0,8,1
180204,8,45,16,0,29,16
180204,7,20,6,0,14,6
180204,6,8,4,0,4,4
180204,5,4,2,0,2,2
180204,4,1,1,0,0,1
234465,10,6,3,1,3,2
234465,9,4,1,0,3,1
234465,8,10,1,0,9,1
234465,7,23,5,1,18,4
234465,6,21,3,0,18,3
234465,4,9,3,0,6,3
234465,3,4,1,0,3,1
234465,2,4,1,0,3,1
234465,1,1,1,0,0,1
162384,10,4,3,0,1,3
162384,9,4,1,0,3,1
162384,8,34,15,0,19,15
162384,7,31,8,0,23,8
162384,6,15,3,0,12,3
162384,5,2,1,0,1,1
162384,2,1,1,0,0,1
66603,10,1,1,0,0,1
66603,9,2,1,0,1,1
66603,8,3,1,0,2,1
66603,7,8,2,0,6,2
66603,6,31,3,0,28,3
66603,5,20,4,0,16,4
66603,4,12,1,0,11,1
66603,3,9,2,0,7,2
66603,2,5,2,0,3,2
159084,10,1,1,0,0,1
159084,9,2,1,0,1,1
159084,8,13,7,1,6,6
159084,7,9,2,1,7,1
159084,6,22,4,1,18,3
159084,5,15,2,0,13,2
159084,4,14,4,0,10,4
159084,3,7,3,2,4,1
159084,2,7,4,0,3,4
6406,9,1,1,0,0,1
6406,8,5,3,0,2,3
6406,7,12,4,0,8,4
6406,6,35,14,0,21,14
6406,5,22,5,0,17,5
6406,4,10,4,0,6,4
6406,2,3,3,0,0,3
6406,1,2,1,0,1,1
4502,8,11,8,0,3,8
4502,7,5,4,0,1,4
4502,6,35,15,0,20,15
4502,5,15,4,0,11,4
4502,4,12,6,0,6,6
4502,3,6,3,0,3,3
4502,2,7,3,0,4,3
249414,8,2,1,0,1,1
249414,7,8,2,0,6,2
249414,6,37,4,0,33,4
249414,5,21,3,0,18,3
249414,4,11,3,0,8,3
249414,3,8,1,0,7,1
249414,2,4,1,0,3,1
249414,1,1,1,0,0,1
13309,9,1,1,0,0,1
13309,8,4,2,0,2,2
13309,7,13,5,0,8,5
13309,6,22,2,0,20,2
13309,5,21,3,0,18,3
13309,4,18,4,0,14,4
13309,3,10,3,0,7,3
13309,2,1,1,0,0,1
168728,10,10,7,0,3,7
168728,9,4,1,0,3,1
168728,8,9,1,0,8,1
168728,7,16,3,0,13,3
168728,6,24,2,0,22,2
168728,5,5,1,0,4,1
168728,4,8,1,0,7,1
168728,3,6,3,0,3,3
168728,2,6,2,0,4,2
168728,1,4,3,0,1,3
8322,9,1,1,0,0,1
8322,8,17,10,0,7,10
8322,7,14,3,0,11,3
8322,6,32,15,0,17,15
8322,5,14,2,0,12,2
8322,4,10,3,0,7,3
8322,3,3,1,0,2,1
25069,7,18,2,0,16,2
25069,6,32,1,0,31,1
25069,5,15,1,0,14,1
25069,4,12,1,0,11,1
25069,3,6,1,0,5,1
6047,8,12,2,0,10,2
6047,7,10,2,0,8,2
6047,6,28,10,0,18,10
6047,5,24,7,0,17,7
6047,4,8,4,0,4,4
6047,3,3,2,0,1,2
6047,2,3,2,0,1,2
6047,1,3,3,0,0,3
32820,10,6,3,0,3,3
32820,8,16,2,0,14,2
32820,7,15,4,0,11,4
32820,6,25,5,0,20,5
32820,5,11,1,0,10,1
32820,4,9,3,0,6,3
32820,3,3,1,0,2,1
17211,8,4,2,0,2,2
17211,7,5,2,0,3,2
17211,6,24,11,0,13,11
17211,5,20,7,0,13,7
17211,4,16,4,0,12,4
17211,3,13,5,0,8,5
17211,2,7,3,0,4,3
17211,1,2,2,0,0,2
1480,10,1,1,0,0,1
1480,9,1,1,0,0,1
1480,8,4,1,0,3,1
1480,7,17,5,0,12,5
1480,6,30,8,0,22,8
1480,5,14,5,0,9,5
1480,4,11,4,0,7,4
1480,3,8,4,0,4,4
1480,2,6,2,0,4,2
145496,10,11,5,1,6,4
145496,9,4,1,0,3,1
145496,8,18,4,0,14,4
145496,7,18,4,1,14,3
145496,6,12,4,1,8,3
145496,5,15,5,0,10,5
145496,4,4,1,0,3,1
145496,3,3,1,0,2,1
145496,2,3,2,0,1,2
145496,1,4,4,3,0,1
191135,10,12,9,0,3,9
191135,9,10,6,0,4,6
191135,8,21,5,2,16,3
191135,7,16,5,2,11,3
191135,6,10,6,2,4,4
191135,5,8,2,0,6,2
191135,4,7,2,0,5,2
191135,3,5,3,0,2,3
191135,2,1,1,0,0,1
156945,8,38,17,1,21,16
156945,7,26,11,0,15,11
156945,6,15,4,0,11,4
156945,5,5,2,0,3,2
156945,3,2,1,0,1,1
156945,2,1,1,0,0,1
85572,10,8,1,0,7,1
85572,9,21,8,0,13,8
85572,8,31,11,0,20,11
85572,7,14,6,0,8,6
85572,6,9,4,0,5,4
85572,5,1,1,0,0,1
85572,4,3,2,0,1,2
85572,3,2,2,0,0,2
85572,2,1,1,0,0,1
85572,1,1,1,0,0,1
1792,9,6,3,0,3,3
1792,8,22,10,0,12,10
1792,7,20,5,0,15,5
1792,6,23,8,0,15,8
1792,5,12,4,0,8,4
1792,4,4,2,0,2,2
1792,3,2,1,0,1,1
1792,2,1,1,0,0,1
1792,1,1,1,0,0,1
69973,9,4,1,0,3,1
69973,8,14,2,0,12,2
69973,6,32,6,0,26,6
69973,5,8,2,0,6,2
69973,4,10,3,0,7,3
69973,3,5,2,0,3,2
69973,2,3,1,0,2,1
42783,8,31,12,0,19,12
42783,7,22,3,0,19,3
42783,6,23,6,0,17,6
42783,5,8,2,0,6,2
42783,2,1,1,0,0,1
1963,8,4,1,0,3,1
1963,7,6,3,0,3,3
1963,6,14,6,0,8,6
1963,5,29,9,0,20,9
1963,4,12,3,0,9,3
1963,3,13,3,0,10,3
1963,2,9,7,0,2,7
1963,1,3,2,0,1,2
176433,9,2,1,0,1,1
176433,8,12,3,0,9,3
176433,7,17,2,0,15,2
176433,6,32,7,0,25,7
176433,5,15,2,0,13,2
176433,4,8,2,0,6,2
176433,3,2,1,0,1,1
172006,10,10,4,1,6,3
172006,9,7,1,0,6,1
172006,8,26,9,1,17,8
172006,7,23,4,0,19,4
172006,6,12,5,1,7,4
172006,5,5,1,0,4,1
172006,4,4,1,0,3,1
172006,3,3,1,1,2,0
238094,9,12,3,0,9,3
238094,8,44,5,0,39,5
238094,7,19,1,0,18,1
238094,5,3,1,0,2,1
79216,8,11,2,0,9,2
79216,7,20,3,0,17,3
79216,6,26,5,0,21,5
79216,5,20,4,0,16,4
79216,4,6,2,0,4,2
199076,10,20,4,0,16,4
199076,9,23,4,0,19,4
199076,8,22,2,0,20,2
199076,7,17,2,0,15,2
199076,6,2,1,0,1,1
199076,4,3,1,0,2,1
190073,8,17,5,0,12,5
190073,7,18,1,0,17,1
190073,6,19,2,0,17,2
190073,5,11,1,0,10,1
190073,4,5,2,0,3,2
190073,3,5,1,1,4,0
190073,2,4,1,0,3,1
489,8,4,1,0,3,1
489,7,26,9,0,17,9
489,6,43,13,0,30,13
489,5,11,2,0,9,2
489,4,5,2,0,3,2
489,2,1,1,0,0,1
1171,8,9,5,0,4,5
1171,7,24,7,0,17,7
1171,6,21,1,0,20,1
1171,5,19,8,0,11,8
1171,4,9,4,0,5,4
1171,3,3,3,0,0,3
1171,2,4,2,0,2,2
161887,9,3,1,0,2,1
161887,7,18,3,0,15,3
161887,6,26,3,0,23,3
161887,5,11,3,0,8,3
161887,4,14,1,0,13,1
161887,2,3,1,0,2,1
24784,9,2,1,0,1,1
24784,7,23,3,0,20,3
24784,6,27,2,0,25,2
24784,4,10,3,0,7,3
24784,2,2,1,0,1,1
2599,8,5,2,0,3,2
2599,7,17,3,0,14,3
2599,6,36,14,0,22,14
2599,5,18,6,0,12,6
2599,4,9,6,0,3,6
2599,2,2,1,0,1,1
844,8,4,3,0,1,3
844,7,6,2,0,4,2
844,6,20,5,0,15,5
844,5,15,4,0,11,4
844,4,23,11,0,12,11
844,3,8,3,0,5,3
844,2,6,3,0,3,3
844,1,8,7,0,1,7
225977,8,23,4,0,19,4
225977,7,32,6,0,26,6
225977,6,25,5,0,20,5
216600,10,10,2,1,8,1
216600,9,13,5,2,8,3
216600,8,32,7,0,25,7
216600,7,21,5,0,16,5
216600,6,13,5,0,8,5
46669,10,15,6,0,9,6
46669,9,20,10,0,10,10
46669,8,32,9,0,23,9
46669,7,11,1,0,10,1
46669,6,10,6,0,4,6
46669,4,1,1,0,0,1
164655,10,8,4,0,4,4
164655,9,17,9,0,8,9
164655,8,34,13,0,21,13
164655,7,20,8,0,12,8
164655,6,10,3,0,7,3
164655,5,1,1,0,0,1
8063,10,2,2,0,0,2
8063,7,6,2,0,4,2
8063,6,20,7,0,13,7
8063,5,23,6,0,17,6
8063,4,15,9,0,6,9
8063,3,7,3,0,4,3
8063,2,5,4,0,1,4
8063,1,11,5,0,6,5
4593,7,22,7,0,15,7
4593,6,36,14,0,22,14
4593,5,14,5,0,9,5
4593,4,6,2,0,4,2
4593,3,5,3,0,2,3
4593,2,1,1,0,0,1
202942,10,10,4,0,6,4
202942,9,26,5,0,21,5
202942,8,36,12,0,24,12
202942,7,14,8,0,6,8
202942,6,4,2,0,2,2
154515,8,10,1,0,9,1
154515,7,15,1,0,14,1
154515,6,38,4,0,34,4
154515,5,15,3,0,12,3
154515,4,8,2,0,6,2
154515,2,1,1,0,0,1
227888,10,10,2,0,8,2
227888,9,36,7,0,29,7
227888,8,31,4,0,27,4
227888,7,9,2,0,7,2
227888,3,1,1,0,0,1
38637,10,3,3,0,0,3
38637,9,2,2,0,0,2
38637,8,23,14,0,9,14
38637,7,19,13,0,6,13
38637,6,15,9,0,6,9
38637,5,11,4,0,7,4
38637,4,2,2,0,0,2
38637,3,3,1,0,2,1
38637,2,3,2,0,1,2
38637,1,10,3,0,7,3
54559,9,1,1,0,0,1
54559,7,6,3,0,3,3
54559,6,22,3,0,19,3
54559,5,26,5,0,21,5
54559,4,15,3,0,12,3
54559,3,7,2,0,5,2
54559,2,8,4,0,4,4
54559,1,4,3,0,1,3
85563,10,3,2,0,1,2
85563,8,10,1,0,9,1
85563,7,28,6,0,22,6
85563,6,32,12,0,20,12
85563,5,11,3,0,8,3
85563,4,3,2,0,1,2
85563,3,2,1,0,1,1
85563,2,1,1,0,0,1
31117,8,2,1,0,1,1
31117,7,8,3,0,5,3
31117,6,14,2,0,12,2
31117,5,20,5,0,15,5
31117,4,22,6,0,16,6
31117,3,16,6,0,10,6
31117,2,8,4,0,4,4
31117,1,1,1,0,0,1
99976,10,4,2,0,2,2
99976,8,18,5,0,13,5
99976,7,27,3,0,24,3
99976,6,22,2,0,20,2
99976,2,4,3,0,1,3
99976,1,1,1,0,0,1
7834,10,1,1,0,0,1
7834,8,6,4,0,2,4
7834,7,26,12,0,14,12
7834,6,33,12,0,21,12
7834,5,16,6,0,10,6
7834,4,5,2,0,3,2
7834,3,1,1,0,0,1
4276,10,2,1,0,1,1
4276,8,16,10,0,6,10
4276,7,19,8,0,11,8
4276,6,23,9,0,14,9
4276,5,16,4,0,12,4
4276,4,6,3,0,3,3
4276,3,6,3,0,3,3
11694,9,5,1,0,4,1
11694,8,19,8,0,11,8
11694,7,26,7,0,19,7
11694,6,23,9,0,14,9
11694,5,10,3,0,7,3
11694,4,5,4,0,1,4
11694,3,1,1,0,0,1
11694,1,1,1,0,0,1
5400,10,17,6,0,11,6
5400,9,6,2,0,4,2
5400,8,18,9,0,9,9
5400,7,16,8,0,8,8
5400,6,24,4,0,20,4
5400,5,6,3,0,3,3
5400,3,2,1,0,1,1
1712,8,16,3,0,13,3
1712,7,23,6,0,17,6
1712,6,30,5,0,25,5
1712,5,10,4,0,6,4
1712,4,7,2,0,5,2
1712,3,5,3,0,2,3
71402,8,3,2,0,1,2
71402,6,29,9,0,20,9
71402,5,25,6,0,19,6
71402,4,15,3,0,12,3
71402,3,9,5,0,4,5
153510,10,4,2,0,2,2
153510,9,7,2,0,5,2
153510,8,14,7,0,7,7
153510,7,26,5,0,21,5
153510,6,26,4,0,22,4
153510,5,7,2,0,5,2
153510,4,4,1,0,3,1
153510,2,2,1,0,1,1
4291,10,4,1,0,3,1
4291,9,12,4,0,8,4
4291,8,34,10,0,24,10
4291,7,16,4,0,12,4
4291,6,18,4,0,14,4
4291,4,1,1,0,0,1
31623,10,6,2,0,4,2
31623,9,8,1,0,7,1
31623,8,28,10,0,18,10
31623,7,26,6,0,20,6
31623,6,13,1,0,12,1
31623,5,6,1,0,5,1
31623,4,2,1,0,1,1
3932,10,2,1,0,1,1
3932,9,3,1,0,2,1
3932,8,14,6,0,8,6
3932,7,18,9,0,9,9
3932,6,33,8,0,25,8
3932,5,16,5,0,11,5
3932,3,1,1,0,0,1
161882,10,2,2,0,0,2
161882,9,5,2,0,3,2
161882,8,39,15,0,24,15
161882,7,28,10,0,18,10
161882,6,12,4,0,8,4
161882,5,4,1,0,3,1
8757,10,5,3,0,2,3
8757,9,5,3,0,2,3
8757,8,18,11,0,7,11
8757,7,29,7,0,22,7
8757,6,20,5,0,15,5
8757,5,8,2,0,6,2
8757,4,5,1,0,4,1
23292,10,2,1,0,1,1
23292,8,6,1,0,5,1
23292,7,10,3,0,7,3
23292,6,34,5,0,29,5
23292,5,16,3,0,13,3
23292,4,11,4,0,7,4
23292,3,3,1,0,2,1
23292,2,6,3,0,3,3
199086,9,8,2,0,6,2
199086,8,21,3,0,18,3
199086,7,25,4,0,21,4
199086,6,25,10,0,15,10
27668,6,25,3,0,22,3
27668,5,23,3,0,20,3
27668,4,23,6,0,17,6
27668,3,8,3,0,5,3
27668,2,4,1,0,3,1
182952,10,3,1,0,2,1
182952,9,7,2,0,5,2
182952,6,33,4,0,29,4
182952,3,1,1,0,0,1
4119,8,8,2,0,6,2
4119,7,16,6,0,10,6
4119,6,27,8,0,19,8
4119,5,15,4,0,11,4
4119,4,11,7,0,4,7
4119,3,10,4,0,6,4
233206,10,2,2,1,0,1
233206,9,4,1,0,3,1
233206,8,15,3,0,12,3
233206,7,26,5,0,21,5
233206,5,16,1,0,15,1
233206,4,5,2,0,3,2
233206,3,3,1,0,2,1
4357,10,2,1,0,1,1
4357,9,6,2,0,4,2
4357,8,15,8,0,7,8
4357,7,34,7,0,27,7
4357,6,19,3,0,16,3
4357,5,9,1,0,8,1
254189,10,6,2,0,4,2
254189,9,9,3,0,6,3
254189,8,31,9,0,22,9
254189,7,22,3,0,19,3
254189,6,14,3,0,11,3
254189,3,2,2,0,0,2
181694,8,14,5,0,9,5
181694,7,27,2,0,25,2
181694,6,30,3,0,27,3
181694,5,12,2,0,10,2
18499,10,2,1,0,1,1
18499,7,11,3,0,8,3
18499,6,34,4,0,30,4
18499,5,16,2,0,14,2
18499,4,13,2,0,11,2
18499,3,6,2,0,4,2
18499,2,1,1,0,0,1
144958,8,28,9,0,19,9
144958,7,29,8,0,21,8
144958,6,23,10,0,13,10
144958,5,5,2,0,3,2
144958,3,3,2,0,1,2
56022,8,19,6,0,13,6
56022,7,18,4,0,14,4
56022,6,23,9,0,14,9
56022,5,14,3,0,11,3
56022,4,11,9,0,2,9
56022,3,4,2,0,2,2
12266,9,15,6,0,9,6
12266,8,31,7,0,24,7
12266,7,26,4,0,22,4
12266,6,10,4,0,6,4
12266,4,5,2,0,3,2
229244,9,3,1,0,2,1
229244,8,25,3,0,22,3
229244,7,28,5,0,23,5
229244,6,24,3,0,21,3
229244,4,4,1,0,3,1
229244,3,3,2,0,1,2
20146,8,7,1,0,6,1
20146,7,14,2,0,12,2
20146,6,27,6,0,21,6
20146,5,19,6,0,13,6
20146,4,18,3,0,15,3
22233,8,12,2,0,10,2
22233,7,28,9,0,19,9
22233,6,21,6,0,15,6
22233,5,14,3,0,11,3
22233,4,7,2,0,5,2
22233,3,4,3,0,1,3
123162,10,2,1,0,1,1
123162,8,22,7,2,15,5
123162,7,18,7,3,11,4
123162,6,16,5,1,11,4
123162,5,7,1,0,6,1
123162,3,6,1,0,5,1
123162,1,7,4,0,3,4
187056,10,35,7,2,28,5
187056,9,17,4,0,13,4
187056,8,16,5,1,11,4
187056,7,9,3,0,6,3
187056,6,4,1,0,3,1
187056,5,5,1,0,4,1
187056,4,3,1,0,2,1
9961,10,4,3,0,1,3
9961,9,8,3,0,5,3
9961,8,21,11,0,10,11
9961,7,16,7,0,9,7
9961,6,24,9,0,15,9
9961,5,10,5,0,5,5
9961,4,7,3,0,4,3
178655,10,7,1,0,6,1
178655,9,17,4,0,13,4
178655,8,33,13,0,20,13
178655,7,21,6,0,15,6
178655,6,10,3,0,7,3
178655,5,1,1,0,0,1
6210,7,7,2,0,5,2
6210,6,28,11,0,17,11
6210,5,21,5,0,16,5
6210,4,16,3,0,13,3
6210,3,8,4,0,4,4
6210,2,3,2,0,1,2
6210,1,4,3,0,1,3
130705,10,6,1,0,5,1
130705,9,4,1,0,3,1
130705,8,29,6,0,23,6
130705,7,24,7,0,17,7
130705,6,19,5,0,14,5
130705,5,6,2,0,4,2
130705,2,2,1,0,1,1
9251,8,6,1,0,5,1
9251,7,8,2,0,6,2
9251,6,33,5,0,28,5
9251,5,23,8,0,15,8
9251,4,11,5,0,6,5
9251,3,4,1,0,3,1
9251,2,3,2,0,1,2
18498,9,2,1,0,1,1
18498,7,9,5,0,4,5
18498,6,31,13,0,18,13
18498,5,28,9,0,19,9
18498,4,13,6,0,7,6
18498,3,3,1,0,2,1
18498,2,1,1,0,0,1
198087,10,3,1,0,2,1
198087,9,11,2,0,9,2
198087,8,41,13,0,28,13
198087,7,22,6,0,16,6
198087,6,8,7,0,1,7
198087,2,1,1,0,0,1
43489,8,5,2,0,3,2
43489,7,17,7,0,10,7
43489,6,32,11,0,21,11
43489,5,24,5,0,19,5
43489,4,8,3,0,5,3
43489,3,3,1,0,2,1
24009,8,3,1,0,2,1
24009,7,9,2,0,7,2
24009,6,26,7,0,19,7
24009,5,28,7,0,21,7
24009,4,16,5,0,11,5
24009,3,6,3,0,3,3
24009,2,2,2,0,0,2
6086,10,3,1,0,2,1
6086,8,9,7,0,2,7
6086,7,20,3,0,17,3
6086,6,32,6,0,26,6
6086,5,12,1,0,11,1
6086,4,8,3,0,5,3
6086,2,1,1,0,0,1
240624,10,4,2,0,2,2
240624,1,84,31,3,53,28
108341,10,2,2,0,0,2
108341,9,6,3,0,3,3
108341,8,19,7,0,12,7
108341,7,25,7,0,18,7
108341,6,17,4,0,13,4
108341,5,8,3,0,5,3
108341,4,9,3,0,6,3
108341,2,2,1,0,1,1
4519,7,11,5,0,6,5
4519,6,30,4,0,26,4
4519,5,21,4,0,17,4
4519,4,17,7,0,10,7
4519,3,6,1,0,5,1
4519,2,4,3,0,1,3
4519,1,1,1,0,0,1
129307,9,4,1,0,3,1
129307,8,4,2,0,2,2
129307,7,26,7,0,19,7
129307,6,41,15,0,26,15
129307,5,10,5,0,5,5
129307,4,3,3,0,0,3
129307,3,2,2,0,0,2
18788,8,9,2,0,7,2
18788,7,21,4,0,17,4
18788,6,32,9,0,23,9
18788,5,9,2,0,7,2
18788,4,9,2,0,7,2
9079,10,2,1,0,1,1
9079,7,6,2,0,4,2
9079,6,28,2,0,26,2
9079,5,17,1,0,16,1
9079,4,13,2,0,11,2
9079,3,18,6,0,12,6
9079,2,5,1,0,4,1
12141,10,8,3,0,5,3
12141,9,19,6,0,13,6
12141,8,36,7,0,29,7
12141,7,13,3,0,10,3
12141,6,8,2,0,6,2
12141,5,5,1,0,4,1
33599,8,4,2,0,2,2
33599,7,13,5,0,8,5
33599,6,31,8,0,23,8
33599,5,23,10,0,13,10
33599,4,7,3,0,4,3
33599,3,6,1,0,5,1
33599,2,4,2,0,2,2
33599,1,2,1,0,1,1
18011,9,1,1,0,0,1
18011,8,8,3,0,5,3
18011,7,18,7,0,11,7
18011,6,34,9,0,25,9
18011,5,19,7,0,12,7
18011,4,8,3,0,5,3
18011,3,1,1,0,0,1
145897,10,4,1,0,3,1
145897,9,3,1,0,2,1
145897,7,16,4,0,12,4
145897,6,32,6,0,26,6
145897,5,19,4,0,15,4
145897,4,8,2,0,6,2
145897,2,1,1,0,0,1
17062,7,4,3,0,1,3
17062,6,20,9,0,11,9
17062,5,13,4,0,9,4
17062,4,18,7,0,11,7
17062,3,20,8,0,12,8
17062,2,7,4,0,3,4
94949,10,2,1,0,1,1
94949,9,2,1,0,1,1
94949,8,15,5,0,10,5
94949,7,32,12,0,20,12
94949,6,27,12,0,15,12
94949,5,10,5,0,5,5
5573,10,4,1,0,3,1
5573,9,5,1,0,4,1
5573,8,23,4,0,19,4
5573,7,28,6,0,22,6
5573,6,19,6,0,13,6
5573,5,7,2,0,5,2
5573,4,3,1,0,2,1
216497,9,8,3,0,5,3
216497,8,30,8,0,22,8
216497,7,42,8,0,34,8
216497,6,8,2,0,6,2
216497,5,2,2,0,0,2
50458,8,5,1,0,4,1
50458,7,14,4,0,10,4
50458,6,23,5,0,18,5
50458,5,26,4,0,22,4
50458,4,12,2,0,10,2
50458,3,6,1,0,5,1
50458,2,3,1,0,2,1
50458,1,1,1,0,0,1
220861,8,16,9,0,7,9
220861,7,23,7,0,16,7
220861,6,33,3,0,30,3
220861,5,8,2,0,6,2
220861,4,5,1,0,4,1
220861,3,3,2,0,1,2
17995,7,32,3,0,29,3
17995,6,26,3,0,23,3
17995,5,6,1,0,5,1
5997,8,18,11,0,7,11
5997,7,26,15,0,11,15
5997,6,25,5,0,20,5
5997,5,8,3,0,5,3
5997,3,4,2,0,2,2
194577,10,2,1,0,1,1
194577,7,34,2,0,32,2
194577,6,29,2,0,27,2
194577,5,9,1,0,8,1
155245,9,3,2,0,1,2
155245,8,14,6,1,8,5
155245,7,22,3,1,19,2
155245,6,28,8,1,20,7
155245,5,16,4,1,12,3
155245,3,1,1,0,0,1
15173,10,2,2,0,0,2
15173,9,5,1,0,4,1
15173,8,19,6,0,13,6
15173,7,25,4,0,21,4
15173,6,25,5,0,20,5
15173,5,10,1,0,9,1
4121,10,7,4,0,3,4
4121,9,7,6,0,1,6
4121,8,18,5,0,13,5
4121,7,22,7,0,15,7
4121,6,25,6,0,19,6
4121,5,9,1,0,8,1
228603,10,3,1,0,2,1
228603,9,5,1,0,4,1
228603,8,13,4,0,9,4
228603,7,19,4,0,15,4
228603,6,24,7,0,17,7
228603,5,17,4,0,13,4
228603,4,4,1,0,3,1
228603,3,4,1,0,3,1
191128,8,8,3,0,5,3
191128,7,25,2,0,23,2
191128,6,31,4,0,27,4
191128,4,9,1,0,8,1
17245,9,1,1,0,0,1
17245,7,9,3,0,6,3
17245,6,22,7,0,15,7
17245,5,25,9,0,16,9
17245,4,15,4,0,11,4
17245,3,8,4,0,4,4
17245,2,5,2,0,3,2
17245,1,1,1,0,0,1
203800,10,21,3,0,18,3
203800,9,23,8,0,15,8
203800,8,18,6,0,12,6
203800,6,3,1,0,2,1
203800,5,6,4,1,2,3
203800,3,1,1,0,0,1
203800,1,12,6,3,6,3
121295,9,1,1,1,0,0
121295,8,15,3,0,12,3
121295,7,14,3,1,11,2
121295,6,26,5,0,21,5
121295,5,17,3,0,14,3
121295,3,6,1,0,5,1
121295,2,1,1,0,0,1
121295,1,3,2,1,1,1
2402,9,6,3,0,3,3
2402,8,9,5,0,4,5
2402,7,22,8,0,14,8
2402,6,31,13,0,18,13
2402,5,12,8,0,4,8
2402,4,6,4,0,2,4
2402,3,3,2,0,1,2
208023,10,10,1,0,9,1
208023,8,18,3,0,15,3
208023,7,14,1,0,13,1
208023,4,7,1,0,6,1
208023,3,2,1,0,1,1
208023,1,5,2,0,3,2
2100,8,6,1,0,5,1
2100,7,10,3,0,7,3
2100,6,19,1,0,18,1
2100,5,16,3,0,13,3
2100,4,17,2,0,15,2
2100,3,13,4,0,9,4
5516,9,8,3,0,5,3
5516,8,29,13,0,16,13
5516,7,20,4,0,16,4
5516,6,17,2,0,15,2
5516,4,7,1,0,6,1
21769,9,12,8,0,4,8
21769,8,24,7,0,17,7
21769,7,21,9,0,12,9
21769,6,15,3,0,12,3
21769,5,7,6,0,1,6
21769,4,5,4,0,1,4
3276,9,2,2,0,0,2
3276,8,8,1,0,7,1
3276,7,16,5,0,11,5
3276,6,24,12,0,12,12
3276,5,20,6,0,14,6
3276,4,8,3,0,5,3
3276,3,7,5,0,2,5
3276,2,3,1,0,2,1
80836,10,2,1,0,1,1
80836,9,4,2,0,2,2
80836,7,19,3,0,16,3
80836,6,16,2,0,14,2
80836,5,14,2,0,12,2
80836,4,8,5,0,3,5
80836,3,7,3,0,4,3
80836,2,9,6,0,3,6
80836,1,7,6,0,1,6
6578,10,6,1,0,5,1
6578,8,8,2,0,6,2
6578,7,15,5,0,10,5
6578,6,18,1,0,17,1
6578,5,19,4,0,15,4
6578,4,3,1,0,2,1
6578,3,7,2,0,5,2
6578,2,7,2,0,5,2
151640,10,4,1,0,3,1
151640,9,8,3,0,5,3
151640,8,12,3,0,9,3
151640,7,17,1,0,16,1
151640,6,17,5,0,12,5
151640,5,12,4,1,8,3
151640,4,5,1,0,4,1
151640,3,9,2,0,7,2
151640,2,3,1,0,2,1
251622,8,7,2,0,5,2
251622,7,22,2,0,20,2
251622,6,27,2,0,25,2
251622,5,18,6,0,12,6
251622,4,7,2,0,5,2
251622,3,4,1,0,3,1
251622,2,4,1,0,3,1
184473,8,10,2,0,8,2
184473,7,12,5,0,7,5
184473,6,24,5,0,19,5
184473,5,12,2,0,10,2
184473,4,14,6,0,8,6
184473,3,9,2,0,7,2
184473,2,3,1,0,2,1
184473,1,3,1,0,2,1
20810,10,1,1,0,0,1
20810,8,5,1,0,4,1
20810,7,10,2,0,8,2
20810,6,40,5,0,35,5
20810,5,19,6,0,13,6
20810,4,9,3,0,6,3
20810,1,1,1,0,0,1
72622,8,8,4,0,4,4
72622,7,11,4,0,7,4
72622,6,33,15,0,18,15
72622,5,22,10,0,12,10
72622,4,11,3,0,8,3
72622,3,1,1,0,0,1
72622,2,1,1,0,0,1
72622,1,1,1,0,0,1
34238,10,10,3,0,7,3
34238,9,5,2,0,3,2
34238,8,21,11,0,10,11
34238,7,26,15,0,11,15
34238,6,5,1,0,4,1
34238,5,9,4,0,5,4
34238,4,7,2,0,5,2
34238,3,2,1,0,1,1
34238,2,4,1,0,3,1
139236,10,6,5,0,1,5
139236,9,7,4,1,3,3
139236,8,11,4,0,7,4
139236,7,17,9,0,8,9
139236,6,24,10,0,14,10
139236,5,13,2,0,11,2
139236,4,8,6,0,2,6
139236,1,1,1,0,0,1
24658,9,4,3,0,1,3
24658,8,9,2,0,7,2
24658,7,14,2,0,12,2
24658,6,19,3,0,16,3
24658,5,19,3,0,16,3
24658,4,14,2,0,12,2
24658,3,4,1,0,3,1
24658,2,4,1,0,3,1
24658,1,1,1,0,0,1
145470,9,6,1,0,5,1
145470,8,28,4,0,24,4
145470,7,20,1,0,19,1
145470,6,19,2,0,17,2
158971,8,11,3,0,8,3
158971,7,31,4,0,27,4
158971,6,29,6,0,23,6
158971,5,9,1,0,8,1
158971,4,4,1,0,3,1
4049,8,6,2,0,4,2
4049,7,18,5,0,13,5
4049,6,32,7,0,25,7
4049,5,17,8,0,9,8
4049,4,11,3,0,8,3
4049,3,3,2,0,1,2
8327,8,6,5,0,1,5
8327,7,6,2,0,4,2
8327,6,14,6,0,8,6
8327,5,23,3,0,20,3
8327,4,13,3,0,10,3
8327,3,16,8,0,8,8
8327,2,5,2,0,3,2
8327,1,5,5,0,0,5
133620,8,14,3,0,11,3
133620,7,23,6,0,17,6
133620,6,31,3,0,28,3
133620,5,10,1,0,9,1
133620,4,7,2,0,5,2
133620,3,4,2,0,2,2
20043,9,5,3,0,2,3
20043,8,20,9,0,11,9
20043,7,11,6,0,5,6
20043,6,25,5,0,20,5
20043,5,13,4,0,9,4
20043,4,8,2,0,6,2
20043,2,5,3,0,2,3
76443,10,2,2,0,0,2
76443,9,2,2,0,0,2
76443,8,8,2,0,6,2
76443,7,14,6,0,8,6
76443,6,23,6,0,17,6
76443,5,14,5,0,9,5
76443,4,10,4,0,6,4
76443,3,10,5,0,5,5
76443,2,4,1,0,3,1
1310,9,2,1,0,1,1
1310,8,10,1,0,9,1
1310,7,12,4,0,8,4
1310,6,28,5,0,23,5
1310,5,27,5,0,22,5
1310,4,8,3,0,5,3
142333,9,3,2,0,1,2
142333,8,19,5,0,14,5
142333,7,26,9,1,17,8
142333,6,27,6,0,21,6
142333,5,9,1,0,8,1
142333,4,3,1,0,2,1
142333,1,1,1,1,0,0
181245,9,2,1,0,1,1
181245,8,8,3,0,5,3
181245,7,14,2,0,12,2
181245,6,26,4,0,22,4
181245,4,10,2,0,8,2
181245,3,7,4,0,3,4
181245,2,5,2,0,3,2
1941,9,2,2,0,0,2
1941,8,9,2,0,7,2
1941,7,9,1,0,8,1
1941,6,23,7,0,16,7
1941,5,18,5,0,13,5
1941,4,16,7,0,9,7
1941,3,8,5,0,3,5
1941,2,3,1,0,2,1
129322,10,4,1,0,3,1
129322,9,3,2,0,1,2
129322,8,11,7,0,4,7
129322,7,13,4,0,9,4
129322,6,27,9,0,18,9
129322,5,13,5,0,8,5
129322,4,12,1,0,11,1
4580,8,5,2,0,3,2
4580,7,13,4,0,9,4
4580,6,33,7,0,26,7
4580,5,20,1,0,19,1
4580,4,9,1,0,8,1
1635,10,3,1,0,2,1
1635,9,12,4,0,8,4
1635,8,16,8,0,8,8
1635,7,21,9,0,12,9
1635,6,18,6,0,12,6
1635,5,13,5,0,8,5
1635,4,4,1,0,3,1
69761,9,3,2,0,1,2
69761,8,8,2,0,6,2
69761,7,26,8,0,18,8
69761,6,22,8,0,14,8
69761,5,13,5,0,8,5
69761,4,8,2,0,6,2
69761,3,4,2,0,2,2
69761,2,2,1,0,1,1
215436,10,7,1,0,6,1
215436,9,9,1,0,8,1
215436,7,18,3,0,15,3
215436,6,20,3,0,17,3
215436,5,4,1,0,3,1
215436,4,4,1,0,3,1
5903,8,7,3,0,4,3
5903,7,8,4,0,4,4
5903,6,24,7,0,17,7
5903,5,12,2,0,10,2
5903,4,17,6,0,11,6
5903,3,12,7,0,5,7
5903,2,3,1,0,2,1
5903,1,5,1,0,4,1
9710,9,1,1,0,0,1
9710,8,2,1,0,1,1
9710,7,10,2,0,8,2
9710,6,38,16,0,22,16
9710,5,20,4,0,16,4
9710,4,11,3,0,8,3
9710,2,2,1,0,1,1
89569,10,3,1,0,2,1
89569,9,2,2,0,0,2
89569,8,10,1,0,9,1
89569,7,15,4,0,11,4
89569,6,17,2,0,15,2
89569,5,16,2,0,14,2
89569,4,9,2,0,7,2
89569,3,7,5,0,2,5
89569,2,8,4,0,4,4
89569,1,2,1,0,1,1
164670,8,10,3,0,7,3
164670,7,23,3,0,20,3
164670,6,24,3,0,21,3
164670,5,19,2,0,17,2
164670,4,7,2,0,5,2
164670,2,1,1,0,0,1
28298,8,6,1,0,5,1
28298,7,7,1,0,6,1
28298,6,31,9,0,22,9
28298,5,21,6,0,15,6
28298,4,10,2,0,8,2
28298,3,7,4,0,3,4
12920,10,1,1,0,0,1
12920,8,6,1,0,5,1
12920,7,13,2,0,11,2
12920,6,24,6,0,18,6
12920,5,23,8,0,15,8
12920,4,15,3,0,12,3
12920,3,5,2,0,3,2
95128,10,3,2,0,1,2
95128,9,4,3,0,1,3
95128,8,9,2,2,7,0
95128,6,24,8,2,16,6
95128,5,14,5,0,9,5
95128,4,12,3,1,9,2
95128,3,7,4,0,3,4
95128,2,8,5,1,3,4
848,8,11,3,0,8,3
848,7,17,5,0,12,5
848,6,26,3,0,23,3
848,5,18,4,0,14,4
848,4,6,1,0,5,1
848,3,5,1,0,4,1
98189,7,17,2,0,15,2
98189,6,29,3,0,26,3
98189,5,20,2,0,18,2
98189,4,12,1,0,11,1
98189,1,2,1,0,1,1
5751,10,1,1,0,0,1
5751,9,8,3,0,5,3
5751,8,30,13,0,17,13
5751,7,24,5,0,19,5
5751,6,19,4,0,15,4
5751,5,4,1,0,3,1
146104,8,4,2,0,2,2
146104,7,13,5,0,8,5
146104,6,27,5,0,22,5
146104,5,23,7,0,16,7
146104,4,15,4,0,11,4
146104,1,3,1,0,2,1
261262,8,16,4,0,12,4
261262,7,28,5,0,23,5
261262,6,25,6,0,19,6
261262,5,16,6,0,10,6
191043,10,15,1,0,14,1
191043,8,8,1,0,7,1
191043,7,8,2,0,6,2
191043,6,22,5,0,17,5
191043,5,12,3,0,9,3
191043,4,9,1,0,8,1
191043,3,3,1,0,2,1
191043,2,4,2,0,2,2
191043,1,4,3,0,1,3
171708,10,4,1,0,3,1
171708,9,6,2,0,4,2
171708,8,24,11,1,13,10
171708,7,19,6,0,13,6
171708,6,21,11,0,10,11
171708,5,5,2,0,3,2
171708,4,7,3,0,4,3
171708,3,2,2,0,0,2
81698,10,8,4,0,4,4
81698,9,7,1,0,6,1
81698,8,18,2,0,16,2
81698,7,16,4,0,12,4
81698,6,25,6,0,19,6
81698,5,9,1,0,8,1
81698,4,3,2,0,1,2
81698,2,1,1,0,0,1
81698,1,2,2,0,0,2
165796,8,6,1,0,5,1
165796,7,12,2,0,10,2
165796,6,35,3,0,32,3
165796,5,19,4,0,15,4
165796,4,7,1,0,6,1
165796,2,3,2,0,1,2
603,7,13,4,0,9,4
603,6,28,4,0,24,4
603,5,16,2,0,14,2
603,4,11,3,0,8,3
603,3,10,3,0,7,3
168792,10,8,3,0,5,3
168792,9,6,2,0,4,2
168792,8,28,9,0,19,9
168792,7,21,5,0,16,5
168792,6,12,3,0,9,3
168792,5,6,2,0,4,2
168792,4,3,1,0,2,1
168792,3,3,2,0,1,2
168792,1,2,1,0,1,1
173389,10,4,1,0,3,1
173389,7,19,7,0,12,7
173389,6,31,5,0,26,5
173389,5,14,1,0,13,1
173389,4,9,2,0,7,2
173389,3,6,2,0,4,2
173389,2,2,1,0,1,1
129290,8,9,1,1,8,0
129290,7,17,1,0,16,1
129290,6,29,5,0,24,5
129290,5,13,3,0,10,3
129290,4,8,1,1,7,0
129290,2,3,2,0,1,2
256442,9,7,1,0,6,1
256442,8,41,8,0,33,8
256442,7,24,1,0,23,1
256442,6,10,2,0,8,2
256442,5,4,2,0,2,2
1981,7,15,1,0,14,1
1981,6,42,10,0,32,10
1981,5,15,4,0,11,4
1981,4,8,2,0,6,2
1981,3,7,3,0,4,3
160517,10,2,1,0,1,1
160517,9,4,1,0,3,1
160517,8,13,1,0,12,1
160517,7,15,4,0,11,4
160517,6,32,5,0,27,5
160517,5,11,1,0,10,1
160517,3,4,1,0,3,1
160517,2,4,1,0,3,1
19372,10,2,1,0,1,1
19372,9,3,1,0,2,1
19372,8,15,5,0,10,5
19372,7,19,6,0,13,6
19372,6,23,7,0,16,7
19372,5,16,6,0,10,6
19372,4,4,2,0,2,2
19372,2,5,3,0,2,3
69292,8,6,3,0,3,3
69292,7,17,5,0,12,5
69292,6,24,9,0,15,9
69292,5,16,4,0,12,4
69292,4,12,5,0,7,5
69292,3,3,2,0,1,2
69292,2,4,1,0,3,1
69292,1,2,1,0,1,1
1907,10,5,3,0,2,3
1907,9,5,1,0,4,1
1907,8,16,10,0,6,10
1907,7,16,10,0,6,10
1907,6,30,7,0,23,7
1907,5,10,6,0,4,6
1907,4,4,2,0,2,2
1907,3,2,2,0,0,2
55896,8,25,10,0,15,10
55896,7,17,7,0,10,7
55896,6,27,9,0,18,9
55896,5,8,4,0,4,4
55896,4,5,2,0,3,2
55896,3,5,2,0,3,2
7189,9,1,1,0,0,1
7189,8,6,2,0,4,2
7189,7,13,6,0,7,6
7189,6,26,11,0,15,11
7189,5,26,7,0,19,7
7189,4,9,4,0,5,4
7189,3,7,2,0,5,2
7189,2,1,1,0,0,1
32245,10,2,1,0,1,1
32245,8,7,1,0,6,1
32245,6,29,5,0,24,5
32245,5,16,4,0,12,4
32245,4,10,2,0,8,2
32245,3,6,1,0,5,1
56406,8,6,1,0,5,1
56406,6,34,2,0,32,2
56406,5,13,3,0,10,3
56406,4,16,3,0,13,3
56406,3,2,1,0,1,1
56406,2,3,1,0,2,1
244795,9,4,2,0,2,2
244795,8,22,4,0,18,4
244795,7,34,7,0,27,7
244795,6,18,5,0,13,5
244795,5,7,1,0,6,1
244795,4,4,1,0,3,1
13817,10,5,1,0,4,1
13817,9,3,2,0,1,2
13817,8,5,3,0,2,3
13817,7,9,2,0,7,2
13817,6,15,6,0,9,6
13817,5,18,5,0,13,5
13817,4,16,4,0,12,4
13817,3,9,6,0,3,6
13817,2,4,2,0,2,2
36973,7,6,2,0,4,2
36973,6,18,3,0,15,3
36973,5,17,4,0,13,4
36973,4,23,4,0,19,4
36973,3,13,4,0,9,4
36973,2,6,3,0,3,3
36973,1,5,3,0,2,3
32683,8,6,3,0,3,3
32683,7,18,3,0,15,3
32683,6,21,7,0,14,7
32683,5,16,3,0,13,3
32683,4,19,2,0,17,2
32683,3,5,2,0,3,2
32683,2,3,1,0,2,1
140236,9,8,3,0,5,3
140236,8,26,9,2,17,7
140236,7,16,5,0,11,5
140236,6,20,4,0,16,4
140236,5,10,3,0,7,3
140236,3,1,1,0,0,1
60228,9,8,6,0,2,6
60228,8,28,9,0,19,9
60228,7,24,4,0,20,4
60228,6,15,3,0,12,3
60228,5,7,4,0,3,4
60228,4,3,2,0,1,2
60228,2,1,1,0,0,1
165022,10,2,1,0,1,1
165022,9,10,4,0,6,4
165022,8,25,5,0,20,5
165022,7,22,5,0,17,5
165022,6,21,5,0,16,5
165022,3,1,1,0,0,1
60464,9,6,1,0,5,1
60464,8,15,1,0,14,1
60464,7,18,1,0,17,1
60464,6,25,4,0,21,4
60464,3,6,1,0,5,1
60464,2,2,1,0,1,1
60464,1,3,1,0,2,1
187587,8,30,6,0,24,6
187587,7,27,4,0,23,4
187587,6,21,7,0,14,7
187587,5,2,1,0,1,1
17132,9,2,2,0,0,2
17132,8,14,2,0,12,2
17132,7,29,7,0,22,7
17132,6,28,10,0,18,10
17132,5,9,2,0,7,2
17132,4,5,4,0,1,4
6914,9,7,3,0,4,3
6914,8,17,7,0,10,7
6914,7,17,7,0,10,7
6914,6,22,7,0,15,7
6914,5,3,1,0,2,1
6914,4,3,1,0,2,1
6914,2,1,1,0,0,1
222531,10,14,3,0,11,3
222531,9,16,5,0,11,5
222531,8,38,10,2,28,8
222531,7,11,1,0,10,1
222531,5,2,1,0,1,1
222531,4,2,1,0,1,1
222531,2,1,1,0,0,1
253763,8,12,3,1,9,2
253763,7,21,8,1,13,7
253763,6,31,6,2,25,4
253763,5,10,3,0,7,3
248065,10,41,12,1,29,11
248065,9,9,3,1,6,2
248065,7,6,1,0,5,1
248065,4,2,1,0,1,1
248065,3,1,1,0,0,1
248065,1,16,9,2,7,7
102151,10,1,1,0,0,1
102151,9,3,1,0,2,1
102151,8,18,9,0,9,9
102151,7,26,14,0,12,14
102151,6,21,10,0,11,10
102151,5,9,3,0,6,3
102151,4,5,3,0,2,3
102151,3,3,2,0,1,2
102151,2,2,2,0,0,2
234373,9,8,3,0,5,3
234373,8,13,2,0,11,2
234373,7,25,5,0,20,5
234373,6,24,4,0,20,4
234373,5,10,1,0,9,1
9559,10,4,2,0,2,2
9559,8,4,2,0,2,2
9559,7,14,5,0,9,5
9559,6,21,7,0,14,7
9559,5,10,4,0,6,4
9559,4,21,4,0,17,4
9559,2,7,4,0,3,4
35585,6,26,8,0,18,8
35585,5,25,4,0,21,4
35585,4,17,8,0,9,8
35585,3,11,3,0,8,3
35585,2,2,1,0,1,1
35585,1,1,1,0,0,1
7033,10,2,1,0,1,1
7033,9,2,1,0,1,1
7033,8,11,6,0,5,6
7033,7,26,3,0,23,3
7033,6,28,8,0,20,8
7033,5,11,2,0,9,2
7033,4,8,3,0,5,3
240108,10,2,1,0,1,1
240108,9,3,2,0,1,2
240108,8,11,4,0,7,4
240108,7,19,4,1,15,3
240108,6,29,6,1,23,5
240108,5,14,3,1,11,2
240108,4,6,1,0,5,1
240108,3,3,1,0,2,1
240108,1,1,1,0,0,1
10267,10,4,1,0,3,1
10267,9,2,1,0,1,1
10267,8,9,5,0,4,5
10267,7,23,5,0,18,5
10267,6,30,11,0,19,11
10267,5,10,4,0,6,4
10267,4,5,2,0,3,2
10267,3,3,2,0,1,2
71956,9,4,1,0,3,1
71956,8,17,5,0,12,5
71956,7,17,5,0,12,5
71956,6,31,3,0,28,3
71956,5,12,3,0,9,3
71956,3,2,2,0,0,2
71956,2,3,3,0,0,3
3078,10,3,2,0,1,2
3078,9,7,4,0,3,4
3078,8,19,10,0,9,10
3078,7,23,10,0,13,10
3078,6,16,8,0,8,8
3078,5,14,3,0,11,3
3078,4,6,4,0,2,4
207883,10,8,4,1,4,3
207883,9,6,3,1,3,2
207883,8,16,3,0,13,3
207883,7,22,1,0,21,1
207883,6,22,4,1,18,3
207883,5,6,1,0,5,1
207883,3,2,1,0,1,1
207883,2,2,1,0,1,1
154,10,3,1,0,2,1
154,9,7,4,0,3,4
154,8,21,7,0,14,7
154,7,19,9,0,10,9
154,6,25,13,0,12,13
154,5,7,2,0,5,2
154,3,2,1,0,1,1
8424,10,2,1,0,1,1
8424,9,5,2,0,3,2
8424,8,11,5,0,6,5
8424,7,19,7,0,12,7
8424,6,22,9,0,13,9
8424,5,17,1,0,16,1
8424,4,7,1,0,6,1
8424,3,2,1,0,1,1
8424,1,3,2,0,1,2
233361,10,32,21,0,11,21
233361,9,26,9,0,17,9
233361,8,22,6,0,16,6
233361,7,4,3,0,1,3
233361,6,3,1,0,2,1
182954,10,5,2,0,3,2
182954,9,6,1,0,5,1
182954,8,19,2,0,17,2
182954,7,21,3,0,18,3
182954,6,28,2,0,26,2
182954,3,1,1,0,0,1
172307,6,23,3,0,20,3
172307,5,22,1,0,21,1
172307,4,14,1,0,13,1
172307,3,8,3,0,5,3
172307,2,11,3,0,8,3
172064,8,4,1,0,3,1
172064,7,13,2,0,11,2
172064,6,32,2,0,30,2
172064,5,20,6,0,14,6
172064,4,12,2,0,10,2
172064,3,5,1,0,4,1
262201,10,57,7,0,50,7
262201,9,15,2,0,13,2
262201,8,10,1,0,9,1
262201,7,2,1,0,1,1
262201,1,2,1,0,1,1
98857,8,6,1,0,5,1
98857,7,9,5,0,4,5
98857,6,33,7,0,26,7
98857,5,18,8,0,10,8
98857,4,14,4,0,10,4
98857,3,3,1,0,2,1
98857,2,3,1,0,2,1
166858,10,1,1,0,0,1
166858,9,5,2,0,3,2
166858,8,23,8,0,15,8
166858,7,26,4,0,22,4
166858,6,21,10,0,11,10
166858,5,8,2,0,6,2
166858,4,1,1,0,0,1
166858,2,1,1,0,0,1
80296,8,8,3,0,5,3
80296,7,14,3,0,11,3
80296,6,31,5,0,26,5
80296,5,20,3,0,17,3
80296,4,9,3,0,6,3
166710,8,15,4,1,11,3
166710,7,11,3,0,8,3
166710,6,39,13,2,26,11
166710,5,11,2,0,9,2
166710,4,5,1,0,4,1
166710,3,3,1,1,2,0
81826,8,24,12,0,12,12
81826,7,26,11,0,15,11
81826,6,20,6,0,14,6
81826,5,11,3,0,8,3
81826,4,5,1,0,4,1
103843,10,1,1,0,0,1
103843,8,7,2,0,5,2
103843,7,21,10,0,11,10
103843,6,28,6,0,22,6
103843,5,16,5,0,11,5
103843,4,5,1,0,4,1
103843,3,5,1,0,4,1
103843,1,1,1,0,0,1
56604,9,4,1,0,3,1
56604,8,18,2,0,16,2
56604,7,17,1,0,16,1
229965,10,5,3,0,2,3
229965,9,10,4,1,6,3
229965,8,21,7,0,14,7
229965,7,25,2,0,23,2
229965,6,22,7,2,15,5
229965,5,3,1,0,2,1
229965,3,2,1,0,1,1
8110,10,1,1,0,0,1
8110,9,1,1,0,0,1
8110,8,9,2,0,7,2
8110,7,23,8,0,15,8
8110,6,33,11,0,22,11
8110,5,12,4,0,8,4
8110,4,6,3,0,3,3
8110,3,3,1,0,2,1
149322,7,15,1,0,14,1
149322,6,24,3,0,21,3
149322,5,17,3,0,14,3
149322,4,12,4,0,8,4
149322,3,6,2,0,4,2
149322,2,3,2,0,1,2
234438,10,12,3,0,9,3
234438,9,14,4,0,10,4
234438,8,31,5,1,26,4
234438,7,16,4,0,12,4
234438,6,7,1,0,6,1
234438,5,3,1,0,2,1
234438,4,2,1,0,1,1
10960,9,3,1,0,2,1
10960,8,5,1,0,4,1
10960,7,14,5,0,9,5
10960,6,23,6,0,17,6
10960,5,19,6,0,13,6
10960,4,15,5,0,10,5
10960,3,6,2,0,4,2
10960,2,2,1,0,1,1
10960,1,1,1,0,0,1
138484,9,3,2,2,1,0
138484,8,10,2,1,8,1
138484,7,20,7,1,13,6
138484,6,36,5,2,31,3
138484,5,7,1,0,6,1
138484,4,5,2,0,3,2
138484,3,3,1,1,2,0
5162,10,2,1,0,1,1
5162,8,12,4,0,8,4
5162,7,13,2,0,11,2
5162,6,39,6,0,33,6
5162,5,10,3,0,7,3
5162,4,10,6,0,4,6
236365,9,5,1,0,4,1
236365,8,7,1,0,6,1
236365,7,17,2,0,15,2
236365,6,27,5,0,22,5
236365,5,16,2,0,14,2
236365,4,6,2,0,4,2
236365,3,6,2,0,4,2
236365,2,1,1,1,0,0
563,9,2,1,0,1,1
563,8,11,4,0,7,4
563,7,24,5,0,19,5
563,6,29,7,0,22,7
563,5,14,3,0,11,3
563,4,6,2,0,4,2
90375,8,9,2,0,7,2
90375,7,17,1,0,16,1
90375,6,36,7,0,29,7
90375,5,14,1,0,13,1
137348,7,4,1,0,3,1
137348,6,9,3,0,6,3
137348,5,9,2,0,7,2
137348,3,13,6,1,7,5
137348,2,9,1,0,8,1
137348,1,24,15,0,9,15
108429,10,6,2,0,4,2
108429,9,11,5,0,6,5
108429,8,23,3,0,20,3
108429,7,18,3,0,15,3
108429,6,21,9,0,12,9
108429,5,2,2,0,0,2
108429,4,4,3,0,1,3
1004,8,10,5,0,5,5
1004,7,17,1,0,16,1
1004,6,31,5,0,26,5
1004,5,21,3,0,18,3
1004,3,4,1,0,3,1
136890,10,9,1,0,8,1
136890,9,14,3,0,11,3
136890,8,29,12,0,17,12
136890,7,22,7,0,15,7
136890,6,10,2,0,8,2
136890,4,1,1,0,0,1
136890,2,1,1,0,0,1
169366,10,15,7,0,8,7
169366,9,15,6,0,9,6
169366,8,34,15,0,19,15
169366,7,12,6,0,6,6
169366,6,7,2,0,5,2
169366,5,3,1,0,2,1
6937,10,5,1,0,4,1
6937,9,7,1,0,6,1
6937,8,22,3,0,19,3
6937,7,15,5,0,10,5
6937,6,27,4,0,23,4
6937,4,4,1,0,3,1
6937,3,1,1,0,0,1
17708,7,6,2,0,4,2
17708,6,15,3,0,12,3
17708,5,27,10,0,17,10
17708,4,20,12,0,8,12
17708,3,11,6,0,5,6
17708,2,4,1,0,3,1
17708,1,5,3,0,2,3
7487,10,4,3,0,1,3
7487,9,2,1,0,1,1
7487,8,13,1,0,12,1
7487,7,27,7,0,20,7
7487,6,28,4,0,24,4
7487,5,7,2,0,5,2
7487,4,6,2,0,4,2
177245,8,18,5,1,13,4
177245,7,29,9,1,20,8
177245,6,20,5,1,15,4
177245,5,8,2,0,6,2
177245,4,7,1,0,6,1
6764,9,1,1,0,0,1
6764,6,8,3,0,5,3
6764,5,30,8,0,22,8
6764,4,17,5,0,12,5
6764,3,15,6,0,9,6
6764,2,11,3,0,8,3
138748,8,3,2,0,1,2
138748,7,12,3,0,9,3
138748,6,28,7,0,21,7
138748,5,21,2,0,19,2
138748,4,15,1,0,14,1
138748,3,2,1,0,1,1
138748,2,2,1,0,1,1
266121,10,12,1,0,11,1
266121,9,24,2,0,22,2
266121,8,34,2,0,32,2
266121,6,5,1,0,4,1
217098,10,3,1,0,2,1
217098,9,6,2,0,4,2
217098,8,26,3,0,23,3
217098,7,21,1,0,20,1
217098,6,20,2,0,18,2
217098,5,7,2,0,5,2
217098,4,4,1,0,3,1
256478,9,2,1,0,1,1
256478,8,17,4,0,13,4
256478,7,34,5,0,29,5
256478,6,28,2,0,26,2
256478,3,3,1,0,2,1
21703,9,4,1,0,3,1
21703,8,15,2,0,13,2
21703,7,31,11,0,20,11
21703,6,22,8,0,14,8
21703,5,7,2,0,5,2
21703,4,6,3,0,3,3
21703,3,2,1,0,1,1
155314,9,3,2,0,1,2
155314,8,15,3,0,12,3
155314,7,29,5,0,24,5
155314,6,22,6,0,16,6
155314,4,5,1,0,4,1
1173,8,12,4,0,8,4
1173,7,13,5,0,8,5
1173,6,26,4,0,22,4
1173,5,16,1,0,15,1
1173,4,6,2,0,4,2
1173,3,6,2,0,4,2
1173,2,4,2,0,2,2
39552,7,8,2,0,6,2
39552,6,32,13,0,19,13
39552,5,19,3,0,16,3
39552,4,16,5,0,11,5
39552,3,5,2,0,3,2
39552,2,1,1,0,0,1
39552,1,2,1,0,1,1
8970,8,3,1,0,2,1
8970,7,9,3,0,6,3
8970,6,19,5,0,14,5
8970,5,30,13,0,17,13
8970,4,13,1,0,12,1
8970,3,9,2,0,7,2
8970,2,2,1,0,1,1
154674,10,8,5,1,3,4
154674,9,4,3,0,1,3
154674,8,19,3,0,16,3
154674,7,13,3,0,10,3
154674,6,18,1,0,17,1
154674,5,11,3,1,8,2
154674,4,7,4,0,3,4
154674,3,5,2,0,3,2
154674,1,2,2,0,0,2
192353,7,14,5,0,9,5
192353,6,27,7,0,20,7
192353,5,17,4,0,13,4
192353,4,14,3,0,11,3
192353,3,8,2,0,6,2
249404,10,5,2,1,3,1
249404,9,5,3,0,2,3
249404,8,24,4,0,20,4
249404,7,28,3,0,25,3
249404,6,17,2,0,15,2
14990,8,4,1,0,3,1
14990,6,25,5,0,20,5
14990,5,28,2,0,26,2
14990,4,10,2,0,8,2
14990,3,9,1,0,8,1
14990,1,2,2,0,0,2
250781,10,4,1,0,3,1
250781,9,6,1,0,5,1
250781,8,17,3,0,14,3
250781,7,24,7,0,17,7
250781,6,21,1,0,20,1
250781,5,9,1,0,8,1
250781,2,1,1,0,0,1
3358,8,3,1,0,2,1
3358,7,21,9,0,12,9
3358,6,36,10,0,26,10
3358,5,14,2,0,12,2
3358,4,11,4,0,7,4
3358,3,1,1,0,0,1
9237,10,3,1,0,2,1
9237,9,9,6,0,3,6
9237,8,27,11,0,16,11
9237,7,26,5,0,21,5
9237,6,15,4,0,11,4
9237,5,6,1,0,5,1
112840,8,7,1,0,6,1
112840,7,14,2,0,12,2
112840,6,39,7,0,32,7
112840,5,14,3,0,11,3
112840,4,8,3,0,5,3
162391,8,20,4,0,16,4
162391,7,31,2,0,29,2
162391,5,11,1,0,10,1
26468,10,5,1,0,4,1
26468,9,6,3,0,3,3
26468,8,27,7,0,20,7
26468,7,23,8,0,15,8
26468,6,17,2,0,15,2
26468,5,5,2,0,3,2
26468,4,3,1,0,2,1
26468,3,1,1,0,0,1
3523,10,7,3,0,4,3
3523,9,6,2,0,4,2
3523,8,26,11,0,15,11
3523,7,21,4,0,17,4
3523,6,18,5,0,13,5
3523,5,3,1,0,2,1
3523,3,1,1,0,0,1
3523,2,3,3,0,0,3
6919,10,1,1,0,0,1
6919,9,2,1,0,1,1
6919,8,14,3,0,11,3
6919,7,18,8,0,10,8
6919,6,27,10,0,17,10
6919,5,12,4,0,8,4
6919,3,6,2,0,4,2
6919,1,2,2,0,0,2
4802,9,3,2,0,1,2
4802,8,17,10,0,7,10
4802,7,16,2,0,14,2
4802,6,28,6,0,22,6
4802,5,12,2,0,10,2
4802,4,6,3,0,3,3
9971,9,5,1,0,4,1
9971,8,11,6,0,5,6
9971,7,23,8,0,15,8
9971,6,22,11,0,11,11
9971,5,15,6,0,9,6
9971,4,7,4,0,3,4
9971,3,3,1,0,2,1
2304,9,3,1,0,2,1
2304,8,6,2,0,4,2
2304,7,13,7,0,6,7
2304,6,39,9,0,30,9
2304,5,20,3,0,17,3
2304,2,1,1,0,0,1
3389,9,1,1,0,0,1
3389,7,9,3,0,6,3
3389,6,16,3,0,13,3
3389,5,16,2,0,14,2
3389,4,18,5,0,13,5
3389,3,14,4,0,10,4
3389,2,12,3,0,9,3
3389,1,1,1,0,0,1
835,10,4,3,0,1,3
835,9,5,2,0,3,2
835,8,19,13,0,6,13
835,7,21,7,0,14,7
835,6,26,10,0,16,10
835,5,8,4,0,4,4
835,3,1,1,0,0,1
161921,10,2,1,0,1,1
161921,9,6,3,0,3,3
161921,8,17,4,0,13,4
161921,7,33,9,0,24,9
161921,6,22,11,0,11,11
161921,5,7,2,0,5,2
8742,10,1,1,0,0,1
8742,9,5,4,0,1,4
8742,8,13,4,0,9,4
8742,7,21,7,0,14,7
8742,6,26,12,0,14,12
8742,5,13,4,0,9,4
8742,4,7,3,0,4,3
244169,9,5,1,0,4,1
244169,8,17,4,0,13,4
244169,7,26,7,0,19,7
244169,6,24,6,0,18,6
244169,5,8,3,0,5,3
244169,3,2,1,0,1,1
28674,10,1,1,0,0,1
28674,8,5,1,0,4,1
28674,7,12,1,0,11,1
28674,6,23,3,0,20,3
28674,5,13,2,0,11,2
28674,4,15,3,0,12,3
28674,3,13,5,0,8,5
28674,2,5,2,0,3,2
1255,8,4,2,0,2,2
1255,7,10,3,0,7,3
1255,6,24,9,0,15,9
1255,5,21,3,0,18,3
1255,4,13,6,0,7,6
1255,3,8,2,0,6,2
1255,2,3,2,0,1,2
1255,1,2,2,0,0,2
246812,9,1,1,0,0,1
246812,8,21,4,0,17,4
246812,7,16,2,0,14,2
246812,6,29,2,0,27,2
246812,4,4,1,0,3,1
246812,2,2,1,0,1,1
209206,10,13,6,0,7,6
209206,9,28,18,0,10,18
209206,8,22,9,0,13,9
209206,7,9,1,0,8,1
209206,6,10,4,0,6,4
124648,8,4,1,0,3,1
124648,7,8,1,0,7,1
124648,6,18,4,0,14,4
124648,5,6,2,0,4,2
124648,4,8,1,0,7,1
124648,3,13,5,0,8,5
124648,2,9,4,0,5,4
124648,1,12,6,0,6,6
199690,8,16,2,0,14,2
199690,7,22,2,0,20,2
199690,6,24,3,0,21,3
199690,5,10,2,0,8,2
199690,4,6,1,0,5,1
16415,10,2,1,0,1,1
16415,8,9,2,0,7,2
16415,7,23,3,0,20,3
16415,6,34,5,0,29,5
16415,5,13,4,0,9,4
16415,4,5,2,0,3,2
17925,9,2,1,0,1,1
17925,7,31,2,0,29,2
17925,6,26,5,0,21,5
17925,4,2,1,0,1,1
11139,10,5,2,0,3,2
11139,9,3,3,0,0,3
11139,8,14,6,0,8,6
11139,7,28,8,0,20,8
11139,6,20,8,0,12,8
11139,5,11,4,0,7,4
11139,4,4,2,0,2,2
11139,3,2,1,0,1,1
10262,9,5,2,0,3,2
10262,8,15,6,0,9,6
10262,7,20,2,0,18,2
10262,6,26,10,0,16,10
10262,5,13,4,0,9,4
10262,4,4,1,0,3,1
10262,3,1,1,0,0,1
10262,2,1,1,0,0,1
9619,9,6,2,0,4,2
9619,8,18,10,0,8,10
9619,7,21,6,0,15,6
9619,6,21,4,0,17,4
9619,5,8,5,0,3,5
9619,4,5,2,0,3,2
28472,8,6,1,0,5,1
28472,7,4,2,0,2,2
28472,6,26,9,0,17,9
28472,5,18,2,0,16,2
28472,4,16,7,0,9,7
28472,3,5,2,0,3,2
28472,2,9,6,0,3,6
28472,1,3,1,0,2,1
10386,9,2,2,0,0,2
10386,8,5,2,0,3,2
10386,7,15,5,0,10,5
10386,6,34,11,0,23,11
10386,5,14,4,0,10,4
10386,4,11,3,0,8,3
10386,2,3,2,0,1,2
10386,1,1,1,0,0,1
86542,8,7,3,0,4,3
86542,7,29,6,0,23,6
86542,6,39,6,0,33,6
86542,3,1,1,0,0,1
29281,8,9,1,0,8,1
29281,7,16,1,0,15,1
29281,6,31,4,0,27,4
29281,5,16,3,0,13,3
29281,4,10,3,0,7,3
29281,2,3,1,0,2,1
126471,8,6,1,0,5,1
126471,7,15,2,0,13,2
126471,6,40,9,0,31,9
126471,5,14,1,0,13,1
126471,4,9,3,0,6,3
126471,3,1,1,0,0,1
126471,2,2,1,0,1,1
21276,8,7,4,0,3,4
21276,7,17,5,0,12,5
21276,6,30,11,0,19,11
21276,5,8,2,0,6,2
21276,4,13,7,0,6,7
21276,3,7,6,0,1,6
21276,2,3,1,0,2,1
21276,1,2,1,0,1,1
160762,10,3,1,0,2,1
160762,9,3,1,0,2,1
160762,8,15,3,1,12,2
160762,7,30,3,0,27,3
160762,6,18,1,0,17,1
160762,5,10,1,1,9,0
160762,4,4,1,0,3,1
22910,10,3,1,0,2,1
22910,8,9,1,0,8,1
22910,7,12,2,0,10,2
22910,6,29,6,0,23,6
22910,5,18,5,0,13,5
22910,4,8,2,0,6,2
22910,3,5,3,0,2,3
4877,9,7,1,0,6,1
4877,8,15,6,0,9,6
4877,7,19,6,0,13,6
4877,6,25,4,0,21,4
4877,5,11,3,0,8,3
4877,4,3,1,0,2,1
4877,3,2,1,0,1,1
4877,1,2,1,0,1,1
78247,9,2,1,0,1,1
78247,7,16,4,0,12,4
78247,6,36,8,0,28,8
78247,5,19,4,0,15,4
78247,4,8,2,0,6,2
78247,3,2,1,0,1,1
78247,2,2,2,0,0,2
1307,9,1,1,0,0,1
1307,8,5,1,0,4,1
1307,7,10,1,0,9,1
1307,6,32,6,0,26,6
1307,5,28,6,0,22,6
1307,3,2,2,0,0,2
3970,8,10,2,0,8,2
3970,7,15,7,0,8,7
3970,6,36,12,0,24,12
3970,5,9,3,0,6,3
3970,4,5,1,0,4,1
58625,10,1,1,0,0,1
58625,9,7,2,0,5,2
58625,8,35,14,0,21,14
58625,7,28,8,0,20,8
58625,6,11,2,0,9,2
58625,3,2,1,0,1,1
4510,10,4,2,0,2,2
4510,9,9,3,0,6,3
4510,8,31,12,0,19,12
4510,7,19,5,0,14,5
4510,6,13,3,0,10,3
4510,5,8,3,0,5,3
4000,9,4,1,0,3,1
4000,7,12,4,0,8,4
4000,6,32,9,0,23,9
4000,5,18,9,0,9,9
4000,4,10,4,0,6,4
4000,3,4,2,0,2,2
172410,8,8,2,0,6,2
172410,7,13,6,0,7,6
172410,6,28,3,0,25,3
172410,5,18,3,0,15,3
172410,4,10,2,0,8,2
172410,1,1,1,0,0,1
3340,10,5,4,0,1,4
3340,9,14,8,0,6,8
3340,8,24,12,0,12,12
3340,7,23,7,0,16,7
3340,6,12,2,0,10,2
3340,5,5,3,0,2,3
3340,3,2,1,0,1,1
6270,10,3,1,0,2,1
6270,9,6,4,0,2,4
6270,8,15,4,0,11,4
6270,7,21,8,0,13,8
6270,6,24,3,0,21,3
6270,5,11,2,0,9,2
6270,4,5,3,0,2,3
6270,3,1,1,0,0,1
6270,1,1,1,0,0,1
165812,10,4,1,0,3,1
165812,9,13,7,1,6,6
165812,8,16,6,1,10,5
165812,7,17,4,1,13,3
165812,6,19,6,1,13,5
165812,5,8,1,0,7,1
165812,3,5,2,0,3,2
165812,2,2,1,0,1,1
144416,8,12,2,0,10,2
144416,7,28,5,0,23,5
144416,6,32,3,0,29,3
144416,5,8,1,0,7,1
144416,4,3,1,0,2,1
3606,9,2,1,0,1,1
3606,8,6,2,0,4,2
3606,7,6,4,0,2,4
3606,6,16,3,0,13,3
3606,5,19,6,0,13,6
3606,4,15,7,0,8,7
3606,3,13,4,0,9,4
3606,2,7,3,0,4,3
3606,1,3,1,0,2,1
172597,8,23,2,0,21,2
172597,7,19,3,2,16,1
172597,6,16,1,0,15,1
172597,5,9,2,0,7,2
172597,4,5,1,0,4,1
216798,10,5,1,0,4,1
216798,9,10,1,0,9,1
216798,8,26,5,0,21,5
216798,7,29,3,0,26,3
216798,6,14,2,0,12,2
83117,9,2,1,0,1,1
83117,8,13,6,0,7,6
83117,7,21,5,0,16,5
83117,6,17,2,0,15,2
83117,5,17,4,0,13,4
83117,4,7,2,0,5,2
83117,1,1,1,0,0,1
2487,9,1,1,0,0,1
2487,8,8,2,0,6,2
2487,7,14,3,0,11,3
2487,6,30,13,0,17,13
2487,5,21,5,0,16,5
2487,4,10,4,0,6,4
2487,3,2,1,0,1,1
2487,1,1,1,0,0,1
4178,10,5,2,0,3,2
4178,9,5,3,0,2,3
4178,8,17,11,0,6,11
4178,7,18,6,0,12,6
4178,6,21,10,0,11,10
4178,5,11,5,0,6,5
4178,4,8,5,0,3,5
4178,3,2,2,0,0,2
10565,9,1,1,0,0,1
10565,8,6,1,0,5,1
10565,7,13,2,0,11,2
10565,6,14,5,0,9,5
10565,5,19,7,0,12,7
10565,4,20,7,0,13,7
10565,3,9,2,0,7,2
10565,2,2,2,0,0,2
144228,9,9,3,0,6,3
144228,8,31,9,0,22,9
144228,7,17,5,0,12,5
144228,6,15,3,0,12,3
144228,5,6,3,0,3,3
144228,4,2,1,0,1,1
8643,9,4,3,0,1,3
8643,8,15,8,0,7,8
8643,7,27,8,0,19,8
8643,6,18,10,0,8,10
8643,5,12,7,0,5,7
8643,4,5,3,0,2,3
8643,3,5,4,0,1,4
1731,7,8,2,0,6,2
1731,6,14,2,0,12,2
1731,5,26,5,0,21,5
1731,4,25,7,0,18,7
1731,3,7,2,0,5,2
1731,2,3,1,0,2,1
121663,8,12,3,0,9,3
121663,7,19,2,0,17,2
121663,6,25,3,0,22,3
4578,7,8,5,0,3,5
4578,6,21,5,0,16,5
4578,5,22,5,0,17,5
4578,4,17,7,0,10,7
4578,3,9,7,0,2,7
4578,2,6,2,0,4,2
1890,10,10,6,0,4,6
1890,9,11,8,0,3,8
1890,8,13,7,0,6,7
1890,7,17,5,0,12,5
1890,6,27,8,0,19,8
1890,5,6,3,0,3,3
1890,4,1,1,0,0,1
194028,9,3,1,0,2,1
194028,7,23,5,0,18,5
194028,6,36,9,0,27,9
29317,9,5,2,0,3,2
29317,8,9,3,0,6,3
29317,7,10,1,0,9,1
29317,6,21,4,0,17,4
29317,5,19,1,0,18,1
29317,4,15,3,0,12,3
29317,3,5,1,0,4,1
4325,8,2,2,0,0,2
4325,7,13,5,0,8,5
4325,6,20,8,0,12,8
4325,5,22,14,0,8,14
4325,4,18,9,0,9,9
4325,3,6,2,0,4,2
4325,2,2,1,0,1,1
190266,9,2,1,0,1,1
190266,8,24,6,4,18,2
190266,7,28,8,0,20,8
190266,6,20,7,0,13,7
190266,5,7,2,0,5,2
237229,9,3,1,0,2,1
237229,8,9,2,0,7,2
237229,7,30,6,0,24,6
237229,6,19,7,0,12,7
237229,5,10,5,0,5,5
237229,4,9,1,0,8,1
237229,1,1,1,0,0,1
202884,9,4,2,0,2,2
202884,8,21,5,1,16,4
202884,7,33,6,0,27,6
202884,6,12,4,0,8,4
202884,5,7,2,0,5,2
202884,4,3,1,0,2,1
131387,10,12,6,0,6,6
131387,9,4,3,0,1,3
131387,8,14,6,0,8,6
131387,7,22,6,0,16,6
131387,6,24,4,0,20,4
131387,5,9,3,0,6,3
11531,8,10,6,0,4,6
11531,7,18,9,0,9,9
11531,6,36,17,0,19,17
11531,5,12,6,0,6,6
11531,4,8,6,0,2,6
193628,9,2,1,0,1,1
193628,8,7,1,0,6,1
193628,7,18,2,0,16,2
193628,6,25,4,0,21,4
193628,5,17,3,0,14,3
193628,4,10,2,0,8,2
193628,3,4,1,0,3,1
193628,2,2,1,0,1,1
193628,1,1,1,0,0,1
37061,10,10,4,0,6,4
37061,9,9,1,0,8,1
37061,8,15,4,0,11,4
37061,7,22,8,0,14,8
37061,6,21,4,0,17,4
37061,5,5,2,0,3,2
37061,4,3,1,0,2,1
5333,10,2,1,0,1,1
5333,9,7,1,0,6,1
5333,8,18,3,0,15,3
5333,7,26,8,0,18,8
5333,6,21,3,0,18,3
5333,5,7,4,0,3,4
5333,4,5,3,0,2,3
35254,10,6,1,0,5,1
35254,9,4,1,0,3,1
35254,7,11,3,0,8,3
35254,6,29,7,0,22,7
35254,5,12,3,0,9,3
35254,4,6,2,0,4,2
35254,3,5,1,0,4,1
35254,1,3,2,0,1,2
101685,9,4,1,0,3,1
101685,8,6,2,0,4,2
101685,7,19,5,2,14,3
101685,6,30,8,0,22,8
101685,5,11,2,0,9,2
101685,4,7,1,0,6,1
101685,3,6,2,0,4,2
89928,8,1,1,0,0,1
89928,7,3,1,0,2,1
89928,6,15,4,0,11,4
89928,5,29,4,0,25,4
89928,4,27,7,0,20,7
89928,3,6,2,0,4,2
89928,2,5,1,0,4,1
1879,10,11,3,0,8,3
1879,9,12,5,0,7,5
1879,8,23,4,0,19,4
1879,7,22,7,0,15,7
1879,6,13,2,0,11,2
1879,5,2,1,0,1,1
4977,10,7,3,1,4,2
4977,9,4,3,0,1,3
4977,8,17,7,0,10,7
4977,7,21,6,0,15,6
4977,6,24,8,0,16,8
4977,5,6,2,0,4,2
4977,4,5,1,0,4,1
189434,9,2,1,0,1,1
189434,8,11,4,3,7,1
189434,7,24,2,1,22,1
189434,6,21,5,0,16,5
189434,5,14,1,0,13,1
189434,4,7,4,0,3,4
5998,9,2,1,0,1,1
5998,8,6,2,0,4,2
5998,7,13,3,0,10,3
5998,6,28,10,0,18,10
5998,5,21,6,0,15,6
5998,4,6,2,0,4,2
5998,3,3,2,0,1,2
5998,2,5,2,0,3,2
5998,1,1,1,0,0,1
174988,9,8,4,0,4,4
174988,8,7,1,0,6,1
174988,6,22,2,0,20,2
174988,5,16,2,0,14,2
174988,4,7,1,0,6,1
174988,2,4,1,0,3,1
154811,9,2,1,0,1,1
154811,8,7,1,0,6,1
154811,7,22,2,1,20,1
154811,6,30,5,2,25,3
154811,5,11,2,0,9,2
154811,4,7,3,0,4,3
8247,8,4,4,0,0,4
8247,7,13,6,0,7,6
8247,6,25,7,0,18,7
8247,5,18,5,0,13,5
8247,4,16,1,0,15,1
8247,3,7,3,0,4,3
8247,1,1,1,0,0,1
111142,10,3,1,0,2,1
111142,7,18,3,0,15,3
111142,6,25,1,0,24,1
111142,5,13,2,0,11,2
165719,8,21,4,0,17,4
165719,7,27,2,0,25,2
165719,6,19,1,0,18,1
165719,5,7,1,0,6,1
165719,4,2,1,0,1,1
4241,10,5,4,0,1,4
4241,9,7,3,0,4,3
4241,8,24,13,0,11,13
4241,7,25,11,0,14,11
4241,6,19,10,0,9,10
4241,5,6,3,0,3,3
125022,9,6,1,0,5,1
125022,8,17,2,0,15,2
125022,7,21,5,0,16,5
125022,6,33,1,0,32,1
125022,5,7,1,0,6,1
31553,10,3,2,0,1,2
31553,9,6,2,0,4,2
31553,8,22,8,0,14,8
31553,7,27,10,0,17,10
31553,6,19,5,0,14,5
31553,5,5,1,0,4,1
31553,4,2,1,0,1,1
31553,3,1,1,0,0,1
103975,8,22,4,0,18,4
103975,7,22,6,1,16,5
103975,6,22,4,0,18,4
103975,5,9,3,0,6,3
103975,4,7,2,0,5,2
194301,10,5,2,0,3,2
194301,9,4,2,0,2,2
194301,8,18,6,1,12,5
194301,7,18,1,0,17,1
194301,6,23,6,0,17,6
194301,5,9,2,0,7,2
194301,4,6,4,1,2,3
876,9,2,1,0,1,1
876,8,9,4,0,5,4
876,7,12,6,0,6,6
876,6,29,13,0,16,13
876,5,20,6,0,14,6
876,4,5,1,0,4,1
876,3,4,2,0,2,2
876,2,4,1,0,3,1
245950,8,17,4,0,13,4
245950,7,24,3,0,21,3
245950,6,22,5,0,17,5
245950,5,13,2,0,11,2
245950,4,2,1,0,1,1
9112,10,5,2,0,3,2
9112,9,9,3,0,6,3
9112,8,20,5,0,15,5
9112,7,27,6,0,21,6
9112,6,15,2,0,13,2
9112,4,5,2,0,3,2
9112,3,1,1,0,0,1
149051,9,1,1,0,0,1
149051,6,8,4,0,4,4
149051,5,16,4,0,12,4
149051,4,28,3,0,25,3
149051,3,17,3,0,14,3
177048,9,2,2,1,0,1
177048,8,13,5,1,8,4
177048,7,12,4,0,8,4
177048,6,23,4,0,19,4
177048,5,13,3,1,10,2
177048,4,13,2,0,11,2
177048,2,4,1,0,3,1
12274,8,6,2,0,4,2
12274,7,11,8,0,3,8
12274,6,26,11,0,15,11
12274,5,15,4,0,11,4
12274,4,14,6,0,8,6
12274,3,8,2,0,6,2
12274,2,4,2,0,2,2
3731,7,20,6,0,14,6
3731,6,25,8,0,17,8
3731,5,14,4,0,10,4
3731,4,10,1,0,9,1
3731,3,3,1,0,2,1
3731,2,3,2,0,1,2
3731,1,1,1,0,0,1
53723,8,12,2,0,10,2
53723,7,29,5,0,24,5
53723,6,28,3,0,25,3
53723,5,7,1,0,6,1
53723,4,2,1,0,1,1
4036,8,8,2,0,6,2
4036,7,14,6,0,8,6
4036,6,28,8,0,20,8
4036,5,22,7,0,15,7
4036,4,9,4,0,5,4
4036,2,2,2,0,0,2
193488,10,2,1,1,1,0
193488,9,1,1,0,0,1
193488,8,5,1,0,4,1
193488,7,9,1,0,8,1
193488,6,18,3,0,15,3
193488,4,6,3,0,3,3
193488,3,5,2,0,3,2
193488,2,8,2,0,6,2
193488,1,19,11,2,8,9
5835,10,3,1,0,2,1
5835,8,12,4,0,8,4
5835,7,18,1,0,17,1
5835,6,32,4,0,28,4
5835,5,8,3,0,5,3
5835,4,7,1,0,6,1
201006,10,2,1,0,1,1
201006,8,20,7,0,13,7
201006,7,39,6,0,33,6
201006,6,16,5,0,11,5
218236,9,4,2,0,2,2
218236,7,14,3,0,11,3
218236,6,40,3,0,37,3
218236,5,13,2,0,11,2
218236,3,3,1,0,2,1
66964,10,2,1,0,1,1
66964,9,8,7,0,1,7
66964,8,19,10,0,9,10
66964,7,15,8,0,7,8
66964,6,20,5,0,15,5
66964,5,7,1,0,6,1
66964,4,6,2,0,4,2
66964,2,7,5,0,2,5
43890,8,2,1,0,1,1
43890,6,25,3,0,22,3
43890,5,22,5,0,17,5
43890,4,14,6,0,8,6
43890,3,5,3,0,2,3
43890,2,8,2,0,6,2
200632,9,3,1,0,2,1
200632,8,8,3,0,5,3
200632,7,19,7,0,12,7
200632,6,24,1,0,23,1
200632,5,17,4,0,13,4
200632,4,8,2,0,6,2
200632,3,3,2,0,1,2
200632,1,2,2,0,0,2
17285,8,10,8,0,2,8
17285,7,15,3,0,12,3
17285,6,22,9,0,13,9
17285,5,23,14,0,9,14
17285,4,11,7,0,4,7
17285,3,2,1,0,1,1
152955,8,2,1,0,1,1
152955,6,12,3,0,9,3
152955,5,12,1,0,11,1
152955,4,13,2,0,11,2
152955,3,8,2,0,6,2
152955,2,17,4,0,13,4
152955,1,19,7,0,12,7
221371,9,6,1,0,5,1
221371,8,25,4,0,21,4
221371,7,18,2,0,16,2
221371,6,23,5,0,18,5
221371,5,6,1,0,5,1
221371,4,1,1,0,0,1
3102,8,6,1,0,5,1
3102,7,20,5,0,15,5
3102,6,32,12,0,20,12
3102,5,13,1,0,12,1
3102,4,13,3,0,10,3
14423,9,3,1,0,2,1
14423,8,4,2,0,2,2
14423,7,7,3,0,4,3
14423,6,29,8,0,21,8
14423,5,20,12,0,8,12
14423,4,9,5,0,4,5
14423,3,10,3,0,7,3
14423,2,2,1,0,1,1
46614,9,7,4,0,3,4
46614,8,25,7,0,18,7
46614,7,22,7,0,15,7
46614,6,23,7,0,16,7
46614,5,5,1,0,4,1
46614,4,2,2,0,0,2
7422,7,5,2,0,3,2
7422,6,13,6,0,7,6
7422,5,17,3,0,14,3
7422,4,13,6,0,7,6
7422,3,13,4,0,9,4
7422,2,14,5,0,9,5
7422,1,11,4,0,7,4
137141,10,14,2,0,12,2
137141,9,17,1,0,16,1
137141,8,27,5,0,22,5
137141,7,14,1,0,13,1
137141,6,11,2,0,9,2
137141,4,1,1,0,0,1
118001,8,4,1,0,3,1
118001,7,15,2,0,13,2
118001,6,36,2,0,34,2
118001,5,19,3,0,16,3
118001,4,10,2,0,8,2
118001,3,2,1,0,1,1
8815,9,5,2,0,3,2
8815,8,17,3,0,14,3
8815,7,18,2,0,16,2
8815,6,28,6,0,22,6
8815,4,3,2,0,1,2
177099,10,2,1,0,1,1
177099,9,12,4,0,8,4
177099,8,18,9,1,9,8
177099,7,22,6,0,16,6
177099,6,13,1,1,12,0
177099,5,9,1,0,8,1
177099,4,6,1,0,5,1
177099,3,3,1,1,2,0
22061,9,8,2,0,6,2
22061,8,6,1,0,5,1
22061,7,23,4,0,19,4
22061,5,15,3,0,12,3
22061,4,8,3,0,5,3
6485,3,16,5,0,11,5
6485,2,24,9,0,15,9
6485,1,23,15,0,8,15
4326,8,4,1,0,3,1
4326,7,11,3,0,8,3
4326,6,26,4,0,22,4
4326,5,19,2,0,17,2
4326,4,18,2,0,16,2
4326,2,4,1,0,3,1
4326,1,2,1,0,1,1
7712,8,7,1,0,6,1
7712,7,14,2,0,12,2
7712,6,37,7,0,30,7
7712,5,9,2,0,7,2
7712,4,10,1,0,9,1
7712,2,1,1,0,0,1
2436,10,2,1,0,1,1
2436,9,2,1,0,1,1
2436,8,7,4,0,3,4
2436,7,16,6,0,10,6
2436,6,32,9,0,23,9
2436,5,16,3,0,13,3
2436,3,3,1,0,2,1
2436,2,2,1,0,1,1
248182,10,7,2,0,5,2
248182,9,15,6,0,9,6
248182,8,26,14,1,12,13
248182,7,14,4,0,10,4
248182,6,10,2,0,8,2
248182,3,1,1,0,0,1
248182,1,4,2,1,2,1
171351,10,7,5,1,2,4
171351,9,9,4,0,5,4
171351,8,15,5,0,10,5
171351,7,23,5,2,18,3
171351,6,23,6,1,17,5
171351,2,1,1,0,0,1
102159,10,5,3,0,2,3
102159,9,8,6,0,2,6
102159,8,23,10,0,13,10
102159,7,25,7,0,18,7
102159,6,13,3,0,10,3
102159,5,6,2,0,4,2
102159,4,4,2,0,2,2
172563,9,4,1,0,3,1
172563,8,27,9,0,18,9
172563,7,28,6,1,22,5
172563,6,20,5,0,15,5
172563,5,4,3,0,1,3
6197,10,3,1,0,2,1
6197,9,12,3,0,9,3
6197,8,22,10,0,12,10
6197,7,25,8,0,17,8
6197,6,15,4,0,11,4
6197,4,2,1,0,1,1
6197,3,1,1,0,0,1
1974,9,4,3,0,1,3
1974,8,13,4,0,9,4
1974,7,21,1,0,20,1
1974,6,29,8,0,21,8
1974,5,11,2,0,9,2
1974,4,4,2,0,2,2
1974,3,3,1,0,2,1
217471,10,8,1,0,7,1
217471,9,8,1,0,7,1
217471,8,30,2,0,28,2
217471,7,19,5,0,14,5
217471,6,14,1,0,13,1
217471,5,5,1,0,4,1
217471,1,1,1,0,0,1
12601,9,3,2,0,1,2
12601,8,3,1,0,2,1
12601,7,8,3,0,5,3
12601,6,21,6,0,15,6
12601,5,19,8,0,11,8
12601,4,13,5,0,8,5
12601,3,7,4,0,3,4
12601,2,4,1,0,3,1
12601,1,5,3,0,2,3
256998,10,3,1,0,2,1
256998,9,7,1,0,6,1
256998,8,28,2,0,26,2
256998,7,27,4,0,23,4
18579,10,4,3,0,1,3
18579,9,6,4,0,2,4
18579,8,17,9,0,8,9
18579,7,22,9,0,13,9
18579,6,18,8,0,10,8
18579,5,7,2,0,5,2
18579,4,7,2,0,5,2
194061,10,4,2,0,2,2
194061,9,13,4,0,9,4
194061,8,28,6,0,22,6
194061,7,24,2,0,22,2
194061,6,8,4,0,4,4
194061,3,2,1,0,1,1
194061,2,1,1,0,0,1
194061,1,2,1,0,1,1
790,9,3,1,0,2,1
790,6,28,6,0,22,6
790,5,10,1,0,9,1
790,4,8,3,0,5,3
790,3,2,1,0,1,1
790,2,1,1,0,0,1
176247,10,29,21,1,8,20
176247,9,10,9,0,1,9
176247,8,7,3,0,4,3
176247,7,14,2,1,12,1
176247,6,8,1,0,7,1
176247,3,7,3,0,4,3
176247,2,1,1,0,0,1
176247,1,3,2,0,1,2
9725,7,9,3,0,6,3
9725,6,18,3,0,15,3
9725,5,17,6,0,11,6
9725,4,12,2,0,10,2
9725,3,11,5,0,6,5
9725,2,7,4,0,3,4
9725,1,2,1,0,1,1
218519,10,10,5,0,5,5
218519,9,11,2,0,9,2
218519,8,22,5,0,17,5
218519,7,19,2,0,17,2
16860,8,3,1,0,2,1
16860,7,8,3,0,5,3
16860,6,20,9,0,11,9
16860,5,27,8,0,19,8
16860,4,17,6,0,11,6
16860,3,5,2,0,3,2
16860,2,4,1,0,3,1
131450,9,2,1,0,1,1
131450,8,5,1,0,4,1
131450,7,13,3,0,10,3
131450,6,31,2,0,29,2
131450,5,17,2,0,15,2
131450,4,10,2,0,8,2
131450,3,4,2,0,2,2
131450,2,3,2,0,1,2
8393,7,9,2,0,7,2
8393,6,21,3,0,18,3
8393,5,19,5,0,14,5
8393,4,12,3,0,9,3
8393,3,13,4,0,9,4
8393,2,5,1,0,4,1
5952,10,4,2,0,2,2
5952,9,1,1,0,0,1
5952,8,4,2,0,2,2
5952,7,9,2,0,7,2
5952,6,14,3,0,11,3
5952,5,17,8,0,9,8
5952,4,17,6,0,11,6
5952,3,13,4,0,9,4
5952,2,6,3,0,3,3
38837,10,1,1,0,0,1
38837,9,8,3,0,5,3
38837,8,30,11,0,19,11
38837,7,26,13,0,13,13
38837,6,12,2,0,10,2
38837,5,5,1,0,4,1
38837,4,3,2,0,1,2
4364,10,2,1,0,1,1
4364,9,13,4,0,9,4
4364,8,25,7,0,18,7
4364,7,26,7,0,19,7
4364,6,15,2,0,13,2
4364,3,2,2,0,0,2
209926,10,5,3,0,2,3
209926,9,11,5,0,6,5
209926,8,21,7,0,14,7
209926,7,24,7,1,17,6
209926,5,9,2,0,7,2
209926,4,3,2,0,1,2
23657,9,4,1,0,3,1
23657,8,11,3,0,8,3
23657,7,34,10,0,24,10
23657,6,23,7,0,16,7
23657,5,9,2,0,7,2
23657,4,3,2,0,1,2
4555,8,4,1,0,3,1
4555,7,14,2,0,12,2
4555,6,35,2,0,33,2
4555,5,19,2,0,17,2
4555,3,3,2,0,1,2
4555,2,1,1,0,0,1
4555,1,1,1,0,0,1
220707,9,9,2,0,7,2
220707,8,9,3,0,6,3
220707,7,20,1,0,19,1
220707,6,29,5,0,24,5
220707,5,11,3,0,8,3
220707,4,2,1,0,1,1
220707,2,1,1,0,0,1
3314,7,9,1,0,8,1
3314,6,31,5,0,26,5
3314,5,15,3,0,12,3
3314,4,13,6,0,7,6
3314,3,6,3,0,3,3
3314,2,3,1,0,2,1
206274,9,2,2,0,0,2
206274,6,7,1,0,6,1
206274,4,10,1,0,9,1
206274,3,13,6,0,7,6
206274,2,23,9,0,14,9
206274,1,9,1,0,8,1
1189,10,5,1,0,4,1
1189,9,7,2,0,5,2
1189,8,20,5,0,15,5
1189,7,24,6,0,18,6
1189,6,19,4,0,15,4
1189,5,8,1,0,7,1
1189,4,2,2,0,0,2
118515,8,4,1,0,3,1
118515,7,18,4,0,14,4
118515,6,26,8,0,18,8
118515,5,19,4,0,15,4
118515,4,10,2,0,8,2
118515,3,2,1,0,1,1
118515,2,3,2,0,1,2
198671,10,3,1,0,2,1
198671,9,9,4,0,5,4
198671,8,20,9,0,11,9
198671,7,25,8,0,17,8
198671,6,20,3,0,17,3
198671,5,6,1,0,5,1
4175,8,5,1,0,4,1
4175,7,14,2,0,12,2
4175,6,20,6,0,14,6
4175,5,18,4,0,14,4
4175,4,14,3,0,11,3
4175,3,9,4,0,5,4
4175,2,2,1,0,1,1
28567,10,9,4,0,5,4
28567,9,10,5,0,5,5
28567,8,17,9,0,8,9
28567,7,13,6,0,7,6
28567,6,16,9,0,7,9
28567,5,11,5,0,6,5
28567,4,5,2,0,3,2
28567,3,1,1,0,0,1
28567,1,3,1,0,2,1
172599,8,23,1,0,22,1
172599,7,18,4,2,14,2
172599,6,14,1,0,13,1
172599,2,2,1,0,1,1
172599,1,2,1,0,1,1
143520,8,15,5,0,10,5
143520,7,18,5,1,13,4
143520,6,30,4,0,26,4
143520,4,6,2,0,4,2
143520,3,4,1,0,3,1
143520,2,1,1,0,0,1
143520,1,5,4,1,1,3
7739,10,3,1,0,2,1
7739,9,4,1,0,3,1
7739,8,19,3,0,16,3
7739,7,24,4,0,20,4
7739,6,16,4,0,12,4
7739,5,8,3,0,5,3
7739,4,7,3,0,4,3
7739,3,2,2,0,0,2
7739,2,1,1,0,0,1
194820,9,8,1,0,7,1
194820,8,8,2,0,6,2
194820,7,15,4,0,11,4
194820,6,23,5,0,18,5
194820,5,15,5,0,10,5
194820,3,8,3,0,5,3
194820,2,4,2,0,2,2
235628,8,5,1,0,4,1
235628,7,16,2,0,14,2
235628,6,24,3,0,21,3
235628,5,22,3,0,19,3
235628,4,11,5,0,6,5
235628,3,1,1,0,0,1
209734,10,5,1,0,4,1
209734,8,5,1,0,4,1
209734,7,20,4,0,16,4
209734,6,35,3,0,32,3
209734,5,9,1,0,8,1
6766,10,3,2,0,1,2
6766,9,2,1,0,1,1
6766,8,9,4,0,5,4
6766,7,12,6,0,6,6
6766,6,17,7,0,10,7
6766,5,17,8,0,9,8
6766,4,16,6,0,10,6
6766,3,5,1,0,4,1
6766,2,3,1,0,2,1
6766,1,1,1,0,0,1
84913,9,2,1,0,1,1
84913,8,19,6,0,13,6
84913,7,25,6,0,19,6
84913,6,29,6,0,23,6
84913,4,5,2,0,3,2
93678,8,8,3,0,5,3
93678,7,16,1,0,15,1
93678,6,24,6,0,18,6
93678,5,20,5,0,15,5
93678,4,9,2,0,7,2
93678,3,2,1,0,1,1
93678,2,2,1,0,1,1
5244,8,9,2,0,7,2
5244,7,10,4,0,6,4
5244,6,22,8,0,14,8
5244,5,20,7,0,13,7
5244,4,6,2,0,4,2
5244,3,11,3,0,8,3
5244,2,3,1,0,2,1
145401,8,6,1,0,5,1
145401,7,9,1,0,8,1
145401,6,26,2,0,24,2
145401,5,18,4,0,14,4
145401,3,8,1,0,7,1
145401,1,3,1,0,2,1
5038,9,7,4,0,3,4
5038,8,20,8,0,12,8
5038,7,21,7,0,14,7
5038,6,18,5,0,13,5
5038,5,11,3,0,8,3
5038,3,2,1,0,1,1
2480,8,20,11,0,9,11
2480,7,23,6,0,17,6
2480,6,23,5,0,18,5
2480,5,7,1,0,6,1
2480,4,2,2,0,0,2
2480,3,2,1,0,1,1
2480,2,3,1,0,2,1
2480,1,1,1,0,0,1
138195,9,1,1,0,0,1
138195,7,13,3,0,10,3
138195,6,25,8,0,17,8
138195,5,20,4,0,16,4
138195,4,17,8,0,9,8
138195,3,3,1,0,2,1
138195,2,3,1,0,2,1
212873,8,3,1,0,2,1
212873,7,15,1,0,14,1
212873,6,25,7,0,18,7
212873,4,10,2,0,8,2
212873,3,8,2,0,6,2
212873,2,4,2,0,2,2
212873,1,3,2,0,1,2
8475,8,7,2,0,5,2
8475,7,15,4,0,11,4
8475,6,32,7,0,25,7
8475,5,8,3,0,5,3
8475,4,7,2,0,5,2
8475,3,5,3,0,2,3
8475,2,6,4,0,2,4
8475,1,3,2,0,1,2
119194,7,4,1,0,3,1
119194,6,29,5,0,24,5
119194,4,13,2,0,11,2
119194,3,7,1,0,6,1
119194,2,6,4,0,2,4
180355,9,3,2,0,1,2
180355,8,9,3,0,6,3
180355,7,32,6,0,26,6
180355,6,27,6,0,21,6
180355,5,9,2,0,7,2
3122,10,1,1,0,0,1
3122,8,3,2,0,1,2
3122,7,2,1,0,1,1
3122,6,6,1,0,5,1
3122,5,6,3,0,3,3
3122,4,14,3,0,11,3
3122,3,24,7,0,17,7
3122,2,17,12,0,5,12
3122,1,12,6,0,6,6
4297,9,4,1,0,3,1
4297,8,10,4,0,6,4
4297,7,12,1,0,11,1
4297,6,19,4,0,15,4
4297,5,16,6,0,10,6
4297,3,5,4,0,1,4
4297,2,4,1,0,3,1
169934,8,6,1,0,5,1
169934,7,10,2,0,8,2
169934,6,27,3,0,24,3
169934,5,20,4,0,16,4
169934,4,14,1,0,13,1
169934,3,6,2,0,4,2
214880,10,15,5,0,10,5
214880,9,27,12,3,15,9
214880,8,26,5,0,21,5
214880,7,9,3,1,6,2
214880,3,1,1,0,0,1
214880,2,1,1,0,0,1
4902,9,1,1,0,0,1
4902,8,5,4,0,1,4
4902,6,16,1,0,15,1
4902,5,17,6,0,11,6
4902,4,16,6,0,10,6
4902,3,16,6,0,10,6
4902,2,7,5,0,2,5
174219,9,8,1,0,7,1
174219,8,24,3,0,21,3
174219,6,16,2,0,14,2
174219,5,4,1,0,3,1
3035,9,5,2,0,3,2
3035,8,20,8,0,12,8
3035,7,20,5,0,15,5
3035,6,19,5,0,14,5
3035,5,10,5,0,5,5
3035,4,6,4,0,2,4
3035,2,2,2,0,0,2
4374,9,1,1,0,0,1
4374,7,14,2,0,12,2
4374,6,24,6,0,18,6
4374,5,20,6,0,14,6
4374,4,15,3,0,12,3
4374,3,4,2,0,2,2
4374,2,4,2,0,2,2
191991,10,7,3,0,4,3
191991,9,10,2,1,8,1
191991,8,28,8,1,20,7
191991,7,20,4,0,16,4
191991,6,14,4,1,10,3
191991,3,2,1,1,1,0
238412,10,37,19,0,18,19
238412,9,22,8,0,14,8
238412,8,6,3,0,3,3
238412,7,9,3,1,6,2
238412,6,5,2,0,3,2
238412,4,3,2,0,1,2
191296,10,19,6,0,13,6
191296,9,21,9,0,12,9
191296,8,29,8,1,21,7
191296,7,6,1,0,5,1
191296,6,7,1,0,6,1
191296,2,2,1,0,1,1
246530,10,5,1,0,4,1
246530,8,19,2,0,17,2
246530,7,24,2,0,22,2
246530,6,23,1,0,22,1
246530,5,6,2,0,4,2
246530,4,3,1,0,2,1
246530,2,2,2,0,0,2
106929,8,7,1,0,6,1
106929,7,18,4,0,14,4
106929,6,25,2,0,23,2
106929,5,17,2,0,15,2
106929,4,3,1,0,2,1
106929,3,3,1,0,2,1
106929,2,7,1,0,6,1
13715,8,8,2,0,6,2
13715,7,14,1,0,13,1
13715,6,30,10,0,20,10
13715,5,17,7,0,10,7
13715,4,7,3,0,4,3
13715,3,3,1,0,2,1
13715,2,2,2,0,0,2
236931,10,11,6,0,5,6
236931,9,21,5,0,16,5
236931,8,25,8,0,17,8
236931,7,18,8,0,10,8
236931,6,7,2,0,5,2
12211,8,10,2,0,8,2
12211,7,22,8,0,14,8
12211,6,30,10,0,20,10
12211,5,13,4,0,9,4
12211,3,3,2,0,1,2
12211,1,1,1,0,0,1
573,9,2,1,0,1,1
573,8,7,1,0,6,1
573,7,26,9,0,17,9
573,6,23,6,0,17,6
573,5,12,2,0,10,2
573,4,3,1,0,2,1
573,3,3,1,0,2,1
573,2,2,1,0,1,1
51197,9,8,6,0,2,6
51197,8,14,4,0,10,4
51197,7,16,11,0,5,11
51197,6,21,9,0,12,9
51197,5,16,5,0,11,5
51197,4,4,4,0,0,4
51197,3,4,3,0,1,3
51197,2,1,1,0,0,1
258752,10,14,6,0,8,6
258752,9,13,5,0,8,5
258752,8,14,6,0,8,6
258752,7,11,2,0,9,2
258752,6,11,3,0,8,3
258752,5,7,1,0,6,1
258752,3,5,3,0,2,3
258752,2,5,1,0,4,1
258752,1,4,1,0,3,1
690,8,13,4,0,9,4
690,7,14,6,0,8,6
690,6,37,15,0,22,15
690,5,9,1,0,8,1
690,4,3,1,0,2,1
690,3,3,1,0,2,1
571,9,1,1,0,0,1
571,8,16,4,0,12,4
571,7,16,4,0,12,4
571,6,31,9,0,22,9
571,5,11,2,0,9,2
571,3,4,2,0,2,2
571,2,2,2,0,0,2
2016,10,9,4,0,5,4
2016,9,7,3,0,4,3
2016,8,10,5,0,5,5
2016,7,10,6,0,4,6
2016,6,28,16,0,12,16
2016,5,9,6,0,3,6
2016,4,6,2,0,4,2
2016,3,4,3,0,1,3
2016,2,2,1,0,1,1
4500,9,3,1,0,2,1
4500,8,9,4,0,5,4
4500,7,21,1,0,20,1
4500,6,32,13,0,19,13
4500,5,12,2,0,10,2
4500,4,5,2,0,3,2
8362,9,3,1,0,2,1
8362,8,13,5,0,8,5
8362,7,20,13,0,7,13
8362,6,24,8,0,16,8
8362,5,12,5,0,7,5
8362,4,4,3,0,1,3
8362,3,4,2,0,2,2
180674,10,4,1,0,3,1
180674,9,9,2,0,7,2
180674,8,12,3,1,9,2
180674,7,14,4,0,10,4
180674,6,23,1,0,22,1
180674,5,13,4,0,9,4
180674,4,5,1,0,4,1
180674,3,2,1,0,1,1
2799,7,11,6,0,5,6
2799,6,18,5,0,13,5
2799,5,22,6,0,16,6
2799,4,14,5,0,9,5
2799,3,6,2,0,4,2
2799,2,5,2,0,3,2
2799,1,3,2,0,1,2
194088,8,7,2,0,5,2
194088,7,20,3,0,17,3
194088,6,32,2,0,30,2
194088,5,11,5,0,6,5
194088,2,2,1,0,1,1
14511,9,1,1,0,0,1
14511,8,2,1,0,1,1
14511,6,25,7,0,18,7
14511,5,26,6,0,20,6
14511,4,13,3,0,10,3
14511,3,8,3,0,5,3
14511,2,5,4,0,1,4
11160,9,2,1,0,1,1
11160,7,17,2,0,15,2
11160,6,29,2,0,27,2
11160,5,12,3,0,9,3
11160,4,8,1,0,7,1
60342,8,14,2,0,12,2
60342,7,17,4,0,13,4
60342,6,34,6,0,28,6
60342,5,12,2,0,10,2
60342,4,5,1,0,4,1
60342,2,1,1,0,0,1
16387,8,3,2,0,1,2
16387,6,15,2,0,13,2
16387,5,16,4,0,12,4
16387,4,18,2,0,16,2
16387,3,11,8,0,3,8
16387,2,5,3,0,2,3
16387,1,14,5,0,9,5
146207,10,10,1,0,9,1
146207,9,17,4,0,13,4
146207,8,30,5,0,25,5
146207,7,17,2,0,15,2
146207,4,2,1,0,1,1
240957,9,7,3,0,4,3
240957,8,26,6,0,20,6
240957,7,23,6,0,17,6
240957,6,24,6,0,18,6
240957,5,2,1,0,1,1
154553,8,6,1,0,5,1
154553,7,11,5,0,6,5
154553,6,30,8,0,22,8
154553,5,18,2,0,16,2
154553,4,12,5,0,7,5
154553,3,4,2,0,2,2
4366,10,2,1,0,1,1
4366,9,4,1,0,3,1
4366,8,20,10,0,10,10
4366,7,20,4,0,16,4
4366,6,25,6,0,19,6
4366,5,11,5,0,6,5
4366,3,1,1,0,0,1
3793,10,5,3,0,2,3
3793,9,4,1,0,3,1
3793,8,12,6,0,6,6
3793,7,9,3,0,6,3
3793,6,21,8,0,13,8
3793,5,11,5,0,6,5
3793,4,10,3,0,7,3
3793,3,7,3,0,4,3
3793,1,4,1,0,3,1
129939,6,24,2,0,22,2
129939,5,22,4,0,18,4
129939,4,21,5,0,16,5
129939,3,7,1,0,6,1
129939,2,5,3,0,2,3
140594,10,7,2,0,5,2
140594,9,3,1,0,2,1
140594,8,15,4,0,11,4
140594,7,28,10,0,18,10
140594,6,20,4,0,16,4
140594,5,6,1,0,5,1
140594,4,1,1,0,0,1
247417,10,40,12,0,28,12
247417,9,20,9,1,11,8
247417,8,7,2,0,5,2
247417,7,2,1,0,1,1
247417,2,1,1,0,0,1
247417,1,6,6,0,0,6
9017,7,10,3,0,7,3
9017,6,21,7,0,14,7
9017,5,21,3,0,18,3
9017,4,19,5,0,14,5
9017,2,3,1,0,2,1
231045,9,3,2,0,1,2
231045,8,9,2,0,7,2
231045,6,33,2,0,31,2
231045,5,13,1,0,12,1
231045,3,1,1,0,0,1
1105,8,3,1,0,2,1
1105,7,13,2,0,11,2
1105,6,24,5,0,19,5
1105,5,22,4,0,18,4
1105,4,13,4,0,9,4
1105,2,2,1,0,1,1
1105,1,3,2,0,1,2
214747,9,7,1,0,6,1
214747,8,32,4,0,28,4
214747,7,24,2,1,22,1
214747,5,7,1,1,6,0
206463,10,1,1,0,0,1
206463,8,20,4,0,16,4
206463,7,28,6,0,22,6
206463,6,21,4,0,17,4
206463,4,4,3,0,1,3
206463,3,2,1,0,1,1
29199,10,4,3,0,1,3
29199,9,8,4,0,4,4
29199,8,30,12,0,18,12
29199,7,25,4,0,21,4
29199,6,11,5,0,6,5
29199,5,6,2,0,4,2
7605,10,1,1,0,0,1
7605,7,9,4,0,5,4
7605,6,30,7,0,23,7
7605,5,7,2,0,5,2
7605,4,10,5,0,5,5
7605,3,6,1,0,5,1
7605,2,6,4,0,2,4
9135,10,11,5,0,6,5
9135,9,15,6,0,9,6
9135,8,24,4,0,20,4
9135,7,15,4,0,11,4
9135,6,9,3,0,6,3
9135,5,5,3,0,2,3
9135,3,2,1,0,1,1
2602,10,5,3,0,2,3
2602,9,5,1,0,4,1
2602,8,22,12,0,10,12
2602,7,14,7,0,7,7
2602,6,24,10,0,14,10
2602,5,7,4,0,3,4
2602,4,4,3,0,1,3
236370,10,5,2,0,3,2
236370,9,15,3,0,12,3
236370,8,36,13,0,23,13
236370,7,16,1,0,15,1
236370,6,7,2,0,5,2
236370,5,3,2,0,1,2
236370,4,1,1,0,0,1
236370,3,1,1,0,0,1
167650,10,9,6,0,3,6
167650,9,6,2,0,4,2
167650,8,33,21,0,12,21
167650,7,22,7,0,15,7
167650,6,10,5,0,5,5
26919,10,13,5,0,8,5
26919,9,4,2,0,2,2
26919,8,18,8,0,10,8
26919,7,17,3,0,14,3
26919,6,14,4,0,10,4
26919,5,9,2,0,7,2
26919,4,2,2,0,0,2
26919,3,3,2,0,1,2
26919,2,2,1,0,1,1
26919,1,2,1,0,1,1
156722,8,17,3,0,14,3
156722,7,24,5,0,19,5
156722,6,24,3,0,21,3
156722,4,5,1,0,4,1
6668,10,1,1,0,0,1
6668,6,10,5,0,5,5
6668,5,12,3,0,9,3
6668,4,21,5,0,16,5
6668,3,12,3,0,9,3
6668,2,14,7,0,7,7
6668,1,10,4,0,6,4
5858,9,6,3,0,3,3
5858,8,6,1,0,5,1
5858,7,18,6,0,12,6
5858,6,22,7,0,15,7
5858,5,13,5,0,8,5
5858,3,6,3,0,3,3
5858,2,3,1,0,2,1
209649,10,7,4,0,3,4
209649,9,6,3,0,3,3
209649,8,13,4,0,9,4
209649,7,16,2,0,14,2
209649,6,13,5,0,8,5
209649,5,9,3,0,6,3
209649,4,11,3,0,8,3
209649,2,6,2,0,4,2
90855,9,5,4,0,1,4
90855,8,13,6,0,7,6
90855,7,16,3,0,13,3
90855,6,25,4,0,21,4
90855,5,8,4,0,4,4
90855,4,6,2,0,4,2
90855,3,4,3,0,1,3
7999,8,9,2,0,7,2
7999,7,14,2,0,12,2
7999,6,20,6,0,14,6
7999,5,15,4,0,11,4
7999,4,12,4,0,8,4
7999,2,6,2,0,4,2
7999,1,3,2,0,1,2
206925,7,16,1,0,15,1
206925,6,26,6,0,20,6
206925,5,9,1,0,8,1
206925,4,4,1,0,3,1
206925,3,4,1,0,3,1
206925,2,4,1,0,3,1
182556,10,2,1,0,1,1
182556,9,3,1,0,2,1
182556,8,7,1,0,6,1
182556,7,13,2,0,11,2
182556,6,29,6,0,23,6
182556,5,15,3,0,12,3
31443,9,18,6,0,12,6
31443,8,25,4,0,21,4
31443,7,23,6,0,17,6
31443,6,5,2,0,3,2
31443,5,3,2,0,1,2
31443,4,3,1,0,2,1
31443,2,1,1,0,0,1
146290,10,3,1,0,2,1
146290,8,19,5,0,14,5
146290,7,17,2,0,15,2
146290,6,20,1,0,19,1
146290,5,12,2,0,10,2
146290,4,9,1,0,8,1
146290,2,2,1,0,1,1
8517,9,2,1,0,1,1
8517,8,8,4,0,4,4
8517,7,8,4,0,4,4
8517,6,24,9,0,15,9
8517,5,17,9,0,8,9
8517,4,14,5,0,9,5
8517,3,7,5,0,2,5
8517,2,3,2,0,1,2
3209,8,8,3,0,5,3
3209,7,13,3,0,10,3
3209,6,19,8,0,11,8
3209,5,14,4,0,10,4
3209,4,13,4,0,9,4
3209,3,9,5,0,4,5
3209,2,3,2,0,1,2
3209,1,2,2,0,0,2
162191,8,7,2,0,5,2
162191,6,41,8,0,33,8
162191,5,10,2,0,8,2
17700,7,12,4,0,8,4
17700,6,26,6,0,20,6
17700,5,16,2,0,14,2
17700,4,16,4,0,12,4
17700,3,3,1,0,2,1
17700,2,4,4,0,0,4
8394,10,1,1,0,0,1
8394,8,8,2,0,6,2
8394,7,21,5,0,16,5
8394,6,33,9,0,24,9
8394,5,12,2,0,10,2
8394,4,6,4,0,2,4
8394,3,3,3,0,0,3
1192,8,4,2,0,2,2
1192,7,17,3,0,14,3
1192,6,29,5,0,24,5
1192,5,22,4,0,18,4
1192,4,10,2,0,8,2
1192,3,2,1,0,1,1
208804,9,12,1,0,11,1
208804,8,19,4,0,15,4
208804,7,27,6,1,21,5
208804,5,10,1,0,9,1
208804,4,5,3,0,2,3
208804,2,1,1,0,0,1
208804,1,1,1,0,0,1
181268,8,22,3,0,19,3
181268,7,16,3,0,13,3
181268,6,23,8,0,15,8
181268,5,6,1,0,5,1
181268,2,2,1,0,1,1
75382,10,3,1,0,2,1
75382,9,3,2,0,1,2
75382,8,18,7,0,11,7
75382,7,18,5,0,13,5
75382,6,18,6,0,12,6
75382,5,14,4,0,10,4
75382,4,2,2,0,0,2
75382,3,7,3,0,4,3
2300,8,28,7,0,21,7
2300,7,33,6,0,27,6
2300,6,12,2,0,10,2
2300,3,1,1,0,0,1
9506,8,6,5,0,1,5
9506,7,16,4,0,12,4
9506,6,26,10,0,16,10
9506,5,15,6,0,9,6
9506,4,11,3,0,8,3
9506,3,2,2,0,0,2
9506,2,7,1,0,6,1
59602,9,3,1,0,2,1
59602,7,14,3,0,11,3
59602,6,28,3,0,25,3
59602,5,18,1,0,17,1
59602,3,4,3,0,1,3
59602,2,2,1,0,1,1
182090,9,5,1,0,4,1
182090,8,6,1,0,5,1
182090,6,29,2,0,27,2
182090,5,10,3,0,7,3
182090,4,11,3,0,8,3
182090,3,3,1,0,2,1
182090,2,4,1,0,3,1
324,10,2,1,0,1,1
324,8,5,1,0,4,1
324,7,16,4,0,12,4
324,6,32,4,0,28,4
324,5,19,5,0,14,5
324,4,6,3,0,3,3
324,3,4,1,0,3,1
264476,10,34,12,0,22,12
264476,9,20,4,0,16,4
264476,8,25,6,0,19,6
4952,9,3,1,0,2,1
4952,8,5,1,0,4,1
4952,7,10,3,0,7,3
4952,6,20,1,0,19,1
4952,5,17,3,0,14,3
4952,4,18,3,0,15,3
4952,3,6,4,0,2,4
4952,1,1,1,0,0,1
143657,9,9,2,0,7,2
143657,8,25,7,1,18,6
143657,7,20,3,1,17,2
143657,5,9,1,1,8,0
143657,1,1,1,0,0,1
13920,10,5,2,0,3,2
13920,9,2,1,0,1,1
13920,8,14,9,0,5,9
13920,7,31,12,0,19,12
13920,6,21,8,0,13,8
13920,5,6,3,0,3,3
13920,3,1,1,0,0,1
231674,8,12,1,0,11,1
231674,7,12,1,0,11,1
231674,6,29,1,0,28,1
231674,5,9,2,0,7,2
231674,4,15,5,0,10,5
231674,2,2,2,0,0,2
650,8,9,3,0,6,3
650,7,15,3,0,12,3
650,6,29,6,0,23,6
650,5,15,7,0,8,7
650,4,7,2,0,5,2
650,3,4,1,0,3,1
650,2,2,1,0,1,1
134964,9,5,4,0,1,4
134964,8,25,14,0,11,14
134964,7,23,10,0,13,10
134964,6,18,7,0,11,7
134964,5,7,2,0,5,2
118342,10,9,8,0,1,8
118342,9,4,3,0,1,3
118342,8,11,6,1,5,5
118342,7,7,4,0,3,4
118342,6,26,11,1,15,10
118342,5,9,3,0,6,3
118342,4,10,1,0,9,1
118342,3,4,2,1,2,1
118342,1,3,2,0,1,2
1651,8,13,1,0,12,1
1651,7,12,1,0,11,1
1651,6,38,6,0,32,6
1651,5,12,2,0,10,2
1651,4,5,2,0,3,2
8103,8,10,5,0,5,5
8103,7,15,4,0,11,4
8103,6,23,11,0,12,11
8103,5,9,2,0,7,2
8103,4,7,1,0,6,1
8103,3,3,2,0,1,2
8103,2,6,4,0,2,4
5940,10,1,1,0,0,1
5940,9,7,1,0,6,1
5940,8,18,4,0,14,4
5940,7,28,5,0,23,5
5940,6,14,4,0,10,4
5940,4,4,1,0,3,1
14685,9,8,3,0,5,3
14685,8,17,4,0,13,4
14685,7,20,2,0,18,2
14685,6,26,5,0,21,5
14685,5,6,1,0,5,1
14685,4,6,2,0,4,2
168549,9,4,1,0,3,1
168549,8,12,5,0,7,5
168549,7,21,2,0,19,2
168549,6,28,5,0,23,5
168549,5,11,2,0,9,2
193422,10,1,1,0,0,1
193422,8,29,8,2,21,6
193422,7,19,7,0,12,7
193422,6,22,3,1,19,2
193422,5,5,2,0,3,2
193422,2,1,1,0,0,1
109718,8,7,1,0,6,1
109718,7,14,6,0,8,6
109718,6,27,3,0,24,3
109718,5,14,5,0,9,5
109718,4,7,1,0,6,1
109718,3,6,4,0,2,4
223312,10,5,2,0,3,2
223312,9,12,1,0,11,1
223312,8,16,2,0,14,2
223312,7,25,5,0,20,5
223312,6,16,1,0,15,1
65554,9,2,1,0,1,1
65554,8,10,4,0,6,4
65554,7,15,2,0,13,2
65554,6,30,8,0,22,8
65554,5,16,5,0,11,5
65554,4,8,2,0,6,2
148179,9,4,4,0,0,4
148179,8,13,6,0,7,6
148179,7,9,2,0,7,2
148179,6,25,5,0,20,5
148179,5,14,2,0,12,2
148179,4,8,2,0,6,2
148179,3,4,1,0,3,1
148179,2,2,1,0,1,1
148179,1,4,1,0,3,1
12599,9,1,1,0,0,1
12599,8,3,1,0,2,1
12599,7,15,3,0,12,3
12599,6,22,4,0,18,4
12599,5,20,7,0,13,7
12599,4,7,2,0,5,2
12599,3,5,2,0,3,2
12599,2,10,5,0,5,5
201345,10,20,7,0,13,7
201345,9,19,12,0,7,12
201345,8,27,19,0,8,19
201345,7,9,4,0,5,4
201345,6,6,2,0,4,2
201345,5,1,1,0,0,1
7575,8,4,3,0,1,3
7575,7,8,1,0,7,1
7575,6,26,8,0,18,8
7575,5,16,6,0,10,6
7575,4,14,7,0,7,7
7575,3,8,3,0,5,3
7575,2,3,2,0,1,2
7575,1,4,2,0,2,2
188129,8,7,1,0,6,1
188129,7,17,1,1,16,0
188129,6,21,5,0,16,5
188129,5,14,4,0,10,4
188129,4,8,2,0,6,2
188129,3,5,2,0,3,2
188129,2,3,1,0,2,1
188129,1,3,1,0,2,1
146204,9,7,2,0,5,2
146204,8,10,3,0,7,3
146204,7,8,3,0,5,3
146204,6,22,5,0,17,5
146204,5,17,1,0,16,1
146204,4,10,2,0,8,2
146204,3,3,2,0,1,2
35003,9,3,2,0,1,2
35003,8,16,6,0,10,6
35003,7,25,12,0,13,12
35003,6,27,12,0,15,12
35003,5,6,3,0,3,3
35003,3,2,1,0,1,1
234946,9,5,2,0,3,2
234946,8,14,4,0,10,4
234946,7,22,5,0,17,5
234946,6,22,3,0,19,3
234946,5,12,2,0,10,2
150049,8,17,7,0,10,7
150049,7,21,3,0,18,3
150049,6,18,3,0,15,3
150049,5,10,2,0,8,2
150049,4,6,1,0,5,1
808,8,4,2,0,2,2
808,7,12,2,0,10,2
808,6,23,4,0,19,4
808,5,17,5,0,12,5
808,4,13,6,0,7,6
808,3,6,3,0,3,3
808,1,2,1,0,1,1
244267,10,5,1,0,4,1
244267,8,12,6,0,6,6
244267,7,28,3,0,25,3
244267,6,19,2,0,17,2
244267,5,7,1,0,6,1
244267,4,9,1,0,8,1
1367,9,1,1,0,0,1
1367,8,8,2,0,6,2
1367,7,27,6,0,21,6
1367,6,29,7,0,22,7
1367,5,10,3,0,7,3
1367,4,5,1,0,4,1
147563,7,22,1,0,21,1
147563,6,30,1,0,29,1
147563,5,3,1,0,2,1
147563,4,5,2,0,3,2
146596,9,1,1,0,0,1
146596,8,3,1,0,2,1
146596,7,11,4,0,7,4
146596,6,24,1,0,23,1
146596,5,17,4,0,13,4
146596,4,15,2,0,13,2
146596,3,8,1,0,7,1
146596,2,2,1,0,1,1
564,8,4,1,0,3,1
564,7,13,2,0,11,2
564,6,32,9,0,23,9
564,5,14,2,0,12,2
564,4,10,3,0,7,3
564,3,8,3,0,5,3
3885,8,4,2,0,2,2
3885,7,13,4,0,9,4
3885,6,23,5,0,18,5
3885,5,19,7,0,12,7
3885,4,6,3,0,3,3
3885,2,1,1,0,0,1
121751,9,3,1,0,2,1
121751,8,9,3,1,6,2
121751,7,5,2,0,3,2
121751,6,17,5,1,12,4
121751,5,17,4,0,13,4
121751,4,12,5,0,7,5
121751,3,10,1,0,9,1
121751,2,8,1,0,7,1
121751,1,2,1,0,1,1
2176,7,19,5,0,14,5
2176,6,28,7,0,21,7
2176,5,15,4,0,11,4
2176,4,10,2,0,8,2
2176,3,4,1,0,3,1
2176,2,3,1,0,2,1
8725,10,2,1,0,1,1
8725,8,6,1,0,5,1
8725,7,10,2,0,8,2
8725,6,24,8,0,16,8
8725,5,20,5,0,15,5
8725,4,15,10,0,5,10
8725,3,3,1,0,2,1
8725,2,2,2,0,0,2
1724,10,1,1,0,0,1
1724,7,3,1,0,2,1
1724,6,14,5,0,9,5
1724,5,12,3,0,9,3
1724,4,23,4,0,19,4
1724,3,13,4,0,9,4
1724,2,14,9,0,5,9
1724,1,3,3,0,0,3
3434,9,2,2,0,0,2
3434,8,6,3,0,3,3
3434,7,16,6,0,10,6
3434,6,20,7,0,13,7
3434,5,19,9,0,10,9
3434,4,11,4,0,7,4
3434,3,6,2,0,4,2
3434,2,2,2,0,0,2
3434,1,1,1,0,0,1
227502,10,2,1,0,1,1
227502,9,7,3,0,4,3
227502,8,25,4,0,21,4
227502,7,12,2,1,10,1
227502,6,16,6,0,10,6
227502,5,4,2,0,2,2
227502,4,5,1,0,4,1
227502,3,4,1,0,3,1
227502,2,1,1,0,0,1
227502,1,1,1,0,0,1
165090,10,5,1,0,4,1
165090,9,4,1,0,3,1
165090,8,12,3,0,9,3
165090,7,17,3,0,14,3
165090,6,25,4,0,21,4
165090,5,14,2,0,12,2
165090,4,4,1,0,3,1
165090,3,2,2,0,0,2
98975,9,3,2,0,1,2
98975,8,31,13,0,18,13
98975,7,31,13,0,18,13
98975,6,8,1,0,7,1
98975,5,3,1,0,2,1
98975,3,1,1,0,0,1
8756,9,1,1,0,0,1
8756,8,13,4,0,9,4
8756,7,11,5,0,6,5
8756,6,28,8,0,20,8
8756,5,12,2,0,10,2
8756,4,13,6,0,7,6
224664,10,5,1,0,4,1
224664,8,6,1,0,5,1
224664,7,7,1,0,6,1
224664,6,42,4,0,38,4
224664,5,11,2,0,9,2
224664,4,7,2,0,5,2
11464,9,2,1,0,1,1
11464,8,4,2,0,2,2
11464,7,13,3,0,10,3
11464,6,29,10,0,19,10
11464,5,21,8,0,13,8
11464,4,8,4,0,4,4
11464,3,4,1,0,3,1
5420,8,6,1,0,5,1
5420,7,8,3,0,5,3
5420,6,14,3,0,11,3
5420,5,13,5,0,8,5
5420,4,18,8,0,10,8
5420,3,11,6,0,5,6
5420,2,9,2,0,7,2
5420,1,3,3,0,0,3
230968,9,9,2,0,7,2
230968,8,18,3,0,15,3
230968,7,15,1,0,14,1
230968,6,30,5,0,25,5
180910,8,9,3,0,6,3
180910,7,16,4,0,12,4
180910,6,28,1,0,27,1
180910,5,10,1,0,9,1
180910,4,10,4,0,6,4
180910,3,6,2,0,4,2
91831,9,2,1,0,1,1
91831,8,10,2,0,8,2
91831,7,18,4,0,14,4
91831,6,35,9,0,26,9
91831,5,9,1,0,8,1
91831,4,5,1,0,4,1
91831,3,2,1,0,1,1
188793,8,14,3,0,11,3
188793,7,15,1,0,14,1
188793,6,31,5,0,26,5
188793,4,7,1,0,6,1
188793,2,1,1,0,0,1
188793,1,2,1,0,1,1
90142,9,5,3,0,2,3
90142,8,10,4,0,6,4
90142,7,15,4,0,11,4
90142,6,28,9,0,19,9
90142,5,17,4,0,13,4
90142,4,5,3,0,2,3
10269,9,3,1,0,2,1
10269,8,14,9,0,5,9
10269,7,26,11,0,15,11
10269,6,25,8,0,17,8
10269,5,9,6,0,3,6
183836,10,7,3,0,4,3
183836,9,14,7,0,7,7
183836,8,33,9,0,24,9
183836,7,15,4,0,11,4
183836,6,7,4,0,3,4
183836,5,4,1,0,3,1
183836,1,1,1,0,0,1
37383,10,3,1,0,2,1
37383,9,20,7,0,13,7
37383,8,31,9,0,22,9
37383,7,15,4,0,11,4
37383,6,10,3,0,7,3
37383,5,2,1,0,1,1
104736,9,10,1,0,9,1
104736,8,19,4,0,15,4
104736,7,25,3,0,22,3
104736,6,16,1,0,15,1
104736,5,6,1,0,5,1
104736,4,4,1,0,3,1
3807,10,2,1,0,1,1
3807,8,20,7,0,13,7
3807,7,20,13,0,7,13
3807,6,30,16,0,14,16
3807,4,4,2,0,2,2
3807,3,3,1,0,2,1
109005,7,21,2,0,19,2
109005,6,25,2,0,23,2
109005,5,13,3,0,10,3
109005,4,8,2,0,6,2
109005,3,5,4,0,1,4
109005,2,2,2,0,0,2
174298,10,14,7,0,7,7
174298,9,35,13,0,22,13
174298,8,22,6,0,16,6
174298,7,6,2,0,4,2
174298,5,2,1,0,1,1
174298,4,1,1,0,0,1
174298,3,1,1,0,0,1
91739,9,23,5,0,18,5
91739,8,30,15,0,15,15
91739,7,20,4,0,16,4
91739,6,4,2,0,2,2
91739,5,1,1,0,0,1
6532,6,9,3,0,6,3
6532,5,23,4,0,19,4
6532,4,14,5,0,9,5
6532,3,13,2,0,11,2
202582,9,4,2,0,2,2
202582,7,18,5,0,13,5
202582,6,21,3,0,18,3
202582,5,7,2,0,5,2
202582,4,11,3,0,8,3
202582,3,4,1,0,3,1
6022,10,2,1,0,1,1
6022,9,3,1,0,2,1
6022,8,8,2,0,6,2
6022,7,12,5,0,7,5
6022,6,23,7,0,16,7
6022,5,23,7,0,16,7
6022,4,5,2,0,3,2
6022,3,4,4,0,0,4
6022,2,1,1,0,0,1
8140,8,19,4,0,15,4
8140,7,22,2,0,20,2
8140,6,22,7,0,15,7
8140,5,10,2,0,8,2
8140,4,4,4,0,0,4
8140,2,1,1,0,0,1
65565,9,3,3,0,0,3
65565,8,23,10,0,13,10
65565,7,38,21,0,17,21
65565,6,12,3,0,9,3
65565,5,3,1,0,2,1
65565,3,1,1,0,0,1
38578,10,12,3,0,9,3
38578,9,18,9,0,9,9
38578,8,18,4,0,14,4
38578,7,13,1,0,12,1
38578,6,7,1,0,6,1
38578,5,4,1,0,3,1
38578,4,4,1,0,3,1
38578,3,2,1,0,1,1
38578,2,1,1,0,0,1
38578,1,3,2,0,1,2
11394,9,3,3,0,0,3
11394,8,4,1,0,3,1
11394,7,12,7,0,5,7
11394,6,22,8,0,14,8
11394,5,22,4,0,18,4
11394,4,14,6,0,8,6
11394,3,2,1,0,1,1
11394,2,3,1,0,2,1
3000,9,8,2,0,6,2
3000,8,24,12,0,12,12
3000,7,20,6,0,14,6
3000,6,17,5,0,12,5
3000,5,5,2,0,3,2
3000,4,2,1,0,1,1
3000,2,1,1,0,0,1
204201,10,6,2,0,4,2
204201,8,15,5,0,10,5
204201,7,19,5,0,14,5
204201,6,25,2,0,23,2
204201,5,3,1,0,2,1
204201,3,3,1,0,2,1
253679,10,2,1,0,1,1
253679,8,14,1,0,13,1
253679,7,28,5,0,23,5
253679,6,26,3,0,23,3
165551,8,6,1,0,5,1
165551,7,13,2,0,11,2
165551,6,21,3,0,18,3
165551,5,22,3,0,19,3
165551,4,10,1,0,9,1
165551,3,9,3,0,6,3
19418,9,6,2,0,4,2
19418,8,10,3,0,7,3
19418,7,23,11,0,12,11
19418,6,26,10,0,16,10
19418,5,10,3,0,7,3
19418,4,4,2,0,2,2
19418,3,3,2,0,1,2
126550,10,5,2,0,3,2
126550,9,5,2,0,3,2
126550,8,19,4,0,15,4
126550,7,23,2,0,21,2
126550,6,13,1,0,12,1
126550,3,3,1,0,2,1
16052,10,1,1,0,0,1
16052,9,1,1,0,0,1
16052,8,4,1,0,3,1
16052,7,5,3,0,2,3
16052,6,23,12,0,11,12
16052,5,24,13,0,11,13
16052,4,10,2,0,8,2
16052,3,4,2,0,2,2
16052,2,7,3,0,4,3
191895,7,24,3,0,21,3
191895,6,25,3,0,22,3
58707,7,15,3,0,12,3
58707,6,35,1,0,34,1
58707,4,7,1,0,6,1
58707,3,4,1,0,3,1
81297,10,2,1,0,1,1
81297,8,17,5,0,12,5
81297,7,20,3,0,17,3
81297,6,21,3,0,18,3
81297,5,9,2,0,7,2
81297,4,6,2,0,4,2
81297,1,3,1,0,2,1
3574,8,2,2,0,0,2
3574,7,7,3,0,4,3
3574,6,26,6,0,20,6
3574,5,14,6,0,8,6
3574,4,16,6,0,10,6
3574,3,11,1,0,10,1
3574,2,2,1,0,1,1
3574,1,2,1,0,1,1
37394,8,11,4,0,7,4
37394,7,21,10,0,11,10
37394,6,29,9,0,20,9
37394,5,11,1,0,10,1
37394,4,9,5,0,4,5
6826,10,6,2,0,4,2
6826,9,7,4,0,3,4
6826,8,19,4,0,15,4
6826,7,15,8,0,7,8
6826,6,13,2,0,11,2
6826,5,11,4,0,7,4
6826,4,4,2,0,2,2
6826,3,6,2,0,4,2
6826,2,1,1,0,0,1
2403,8,2,1,0,1,1
2403,6,27,6,0,21,6
2403,5,26,5,0,21,5
2403,4,11,3,0,8,3
2403,3,5,2,0,3,2
2403,1,2,2,0,0,2
11001,9,1,1,0,0,1
11001,7,6,2,0,4,2
11001,6,32,9,0,23,9
11001,5,16,3,0,13,3
11001,4,18,9,0,9,9
11001,3,5,3,0,2,3
791,8,10,3,0,7,3
791,7,14,5,0,9,5
791,6,34,11,0,23,11
791,5,13,6,0,7,6
791,4,5,3,0,2,3
791,3,2,2,0,0,2
791,2,3,2,0,1,2
136279,9,2,1,0,1,1
136279,8,14,1,0,13,1
136279,7,27,4,0,23,4
136279,6,26,6,0,20,6
136279,5,6,1,0,5,1
136279,4,5,1,0,4,1
136279,3,1,1,0,0,1
220284,10,13,3,0,10,3
220284,9,17,7,0,10,7
220284,8,17,1,0,16,1
220284,7,14,2,0,12,2
220284,6,13,1,0,12,1
220284,5,3,1,0,2,1
220284,4,3,1,0,2,1
196698,10,12,5,0,7,5
196698,9,10,3,0,7,3
196698,8,18,2,0,16,2
196698,7,21,2,0,19,2
196698,6,13,1,0,12,1
196698,5,3,1,0,2,1
196698,4,3,1,0,2,1
22029,10,12,6,0,6,6
22029,9,27,6,0,21,6
22029,8,14,4,0,10,4
22029,7,11,2,0,9,2
22029,6,10,4,0,6,4
22029,5,4,2,0,2,2
22029,1,2,2,0,0,2
3077,8,9,4,0,5,4
3077,7,16,4,0,12,4
3077,6,23,6,0,17,6
3077,5,9,2,0,7,2
3077,4,12,4,0,8,4
3077,3,3,2,0,1,2
3077,1,3,1,0,2,1
1657,10,2,1,0,1,1
1657,8,7,2,0,5,2
1657,7,14,4,0,10,4
1657,6,19,7,0,12,7
1657,5,17,4,0,13,4
1657,3,5,1,0,4,1
1657,2,5,3,0,2,3
1657,1,3,1,0,2,1
12996,8,3,1,0,2,1
12996,7,9,7,0,2,7
12996,6,15,8,0,7,8
12996,5,25,6,0,19,6
12996,4,12,2,0,10,2
12996,3,7,3,0,4,3
12996,2,7,3,0,4,3
12996,1,4,2,0,2,2
6009,9,4,1,0,3,1
6009,8,10,3,0,7,3
6009,7,18,5,0,13,5
6009,6,29,11,0,18,11
6009,5,13,2,0,11,2
6009,4,4,2,0,2,2
3603,9,4,3,0,1,3
3603,8,16,7,0,9,7
3603,7,25,3,0,22,3
3603,6,19,7,0,12,7
3603,5,9,2,0,7,2
3603,3,3,1,0,2,1
55781,8,32,9,0,23,9
55781,7,26,9,0,17,9
55781,6,12,3,0,9,3
55781,5,2,2,0,0,2
55781,4,5,4,0,1,4
55781,3,1,1,0,0,1
55781,2,2,1,0,1,1
123991,10,1,1,0,0,1
123991,6,26,1,0,25,1
123991,3,7,2,0,5,2
123991,2,4,1,0,3,1
26363,8,9,3,0,6,3
26363,7,25,5,0,20,5
26363,6,27,9,0,18,9
26363,5,9,4,0,5,4
26363,4,7,4,0,3,4
26363,3,4,3,0,1,3
26363,2,1,1,0,0,1
114316,10,1,1,0,0,1
114316,9,1,1,0,0,1
114316,8,11,7,0,4,7
114316,7,11,4,1,7,3
114316,6,28,7,0,21,7
114316,5,13,4,0,9,4
114316,3,2,1,0,1,1
114316,2,8,4,0,4,4
114316,1,3,1,0,2,1
121122,10,5,1,0,4,1
121122,8,6,2,0,4,2
121122,7,9,3,1,6,2
121122,6,28,6,1,22,5
121122,5,13,3,0,10,3
121122,4,11,5,0,6,5
121122,3,8,3,0,5,3
121122,2,2,1,0,1,1
227466,10,4,3,0,1,3
227466,9,8,2,0,6,2
227466,8,24,3,0,21,3
227466,7,18,3,0,15,3
227466,6,24,1,0,23,1
35910,9,7,6,0,1,6
35910,8,16,9,0,7,9
35910,7,32,17,0,15,17
35910,6,17,9,0,8,9
35910,5,8,3,0,5,3
230424,10,7,3,0,4,3
230424,9,8,2,0,6,2
230424,8,24,4,1,20,3
230424,7,12,5,0,7,5
230424,6,12,2,0,10,2
230424,5,13,3,0,10,3
230424,3,4,3,0,1,3
1063,9,1,1,0,0,1
1063,7,17,2,0,15,2
1063,6,23,3,0,20,3
1063,5,18,1,0,17,1
1063,4,7,2,0,5,2
1063,3,6,3,0,3,3
1063,2,5,2,0,3,2
1063,1,1,1,0,0,1
8304,8,16,4,0,12,4
8304,7,22,9,0,13,9
8304,6,17,3,0,14,3
8304,5,13,6,0,7,6
8304,4,4,1,0,3,1
8304,3,3,1,0,2,1
14538,6,15,4,0,11,4
14538,5,14,2,0,12,2
14538,4,21,3,0,18,3
14538,3,11,2,0,9,2
14538,2,9,4,0,5,4
14538,1,5,2,0,3,2
240584,8,23,4,0,19,4
240584,7,28,7,0,21,7
240584,6,18,4,0,14,4
240584,5,7,2,0,5,2
240584,4,5,2,0,3,2
240584,3,1,1,0,0,1
126206,10,3,2,0,1,2
126206,9,3,2,0,1,2
126206,8,10,2,0,8,2
126206,7,10,2,0,8,2
126206,6,24,8,2,16,6
126206,5,17,7,0,10,7
126206,4,5,1,0,4,1
126206,3,4,3,0,1,3
126206,2,6,3,0,3,3
165797,8,9,1,0,8,1
165797,7,17,3,0,14,3
165797,6,24,2,0,22,2
165797,5,14,2,0,12,2
165797,4,10,4,0,6,4
165797,3,4,1,0,3,1
146864,9,1,1,0,0,1
146864,8,5,1,0,4,1
146864,7,9,1,0,8,1
146864,6,23,5,0,18,5
146864,5,13,2,0,11,2
146864,4,19,5,0,14,5
146864,1,2,1,0,1,1
141825,10,8,5,1,3,4
141825,9,9,2,0,7,2
141825,8,21,6,1,15,5
141825,7,14,5,0,9,5
141825,6,21,6,0,15,6
141825,5,5,2,0,3,2
141825,2,1,1,0,0,1
141825,1,1,1,0,0,1
70376,8,9,2,0,7,2
70376,7,12,2,0,10,2
70376,6,27,7,0,20,7
70376,5,18,2,0,16,2
6862,10,2,1,0,1,1
6862,9,6,3,0,3,3
6862,8,20,5,0,15,5
6862,7,22,4,0,18,4
6862,6,17,3,0,14,3
6862,5,9,1,0,8,1
6862,4,4,3,0,1,3
6862,3,2,1,0,1,1
18588,8,12,3,0,9,3
18588,7,16,4,0,12,4
18588,6,39,5,0,34,5
18588,5,6,2,0,4,2
18588,4,4,2,0,2,2
18588,1,1,1,0,0,1
208256,10,6,1,0,5,1
208256,9,6,1,0,5,1
208256,8,19,1,0,18,1
208256,7,21,2,0,19,2
208256,6,19,3,0,16,3
208256,2,3,2,0,1,2
173005,10,4,3,0,1,3
173005,8,12,4,2,8,2
173005,7,9,3,0,6,3
173005,6,26,4,0,22,4
173005,5,14,6,0,8,6
173005,4,7,1,0,6,1
173005,3,6,3,0,3,3
173005,2,1,1,0,0,1
260789,10,40,14,0,26,14
260789,9,14,8,0,6,8
260789,8,16,10,0,6,10
260789,7,4,3,0,1,3
260789,6,2,1,0,1,1
260789,5,4,2,0,2,2
260789,1,2,1,0,1,1
1473,10,1,1,0,0,1
1473,8,2,1,0,1,1
1473,7,15,5,0,10,5
1473,6,20,5,0,15,5
1473,5,19,6,0,13,6
1473,4,14,5,0,9,5
1473,3,7,3,0,4,3
1473,2,4,3,0,1,3
7377,10,2,1,0,1,1
7377,9,2,1,0,1,1
7377,8,13,2,0,11,2
7377,7,27,8,0,19,8
7377,6,25,5,0,20,5
7377,5,6,1,0,5,1
7377,4,5,3,0,2,3
42066,9,1,1,0,0,1
42066,7,21,3,0,18,3
42066,6,35,8,0,27,8
42066,4,8,1,0,7,1
42066,3,3,1,0,2,1
9583,9,2,2,0,0,2
9583,8,7,1,0,6,1
9583,7,13,6,0,7,6
9583,6,21,5,0,16,5
9583,5,22,7,0,15,7
9583,4,9,3,0,6,3
8332,8,6,1,0,5,1
8332,7,9,2,0,7,2
8332,6,26,11,0,15,11
8332,5,21,4,0,17,4
8332,4,9,2,0,7,2
8332,3,3,2,0,1,2
8332,2,5,2,0,3,2
8332,1,1,1,0,0,1
172035,9,2,1,0,1,1
172035,7,6,2,0,4,2
172035,6,33,7,0,26,7
172035,5,23,5,0,18,5
172035,4,10,3,0,7,3
172035,2,1,1,0,0,1
172035,1,1,1,0,0,1
159877,10,2,2,0,0,2
159877,9,11,4,0,7,4
159877,8,25,15,1,10,14
159877,7,20,5,0,15,5
159877,6,12,3,0,9,3
159877,5,3,2,0,1,2
159877,4,9,1,0,8,1
250821,10,19,8,0,11,8
250821,9,22,9,0,13,9
250821,8,19,9,0,10,9
250821,7,14,1,0,13,1
250821,6,7,2,0,5,2
175090,7,9,1,0,8,1
175090,6,18,2,0,16,2
175090,5,14,3,0,11,3
175090,4,13,3,0,10,3
175090,3,11,1,0,10,1
175090,2,9,4,0,5,4
153213,10,8,5,0,3,5
153213,9,7,3,1,4,2
153213,8,16,3,0,13,3
153213,7,14,2,1,12,1
153213,6,16,2,0,14,2
153213,4,5,2,0,3,2
153213,3,7,2,1,5,1
153213,2,2,1,0,1,1
43693,9,1,1,0,0,1
43693,8,13,4,0,9,4
43693,7,11,5,0,6,5
43693,6,25,7,0,18,7
43693,5,19,9,0,10,9
43693,4,3,1,0,2,1
43693,3,5,4,0,1,4
43693,2,2,2,0,0,2
707,9,4,1,0,3,1
707,8,7,3,0,4,3
707,7,15,3,0,12,3
707,6,31,11,0,20,11
707,5,14,4,0,10,4
707,4,4,1,0,3,1
707,3,3,2,0,1,2
707,2,1,1,0,0,1
707,1,1,1,0,0,1
10807,8,7,3,0,4,3
10807,7,10,2,0,8,2
10807,6,20,3,0,17,3
10807,5,18,4,0,14,4
10807,4,14,6,0,8,6
10807,3,4,1,0,3,1
10807,2,5,4,0,1,4
10807,1,4,2,0,2,2
179547,10,4,2,0,2,2
179547,9,24,6,0,18,6
179547,8,30,4,0,26,4
179547,7,11,1,0,10,1
33259,9,10,4,0,6,4
33259,8,36,13,0,23,13
33259,7,18,3,0,15,3
33259,6,9,3,0,6,3
33259,4,1,1,0,0,1
33259,3,2,2,0,0,2
154477,9,4,2,0,2,2
154477,8,3,2,1,1,1
154477,7,14,1,0,13,1
154477,6,26,5,0,21,5
154477,5,17,4,0,13,4
154477,4,13,3,0,10,3
154477,2,1,1,0,0,1
154477,1,1,1,0,0,1
801,9,8,3,0,5,3
801,8,12,6,0,6,6
801,7,28,8,0,20,8
801,6,24,8,0,16,8
801,5,6,1,0,5,1
801,4,2,1,0,1,1
2369,9,2,1,0,1,1
2369,8,5,5,0,0,5
2369,7,16,6,0,10,6
2369,6,35,9,0,26,9
2369,5,17,5,0,12,5
2369,4,4,1,0,3,1
104558,8,9,1,0,8,1
104558,7,21,4,0,17,4
104558,6,30,7,0,23,7
104558,5,10,1,0,9,1
104558,3,5,1,0,4,1
104558,2,1,1,0,0,1
8965,9,2,1,0,1,1
8965,8,9,1,0,8,1
8965,7,18,4,0,14,4
8965,6,30,8,0,22,8
8965,5,10,3,0,7,3
8965,4,7,2,0,5,2
8965,2,2,1,0,1,1
180908,8,12,3,0,9,3
180908,7,14,5,0,9,5
180908,6,20,6,0,14,6
180908,5,21,6,0,15,6
180908,4,8,4,0,4,4
180908,2,1,1,0,0,1
180908,1,2,1,0,1,1
179251,10,8,2,0,6,2
179251,9,14,3,0,11,3
179251,8,23,7,0,16,7
179251,7,15,5,0,10,5
179251,6,12,2,0,10,2
179251,5,2,1,0,1,1
179251,4,3,2,0,1,2
179251,3,2,2,0,0,2
179251,2,1,1,0,0,1
179251,1,1,1,0,0,1
9077,9,5,3,0,2,3
9077,8,17,6,0,11,6
9077,7,20,7,0,13,7
9077,6,20,9,0,11,9
9077,5,13,5,0,8,5
111119,8,23,3,0,20,3
111119,7,22,3,0,19,3
111119,6,19,2,0,17,2
111119,5,5,2,0,3,2
13654,9,1,1,0,0,1
13654,8,6,2,0,4,2
13654,7,13,4,0,9,4
13654,6,32,8,0,24,8
13654,5,13,4,0,9,4
13654,4,9,3,0,6,3
13654,3,2,1,0,1,1
13654,1,3,1,0,2,1
3516,9,2,2,0,0,2
3516,8,7,3,0,4,3
3516,7,8,4,0,4,4
3516,6,28,6,0,22,6
3516,5,21,4,0,17,4
3516,3,4,2,0,2,2
3516,2,4,1,0,3,1
18875,8,13,6,0,7,6
18875,7,13,3,0,10,3
18875,6,23,7,0,16,7
18875,5,14,5,0,9,5
18875,4,8,1,0,7,1
18875,3,5,3,0,2,3
18875,2,1,1,0,0,1
18875,1,2,2,0,0,2
4343,10,6,1,0,5,1
4343,9,4,1,0,3,1
4343,8,16,5,0,11,5
4343,7,24,5,0,19,5
4343,6,20,4,0,16,4
4343,5,8,2,0,6,2
4343,3,3,2,0,1,2
6010,7,6,1,0,5,1
6010,6,26,7,0,19,7
6010,5,17,6,0,11,6
6010,4,15,4,0,11,4
6010,3,9,2,0,7,2
6010,2,3,1,0,2,1
66551,10,2,1,0,1,1
66551,9,5,2,0,3,2
66551,7,15,4,0,11,4
66551,6,22,4,0,18,4
66551,5,13,3,0,10,3
66551,4,5,1,0,4,1
66551,3,10,5,0,5,5
66551,2,1,1,0,0,1
8479,7,2,1,0,1,1
8479,6,20,9,0,11,9
8479,5,19,2,0,17,2
8479,4,21,10,0,11,10
8479,3,12,6,0,6,6
8479,2,5,2,0,3,2
56943,9,4,1,0,3,1
56943,8,10,3,0,7,3
56943,7,28,4,0,24,4
56943,6,29,4,0,25,4
56943,5,7,3,0,4,3
15383,10,1,1,0,0,1
15383,9,4,2,0,2,2
15383,7,16,3,0,13,3
15383,6,29,6,0,23,6
15383,5,17,2,0,15,2
15383,4,7,2,0,5,2
15383,2,1,1,0,0,1
783,9,1,1,0,0,1
783,8,13,6,0,7,6
783,7,15,6,0,9,6
783,6,28,8,0,20,8
783,5,10,2,0,8,2
783,4,8,2,0,6,2
783,3,5,1,0,4,1
221263,8,4,2,0,2,2
221263,7,18,1,0,17,1
221263,5,15,3,0,12,3
221263,4,12,3,0,9,3
221263,3,1,1,0,0,1
148940,9,3,1,0,2,1
148940,8,5,2,0,3,2
148940,7,16,5,0,11,5
148940,6,20,1,0,19,1
148940,5,18,3,0,15,3
148940,3,2,1,0,1,1
203885,9,1,1,0,0,1
203885,8,11,2,0,9,2
203885,7,27,6,0,21,6
203885,6,32,6,0,26,6
16620,9,2,2,0,0,2
16620,7,6,1,0,5,1
16620,6,20,6,0,14,6
16620,5,23,6,0,17,6
16620,4,17,9,0,8,9
16620,3,5,3,0,2,3
16620,2,5,1,0,4,1
6040,8,5,2,0,3,2
6040,7,20,5,0,15,5
6040,6,24,10,0,14,10
6040,5,13,3,0,10,3
6040,4,13,5,0,8,5
6040,3,3,1,0,2,1
6040,2,1,1,0,0,1
30261,8,7,1,0,6,1
30261,7,22,4,0,18,4
30261,6,27,6,0,21,6
30261,5,11,2,0,9,2
30261,4,4,2,0,2,2
30261,3,4,1,0,3,1
30261,2,4,2,0,2,2
191906,9,4,1,0,3,1
191906,8,3,1,0,2,1
191906,7,21,2,0,19,2
191906,6,30,2,0,28,2
191906,4,7,3,0,4,3
191906,3,3,2,0,1,2
105864,10,2,1,0,1,1
105864,9,5,1,0,4,1
105864,8,11,6,0,5,6
105864,7,21,3,0,18,3
105864,6,28,14,0,14,14
105864,5,9,3,0,6,3
105864,4,3,2,0,1,2
127646,8,10,2,0,8,2
127646,7,14,2,0,12,2
127646,6,25,4,0,21,4
127646,5,17,2,0,15,2
127646,4,6,1,0,5,1
127646,1,2,1,0,1,1
19416,9,4,2,0,2,2
19416,8,7,5,0,2,5
19416,7,19,7,0,12,7
19416,6,29,13,0,16,13
19416,5,14,4,0,10,4
19416,3,4,2,0,2,2
23615,10,1,1,0,0,1
23615,9,5,3,0,2,3
23615,8,14,7,0,7,7
23615,7,31,10,0,21,10
23615,6,21,9,0,12,9
23615,5,7,2,0,5,2
23615,4,2,1,0,1,1
23615,3,1,1,0,0,1
20269,9,2,2,0,0,2
20269,8,24,12,0,12,12
20269,7,26,9,0,17,9
20269,6,22,10,0,12,10
20269,5,3,2,0,1,2
26604,10,2,1,0,1,1
26604,9,3,2,0,1,2
26604,8,13,6,0,7,6
26604,7,13,2,0,11,2
26604,6,26,10,0,16,10
26604,5,13,2,0,11,2
26604,4,7,2,0,5,2
3457,8,5,4,0,1,4
3457,7,13,4,0,9,4
3457,6,28,8,0,20,8
3457,5,20,6,0,14,6
3457,4,11,5,0,6,5
3457,3,3,2,0,1,2
224060,10,2,1,0,1,1
224060,9,2,1,0,1,1
224060,8,9,6,0,3,6
224060,7,26,5,0,21,5
224060,6,22,3,0,19,3
224060,5,8,2,0,6,2
224060,4,9,1,0,8,1
101335,7,6,3,0,3,3
101335,6,18,1,0,17,1
101335,5,23,3,0,20,3
101335,4,17,3,0,14,3
101335,3,6,4,0,2,4
101335,2,4,2,0,2,2
101335,1,5,1,0,4,1
189154,8,21,3,0,18,3
189154,7,19,2,1,17,1
189154,6,16,3,1,13,2
189154,5,6,1,0,5,1
189154,4,6,4,0,2,4
189154,3,5,2,0,3,2
189154,1,1,1,0,0,1
225736,9,13,5,1,8,4
225736,8,18,4,1,14,3
225736,7,27,3,0,24,3
225736,6,11,1,0,10,1
225736,5,6,2,0,4,2
225736,4,1,1,0,0,1
225736,2,2,1,0,1,1
165889,10,1,1,0,0,1
165889,9,1,1,0,0,1
165889,8,8,2,0,6,2
165889,7,22,7,0,15,7
165889,6,26,6,0,20,6
165889,5,12,3,0,9,3
165889,4,8,3,0,5,3
165889,3,1,1,0,0,1
165889,1,1,1,0,0,1
6363,7,9,1,0,8,1
6363,6,22,4,0,18,4
6363,5,21,1,0,20,1
6363,4,15,2,0,13,2
6363,3,3,1,0,2,1
6363,2,7,3,0,4,3
25204,10,3,1,0,2,1
25204,7,13,3,0,10,3
25204,6,27,7,0,20,7
25204,5,23,4,0,19,4
25204,4,7,3,0,4,3
25204,1,2,1,0,1,1
95115,10,3,1,0,2,1
95115,7,14,2,0,12,2
95115,6,21,2,0,19,2
95115,4,11,4,0,7,4
95115,3,9,2,0,7,2
95115,2,5,1,0,4,1
95115,1,2,1,0,1,1
141089,10,2,1,0,1,1
141089,8,13,2,0,11,2
141089,7,15,4,0,11,4
141089,6,24,5,0,19,5
141089,5,10,2,0,8,2
141089,2,3,1,0,2,1
141089,1,2,2,0,0,2
11899,9,1,1,0,0,1
11899,8,6,1,0,5,1
11899,7,18,4,0,14,4
11899,6,25,5,0,20,5
11899,5,14,2,0,12,2
11899,4,12,4,0,8,4
36790,8,5,1,0,4,1
36790,7,19,4,0,15,4
36790,6,34,7,0,27,7
36790,5,11,1,0,10,1
36790,4,8,2,0,6,2
36790,3,2,1,0,1,1
202490,9,6,1,1,5,0
202490,8,18,7,0,11,7
202490,7,24,1,0,23,1
202490,6,15,5,0,10,5
202490,4,4,1,0,3,1
202490,3,5,3,0,2,3
4893,10,3,1,0,2,1
4893,8,6,1,0,5,1
4893,7,5,2,0,3,2
4893,6,25,5,0,20,5
4893,5,15,2,0,13,2
4893,4,16,2,0,14,2
4893,3,6,1,0,5,1
4893,1,1,1,0,0,1
1443,9,2,1,0,1,1
1443,8,3,2,0,1,2
1443,7,5,2,0,3,2
1443,6,16,4,0,12,4
1443,5,32,10,0,22,10
1443,4,11,1,0,10,1
1443,3,9,1,0,8,1
6840,8,4,1,0,3,1
6840,7,16,5,0,11,5
6840,6,22,2,0,20,2
6840,5,15,6,0,9,6
6840,4,13,7,0,6,7
6840,3,4,1,0,3,1
6840,2,3,1,0,2,1
6840,1,2,1,0,1,1
195253,8,14,4,0,10,4
195253,7,19,3,0,16,3
195253,6,20,2,0,18,2
195253,4,5,2,0,3,2
195253,3,3,1,0,2,1
21343,8,4,3,0,1,3
21343,7,13,6,0,7,6
21343,6,35,9,0,26,9
21343,5,15,2,0,13,2
21343,4,11,5,0,6,5
934,7,12,4,0,8,4
934,6,29,4,0,25,4
934,5,20,1,0,19,1
934,4,9,3,0,6,3
934,3,5,2,0,3,2
5146,10,2,1,0,1,1
5146,9,2,1,0,1,1
5146,8,15,6,0,9,6
5146,7,15,5,0,10,5
5146,6,30,9,0,21,9
5146,5,11,4,0,7,4
5146,4,2,1,0,1,1
5146,3,2,1,0,1,1
5146,2,2,2,0,0,2
5993,10,2,1,0,1,1
5993,9,3,1,0,2,1
5993,8,5,3,0,2,3
5993,7,30,10,0,20,10
5993,6,25,4,0,21,4
5993,5,10,5,0,5,5
5993,4,5,1,0,4,1
207311,10,2,2,0,0,2
207311,9,4,1,0,3,1
207311,7,7,2,1,5,1
207311,6,27,4,0,23,4
207311,5,14,2,0,12,2
207311,4,5,2,0,3,2
207311,3,9,4,1,5,3
207311,2,5,2,0,3,2
137179,8,8,4,1,4,3
137179,7,17,7,2,10,5
137179,6,27,6,2,21,4
137179,5,18,4,1,14,3
137179,4,7,1,0,6,1
137179,2,1,1,0,0,1
15196,8,7,1,0,6,1
15196,7,13,6,0,7,6
15196,6,33,6,0,27,6
15196,5,13,2,0,11,2
15196,4,11,2,0,9,2
15196,3,3,2,0,1,2
1703,7,3,1,0,2,1
1703,6,25,2,0,23,2
1703,5,29,6,0,23,6
1703,4,13,3,0,10,3
1703,3,6,3,0,3,3
1703,2,4,1,0,3,1
2094,10,1,1,0,0,1
2094,8,5,2,0,3,2
2094,7,8,3,0,5,3
2094,6,16,7,0,9,7
2094,5,20,7,0,13,7
2094,4,13,4,0,9,4
2094,3,13,6,0,7,6
2094,2,2,2,0,0,2
2094,1,3,3,0,0,3
8747,10,5,1,0,4,1
8747,9,2,1,0,1,1
8747,8,10,4,0,6,4
8747,7,14,4,0,10,4
8747,6,24,11,0,13,11
8747,5,14,6,0,8,6
8747,4,6,3,0,3,3
8747,3,4,2,0,2,2
84230,8,7,2,0,5,2
84230,7,20,6,0,14,6
84230,6,26,3,0,23,3
84230,5,11,4,0,7,4
84230,4,5,2,0,3,2
84230,3,2,1,0,1,1
32849,9,1,1,0,0,1
32849,8,3,1,0,2,1
32849,7,4,2,0,2,2
32849,6,22,10,0,12,10
32849,5,23,10,0,13,10
32849,4,15,4,0,11,4
32849,3,9,2,0,7,2
1641,9,2,2,0,0,2
1641,8,7,3,0,4,3
1641,7,10,5,0,5,5
1641,6,22,9,0,13,9
1641,5,11,3,0,8,3
1641,4,12,5,0,7,5
1641,3,12,5,0,7,5
1641,2,5,3,0,2,3
42361,10,8,1,0,7,1
42361,9,13,5,0,8,5
42361,8,21,5,0,16,5
42361,7,11,3,0,8,3
42361,6,13,3,0,10,3
42361,5,8,3,0,5,3
42361,4,5,3,0,2,3
1534,8,5,3,0,2,3
1534,7,7,3,0,4,3
1534,6,26,7,0,19,7
1534,5,18,7,0,11,7
1534,4,14,6,0,8,6
1534,3,9,3,0,6,3
1534,2,2,2,0,0,2
4254,10,2,1,0,1,1
4254,9,3,1,0,2,1
4254,8,20,7,0,13,7
4254,7,17,6,0,11,6
4254,6,27,11,0,16,11
4254,5,8,3,0,5,3
4254,4,4,1,0,3,1
4240,8,2,1,0,1,1
4240,6,17,5,0,12,5
4240,5,16,6,0,10,6
4240,4,15,6,0,9,6
4240,3,11,5,0,6,5
4240,2,8,4,0,4,4
4240,1,5,2,0,3,2
231644,8,14,1,0,13,1
231644,7,23,7,0,16,7
231644,6,24,3,0,21,3
231644,5,11,2,0,9,2
781,10,2,1,0,1,1
781,9,3,2,0,1,2
781,8,10,5,0,5,5
781,7,18,9,0,9,9
781,6,16,2,0,14,2
781,5,13,4,0,9,4
781,4,12,2,0,10,2
781,3,3,1,0,2,1
136,8,3,2,0,1,2
136,7,19,5,0,14,5
136,6,23,4,0,19,4
136,5,16,4,0,12,4
136,4,15,2,0,13,2
136,2,2,1,0,1,1
166019,10,1,1,0,0,1
166019,7,21,4,0,17,4
166019,6,23,5,0,18,5
166019,5,10,3,0,7,3
166019,4,6,2,0,4,2
130734,7,18,5,0,13,5
130734,6,29,9,0,20,9
130734,5,9,5,0,4,5
130734,4,10,1,0,9,1
130734,3,5,2,0,3,2
113200,8,4,1,0,3,1
113200,7,5,1,0,4,1
113200,6,10,1,0,9,1
113200,5,28,9,0,19,9
113200,4,21,2,0,19,2
113200,3,7,1,0,6,1
113200,2,3,1,0,2,1
113200,1,3,1,0,2,1
2563,8,4,1,0,3,1
2563,7,22,7,0,15,7
2563,6,21,5,0,16,5
2563,5,21,3,0,18,3
2563,4,6,1,0,5,1
2563,3,4,1,0,3,1
2751,9,3,2,0,1,2
2751,8,9,3,0,6,3
2751,7,21,6,0,15,6
2751,6,25,6,0,19,6
2751,5,14,3,0,11,3
2751,4,1,1,0,0,1
2751,3,4,2,0,2,2
2751,2,1,1,0,0,1
2751,1,2,1,0,1,1
85004,9,7,3,0,4,3
85004,8,11,2,0,9,2
85004,7,19,5,0,14,5
85004,6,27,7,0,20,7
85004,5,10,3,0,7,3
85004,4,5,1,0,4,1
4623,10,3,2,0,1,2
4623,8,7,3,0,4,3
4623,7,11,3,0,8,3
4623,6,29,9,0,20,9
4623,5,13,5,0,8,5
4623,4,9,3,0,6,3
4623,3,4,3,0,1,3
4623,2,2,1,0,1,1
4623,1,1,1,0,0,1
25760,9,2,1,0,1,1
25760,8,20,6,0,14,6
25760,7,17,3,0,14,3
25760,6,29,13,0,16,13
25760,5,7,3,0,4,3
25760,4,4,2,0,2,2
25760,3,2,2,0,0,2
16232,8,3,1,0,2,1
16232,6,19,8,0,11,8
16232,5,20,4,0,16,4
16232,4,17,3,0,14,3
16232,3,9,1,0,8,1
16232,1,2,1,0,1,1
184462,8,12,1,0,11,1
184462,7,23,3,0,20,3
184462,6,27,5,0,22,5
184462,5,7,1,0,6,1
184462,4,5,4,0,1,4
123635,9,3,1,0,2,1
123635,8,17,4,1,13,3
123635,7,20,7,2,13,5
123635,6,18,5,1,13,4
123635,5,11,4,0,7,4
123635,4,8,5,1,3,4
123635,3,2,2,0,0,2
731,10,1,1,0,0,1
731,9,1,1,0,0,1
731,8,7,2,0,5,2
731,7,13,4,0,9,4
731,6,19,11,0,8,11
731,5,19,6,0,13,6
731,4,10,3,0,7,3
731,3,5,1,0,4,1
731,2,4,2,0,2,2
731,1,1,1,0,0,1
38680,9,3,1,0,2,1
38680,8,9,4,0,5,4
38680,7,31,10,0,21,10
38680,6,28,9,0,19,9
38680,5,7,1,0,6,1
8471,10,3,2,0,1,2
8471,9,3,3,0,0,3
8471,8,6,4,0,2,4
8471,7,16,3,0,13,3
8471,6,26,8,0,18,8
8471,5,11,3,0,8,3
8471,4,4,1,0,3,1
8471,3,5,3,0,2,3
8471,1,4,1,0,3,1
184170,10,11,5,0,6,5
184170,9,7,2,0,5,2
184170,8,21,6,0,15,6
184170,7,14,1,0,13,1
184170,3,6,2,0,4,2
42380,8,5,3,0,2,3
42380,7,12,6,0,6,6
42380,6,28,10,0,18,10
42380,5,9,3,0,6,3
42380,4,14,5,0,9,5
42380,3,7,6,0,1,6
42380,2,1,1,0,0,1
42380,1,2,1,0,1,1
26089,8,3,2,0,1,2
26089,7,12,3,0,9,3
26089,6,26,3,0,23,3
26089,5,12,1,0,11,1
26089,4,10,2,0,8,2
26089,3,10,2,0,8,2
26089,2,6,4,0,2,4
194307,10,12,4,0,8,4
194307,9,10,3,1,7,2
194307,8,20,7,2,13,5
194307,7,17,4,0,13,4
194307,6,8,1,0,7,1
194307,4,3,1,0,2,1
194307,2,2,2,0,0,2
7851,8,9,6,0,3,6
7851,7,16,5,0,11,5
7851,6,24,9,0,15,9
7851,5,15,7,0,8,7
7851,4,7,4,0,3,4
7851,3,4,2,0,2,2
7851,2,5,2,0,3,2
11482,10,2,1,0,1,1
11482,8,4,1,0,3,1
11482,7,19,4,0,15,4
11482,6,31,12,0,19,12
11482,5,14,5,0,9,5
11482,4,5,2,0,3,2
7636,9,2,1,0,1,1
7636,8,14,6,0,8,6
7636,7,22,7,0,15,7
7636,6,27,6,0,21,6
7636,5,7,2,0,5,2
256838,9,2,1,0,1,1
256838,8,12,1,0,11,1
256838,7,23,3,0,20,3
256838,6,29,3,0,26,3
256838,4,3,1,0,2,1
256838,3,2,1,0,1,1
163565,8,8,2,0,6,2
163565,7,16,5,0,11,5
163565,6,31,3,0,28,3
163565,5,12,1,0,11,1
163565,4,7,1,0,6,1
17735,8,7,2,0,5,2
17735,7,14,6,0,8,6
17735,6,36,6,0,30,6
17735,5,12,3,0,9,3
222951,10,7,3,0,4,3
222951,9,7,1,0,6,1
222951,8,32,8,0,24,8
222951,7,15,3,0,12,3
222951,6,9,2,0,7,2
222951,5,6,2,0,4,2
240827,9,1,1,0,0,1
240827,8,15,2,0,13,2
240827,7,24,5,0,19,5
240827,6,27,4,0,23,4
240827,5,4,1,0,3,1
240827,4,3,1,0,2,1
240827,3,3,1,0,2,1
14236,9,3,3,0,0,3
14236,8,3,1,0,2,1
14236,7,10,5,0,5,5
14236,6,32,11,0,21,11
14236,5,13,5,0,8,5
14236,4,9,4,0,5,4
14236,3,4,2,0,2,2
14236,2,3,2,0,1,2
195353,10,7,5,0,2,5
195353,9,8,3,0,5,3
195353,8,25,8,0,17,8
195353,7,19,5,0,14,5
195353,6,15,1,0,14,1
195353,5,4,2,0,2,2
195353,4,1,1,0,0,1
175855,10,2,1,0,1,1
175855,9,4,3,0,1,3
175855,8,7,2,0,5,2
175855,7,17,3,0,14,3
175855,6,18,3,0,15,3
175855,5,12,1,0,11,1
175855,4,10,5,0,5,5
175855,3,4,3,0,1,3
175855,2,5,2,0,3,2
94481,8,7,1,0,6,1
94481,7,8,1,0,7,1
94481,6,18,4,0,14,4
94481,5,23,7,0,16,7
94481,4,11,3,0,8,3
94481,3,9,4,0,5,4
94481,2,1,1,0,0,1
43196,10,4,1,0,3,1
43196,8,31,12,0,19,12
43196,7,14,3,0,11,3
43196,6,18,7,0,11,7
43196,5,4,1,0,3,1
43196,4,2,1,0,1,1
43196,3,1,1,0,0,1
225976,10,4,1,0,3,1
225976,8,28,5,0,23,5
225976,7,25,6,0,19,6
225976,6,12,5,0,7,5
225976,5,3,1,0,2,1
117862,9,1,1,0,0,1
117862,8,5,2,0,3,2
117862,7,13,2,0,11,2
117862,6,34,8,0,26,8
117862,5,12,3,0,9,3
117862,4,9,2,0,7,2
117862,3,2,1,0,1,1
168265,10,1,1,0,0,1
168265,9,7,2,0,5,2
168265,8,16,2,1,14,1
168265,7,18,5,0,13,5
168265,5,9,2,0,7,2
168265,3,1,1,1,0,0
168265,2,1,1,0,0,1
184800,9,5,2,0,3,2
184800,8,18,3,1,15,2
184800,7,28,6,3,22,3
184800,6,14,2,0,12,2
184800,5,4,1,0,3,1
184800,2,5,2,0,3,2
2337,7,13,3,0,10,3
2337,6,26,5,0,21,5
2337,4,10,2,0,8,2
2337,3,7,2,0,5,2
193029,10,2,1,0,1,1
193029,8,9,4,0,5,4
193029,7,13,5,0,8,5
193029,6,25,4,0,21,4
193029,5,15,2,0,13,2
193029,4,10,2,0,8,2
159865,9,3,1,0,2,1
159865,7,10,1,0,9,1
159865,6,26,3,0,23,3
159865,5,16,3,0,13,3
159865,4,6,1,0,5,1
159865,3,6,1,0,5,1
10301,10,3,2,0,1,2
10301,9,5,4,0,1,4
10301,8,8,5,0,3,5
10301,7,20,8,0,12,8
10301,6,24,11,0,13,11
10301,5,11,4,0,7,4
10301,4,7,5,0,2,5
10301,2,2,1,0,1,1
131199,10,3,2,0,1,2
131199,8,8,2,0,6,2
131199,7,14,3,0,11,3
131199,6,28,1,0,27,1
131199,5,17,3,0,14,3
131199,4,5,1,0,4,1
131199,3,4,1,0,3,1
38577,8,4,1,0,3,1
38577,7,14,1,0,13,1
38577,6,16,1,0,15,1
38577,5,16,5,0,11,5
38577,4,17,6,0,11,6
38577,3,6,1,0,5,1
141980,9,6,3,0,3,3
141980,8,11,4,0,7,4
141980,7,11,4,0,7,4
141980,6,24,2,0,22,2
141980,5,15,2,0,13,2
141980,3,2,1,0,1,1
8491,7,8,5,0,3,5
8491,6,29,10,0,19,10
8491,5,17,4,0,13,4
8491,4,14,5,0,9,5
8491,2,4,2,0,2,2
131393,10,22,9,0,13,9
131393,9,14,7,0,7,7
131393,8,21,6,0,15,6
131393,7,14,4,0,10,4
131393,6,4,1,0,3,1
131393,4,2,1,0,1,1
131393,2,2,1,0,1,1
1714,10,1,1,0,0,1
1714,8,5,2,0,3,2
1714,7,16,3,0,13,3
1714,6,16,9,0,7,9
1714,5,13,2,0,11,2
1714,4,16,6,0,10,6
1714,3,3,1,0,2,1
1714,2,5,2,0,3,2
1714,1,5,2,0,3,2
125549,8,13,2,0,11,2
125549,7,12,4,0,8,4
125549,6,28,7,0,21,7
125549,5,8,2,0,6,2
125549,4,10,4,0,6,4
125549,2,1,1,0,0,1
125549,1,1,1,0,0,1
251037,10,6,4,0,2,4
251037,9,4,2,0,2,2
251037,8,21,4,0,17,4
251037,7,19,2,0,17,2
251037,6,17,3,0,14,3
251037,5,6,1,0,5,1
251037,4,1,1,0,0,1
251037,1,2,1,1,1,0
4494,10,4,4,0,0,4
4494,9,6,3,0,3,3
4494,8,13,5,0,8,5
4494,7,12,3,0,9,3
4494,6,20,9,0,11,9
4494,5,12,3,0,9,3
4494,3,2,1,0,1,1
4494,2,1,1,0,0,1
4494,1,3,2,0,1,2
11964,8,13,2,0,11,2
11964,7,27,3,0,24,3
11964,6,18,4,0,14,4
11964,5,10,3,0,7,3
11964,4,7,3,0,4,3
177619,10,12,5,0,7,5
177619,9,10,5,0,5,5
177619,8,24,8,0,16,8
177619,7,15,4,0,11,4
177619,6,10,4,0,6,4
54986,10,2,1,0,1,1
54986,8,9,3,0,6,3
54986,7,10,3,0,7,3
54986,6,33,8,0,25,8
54986,5,17,3,0,14,3
54986,4,5,1,0,4,1
2277,10,2,2,0,0,2
2277,9,5,2,0,3,2
2277,8,11,4,0,7,4
2277,7,21,6,0,15,6
2277,6,29,7,0,22,7
2277,5,7,3,0,4,3
3547,10,1,1,0,0,1
3547,8,4,3,0,1,3
3547,7,6,2,0,4,2
3547,6,16,5,0,11,5
3547,5,9,1,0,8,1
3547,4,14,7,0,7,7
3547,3,13,6,0,7,6
3547,2,7,3,0,4,3
3547,1,9,7,0,2,7
3050,10,6,3,0,3,3
3050,9,14,7,0,7,7
3050,8,28,10,0,18,10
3050,7,21,8,0,13,8
3050,4,2,1,0,1,1
3050,3,2,1,0,1,1
149069,9,3,1,0,2,1
149069,8,9,4,0,5,4
149069,7,14,6,1,8,5
149069,6,16,5,0,11,5
149069,5,12,2,0,10,2
149069,4,12,2,0,10,2
149069,2,3,1,0,2,1
149069,1,7,3,0,4,3
236305,10,12,5,1,7,4
236305,9,15,5,0,10,5
236305,8,33,7,1,26,6
236305,7,10,1,0,9,1
236305,6,5,1,0,4,1
236305,4,3,1,0,2,1
24141,10,4,1,0,3,1
24141,7,6,1,0,5,1
24141,6,11,1,0,10,1
24141,5,21,5,0,16,5
24141,4,17,5,0,12,5
24141,2,7,2,0,5,2
24141,1,5,1,0,4,1
3270,9,2,1,0,1,1
3270,8,14,7,0,7,7
3270,7,17,8,0,9,8
3270,6,30,20,0,10,20
3270,5,5,2,0,3,2
3270,4,8,4,0,4,4
3270,2,1,1,0,0,1
856,8,7,3,0,4,3
856,7,12,3,0,9,3
856,6,28,4,0,24,4
856,5,17,3,0,14,3
856,4,9,4,0,5,4
856,3,5,2,0,3,2
211454,10,3,1,0,2,1
211454,9,8,4,0,4,4
211454,8,19,8,0,11,8
211454,7,20,4,0,16,4
211454,6,21,2,0,19,2
211454,5,6,3,0,3,3
211454,3,2,1,0,1,1
194536,8,13,2,0,11,2
194536,7,7,2,0,5,2
194536,6,32,3,0,29,3
194536,1,1,1,0,0,1
217424,10,2,1,0,1,1
217424,9,2,1,0,1,1
217424,8,6,1,0,5,1
217424,6,22,3,0,19,3
217424,5,18,2,0,16,2
217424,3,5,3,0,2,3
174049,10,1,1,0,0,1
174049,9,2,1,0,1,1
174049,8,15,8,0,7,8
174049,7,17,6,1,11,5
174049,6,22,3,0,19,3
174049,5,9,2,1,7,1
174049,4,10,3,0,7,3
174049,3,4,2,0,2,2
8336,8,9,3,0,6,3
8336,7,15,6,0,9,6
8336,6,30,11,0,19,11
8336,5,16,2,0,14,2
8336,4,7,4,0,3,4
8336,2,2,2,0,0,2
204281,9,10,2,0,8,2
204281,8,12,2,0,10,2
204281,7,17,1,0,16,1
204281,6,28,4,0,24,4
204281,5,4,1,0,3,1
204281,4,3,1,0,2,1
708,10,3,1,0,2,1
708,9,1,1,0,0,1
708,8,7,2,0,5,2
708,7,22,10,0,12,10
708,6,21,4,0,17,4
708,5,19,4,0,15,4
22790,8,7,4,0,3,4
22790,7,11,6,0,5,6
22790,6,30,15,0,15,15
22790,5,9,5,0,4,5
22790,4,9,4,0,5,4
22790,3,6,1,0,5,1
22790,1,3,2,0,1,2
104780,8,13,5,0,8,5
104780,7,22,1,0,21,1
104780,6,22,2,0,20,2
104780,5,15,4,0,11,4
104780,4,4,2,0,2,2
103828,8,8,1,0,7,1
103828,7,13,2,0,11,2
103828,6,22,3,0,19,3
103828,5,11,1,0,10,1
103828,4,13,1,0,12,1
103828,3,9,3,0,6,3
103828,2,2,1,0,1,1
103828,1,1,1,0,0,1
5065,10,3,1,0,2,1
5065,9,4,2,0,2,2
5065,8,15,6,0,9,6
5065,7,19,5,0,14,5
5065,6,29,11,0,18,11
5065,5,5,3,0,2,3
5065,3,2,1,0,1,1
665,9,9,2,0,7,2
665,8,18,6,0,12,6
665,7,17,8,0,9,8
665,6,20,10,0,10,10
665,5,7,3,0,4,3
665,4,5,2,0,3,2
665,3,3,2,0,1,2
128568,10,5,1,0,4,1
128568,9,9,2,0,7,2
128568,8,23,5,0,18,5
128568,7,20,7,0,13,7
128568,6,20,9,0,11,9
128568,5,2,1,0,1,1
128568,4,1,1,0,0,1
32337,9,2,2,0,0,2
32337,8,8,2,0,6,2
32337,7,22,4,0,18,4
32337,6,27,12,0,15,12
32337,5,8,2,0,6,2
32337,4,7,4,0,3,4
32337,3,3,1,0,2,1
32337,2,2,2,0,0,2
7382,10,4,1,0,3,1
7382,9,6,4,0,2,4
7382,8,22,13,0,9,13
7382,7,30,9,0,21,9
7382,6,15,4,0,11,4
181807,10,12,4,0,8,4
181807,9,20,6,0,14,6
181807,8,28,5,0,23,5
181807,7,11,6,0,5,6
181807,6,7,2,0,5,2
181807,5,1,1,0,0,1
51067,10,7,2,0,5,2
51067,6,29,3,0,26,3
51067,5,13,1,0,12,1
51067,4,10,3,0,7,3
51067,3,5,1,0,4,1
51067,2,2,1,0,1,1
39375,8,12,5,1,7,4
39375,7,12,2,0,10,2
39375,6,32,8,0,24,8
39375,5,11,3,0,8,3
39375,4,4,2,0,2,2
39375,3,5,3,0,2,3
39375,1,1,1,0,0,1
180006,9,2,1,0,1,1
180006,7,20,2,0,18,2
180006,6,31,8,0,23,8
180006,5,16,3,0,13,3
180006,4,3,1,0,2,1
1259,7,11,4,0,7,4
1259,6,24,5,0,19,5
1259,5,22,5,0,17,5
1259,4,8,5,0,3,5
1259,3,7,4,0,3,4
1259,2,4,2,0,2,2
30879,9,4,1,0,3,1
30879,8,4,2,0,2,2
30879,7,18,2,0,16,2
30879,6,27,5,0,22,5
30879,5,14,4,0,10,4
30879,3,5,1,0,4,1
98352,10,5,3,0,2,3
98352,8,8,3,0,5,3
98352,7,20,1,0,19,1
98352,6,24,1,0,23,1
98352,5,9,3,0,6,3
98352,4,9,1,0,8,1
134777,10,2,1,0,1,1
134777,9,2,1,0,1,1
134777,8,5,1,0,4,1
134777,6,16,4,0,12,4
134777,4,9,2,0,7,2
134777,3,8,5,0,3,5
134777,2,9,3,0,6,3
134777,1,13,5,0,8,5
233094,9,2,1,0,1,1
233094,8,14,2,0,12,2
233094,7,19,3,0,16,3
233094,6,20,3,0,17,3
233094,5,7,2,0,5,2
233094,3,8,1,0,7,1
22839,9,2,1,0,1,1
22839,7,8,1,0,7,1
22839,6,22,2,0,20,2
22839,5,20,4,0,16,4
22839,4,8,1,0,7,1
22839,3,5,2,0,3,2
22839,2,6,2,0,4,2
186295,8,4,2,1,2,1
186295,7,9,2,0,7,2
186295,6,19,2,0,17,2
186295,5,21,4,0,17,4
186295,4,12,2,1,10,1
186295,3,6,1,0,5,1
186295,2,3,1,0,2,1
186295,1,2,1,0,1,1
145042,10,9,3,0,6,3
145042,9,13,5,0,8,5
145042,8,24,7,0,17,7
145042,7,15,2,0,13,2
145042,6,12,1,0,11,1
145042,5,5,1,0,4,1
145042,2,1,1,0,0,1
7267,8,3,1,0,2,1
7267,7,15,7,0,8,7
7267,6,26,8,0,18,8
7267,5,19,4,0,15,4
7267,4,8,3,0,5,3
7267,3,5,3,0,2,3
175263,9,3,1,0,2,1
175263,8,7,1,1,6,0
175263,7,17,6,0,11,6
175263,6,28,6,0,22,6
175263,4,8,2,0,6,2
175263,2,4,1,0,3,1
11429,10,8,5,0,3,5
11429,9,7,3,0,4,3
11429,8,21,7,0,14,7
11429,7,22,1,0,21,1
11429,6,12,2,0,10,2
11429,4,2,1,0,1,1
11429,3,2,2,0,0,2
214970,9,5,3,0,2,3
214970,8,11,2,0,9,2
214970,7,19,3,0,16,3
214970,6,19,2,2,17,0
214970,5,14,2,0,12,2
214970,4,2,1,0,1,1
214970,3,5,2,0,3,2
214970,2,3,2,0,1,2
25167,9,3,3,0,0,3
25167,8,6,3,0,3,3
25167,7,12,3,0,9,3
25167,6,14,4,0,10,4
25167,5,17,4,0,13,4
25167,4,11,4,0,7,4
25167,3,8,4,0,4,4
25167,2,6,3,0,3,3
25167,1,2,2,0,0,2
1680,8,10,4,0,6,4
1680,7,16,2,0,14,2
1680,6,20,4,0,16,4
1680,4,7,2,0,5,2
14523,9,4,2,0,2,2
14523,8,7,3,0,4,3
14523,7,21,9,0,12,9
14523,6,25,13,0,12,13
14523,5,10,6,0,4,6
14523,4,7,5,0,2,5
14523,3,3,1,0,2,1
14523,2,1,1,0,0,1
33208,10,1,1,0,0,1
33208,9,5,1,0,4,1
33208,7,12,2,0,10,2
33208,6,25,8,0,17,8
33208,5,18,4,0,14,4
33208,4,11,4,0,7,4
6,10,2,1,0,1,1
6,9,4,1,0,3,1
6,8,15,2,0,13,2
6,7,23,4,0,19,4
6,6,19,5,0,14,5
6,5,8,2,0,6,2
6,4,4,1,0,3,1
6,2,3,2,0,1,2
4960,8,15,6,0,9,6
4960,7,23,8,0,15,8
4960,6,21,4,0,17,4
4960,5,11,4,0,7,4
4960,4,2,1,0,1,1
4960,3,1,1,0,0,1
24013,8,13,8,0,5,8
24013,7,15,3,0,12,3
24013,6,25,8,0,17,8
24013,5,14,3,0,11,3
24013,4,6,5,0,1,5
24013,2,3,1,0,2,1
24013,1,1,1,0,0,1
160550,9,2,1,0,1,1
160550,8,11,3,0,8,3
160550,7,14,2,0,12,2
160550,6,27,2,0,25,2
160550,5,12,1,0,11,1
160550,4,7,2,0,5,2
160550,3,5,1,0,4,1
207351,9,4,2,0,2,2
207351,8,10,2,0,8,2
207351,7,23,8,1,15,7
207351,6,23,5,0,18,5
207351,5,12,1,0,11,1
207351,4,5,1,0,4,1
208807,8,8,3,0,5,3
208807,7,11,4,0,7,4
208807,6,28,2,0,26,2
208807,5,14,1,0,13,1
208807,4,7,1,0,6,1
217012,10,16,3,0,13,3
217012,9,10,3,1,7,2
217012,8,16,2,0,14,2
217012,7,12,1,0,11,1
217012,6,9,1,0,8,1
217012,5,7,4,0,3,4
217012,4,2,1,0,1,1
217012,2,3,2,1,1,1
217012,1,3,1,0,2,1
39070,9,2,1,0,1,1
39070,8,9,1,0,8,1
39070,7,17,1,0,16,1
39070,6,26,5,0,21,5
39070,5,12,3,0,9,3
39070,4,7,2,0,5,2
39070,3,3,2,0,1,2
196031,10,5,1,0,4,1
196031,8,12,3,0,9,3
196031,7,25,2,0,23,2
196031,6,20,5,1,15,4
196031,5,3,1,0,2,1
196031,4,4,3,0,1,3
39536,10,5,2,0,3,2
39536,9,3,2,0,1,2
39536,8,16,5,0,11,5
39536,7,20,10,0,10,10
39536,6,16,3,0,13,3
39536,5,10,4,0,6,4
39536,4,5,2,0,3,2
22090,7,10,6,0,4,6
22090,6,21,9,0,12,9
22090,5,25,11,0,14,11
22090,4,10,7,0,3,7
22090,3,8,3,0,5,3
22090,2,3,1,0,2,1
5519,10,1,1,0,0,1
5519,9,2,1,0,1,1
5519,8,5,3,0,2,3
5519,7,16,6,0,10,6
5519,6,25,5,0,20,5
5519,5,19,8,0,11,8
5519,4,8,3,0,5,3
5519,2,1,1,0,0,1
5519,1,1,1,0,0,1
13926,8,8,3,0,5,3
13926,7,30,9,0,21,9
13926,6,31,7,0,24,7
13926,5,4,1,0,3,1
13926,4,2,1,0,1,1
5702,9,4,2,0,2,2
5702,8,25,11,0,14,11
5702,7,26,6,0,20,6
5702,6,19,4,0,15,4
5702,4,1,1,0,0,1
180387,10,4,2,0,2,2
180387,9,6,1,0,5,1
180387,8,21,8,0,13,8
180387,7,18,10,0,8,10
180387,6,24,5,0,19,5
180387,5,3,1,0,2,1
180387,2,1,1,0,0,1
7378,9,1,1,0,0,1
7378,8,9,5,0,4,5
7378,7,14,8,0,6,8
7378,6,28,11,0,17,11
7378,5,11,7,0,4,7
7378,4,11,9,0,2,9
7378,3,4,1,0,3,1
42636,10,1,1,0,0,1
42636,8,6,1,0,5,1
42636,7,11,1,0,10,1
42636,6,25,2,0,23,2
42636,5,19,7,0,12,7
42636,3,6,3,0,3,3
129609,10,2,1,0,1,1
129609,8,5,1,0,4,1
129609,7,16,2,0,14,2
129609,6,26,11,0,15,11
129609,5,13,3,0,10,3
129609,2,2,1,0,1,1
129609,1,2,1,0,1,1
135840,10,9,2,0,7,2
135840,9,19,7,0,12,7
135840,8,32,9,0,23,9
135840,7,11,6,0,5,6
135840,6,2,1,0,1,1
135840,5,3,2,0,1,2
135840,4,2,2,0,0,2
135840,3,1,1,0,0,1
135840,1,1,1,0,0,1
1136,7,13,6,0,7,6
1136,6,26,6,0,20,6
1136,5,16,3,0,13,3
1136,4,12,3,0,9,3
1136,3,4,2,0,2,2
24053,8,5,1,0,4,1
24053,7,8,2,0,6,2
24053,6,22,2,0,20,2
24053,5,18,2,0,16,2
24053,4,10,3,0,7,3
24053,3,8,2,0,6,2
24053,2,5,1,0,4,1
13295,10,2,1,0,1,1
13295,8,3,1,0,2,1
13295,6,36,7,0,29,7
13295,5,13,3,0,10,3
13295,4,8,1,0,7,1
13295,3,4,2,0,2,2
189030,9,8,1,0,7,1
189030,8,15,3,0,12,3
189030,7,28,4,0,24,4
189030,3,1,1,0,0,1
169986,10,7,4,0,3,4
169986,9,12,7,0,5,7
169986,8,33,11,0,22,11
169986,7,14,2,1,12,1
169986,6,9,5,0,4,5
169986,2,2,2,1,0,1
163242,9,1,1,0,0,1
163242,7,8,1,0,7,1
163242,6,30,6,0,24,6
163242,5,20,9,0,11,9
163242,4,8,4,0,4,4
163242,3,3,1,0,2,1
1649,8,9,4,0,5,4
1649,7,17,2,0,15,2
1649,6,26,8,0,18,8
1649,5,17,2,0,15,2
1649,4,6,3,0,3,3
156453,9,5,1,0,4,1
156453,8,8,1,0,7,1
156453,7,14,3,0,11,3
156453,6,26,4,0,22,4
156453,5,19,3,0,16,3
156453,4,4,1,0,3,1
2784,8,5,3,0,2,3
2784,6,24,8,0,16,8
2784,5,22,9,0,13,9
2784,4,9,4,0,5,4
2784,3,3,1,0,2,1
124958,8,9,2,0,7,2
124958,7,14,1,0,13,1
124958,6,17,4,0,13,4
124958,5,16,6,0,10,6
124958,4,8,3,0,5,3
124958,3,6,1,0,5,1
7203,10,6,3,0,3,3
7203,9,2,1,0,1,1
7203,8,16,5,0,11,5
7203,7,17,7,0,10,7
7203,6,11,4,0,7,4
7203,5,13,7,0,6,7
7203,4,6,3,0,3,3
7203,3,4,2,0,2,2
7203,2,4,2,0,2,2
186020,10,11,3,0,8,3
186020,8,36,8,0,28,8
189504,10,4,1,0,3,1
189504,9,6,1,0,5,1
189504,8,19,5,0,14,5
189504,7,29,2,0,27,2
189504,6,13,1,0,12,1
189504,2,3,1,0,2,1
8985,9,3,1,0,2,1
8985,8,11,6,0,5,6
8985,7,17,5,0,12,5
8985,6,25,7,0,18,7
8985,5,13,5,0,8,5
8985,4,4,1,0,3,1
8985,3,4,1,0,3,1
7625,10,4,1,0,3,1
7625,9,5,2,0,3,2
7625,8,11,7,0,4,7
7625,7,14,5,0,9,5
7625,6,23,9,0,14,9
7625,5,12,4,0,8,4
7625,4,6,3,0,3,3
103328,8,11,3,0,8,3
103328,7,24,3,0,21,3
103328,6,23,4,0,19,4
103328,5,9,1,0,8,1
131282,10,2,1,0,1,1
131282,9,2,1,0,1,1
131282,8,5,4,0,1,4
131282,7,17,2,0,15,2
131282,6,21,5,0,16,5
131282,5,18,4,0,14,4
131282,4,2,2,0,0,2
131282,3,7,3,0,4,3
131282,2,4,2,0,2,2
7491,10,4,2,0,2,2
7491,8,8,3,0,5,3
7491,7,12,5,0,7,5
7491,6,23,15,0,8,15
7491,5,16,8,0,8,8
7491,4,11,7,0,4,7
7491,3,3,1,0,2,1
7491,2,2,1,0,1,1
197944,8,16,4,0,12,4
197944,7,20,5,0,15,5
197944,6,28,3,0,25,3
197944,5,8,2,0,6,2
197944,2,2,2,0,0,2
112118,10,3,1,0,2,1
112118,9,6,2,0,4,2
112118,8,22,8,0,14,8
112118,7,23,9,0,14,9
112118,6,15,3,0,12,3
112118,5,6,2,0,4,2
112118,4,3,1,0,2,1
19888,10,1,1,0,0,1
19888,8,8,1,0,7,1
19888,7,5,1,0,4,1
19888,6,11,1,0,10,1
19888,5,17,3,0,14,3
19888,4,19,4,0,15,4
19888,3,13,2,0,11,2
19888,2,4,1,0,3,1
8459,8,9,5,0,4,5
8459,7,11,6,0,5,6
8459,6,24,4,0,20,4
8459,5,16,6,0,10,6
8459,4,14,2,0,12,2
8459,3,4,3,0,1,3
1095,7,2,2,0,0,2
1095,6,11,5,0,6,5
1095,5,18,5,0,13,5
1095,4,16,3,0,13,3
1095,3,11,3,0,8,3
1095,2,10,4,0,6,4
1095,1,11,4,0,7,4
183778,8,5,4,2,1,2
183778,7,6,2,2,4,0
183778,6,21,5,2,16,3
183778,5,17,5,1,12,4
183778,4,14,3,2,11,1
183778,3,9,5,1,4,4
183778,2,5,1,0,4,1
186904,9,12,3,0,9,3
186904,8,23,4,0,19,4
186904,7,22,3,0,19,3
186904,5,6,1,0,5,1
186904,3,3,1,0,2,1
9540,7,6,2,0,4,2
9540,6,13,3,0,10,3
9540,5,17,4,0,13,4
9540,4,21,10,0,11,10
9540,3,7,1,0,6,1
9540,2,5,3,0,2,3
9540,1,7,5,0,2,5
33018,9,6,1,0,5,1
33018,8,25,13,0,12,13
33018,7,21,6,0,15,6
33018,6,16,4,0,12,4
33018,5,3,3,0,0,3
33018,4,5,3,0,2,3
13829,8,5,3,0,2,3
13829,7,13,4,0,9,4
13829,6,37,15,0,22,15
13829,5,11,3,0,8,3
13829,4,7,4,0,3,4
13829,3,6,2,0,4,2
55,10,2,1,0,1,1
55,8,2,1,0,1,1
55,7,10,3,0,7,3
55,6,19,3,0,16,3
55,5,19,3,0,16,3
55,4,11,3,0,8,3
55,3,8,3,0,5,3
55,2,4,2,0,2,2
55,1,4,2,0,2,2
149324,10,10,6,0,4,6
149324,9,4,4,0,0,4
149324,8,9,3,0,6,3
149324,7,11,4,0,7,4
149324,6,13,3,0,10,3
149324,5,6,1,0,5,1
149324,4,5,1,0,4,1
149324,3,13,3,0,10,3
149324,2,4,1,0,3,1
149324,1,4,1,0,3,1
7503,8,15,8,0,7,8
7503,7,26,3,0,23,3
7503,6,21,5,0,16,5
7503,5,6,1,0,5,1
7503,3,3,1,0,2,1
1232,8,3,1,0,2,1
1232,7,17,5,0,12,5
1232,6,24,5,0,19,5
1232,5,17,6,0,11,6
1232,4,9,3,0,6,3
1232,3,7,1,0,6,1
1232,2,2,2,0,0,2
8193,10,2,2,0,0,2
8193,8,3,1,0,2,1
8193,7,9,3,0,6,3
8193,6,17,7,0,10,7
8193,5,27,9,0,18,9
8193,4,13,6,0,7,6
8193,3,6,4,0,2,4
40823,10,2,1,0,1,1
40823,9,3,1,0,2,1
40823,8,14,5,0,9,5
40823,7,26,16,0,10,16
40823,6,14,5,0,9,5
40823,5,14,5,0,9,5
40823,4,3,2,0,1,2
40823,1,3,3,0,0,3
92177,9,1,1,0,0,1
92177,8,11,4,0,7,4
92177,7,15,1,0,14,1
92177,6,31,1,0,30,1
92177,5,11,1,0,10,1
92177,4,5,2,0,3,2
92177,2,1,1,0,0,1
27042,10,3,1,0,2,1
27042,8,16,3,0,13,3
27042,7,27,9,0,18,9
27042,6,18,2,0,16,2
27042,5,7,1,0,6,1
27042,4,4,2,0,2,2
2864,8,9,3,0,6,3
2864,7,11,2,0,9,2
2864,6,28,6,0,22,6
2864,5,16,2,0,14,2
2864,4,10,2,0,8,2
2864,3,3,2,0,1,2
81691,9,3,1,0,2,1
81691,8,18,7,0,11,7
81691,7,26,2,0,24,2
81691,6,25,5,0,20,5
81691,5,5,2,0,3,2
131982,8,5,3,0,2,3
131982,6,21,4,3,17,1
131982,5,20,4,0,16,4
131982,4,10,4,0,6,4
131982,3,4,1,0,3,1
131982,2,5,1,0,4,1
4861,9,3,2,0,1,2
4861,8,9,3,0,6,3
4861,7,11,6,0,5,6
4861,6,25,9,0,16,9
4861,5,17,4,0,13,4
4861,4,10,1,0,9,1
4861,3,3,2,0,1,2
131933,10,2,1,0,1,1
131933,8,12,4,0,8,4
131933,7,20,4,0,16,4
131933,6,30,7,0,23,7
131933,5,10,1,0,9,1
131933,4,4,2,0,2,2
1653,7,11,4,0,7,4
1653,6,13,4,0,9,4
1653,5,15,4,0,11,4
1653,4,14,4,0,10,4
1653,3,3,1,0,2,1
1653,2,3,2,0,1,2
1653,1,1,1,0,0,1
202652,10,8,7,0,1,7
202652,9,7,1,1,6,0
202652,8,17,4,1,13,3
202652,7,16,6,0,10,6
202652,6,16,5,0,11,5
202652,5,9,4,0,5,4
202652,3,3,1,0,2,1
119500,10,2,1,0,1,1
119500,9,2,1,0,1,1
119500,6,21,1,0,20,1
119500,5,19,1,0,18,1
119500,4,8,2,0,6,2
119500,3,10,1,0,9,1
32885,7,11,1,0,10,1
32885,6,33,5,0,28,5
32885,5,17,8,0,9,8
32885,4,9,4,0,5,4
32885,3,4,1,0,3,1
32885,1,1,1,0,0,1
131416,10,6,2,0,4,2
131416,8,15,3,0,12,3
131416,7,14,3,0,11,3
131416,6,23,2,0,21,2
131416,5,14,2,0,12,2
6647,7,10,2,0,8,2
6647,6,23,7,0,16,7
6647,5,16,5,0,11,5
6647,1,2,2,0,0,2
42216,9,3,1,0,2,1
42216,7,14,1,0,13,1
42216,6,33,2,0,31,2
42216,5,8,2,0,6,2
42216,4,6,2,0,4,2
42216,1,1,1,0,0,1
139779,8,10,2,0,8,2
139779,7,9,1,0,8,1
139779,6,26,4,0,22,4
139779,5,14,4,0,10,4
139779,4,13,1,0,12,1
77596,8,4,1,0,3,1
77596,7,6,2,0,4,2
77596,6,22,6,0,16,6
77596,5,17,1,0,16,1
77596,4,11,4,0,7,4
77596,3,9,3,0,6,3
77596,2,5,4,0,1,4
7869,9,1,1,0,0,1
7869,8,7,4,0,3,4
7869,6,22,10,0,12,10
7869,5,27,14,0,13,14
7869,4,11,6,0,5,6
7869,3,6,2,0,4,2
31068,8,6,2,0,4,2
31068,7,6,2,0,4,2
31068,6,25,1,0,24,1
31068,5,18,1,0,17,1
31068,4,10,2,0,8,2
31068,3,8,3,0,5,3
31068,2,5,2,0,3,2
43856,10,1,1,0,0,1
43856,8,10,3,0,7,3
43856,7,15,4,0,11,4
43856,6,26,3,0,23,3
43856,5,10,2,0,8,2
43856,4,5,3,0,2,3
43856,3,2,2,0,0,2
7815,8,6,4,0,2,4
7815,7,17,9,0,8,9
7815,6,33,6,0,27,6
7815,5,13,1,0,12,1
7815,4,6,2,0,4,2
7815,3,3,1,0,2,1
234439,9,5,3,0,2,3
234439,8,13,1,0,12,1
234439,7,18,3,0,15,3
234439,6,27,4,0,23,4
234439,5,8,1,0,7,1
63899,8,3,2,0,1,2
63899,7,8,2,0,6,2
63899,6,25,8,0,17,8
63899,5,22,7,0,15,7
63899,4,11,2,0,9,2
63899,3,7,2,0,5,2
7849,9,11,1,0,10,1
7849,8,21,6,0,15,6
7849,7,22,4,0,18,4
7849,6,8,2,0,6,2
7849,5,7,1,0,6,1
7849,4,4,1,0,3,1
7849,2,1,1,0,0,1
3080,8,3,2,0,1,2
3080,7,13,4,0,9,4
3080,6,24,6,0,18,6
3080,5,17,5,0,12,5
3080,4,8,2,0,6,2
3080,3,7,4,0,3,4
3080,1,3,2,0,1,2
7169,9,4,1,0,3,1
7169,8,16,2,0,14,2
7169,7,17,2,0,15,2
7169,6,20,5,0,15,5
7169,5,14,1,0,13,1
7169,4,4,2,0,2,2
7169,3,3,1,0,2,1
108155,10,3,2,0,1,2
108155,9,2,1,0,1,1
108155,7,14,2,0,12,2
108155,6,34,7,0,27,7
108155,5,13,1,0,12,1
108155,4,3,2,0,1,2
8402,9,7,3,0,4,3
8402,8,21,8,0,13,8
8402,7,20,9,0,11,9
8402,6,16,6,0,10,6
8402,5,9,2,0,7,2
8402,3,2,1,0,1,1
8402,2,2,2,0,0,2
5549,10,10,3,0,7,3
5549,9,13,6,0,7,6
5549,8,18,2,0,16,2
5549,7,21,10,0,11,10
5549,6,12,2,0,10,2
220499,10,3,1,0,2,1
220499,8,32,4,0,28,4
220499,7,18,3,0,15,3
220499,6,15,1,0,14,1
220499,5,3,2,0,1,2
220499,3,2,1,0,1,1
14314,9,2,2,0,0,2
14314,8,3,1,0,2,1
14314,7,5,2,0,3,2
14314,6,25,6,0,19,6
14314,5,22,6,0,16,6
14314,4,6,3,0,3,3
14314,3,13,6,0,7,6
96310,10,5,1,0,4,1
96310,9,8,4,0,4,4
96310,8,28,7,0,21,7
96310,7,24,8,0,16,8
96310,6,7,1,0,6,1
96310,5,3,1,0,2,1
96310,4,3,1,0,2,1
253185,10,18,10,0,8,10
253185,9,8,6,1,2,5
253185,8,20,7,0,13,7
253185,7,11,5,0,6,5
253185,6,8,1,0,7,1
253185,5,6,3,0,3,3
253185,3,2,2,1,0,1
253185,2,2,1,0,1,1
7473,8,3,1,0,2,1
7473,7,6,2,0,4,2
7473,6,11,3,0,8,3
7473,5,25,7,0,18,7
7473,4,14,3,0,11,3
7473,3,11,3,0,8,3
7473,2,4,2,0,2,2
7058,9,4,4,0,0,4
7058,8,10,5,0,5,5
7058,7,18,10,0,8,10
7058,6,23,7,0,16,7
7058,5,12,2,0,10,2
90730,10,2,1,0,1,1
90730,9,3,1,0,2,1
90730,8,14,2,0,12,2
90730,7,15,8,0,7,8
90730,6,32,9,0,23,9
90730,5,7,2,0,5,2
90730,2,2,2,0,0,2
21012,9,4,1,0,3,1
21012,8,11,1,0,10,1
21012,7,16,5,0,11,5
21012,6,20,5,0,15,5
21012,5,12,3,0,9,3
21012,4,10,4,0,6,4
147400,9,4,1,0,3,1
147400,8,15,5,1,10,4
147400,7,28,5,0,23,5
147400,6,19,4,0,15,4
147400,5,8,3,0,5,3
147400,4,2,1,0,1,1
147400,2,1,1,0,0,1
85609,10,5,3,0,2,3
85609,9,10,5,0,5,5
85609,8,41,11,0,30,11
85609,7,14,4,0,10,4
85609,5,3,2,0,1,2
85609,4,2,1,0,1,1
6553,8,3,1,0,2,1
6553,7,6,4,0,2,4
6553,6,37,9,0,28,9
6553,5,19,9,0,10,9
6553,4,9,2,0,7,2
6553,3,2,2,0,0,2
114800,10,6,1,0,5,1
114800,8,31,1,0,30,1
114800,1,1,1,0,0,1
90942,10,4,1,0,3,1
90942,9,12,5,0,7,5
90942,8,25,7,0,18,7
90942,7,20,5,0,15,5
90942,6,12,4,0,8,4
90942,5,4,2,0,2,2
90942,3,1,1,0,0,1
26906,10,6,2,0,4,2
26906,9,9,4,0,5,4
26906,8,25,6,0,19,6
26906,7,25,6,0,19,6
26906,6,10,3,0,7,3
26906,5,3,2,0,1,2
6509,9,8,1,0,7,1
6509,8,9,1,0,8,1
6509,7,15,5,0,10,5
6509,6,18,4,0,14,4
6509,5,11,6,0,5,6
6509,4,6,3,0,3,3
6509,3,4,2,0,2,2
6509,2,3,3,0,0,3
33907,8,3,2,0,1,2
33907,7,13,4,0,9,4
33907,6,32,6,0,26,6
33907,5,17,5,0,12,5
33907,4,10,2,0,8,2
33907,3,2,2,0,0,2
33907,2,1,1,0,0,1
12577,10,5,3,0,2,3
12577,9,4,1,0,3,1
12577,8,11,4,0,7,4
12577,7,11,3,0,8,3
12577,6,22,6,0,16,6
12577,5,8,1,0,7,1
12577,4,7,4,0,3,4
12577,3,6,1,0,5,1
12577,1,4,3,0,1,3
11955,8,6,4,0,2,4
11955,7,7,3,0,4,3
11955,6,29,12,0,17,12
11955,5,16,5,0,11,5
11955,4,10,3,0,7,3
11955,3,4,1,0,3,1
11955,2,2,1,0,1,1
11955,1,2,1,0,1,1
2777,8,1,1,0,0,1
2777,7,9,4,0,5,4
2777,6,18,9,0,9,9
2777,5,21,6,0,15,6
2777,4,17,6,0,11,6
2777,3,10,3,0,7,3
2777,2,2,2,0,0,2
164566,8,11,1,0,10,1
164566,7,14,3,0,11,3
164566,6,28,4,0,24,4
164566,5,10,4,0,6,4
164566,4,8,2,0,6,2
28289,9,5,3,0,2,3
28289,8,17,5,0,12,5
28289,7,28,9,0,19,9
28289,6,14,3,0,11,3
28289,5,9,1,0,8,1
28289,4,3,1,0,2,1
211996,8,13,3,0,10,3
211996,7,16,1,0,15,1
211996,6,24,4,0,20,4
211996,5,8,2,0,6,2
211996,4,6,1,0,5,1
211996,2,1,1,0,0,1
8913,9,1,1,0,0,1
8913,8,11,8,0,3,8
8913,7,16,5,0,11,5
8913,6,33,10,0,23,10
8913,5,10,2,0,8,2
39382,10,1,1,0,0,1
39382,9,3,1,0,2,1
39382,8,9,7,0,2,7
39382,7,24,7,0,17,7
39382,6,25,10,0,15,10
39382,5,5,4,0,1,4
39382,4,5,3,0,2,3
39382,3,2,1,0,1,1
39382,2,2,2,0,0,2
39382,1,2,1,0,1,1
7847,8,6,4,0,2,4
7847,7,17,6,0,11,6
7847,6,29,15,0,14,15
7847,5,11,6,0,5,6
7847,4,9,2,0,7,2
7847,3,2,1,0,1,1
7847,2,2,2,0,0,2
185028,8,11,1,0,10,1
185028,7,10,2,0,8,2
185028,6,24,3,0,21,3
185028,5,12,1,0,11,1
185028,4,10,1,0,9,1
185028,3,6,1,0,5,1
4273,9,4,1,0,3,1
4273,8,6,3,0,3,3
4273,7,15,3,0,12,3
4273,6,25,7,0,18,7
4273,5,15,6,0,9,6
4273,4,5,3,0,2,3
4273,3,5,1,0,4,1
4273,1,2,1,0,1,1
186905,10,4,1,0,3,1
186905,8,7,1,0,6,1
186905,7,20,4,0,16,4
186905,6,22,3,0,19,3
186905,5,12,2,0,10,2
186905,3,4,1,0,3,1
266967,10,17,1,0,16,1
266967,8,27,3,0,24,3
266967,7,14,1,0,13,1
266967,5,3,1,0,2,1
266967,4,1,1,0,0,1
3005,9,4,2,0,2,2
3005,8,6,2,0,4,2
3005,7,17,3,0,14,3
3005,6,21,5,0,16,5
3005,5,7,2,0,5,2
3005,4,12,3,0,9,3
3005,3,5,2,0,3,2
3005,2,2,1,0,1,1
3005,1,1,1,0,0,1
20595,10,2,1,0,1,1
20595,9,2,1,0,1,1
20595,8,16,6,0,10,6
20595,7,20,3,0,17,3
20595,6,16,3,0,13,3
20595,5,11,4,0,7,4
20595,4,7,4,0,3,4
20595,3,4,3,0,1,3
235454,10,17,5,0,12,5
235454,9,24,7,0,17,7
235454,8,22,8,0,14,8
235454,7,14,4,0,10,4
410,8,12,8,0,4,8
410,7,12,4,0,8,4
410,6,23,4,0,19,4
410,5,16,3,0,13,3
410,4,8,4,0,4,4
410,3,3,1,0,2,1
410,2,2,2,0,0,2
260788,9,3,1,0,2,1
260788,8,20,4,0,16,4
260788,7,25,5,0,20,5
260788,6,16,1,0,15,1
260788,5,7,1,0,6,1
260788,3,2,1,0,1,1
260788,2,1,1,0,0,1
130393,10,2,2,0,0,2
130393,9,5,2,0,3,2
130393,8,10,3,0,7,3
130393,7,29,2,0,27,2
130393,6,23,6,0,17,6
130393,5,8,3,0,5,3
130393,4,1,1,0,0,1
191432,10,8,2,0,6,2
191432,8,6,1,0,5,1
191432,7,20,6,0,14,6
191432,6,15,3,0,12,3
191432,5,12,2,0,10,2
191432,3,4,1,0,3,1
191432,1,3,2,2,1,0
201446,10,9,1,0,8,1
201446,9,16,8,3,8,5
201446,8,19,4,0,15,4
201446,7,13,2,0,11,2
201446,6,10,3,0,7,3
201446,5,8,3,1,5,2
852,8,4,4,0,0,4
852,7,4,1,0,3,1
852,6,26,14,0,12,14
852,5,28,11,0,17,11
852,4,9,2,0,7,2
852,3,6,3,0,3,3
183402,8,6,1,0,5,1
183402,7,24,4,0,20,4
183402,6,33,13,0,20,13
183402,3,1,1,0,0,1
160773,8,17,3,0,14,3
160773,5,16,6,0,10,6
160773,4,2,1,0,1,1
160773,2,1,1,0,0,1
160773,1,1,1,0,0,1
12420,7,13,4,0,9,4
12420,6,23,7,0,16,7
12420,5,18,5,0,13,5
12420,4,16,3,0,13,3
12420,3,5,2,0,3,2
703,9,5,3,0,2,3
703,8,20,6,0,14,6
703,7,21,6,0,15,6
703,6,18,3,0,15,3
703,5,10,5,0,5,5
226006,10,12,9,2,3,7
226006,9,10,3,1,7,2
226006,8,22,8,0,14,8
226006,7,12,3,0,9,3
226006,6,19,3,1,16,2
229708,10,5,2,0,3,2
229708,8,9,1,0,8,1
229708,7,20,1,0,19,1
229708,6,31,3,0,28,3
229708,3,4,1,0,3,1
69232,10,7,2,0,5,2
69232,9,5,2,0,3,2
69232,8,14,4,0,10,4
69232,7,15,4,0,11,4
69232,6,19,5,0,14,5
69232,5,9,3,0,6,3
69232,4,3,2,0,1,2
69232,1,1,1,0,0,1
18696,8,3,1,0,2,1
18696,7,6,3,0,3,3
18696,6,25,13,0,12,13
18696,5,17,7,0,10,7
18696,4,13,4,0,9,4
18696,3,9,4,0,5,4
18696,2,3,3,0,0,3
18696,1,2,1,0,1,1
455,9,1,1,0,0,1
455,8,4,3,0,1,3
455,7,10,6,0,4,6
455,6,28,14,0,14,14
455,5,19,6,0,13,6
455,4,15,1,0,14,1
197066,8,6,1,0,5,1
197066,7,14,2,0,12,2
197066,6,25,3,0,22,3
197066,5,12,3,0,9,3
197066,4,9,2,0,7,2
197066,3,5,1,0,4,1
197066,1,1,1,0,0,1
193725,10,36,22,3,14,19
193725,9,22,6,0,16,6
193725,8,9,1,0,8,1
193725,7,8,1,0,7,1
39447,8,6,2,0,4,2
39447,7,9,2,0,7,2
39447,6,32,6,0,26,6
39447,5,11,2,0,9,2
39447,4,8,5,0,3,5
39447,2,5,1,0,4,1
182228,8,14,3,1,11,2
182228,7,20,6,1,14,5
182228,6,21,3,1,18,2
182228,5,11,2,1,9,1
182228,4,6,1,0,5,1
182228,2,1,1,0,0,1
5494,9,4,1,0,3,1
5494,8,10,7,0,3,7
5494,7,23,7,0,16,7
5494,6,21,7,0,14,7
5494,5,12,5,0,7,5
5494,4,5,1,0,4,1
6534,9,1,1,0,0,1
6534,8,8,6,0,2,6
6534,7,10,6,0,4,6
6534,6,26,14,0,12,14
6534,5,10,3,0,7,3
6534,4,11,3,0,8,3
6534,3,7,3,0,4,3
6534,2,4,1,0,3,1
97287,7,6,3,0,3,3
97287,6,32,13,0,19,13
97287,5,19,9,0,10,9
97287,4,10,6,0,4,6
97287,3,3,1,0,2,1
97287,2,5,2,0,3,2
21182,9,14,3,0,11,3
21182,8,24,11,0,13,11
21182,7,18,7,0,11,7
21182,6,10,1,0,9,1
21182,5,4,2,0,2,2
21182,4,3,1,0,2,1
158888,10,3,1,0,2,1
158888,9,9,2,0,7,2
158888,8,36,8,0,28,8
158888,7,20,3,0,17,3
158888,6,7,4,0,3,4
99573,10,12,7,0,5,7
99573,9,21,4,0,17,4
99573,8,23,5,0,18,5
99573,7,13,3,0,10,3
99573,2,1,1,0,0,1
216907,8,11,3,1,8,2
216907,7,20,6,0,14,6
216907,6,15,3,1,12,2
216907,3,7,2,0,5,2
3641,10,8,8,0,0,8
3641,9,5,1,0,4,1
3641,8,11,2,0,9,2
3641,7,20,6,0,14,6
3641,6,22,9,0,13,9
3641,5,7,3,0,4,3
3641,4,2,1,0,1,1
3641,3,2,2,0,0,2
97683,10,3,1,0,2,1
97683,9,14,8,0,6,8
97683,8,26,9,0,17,9
97683,7,24,9,0,15,9
97683,6,7,1,0,6,1
153780,10,2,1,0,1,1
153780,6,33,4,0,29,4
153780,5,14,4,0,10,4
153780,4,10,1,0,9,1
153780,3,3,2,0,1,2
153780,2,2,1,0,1,1
153780,1,1,1,0,0,1
2616,8,8,1,0,7,1
2616,7,10,2,0,8,2
2616,6,29,7,0,22,7
2616,5,15,2,0,13,2
2616,4,9,1,0,8,1
2616,3,3,1,0,2,1
1626,10,2,1,0,1,1
1626,7,7,2,0,5,2
1626,6,23,10,0,13,10
1626,5,18,6,0,12,6
1626,4,12,3,0,9,3
1626,3,10,6,0,4,6
1626,2,2,1,0,1,1
28454,10,3,1,0,2,1
28454,9,5,1,0,4,1
28454,8,6,3,0,3,3
28454,7,14,4,0,10,4
28454,6,23,6,0,17,6
28454,5,12,2,0,10,2
28454,4,8,2,0,6,2
28454,3,5,2,0,3,2
28454,1,1,1,0,0,1
114261,10,2,1,0,1,1
114261,9,10,7,0,3,7
114261,8,26,13,0,13,13
114261,7,26,10,0,16,10
114261,6,9,5,0,4,5
114261,5,4,1,0,3,1
174252,9,4,1,0,3,1
174252,8,21,4,0,17,4
174252,7,15,3,0,12,3
174252,6,25,6,0,19,6
174252,5,4,1,0,3,1
174252,4,5,3,0,2,3
174252,3,2,1,0,1,1
215503,10,9,3,0,6,3
215503,9,14,3,0,11,3
215503,8,23,6,0,17,6
215503,7,13,1,0,12,1
215503,6,12,1,0,11,1
215503,5,5,1,0,4,1
163601,10,3,1,0,2,1
163601,7,29,1,0,28,1
163601,6,26,3,0,23,3
5437,10,2,1,0,1,1
5437,9,1,1,0,0,1
5437,8,6,2,0,4,2
5437,7,14,3,0,11,3
5437,6,25,13,0,12,13
5437,5,19,6,0,13,6
5437,4,6,1,0,5,1
5437,3,4,2,0,2,2
6266,10,6,1,0,5,1
6266,9,13,5,0,8,5
6266,8,21,3,0,18,3
6266,7,20,3,0,17,3
6266,6,11,5,0,6,5
6266,5,6,2,0,4,2
38050,10,3,2,0,1,2
38050,8,10,4,0,6,4
38050,7,13,4,0,9,4
38050,6,23,7,0,16,7
38050,5,12,2,0,10,2
38050,4,3,1,0,2,1
38050,3,7,2,0,5,2
38050,2,3,1,0,2,1
5136,9,1,1,0,0,1
5136,8,9,3,0,6,3
5136,7,20,7,0,13,7
5136,6,27,9,0,18,9
5136,5,15,5,0,10,5
60697,9,3,2,0,1,2
60697,8,2,1,0,1,1
60697,6,20,3,0,17,3
60697,5,9,2,0,7,2
60697,4,13,4,0,9,4
60697,3,15,3,0,12,3
60697,2,6,2,0,4,2
60697,1,2,2,0,0,2
24826,9,3,1,0,2,1
24826,8,4,1,0,3,1
24826,6,32,9,0,23,9
24826,5,12,4,0,8,4
24826,4,8,1,0,7,1
24826,3,4,2,0,2,2
176872,8,13,4,2,9,2
176872,7,15,5,2,10,3
176872,6,21,4,0,17,4
176872,5,9,1,1,8,0
176872,4,12,2,1,10,1
176872,3,4,1,0,3,1
135530,10,1,1,0,0,1
135530,9,7,6,0,1,6
135530,8,32,11,0,21,11
135530,7,25,11,0,14,11
135530,6,7,3,0,4,3
135530,5,1,1,0,0,1
135530,2,1,1,0,0,1
135530,1,1,1,0,0,1
4092,9,1,1,0,0,1
4092,8,7,1,0,6,1
4092,7,10,5,0,5,5
4092,6,26,3,0,23,3
4092,5,24,9,0,15,9
4092,4,5,3,0,2,3
4092,3,3,1,0,2,1
4092,2,1,1,0,0,1
20281,8,3,2,0,1,2
20281,7,4,2,0,2,2
20281,5,17,5,0,12,5
20281,4,23,7,0,16,7
20281,3,11,2,0,9,2
20281,2,5,2,0,3,2
227127,10,10,4,0,6,4
227127,9,22,7,0,15,7
227127,8,37,12,0,25,12
227127,7,5,2,0,3,2
227127,5,2,1,0,1,1
183508,10,4,1,0,3,1
183508,9,3,1,0,2,1
183508,8,8,1,0,7,1
183508,7,12,3,0,9,3
183508,3,3,1,0,2,1
2314,9,1,1,0,0,1
2314,8,5,4,0,1,4
2314,7,6,1,0,5,1
2314,6,23,12,0,11,12
2314,5,20,7,0,13,7
2314,4,16,6,0,10,6
2314,3,2,1,0,1,1
2314,2,3,1,0,2,1
21849,10,2,1,0,1,1
21849,8,7,2,0,5,2
21849,6,23,2,0,21,2
21849,4,11,1,0,10,1
36616,10,5,2,0,3,2
36616,8,22,13,0,9,13
36616,7,23,12,0,11,12
36616,6,12,5,0,7,5
36616,5,7,4,0,3,4
36616,4,4,2,0,2,2
136585,10,1,1,0,0,1
136585,8,4,2,0,2,2
136585,7,11,2,0,9,2
136585,6,22,6,0,16,6
136585,5,17,7,0,10,7
136585,4,11,2,0,9,2
136585,3,4,3,0,1,3
136585,2,3,3,0,0,3
10346,10,3,1,0,2,1
10346,9,3,2,0,1,2
10346,8,16,4,0,12,4
10346,7,25,10,0,15,10
10346,6,19,3,0,16,3
10346,5,6,1,0,5,1
10346,4,3,1,0,2,1
217470,8,24,2,0,22,2
217470,7,22,2,0,20,2
217470,6,20,5,0,15,5
217470,4,4,2,0,2,2
217470,3,2,1,0,1,1
34276,10,6,5,0,1,5
34276,9,19,6,0,13,6
34276,8,24,7,0,17,7
34276,7,13,5,0,8,5
34276,6,9,2,0,7,2
34276,5,1,1,0,0,1
34276,4,2,2,0,0,2
104769,8,10,1,0,9,1
104769,7,28,3,0,25,3
104769,6,21,2,0,19,2
104769,5,9,1,0,8,1
104769,4,4,1,0,3,1
191901,10,2,1,0,1,1
191901,8,12,3,0,9,3
191901,7,22,3,0,19,3
191901,6,24,4,0,20,4
191901,5,9,1,0,8,1
191901,3,1,1,0,0,1
8720,9,3,1,0,2,1
8720,7,20,5,0,15,5
8720,6,33,9,0,24,9
8720,5,8,2,0,6,2
8720,1,1,1,0,0,1
1936,8,4,1,0,3,1
1936,7,20,1,0,19,1
1936,6,25,9,0,16,9
1936,5,13,2,0,11,2
1936,4,10,3,0,7,3
1936,3,2,1,0,1,1
1936,2,2,1,0,1,1
256883,9,3,1,0,2,1
256883,8,22,3,0,19,3
256883,7,13,2,0,11,2
256883,6,15,3,0,12,3
256883,5,9,3,0,6,3
256883,4,6,2,0,4,2
256883,3,3,2,0,1,2
223763,10,4,1,0,3,1
223763,9,1,1,0,0,1
223763,8,14,4,0,10,4
223763,7,19,5,0,14,5
223763,6,14,5,0,9,5
223763,5,10,1,0,9,1
223763,4,7,3,0,4,3
223763,3,5,3,0,2,3
223763,1,2,1,0,1,1
41834,9,1,1,0,0,1
41834,8,4,3,0,1,3
41834,7,15,1,0,14,1
41834,6,19,5,0,14,5
41834,5,20,8,0,12,8
41834,4,10,4,0,6,4
41834,3,7,2,0,5,2
240271,10,48,17,2,31,15
240271,9,18,3,0,15,3
240271,8,10,4,1,6,3
108080,10,4,1,0,3,1
108080,8,16,10,0,6,10
108080,7,16,6,0,10,6
108080,6,27,8,0,19,8
108080,5,6,3,0,3,3
108080,3,2,2,0,0,2
2757,10,4,1,0,3,1
2757,8,6,3,0,3,3
2757,7,12,4,0,8,4
2757,6,30,9,0,21,9
2757,5,14,3,0,11,3
2757,4,9,4,0,5,4
2757,3,2,1,0,1,1
92046,9,9,3,0,6,3
92046,8,15,6,0,9,6
92046,7,15,4,1,11,3
92046,6,20,8,0,12,8
92046,5,8,3,0,5,3
92046,4,6,3,1,3,2
92046,3,2,1,0,1,1
92046,2,1,1,0,0,1
167404,8,17,2,0,15,2
167404,6,17,2,0,15,2
167404,5,9,1,0,8,1
167404,4,3,2,0,1,2
194392,10,15,6,1,9,5
194392,9,23,7,3,16,4
194392,8,20,6,1,14,5
194392,7,11,2,0,9,2
194392,6,4,2,0,2,2
194392,4,1,1,0,0,1
133524,8,8,2,0,6,2
133524,7,25,3,0,22,3
133524,6,29,5,0,24,5
133524,4,6,2,0,4,2
145675,10,3,2,0,1,2
145675,9,5,1,0,4,1
145675,8,16,3,0,13,3
145675,7,18,4,0,14,4
145675,6,26,3,0,23,3
145675,5,5,1,0,4,1
11821,10,1,1,0,0,1
11821,9,5,5,0,0,5
11821,8,16,8,0,8,8
11821,7,15,10,0,5,10
11821,6,14,8,0,6,8
11821,5,16,8,0,8,8
11821,4,7,3,0,4,3
11821,3,2,1,0,1,1
3846,9,1,1,0,0,1
3846,8,4,1,0,3,1
3846,7,6,3,0,3,3
3846,6,29,5,0,24,5
3846,5,16,6,0,10,6
3846,4,8,3,0,5,3
3846,3,7,4,0,3,4
3846,2,5,1,0,4,1
1405,10,1,1,0,0,1
1405,8,5,1,0,4,1
1405,7,19,3,0,16,3
1405,6,34,12,0,22,12
1405,5,11,6,0,5,6
1405,3,3,1,0,2,1
174696,7,19,2,0,17,2
174696,6,28,4,0,24,4
174696,5,13,1,0,12,1
174696,4,6,1,0,5,1
17697,8,16,6,0,10,6
17697,7,23,10,0,13,10
17697,6,19,7,0,12,7
17697,5,10,6,0,4,6
17697,4,4,1,0,3,1
17697,3,2,1,0,1,1
17697,2,2,1,0,1,1
2823,10,1,1,0,0,1
2823,9,1,1,0,0,1
2823,8,1,1,0,0,1
2823,7,12,3,0,9,3
2823,6,19,4,0,15,4
2823,5,16,4,0,12,4
2823,4,13,7,0,6,7
2823,3,7,2,0,5,2
2823,2,5,2,0,3,2
2823,1,2,1,0,1,1
209190,10,2,1,0,1,1
209190,8,16,3,0,13,3
209190,7,18,4,0,14,4
209190,6,19,7,0,12,7
209190,5,9,1,0,8,1
209190,4,8,1,0,7,1
209190,3,2,1,0,1,1
209190,1,1,1,0,0,1
26736,10,2,2,0,0,2
26736,9,7,5,0,2,5
26736,8,31,10,0,21,10
26736,7,32,13,0,19,13
26736,6,6,1,0,5,1
2051,7,13,1,0,12,1
2051,6,31,15,0,16,15
2051,5,19,5,0,14,5
2051,4,7,3,0,4,3
1547,10,2,2,0,0,2
1547,9,3,1,0,2,1
1547,8,9,3,0,6,3
1547,7,16,2,0,14,2
1547,6,23,4,0,19,4
1547,4,5,2,0,3,2
1547,3,3,2,0,1,2
65592,10,3,1,0,2,1
65592,8,9,2,0,7,2
65592,7,12,3,0,9,3
65592,5,13,1,0,12,1
65592,4,12,4,0,8,4
65592,3,4,1,0,3,1
65592,2,3,1,0,2,1
65592,1,1,1,0,0,1
108430,10,6,2,0,4,2
108430,9,21,9,0,12,9
108430,8,30,10,0,20,10
108430,7,15,5,0,10,5
108430,6,4,1,0,3,1
59008,10,6,4,0,2,4
59008,9,15,2,0,13,2
59008,8,31,11,0,20,11
59008,6,8,5,0,3,5
59008,5,5,2,0,3,2
59008,4,1,1,0,0,1
136089,8,13,1,0,12,1
136089,7,24,7,0,17,7
136089,6,29,5,0,24,5
136089,4,3,1,0,2,1
3979,7,18,3,0,15,3
3979,6,25,6,0,19,6
3979,5,15,2,0,13,2
21051,8,5,1,0,4,1
21051,7,12,2,0,10,2
21051,6,25,5,0,20,5
21051,5,22,3,0,19,3
21051,4,7,1,0,6,1
21051,3,6,3,0,3,3
112462,9,5,1,0,4,1
112462,8,10,2,1,8,1
112462,7,15,3,0,12,3
112462,6,19,3,0,16,3
112462,5,11,1,0,10,1
112462,4,9,6,0,3,6
112462,2,3,2,0,1,2
5023,10,3,1,0,2,1
5023,9,4,2,0,2,2
5023,8,22,12,0,10,12
5023,7,19,7,0,12,7
5023,6,13,2,0,11,2
5023,5,10,5,0,5,5
5023,3,2,1,0,1,1
5023,2,1,1,0,0,1
22843,10,15,7,0,8,7
22843,9,14,3,0,11,3
22843,8,16,2,0,14,2
22843,7,16,4,0,12,4
22843,6,6,2,0,4,2
22843,5,2,1,0,1,1
22843,3,3,3,0,0,3
156224,9,5,2,0,3,2
156224,8,16,4,0,12,4
156224,7,11,1,0,10,1
156224,6,20,6,0,14,6
156224,5,13,5,1,8,4
156224,4,6,1,0,5,1
156224,3,4,1,0,3,1
156224,2,1,1,0,0,1
156224,1,1,1,0,0,1
131144,10,1,1,1,0,0
131144,9,4,2,0,2,2
131144,8,14,6,1,8,5
131144,7,14,1,0,13,1
131144,6,18,4,0,14,4
131144,4,9,2,0,7,2
131144,3,6,1,0,5,1
131144,2,2,1,1,1,0
154174,10,1,1,0,0,1
154174,8,3,1,0,2,1
154174,6,10,2,0,8,2
154174,5,12,1,0,11,1
154174,4,15,4,0,11,4
154174,3,13,4,0,9,4
154174,2,16,4,0,12,4
154174,1,7,2,0,5,2
23954,8,7,2,0,5,2
23954,7,20,6,0,14,6
23954,6,27,3,0,24,3
23954,5,13,4,0,9,4
4048,9,2,2,0,0,2
4048,8,10,3,0,7,3
4048,7,15,3,0,12,3
4048,6,27,8,0,19,8
4048,5,8,3,0,5,3
4048,4,6,4,0,2,4
4048,3,4,3,0,1,3
4048,2,1,1,0,0,1
4048,1,2,2,0,0,2
103844,8,7,5,0,2,5
103844,7,10,1,0,9,1
103844,6,26,8,1,18,7
103844,5,14,3,1,11,2
103844,4,8,2,0,6,2
103844,3,5,1,0,4,1
103844,2,1,1,0,0,1
166888,8,13,4,0,9,4
166888,7,15,5,0,10,5
166888,6,29,2,0,27,2
166888,5,9,2,0,7,2
166888,4,4,1,0,3,1
6974,10,7,5,0,2,5
6974,9,7,3,0,4,3
6974,8,16,4,0,12,4
6974,7,15,4,0,11,4
6974,6,18,4,0,14,4
6974,5,9,3,0,6,3
6974,4,3,1,0,2,1
6974,3,1,1,0,0,1
14001,9,2,1,0,1,1
14001,8,4,2,0,2,2
14001,7,13,5,0,8,5
14001,6,27,7,0,20,7
14001,5,14,4,0,10,4
14001,4,8,4,0,4,4
14001,2,2,1,0,1,1
31070,8,9,5,0,4,5
31070,7,14,7,0,7,7
31070,6,31,11,0,20,11
31070,5,7,3,0,4,3
31070,4,11,1,0,10,1
31070,3,2,1,0,1,1
2151,8,7,2,0,5,2
2151,6,27,9,0,18,9
2151,5,22,11,0,11,11
2151,4,10,2,0,8,2
2151,1,1,1,0,0,1
161429,9,3,2,0,1,2
161429,8,11,3,0,8,3
161429,7,14,4,0,10,4
161429,6,23,6,0,17,6
161429,5,13,5,0,8,5
161429,4,8,2,0,6,2
161429,3,3,1,0,2,1
38870,8,33,7,0,26,7
38870,7,20,5,0,15,5
38870,6,9,2,0,7,2
38870,4,1,1,0,0,1
38870,3,1,1,0,0,1
136285,7,9,1,0,8,1
136285,6,26,4,0,22,4
136285,5,17,2,0,15,2
294,10,2,1,0,1,1
294,9,5,2,0,3,2
294,8,14,3,0,11,3
294,7,23,5,0,18,5
294,6,20,3,0,17,3
294,5,11,2,0,9,2
3417,10,1,1,0,0,1
3417,8,6,2,0,4,2
3417,7,10,6,0,4,6
3417,6,28,4,0,24,4
3417,5,11,3,0,8,3
3417,4,10,4,0,6,4
3417,3,4,2,0,2,2
3417,2,2,2,0,0,2
41849,10,2,1,0,1,1
41849,9,2,1,0,1,1
41849,8,35,16,0,19,16
41849,7,17,3,0,14,3
41849,6,11,3,0,8,3
41849,3,3,2,0,1,2
140986,8,20,2,0,18,2
140986,7,19,2,0,17,2
140986,6,16,3,0,13,3
140986,4,2,1,0,1,1
94140,8,8,4,0,4,4
94140,7,11,6,0,5,6
94140,6,34,12,0,22,12
94140,5,15,4,0,11,4
94140,4,5,1,0,4,1
94140,3,2,1,0,1,1
8703,9,4,3,0,1,3
8703,8,12,5,0,7,5
8703,7,11,5,0,6,5
8703,6,26,6,0,20,6
8703,5,13,3,0,10,3
8703,4,5,3,0,2,3
8703,1,1,1,0,0,1
142691,8,9,4,0,5,4
142691,7,15,5,0,10,5
142691,6,30,5,0,25,5
142691,5,11,3,0,8,3
142691,4,6,2,0,4,2
142691,3,2,1,0,1,1
65559,7,18,12,0,6,12
65559,6,16,5,0,11,5
65559,5,20,6,0,14,6
65559,4,14,3,0,11,3
65559,3,3,1,0,2,1
65559,2,1,1,0,0,1
205164,10,14,7,1,7,6
205164,9,30,8,0,22,8
205164,8,20,2,1,18,1
205164,7,9,4,1,5,3
232139,10,5,1,0,4,1
232139,9,8,3,0,5,3
232139,8,36,20,0,16,20
232139,7,16,7,0,9,7
232139,6,9,2,0,7,2
232139,5,2,1,0,1,1
132416,10,15,8,0,7,8
132416,9,11,6,0,5,6
132416,8,17,4,0,13,4
132416,7,15,4,0,11,4
132416,6,12,2,0,10,2
132416,5,3,1,0,2,1
30582,8,4,2,0,2,2
30582,7,13,2,0,11,2
30582,6,30,6,0,24,6
30582,5,11,6,0,5,6
30582,4,9,5,0,4,5
30582,3,6,2,0,4,2
266179,10,3,1,0,2,1
266179,9,9,2,0,7,2
266179,8,33,4,0,29,4
266179,7,18,2,0,16,2
266179,6,10,3,0,7,3
148047,8,15,5,0,10,5
148047,7,25,10,0,15,10
148047,6,20,7,0,13,7
148047,5,6,2,0,4,2
148047,4,5,3,0,2,3
197893,7,11,2,0,9,2
197893,6,29,2,0,27,2
197893,5,14,4,0,10,4
197893,4,8,1,0,7,1
189628,8,9,2,0,7,2
189628,7,21,2,0,19,2
189628,6,29,2,0,27,2
189628,5,5,2,0,3,2
189628,4,2,1,0,1,1
189628,3,2,1,0,1,1
5548,10,5,1,0,4,1
5548,9,5,3,0,2,3
5548,8,26,6,0,20,6
5548,6,13,3,0,10,3
5548,5,4,1,0,3,1
5548,3,2,1,0,1,1
5548,2,1,1,0,0,1
141428,10,2,1,0,1,1
141428,8,14,4,0,10,4
141428,7,12,4,0,8,4
141428,6,23,2,0,21,2
141428,5,14,2,0,12,2
141428,4,3,1,0,2,1
141428,2,2,2,0,0,2
124759,8,14,6,0,8,6
124759,7,22,7,0,15,7
124759,6,27,5,0,22,5
124759,5,7,2,0,5,2
124759,4,4,1,0,3,1
36788,8,19,3,0,16,3
36788,7,27,4,0,23,4
36788,6,17,2,0,15,2
36788,4,3,1,0,2,1
107971,7,3,1,0,2,1
107971,6,16,4,0,12,4
107971,5,18,2,0,16,2
107971,4,18,3,0,15,3
107971,3,13,2,0,11,2
64735,10,2,1,0,1,1
64735,9,5,2,0,3,2
64735,8,19,8,0,11,8
64735,7,16,7,0,9,7
64735,6,23,5,0,18,5
64735,5,5,1,0,4,1
64735,4,4,1,0,3,1
64735,3,2,2,0,0,2
246696,9,4,2,0,2,2
246696,8,11,1,0,10,1
246696,7,23,5,0,18,5
246696,6,32,7,0,25,7
246696,5,3,1,0,2,1
246696,4,2,1,0,1,1
246696,3,1,1,0,0,1
32346,10,2,1,0,1,1
32346,9,3,1,0,2,1
32346,8,13,3,0,10,3
32346,7,16,4,0,12,4
32346,6,26,3,0,23,3
32346,5,8,3,0,5,3
32346,4,4,1,0,3,1
175848,9,3,1,0,2,1
175848,8,7,1,0,6,1
175848,6,22,7,1,15,6
175848,5,19,1,0,18,1
175848,4,5,2,1,3,1
175848,3,4,1,0,3,1
31302,10,3,1,0,2,1
31302,9,2,1,0,1,1
31302,8,6,2,0,4,2
31302,7,15,2,0,13,2
31302,6,21,5,0,16,5
31302,5,12,2,0,10,2
31302,4,12,2,0,10,2
31302,2,1,1,0,0,1
235767,8,13,2,0,11,2
235767,7,25,4,0,21,4
235767,6,19,3,0,16,3
235767,5,11,1,0,10,1
190577,10,12,5,0,7,5
190577,9,10,6,0,4,6
190577,8,9,3,1,6,2
190577,7,19,4,1,15,3
190577,6,14,4,1,10,3
190577,5,6,4,0,2,4
190577,4,6,2,0,4,2
4935,7,12,2,0,10,2
4935,6,30,11,0,19,11
4935,5,17,7,0,10,7
4935,4,6,3,0,3,3
4935,3,1,1,0,0,1
4935,2,1,1,0,0,1
151416,8,13,2,0,11,2
151416,7,14,3,0,11,3
151416,6,23,2,0,21,2
151416,5,13,5,0,8,5
151416,4,7,3,0,4,3
151416,3,5,2,0,3,2
70912,7,13,4,0,9,4
70912,6,29,10,0,19,10
70912,3,7,2,0,5,2
28989,7,8,2,0,6,2
28989,6,21,3,0,18,3
28989,5,17,1,0,16,1
28989,4,10,2,0,8,2
28989,3,8,1,0,7,1
31138,10,2,1,0,1,1
31138,8,6,3,0,3,3
31138,7,12,6,0,6,6
31138,6,27,7,0,20,7
31138,5,16,7,0,9,7
31138,4,7,3,0,4,3
31138,3,5,2,0,3,2
14133,7,8,2,0,6,2
14133,6,18,5,0,13,5
14133,5,16,2,0,14,2
14133,4,16,1,0,15,1
14133,3,7,3,0,4,3
14133,2,6,3,0,3,3
14133,1,3,2,0,1,2
133557,10,3,1,0,2,1
133557,8,5,1,0,4,1
133557,6,21,2,0,19,2
133557,5,17,2,0,15,2
133557,4,8,2,0,6,2
133557,2,3,2,0,1,2
133557,1,4,1,0,3,1
11404,9,1,1,0,0,1
11404,8,7,3,0,4,3
11404,7,13,6,0,7,6
11404,6,24,13,0,11,13
11404,5,20,4,0,16,4
11404,4,9,2,0,7,2
11404,3,1,1,0,0,1
218556,10,8,4,0,4,4
218556,9,8,3,0,5,3
218556,8,6,2,0,4,2
218556,6,22,2,0,20,2
218556,5,5,1,0,4,1
218556,4,6,2,0,4,2
218556,3,6,1,0,5,1
218556,2,3,1,0,2,1
218556,1,4,1,0,3,1
206588,7,14,1,0,13,1
206588,6,21,4,0,17,4
206588,5,18,2,0,16,2
206588,3,7,3,0,4,3
206588,2,4,3,0,1,3
177080,9,3,2,0,1,2
177080,8,9,1,0,8,1
177080,7,7,3,0,4,3
177080,6,27,10,1,17,9
177080,5,14,1,1,13,0
177080,4,5,1,0,4,1
177080,3,4,2,0,2,2
177080,2,3,1,0,2,1
9650,10,9,2,0,7,2
9650,9,6,3,0,3,3
9650,8,13,5,0,8,5
9650,7,21,9,0,12,9
9650,6,16,10,0,6,10
9650,5,7,2,0,5,2
9650,4,2,1,0,1,1
54541,9,2,1,0,1,1
54541,8,18,2,0,16,2
54541,7,22,2,0,20,2
54541,6,20,1,0,19,1
191041,10,11,2,1,9,1
191041,9,2,1,0,1,1
191041,8,4,3,0,1,3
191041,6,13,3,0,10,3
191041,5,4,2,0,2,2
191041,4,12,2,0,10,2
191041,3,12,3,0,9,3
191041,2,7,4,0,3,4
191041,1,5,3,0,2,3
140675,10,2,1,0,1,1
140675,9,4,3,0,1,3
140675,8,9,5,0,4,5
140675,7,9,5,0,4,5
140675,6,28,7,0,21,7
140675,5,13,2,0,11,2
140675,4,7,1,0,6,1
140675,3,4,1,0,3,1
7650,8,8,4,0,4,4
7650,7,17,4,0,13,4
7650,6,28,7,0,21,7
7650,5,7,2,0,5,2
7650,4,10,3,0,7,3
7650,3,3,1,0,2,1
5277,10,5,2,0,3,2
5277,9,7,5,0,2,5
5277,8,15,5,0,10,5
5277,7,17,5,0,12,5
5277,6,23,10,0,13,10
5277,5,4,2,0,2,2
226354,9,1,1,0,0,1
226354,7,24,1,0,23,1
226354,6,20,1,0,19,1
226354,3,2,1,0,1,1
5321,8,7,2,0,5,2
5321,7,12,4,0,8,4
5321,6,27,10,0,17,10
5321,5,19,9,0,10,9
5321,4,5,1,0,4,1
25155,9,1,1,0,0,1
25155,8,6,4,0,2,4
25155,7,9,1,0,8,1
25155,6,27,8,0,19,8
25155,5,13,3,0,10,3
25155,3,6,2,0,4,2
25155,2,3,1,0,2,1
53557,6,17,2,0,15,2
53557,5,21,7,0,14,7
53557,4,21,2,0,19,2
53557,3,7,2,0,5,2
189341,6,22,3,0,19,3
189341,5,3,1,0,2,1
11978,10,2,1,0,1,1
11978,8,13,2,0,11,2
11978,7,28,7,0,21,7
11978,6,14,3,0,11,3
11978,5,8,3,0,5,3
11978,4,2,1,0,1,1
11978,2,3,2,0,1,2
4919,9,4,3,0,1,3
4919,8,21,8,0,13,8
4919,7,19,5,0,14,5
4919,6,18,6,0,12,6
4919,5,8,1,0,7,1
4919,4,3,1,0,2,1
4919,3,1,1,0,0,1
4919,1,1,1,0,0,1
38886,10,4,1,0,3,1
38886,9,2,1,0,1,1
38886,8,6,1,0,5,1
38886,7,27,10,0,17,10
38886,6,22,3,0,19,3
38886,5,7,1,0,6,1
38886,4,5,2,0,3,2
38886,3,1,1,0,0,1
38886,2,2,2,0,0,2
7609,10,2,1,0,1,1
7609,9,2,1,0,1,1
7609,8,18,8,0,10,8
7609,7,18,8,0,10,8
7609,6,20,9,0,11,9
7609,5,7,2,0,5,2
7609,4,6,2,0,4,2
7609,3,1,1,0,0,1
7609,2,1,1,0,0,1
246744,10,17,4,0,13,4
246744,8,9,6,1,3,5
246744,7,8,1,0,7,1
246744,6,7,3,0,4,3
246744,5,6,3,0,3,3
246744,4,3,1,0,2,1
246744,3,7,4,0,3,4
246744,1,14,6,0,8,6
4300,10,3,3,0,0,3
4300,9,1,1,0,0,1
4300,8,8,4,0,4,4
4300,7,12,5,0,7,5
4300,6,24,9,0,15,9
4300,5,17,6,0,11,6
4300,4,8,4,0,4,4
4437,9,3,1,0,2,1
4437,8,8,1,0,7,1
4437,7,7,3,0,4,3
4437,6,35,11,0,24,11
4437,5,8,1,0,7,1
4437,3,5,3,0,2,3
4437,2,4,1,0,3,1
9146,9,1,1,0,0,1
9146,8,12,9,0,3,9
9146,7,24,8,0,16,8
9146,6,23,6,0,17,6
9146,5,8,5,0,3,5
9146,4,3,2,0,1,2
9146,3,1,1,0,0,1
9146,2,2,2,0,0,2
9146,1,1,1,0,0,1
4336,10,3,1,0,2,1
4336,9,2,2,0,0,2
4336,8,4,2,0,2,2
4336,7,14,3,0,11,3
4336,6,33,9,0,24,9
4336,5,17,3,0,14,3
4336,4,3,2,0,1,2
26132,10,2,1,0,1,1
26132,9,5,4,0,1,4
26132,8,16,2,0,14,2
26132,7,21,3,0,18,3
26132,6,17,4,0,13,4
26132,5,10,2,0,8,2
26132,2,1,1,0,0,1
10300,10,2,1,0,1,1
10300,9,4,2,0,2,2
10300,8,14,9,0,5,9
10300,7,23,8,0,15,8
10300,6,20,7,0,13,7
10300,5,7,4,0,3,4
10300,4,4,1,0,3,1
17578,7,5,3,0,2,3
17578,6,9,6,0,3,6
17578,5,27,14,0,13,14
17578,4,17,9,0,8,9
17578,3,12,6,0,6,6
17578,2,3,1,0,2,1
122598,9,3,3,0,0,3
122598,8,10,5,0,5,5
122598,6,17,2,0,15,2
122598,5,12,1,0,11,1
122598,4,11,3,0,8,3
122598,3,6,2,0,4,2
122598,2,7,2,0,5,2
122598,1,3,2,0,1,2
111830,9,1,1,0,0,1
111830,8,1,1,0,0,1
111830,7,13,4,1,9,3
111830,6,25,5,0,20,5
111830,5,25,5,0,20,5
111830,4,6,3,0,3,3
166931,8,5,1,0,4,1
166931,7,25,5,0,20,5
166931,6,25,4,0,21,4
166931,5,11,3,0,8,3
166931,4,5,2,0,3,2
3488,10,1,1,0,0,1
3488,9,4,3,0,1,3
3488,7,4,2,0,2,2
3488,6,13,4,0,9,4
3488,5,13,3,0,10,3
3488,4,12,4,0,8,4
3488,3,12,4,0,8,4
3488,2,11,7,0,4,7
3488,1,1,1,0,0,1
7334,8,4,1,0,3,1
7334,7,11,1,0,10,1
7334,6,23,11,0,12,11
7334,5,15,3,0,12,3
7334,4,14,5,0,9,5
7334,3,5,2,0,3,2
7334,1,1,1,0,0,1
2164,9,3,1,0,2,1
2164,8,10,5,0,5,5
2164,7,17,3,0,14,3
2164,6,19,7,0,12,7
2164,5,18,7,0,11,7
2164,4,4,1,0,3,1
2164,3,3,1,0,2,1
32161,7,7,1,0,6,1
32161,6,10,2,0,8,2
32161,5,20,3,0,17,3
32161,4,17,2,0,15,2
32161,3,12,4,0,8,4
32161,1,4,2,0,2,2
171547,6,26,6,0,20,6
171547,5,17,1,0,16,1
171547,4,10,3,0,7,3
171547,3,7,3,0,4,3
171547,2,2,2,0,0,2
32109,10,2,1,0,1,1
32109,8,10,3,0,7,3
32109,7,12,3,0,9,3
32109,6,22,4,0,18,4
32109,5,13,7,0,6,7
32109,4,6,4,0,2,4
32109,3,4,2,0,2,2
32109,2,5,5,0,0,5
35023,8,4,1,0,3,1
35023,7,12,3,0,9,3
35023,6,23,7,0,16,7
35023,5,17,7,0,10,7
35023,4,13,2,0,11,2
162383,10,2,1,0,1,1
162383,9,10,1,0,9,1
162383,8,20,6,0,14,6
162383,7,20,9,0,11,9
162383,6,7,6,0,1,6
162383,5,8,6,0,2,6
162383,3,3,3,0,0,3
162383,2,2,1,0,1,1
17008,9,1,1,0,0,1
17008,7,5,2,0,3,2
17008,6,11,4,0,7,4
17008,5,13,2,0,11,2
17008,4,22,6,0,16,6
17008,3,10,3,0,7,3
17008,2,9,5,0,4,5
17008,1,4,2,0,2,2
155315,9,4,2,0,2,2
155315,8,26,14,2,12,12
155315,7,20,6,0,14,6
155315,6,14,5,0,9,5
155315,5,5,1,0,4,1
155315,1,1,1,0,0,1
139660,8,7,5,1,2,4
139660,7,17,3,1,14,2
139660,6,29,8,2,21,6
139660,5,11,2,0,9,2
139660,4,7,2,0,5,2
139660,2,1,1,0,0,1
139660,1,1,1,0,0,1
2840,7,12,2,0,10,2
2840,6,16,2,0,14,2
2840,5,17,4,0,13,4
2840,4,15,3,0,12,3
2840,3,9,2,0,7,2
185845,10,7,1,0,6,1
185845,9,16,6,0,10,6
185845,8,19,1,0,18,1
185845,5,7,3,1,4,2
185845,4,1,1,0,0,1
185845,1,3,1,0,2,1
160614,7,18,1,0,17,1
160614,6,20,2,0,18,2
160614,5,9,1,0,8,1
160614,4,8,2,0,6,2
160614,3,2,1,0,1,1
154878,10,4,1,1,3,0
154878,9,2,1,0,1,1
154878,8,9,4,0,5,4
154878,7,14,3,0,11,3
154878,6,20,2,0,18,2
154878,5,8,5,1,3,4
154878,4,8,2,0,6,2
154878,3,5,1,0,4,1
154878,2,3,1,0,2,1
28308,8,5,2,0,3,2
28308,6,19,6,0,13,6
28308,5,14,4,0,10,4
28308,4,11,3,0,8,3
28308,3,7,4,0,3,4
28308,2,8,2,0,6,2
28308,1,1,1,0,0,1
8208,10,13,5,0,8,5
8208,9,16,11,0,5,11
8208,8,25,8,0,17,8
8208,7,10,4,0,6,4
8208,6,5,2,0,3,2
8208,5,2,1,0,1,1
8208,4,3,1,0,2,1
8208,3,1,1,0,0,1
29099,7,4,1,0,3,1
29099,6,13,3,0,10,3
29099,5,10,1,0,9,1
29099,4,15,1,0,14,1
29099,3,10,3,0,7,3
29099,2,16,3,0,13,3
138799,10,1,1,0,0,1
138799,8,12,3,0,9,3
138799,7,15,3,1,12,2
138799,6,22,2,0,20,2
138799,4,5,2,0,3,2
138799,3,5,1,0,4,1
138799,2,3,2,1,1,1
6375,7,6,1,0,5,1
6375,6,19,6,0,13,6
6375,5,17,7,0,10,7
6375,4,17,5,0,12,5
6375,3,6,3,0,3,3
6375,2,6,2,0,4,2
6375,1,1,1,0,0,1
175150,10,1,1,0,0,1
175150,8,15,2,0,13,2
175150,7,11,1,0,10,1
175150,6,27,4,0,23,4
1729,10,2,2,0,0,2
1729,8,6,1,0,5,1
1729,7,7,3,0,4,3
1729,6,23,4,0,19,4
1729,5,17,5,0,12,5
1729,4,13,6,0,7,6
1729,3,5,2,0,3,2
2584,10,1,1,0,0,1
2584,9,3,1,0,2,1
2584,8,6,3,0,3,3
2584,7,6,2,0,4,2
2584,6,28,13,0,15,13
2584,5,17,4,0,13,4
2584,4,10,5,0,5,5
2584,3,3,2,0,1,2
32751,10,1,1,0,0,1
32751,8,8,2,0,6,2
32751,7,9,2,0,7,2
32751,6,25,5,0,20,5
32751,5,17,2,0,15,2
32751,4,11,4,0,7,4
32751,3,1,1,0,0,1
4222,10,3,2,0,1,2
4222,8,20,7,0,13,7
4222,7,15,2,0,13,2
4222,6,21,7,0,14,7
4222,4,4,2,0,2,2
4222,2,2,2,0,0,2
7065,9,2,1,0,1,1
7065,8,10,4,0,6,4
7065,7,16,6,0,10,6
7065,6,23,9,0,14,9
7065,5,14,3,0,11,3
7065,2,2,2,0,0,2
7065,1,1,1,0,0,1
5346,9,4,2,0,2,2
5346,8,8,6,0,2,6
5346,7,16,9,0,7,9
5346,6,23,6,0,17,6
5346,5,14,5,0,9,5
5346,4,5,3,0,2,3
23977,10,5,1,0,4,1
23977,9,14,4,1,10,3
23977,8,25,6,0,19,6
23977,7,17,1,0,16,1
23977,6,8,2,0,6,2
23977,5,4,1,1,3,0
23977,1,1,1,0,0,1
70329,6,10,2,0,8,2
70329,5,8,1,0,7,1
70329,4,14,1,0,13,1
70329,3,15,3,0,12,3
70329,2,10,5,0,5,5
70329,1,10,2,0,8,2
25968,7,8,3,0,5,3
25968,6,14,6,0,8,6
25968,5,17,4,0,13,4
25968,4,14,5,0,9,5
25968,3,14,4,0,10,4
25968,2,3,1,0,2,1
221661,10,10,6,0,4,6
221661,9,12,2,0,10,2
221661,8,17,5,0,12,5
221661,7,10,2,0,8,2
221661,6,12,3,0,9,3
221661,5,6,1,0,5,1
221661,4,4,2,1,2,1
221661,3,2,1,0,1,1
221661,1,1,1,1,0,0
130227,9,3,2,0,1,2
130227,7,11,3,0,8,3
130227,6,25,3,0,22,3
130227,5,13,3,0,10,3
130227,4,8,2,0,6,2
130227,2,5,3,0,2,3
130227,1,3,1,0,2,1
23400,10,5,1,0,4,1
23400,9,7,4,0,3,4
23400,8,24,3,0,21,3
23400,7,21,4,0,17,4
23400,6,13,3,0,10,3
23400,4,2,1,0,1,1
198630,10,12,4,0,8,4
198630,9,10,2,0,8,2
198630,8,25,5,0,20,5
198630,7,14,5,1,9,4
198630,6,10,3,0,7,3
198630,3,1,1,0,0,1
43845,10,6,2,0,4,2
43845,9,11,3,0,8,3
43845,8,30,7,0,23,7
43845,7,16,7,0,9,7
43845,6,6,1,0,5,1
43845,2,2,1,0,1,1
28388,9,1,1,0,0,1
28388,8,4,2,0,2,2
28388,7,13,4,0,9,4
28388,6,27,15,0,12,15
28388,5,17,7,0,10,7
28388,4,10,4,0,6,4
28388,3,1,1,0,0,1
28388,2,1,1,0,0,1
28388,1,1,1,0,0,1
2153,9,4,2,0,2,2
2153,8,16,4,0,12,4
2153,7,15,8,0,7,8
2153,6,19,9,0,10,9
2153,5,14,4,0,10,4
2153,4,5,1,0,4,1
68251,9,1,1,0,0,1
68251,8,12,3,0,9,3
68251,7,11,2,0,9,2
68251,6,27,11,0,16,11
68251,5,8,2,0,6,2
68251,4,8,4,0,4,4
68251,2,2,1,0,1,1
75957,10,12,8,0,4,8
75957,9,12,4,0,8,4
75957,8,32,10,0,22,10
75957,7,11,5,0,6,5
75957,6,5,1,0,4,1
75957,5,1,1,0,0,1
75957,4,1,1,0,0,1
3533,8,2,1,0,1,1
3533,7,8,2,0,6,2
3533,6,23,6,0,17,6
3533,5,19,3,0,16,3
3533,4,14,4,0,10,4
3533,3,7,4,0,3,4
3533,2,2,1,0,1,1
137017,6,28,5,0,23,5
137017,5,14,2,0,12,2
137017,4,8,1,0,7,1
137017,1,2,1,0,1,1
5834,10,4,2,0,2,2
5834,9,4,1,0,3,1
5834,8,13,4,0,9,4
5834,7,33,6,0,27,6
5834,6,13,2,0,11,2
5834,5,2,2,0,0,2
5834,4,4,1,0,3,1
5834,1,1,1,0,0,1
119316,10,1,1,0,0,1
119316,9,4,1,0,3,1
119316,8,4,2,0,2,2
119316,7,8,1,0,7,1
119316,6,25,2,0,23,2
119316,5,17,2,0,15,2
119316,3,5,2,0,3,2
119316,2,4,2,0,2,2
10634,8,6,3,0,3,3
10634,7,15,10,0,5,10
10634,6,28,7,0,21,7
10634,5,15,3,0,12,3
10634,4,6,1,0,5,1
67026,8,3,1,0,2,1
67026,7,5,2,0,3,2
67026,6,22,1,0,21,1
67026,5,19,4,0,15,4
67026,4,13,5,0,8,5
7991,8,9,4,0,5,4
7991,7,18,10,0,8,10
7991,6,22,4,0,18,4
7991,5,15,2,0,13,2
7991,4,5,1,0,4,1
7991,3,2,1,0,1,1
22940,10,6,3,0,3,3
22940,9,8,1,0,7,1
22940,8,31,12,0,19,12
22940,7,18,4,0,14,4
22940,6,8,3,0,5,3
22940,4,1,1,0,0,1
199382,8,5,1,0,4,1
199382,7,18,1,0,17,1
199382,6,25,3,0,22,3
227018,10,4,1,0,3,1
227018,7,23,2,0,21,2
227018,6,13,1,0,12,1
227018,4,7,1,0,6,1
227018,3,5,1,0,4,1
227018,1,2,2,0,0,2
625,8,10,5,0,5,5
625,7,14,7,0,7,7
625,6,21,6,0,15,6
625,5,14,4,0,10,4
625,4,10,4,0,6,4
625,2,2,2,0,0,2
13576,10,4,1,0,3,1
13576,8,5,3,0,2,3
13576,6,18,6,0,12,6
13576,5,20,7,0,13,7
13576,4,12,4,0,8,4
13576,3,4,1,0,3,1
13576,2,2,2,0,0,2
180292,8,7,2,0,5,2
180292,7,13,2,0,11,2
180292,6,23,4,0,19,4
180292,5,10,2,0,8,2
180292,4,14,2,0,12,2
180292,3,4,1,0,3,1
180292,1,3,2,0,1,2
245704,10,1,1,0,0,1
245704,8,6,2,0,4,2
245704,7,25,4,0,21,4
245704,6,29,3,0,26,3
245704,5,8,1,0,7,1
245704,4,6,2,0,4,2
234451,9,2,1,0,1,1
234451,8,10,2,0,8,2
234451,7,22,4,0,18,4
234451,6,28,2,0,26,2
234451,5,9,1,0,8,1
4060,9,1,1,0,0,1
4060,8,7,3,0,4,3
4060,7,16,3,0,13,3
4060,6,25,9,0,16,9
4060,5,14,4,0,10,4
4060,4,8,2,0,6,2
4060,2,2,1,0,1,1
4060,1,1,1,0,0,1
10912,10,1,1,0,0,1
10912,9,1,1,0,0,1
10912,7,6,3,0,3,3
10912,6,17,8,0,9,8
10912,5,20,9,0,11,9
10912,4,13,3,0,10,3
10912,3,9,6,0,3,6
10912,2,6,4,0,2,4
180644,10,11,2,0,9,2
180644,9,10,4,0,6,4
180644,7,18,2,0,16,2
180644,6,12,1,0,11,1
180644,4,6,1,0,5,1
180644,3,3,1,0,2,1
5621,10,3,1,0,2,1
5621,8,4,1,0,3,1
5621,7,7,3,0,4,3
5621,6,21,6,0,15,6
5621,5,17,5,0,12,5
5621,4,14,5,0,9,5
5621,3,4,1,0,3,1
5621,1,1,1,0,0,1
3471,10,6,5,0,1,5
3471,9,2,1,0,1,1
3471,8,7,3,0,4,3
3471,7,18,7,0,11,7
3471,6,20,11,0,9,11
3471,5,17,8,0,9,8
3471,4,2,1,0,1,1
3471,2,2,1,0,1,1
10716,9,2,1,0,1,1
10716,8,10,3,0,7,3
10716,7,13,2,0,11,2
10716,6,21,5,0,16,5
10716,5,12,3,0,9,3
10716,4,10,4,0,6,4
10716,3,3,1,0,2,1
260407,10,8,1,0,7,1
260407,9,3,1,0,2,1
260407,8,14,1,0,13,1
260407,7,25,2,0,23,2
260407,6,17,5,0,12,5
260407,5,7,1,0,6,1
23304,10,8,5,0,3,5
23304,8,7,1,0,6,1
23304,7,11,2,0,9,2
23304,6,19,4,1,15,3
23304,5,10,2,0,8,2
23304,4,10,5,0,5,5
23304,2,3,1,0,2,1
85633,10,4,2,0,2,2
85633,9,6,1,0,5,1
85633,8,24,7,0,17,7
85633,7,16,5,0,11,5
85633,6,16,2,0,14,2
85633,5,6,1,0,5,1
16435,10,7,4,0,3,4
16435,8,22,13,0,9,13
16435,7,23,8,0,15,8
16435,6,13,2,0,11,2
16435,5,6,2,0,4,2
16435,3,1,1,0,0,1
258693,10,3,2,0,1,2
258693,9,6,3,0,3,3
258693,8,33,8,0,25,8
258693,5,2,1,0,1,1
9160,10,1,1,0,0,1
9160,9,4,1,0,3,1
9160,8,6,2,0,4,2
9160,7,4,2,0,2,2
9160,6,10,4,0,6,4
9160,5,19,5,0,14,5
9160,4,17,5,0,12,5
9160,3,6,2,0,4,2
9160,2,7,3,0,4,3
9160,1,1,1,0,0,1
29924,7,11,1,0,10,1
29924,6,22,5,0,17,5
29924,5,17,3,0,14,3
29924,4,11,2,0,9,2
29924,3,8,2,0,6,2
16792,9,5,2,0,3,2
16792,8,22,5,0,17,5
16792,7,21,2,0,19,2
16792,6,20,4,0,16,4
16792,5,3,1,0,2,1
16792,2,1,1,0,0,1
4189,7,2,1,0,1,1
4189,6,9,4,0,5,4
4189,5,18,5,0,13,5
4189,4,13,5,0,8,5
4189,3,18,11,0,7,11
4189,2,7,2,0,5,2
4189,1,6,2,0,4,2
19621,8,6,1,0,5,1
19621,7,7,1,0,6,1
19621,6,18,5,0,13,5
19621,5,26,3,0,23,3
19621,4,12,3,0,9,3
19621,3,4,1,0,3,1
20623,10,3,2,0,1,2
20623,9,8,4,0,4,4
20623,8,22,14,0,8,14
20623,7,20,9,0,11,9
20623,6,16,9,0,7,9
20623,5,3,1,0,2,1
20623,4,2,2,0,0,2
7047,9,4,4,0,0,4
7047,8,9,8,0,1,8
7047,7,19,13,0,6,13
7047,6,27,13,0,14,13
7047,5,8,4,0,4,4
7047,4,4,3,0,1,3
7047,2,1,1,0,0,1
134477,7,9,1,0,8,1
134477,6,20,6,0,14,6
134477,5,20,10,0,10,10
134477,4,11,4,0,7,4
134477,3,10,2,0,8,2
232353,10,4,2,0,2,2
232353,9,5,1,0,4,1
232353,8,19,5,0,14,5
232353,7,17,1,0,16,1
232353,6,17,3,0,14,3
232353,5,5,1,0,4,1
232353,4,2,1,0,1,1
232353,3,4,2,0,2,2
232353,1,2,1,0,1,1
9918,9,8,2,0,6,2
9918,8,32,19,0,13,19
9918,7,20,2,0,18,2
9918,5,1,1,0,0,1
7694,10,6,2,0,4,2
7694,9,1,1,0,0,1
7694,8,9,1,0,8,1
7694,7,16,5,0,11,5
7694,6,19,9,0,10,9
7694,5,16,8,0,8,8
7694,4,5,1,0,4,1
7694,2,1,1,0,0,1
181377,10,5,3,0,2,3
181377,8,31,8,1,23,7
181377,7,17,1,0,16,1
181377,6,9,3,0,6,3
181377,2,1,1,0,0,1
773,8,3,1,0,2,1
773,7,6,3,0,3,3
773,6,28,4,0,24,4
773,5,16,2,0,14,2
773,4,13,3,0,10,3
773,3,4,1,0,3,1
773,2,2,2,0,0,2
1215,8,5,3,0,2,3
1215,7,11,5,0,6,5
1215,6,25,11,0,14,11
1215,5,20,7,0,13,7
1215,4,7,3,0,4,3
1215,3,6,1,0,5,1
6085,10,3,1,0,2,1
6085,8,6,2,0,4,2
6085,7,17,2,0,15,2
6085,6,30,7,0,23,7
6085,5,10,2,0,8,2
6085,4,4,2,0,2,2
6085,3,4,1,0,3,1
9610,10,3,2,0,1,2
9610,8,8,2,0,6,2
9610,7,16,5,0,11,5
9610,6,19,6,0,13,6
9610,4,10,2,0,8,2
9610,3,6,2,0,4,2
9610,2,4,1,0,3,1
675,10,1,1,0,0,1
675,8,3,3,0,0,3
675,7,7,4,0,3,4
675,6,25,14,0,11,14
675,5,17,8,0,9,8
675,4,14,5,0,9,5
675,3,4,1,0,3,1
675,2,3,3,0,0,3
2171,10,2,1,0,1,1
2171,8,12,3,0,9,3
2171,7,18,10,0,8,10
2171,6,29,7,0,22,7
2171,4,3,2,0,1,2
2171,2,1,1,0,0,1
246746,10,6,1,0,5,1
246746,8,30,6,0,24,6
246746,7,17,1,0,16,1
246746,6,8,2,0,6,2
246746,2,1,1,0,0,1
72298,9,10,4,0,6,4
72298,8,28,11,0,17,11
72298,7,18,5,0,13,5
72298,6,11,4,0,7,4
72298,5,4,2,0,2,2
190915,10,11,7,2,4,5
190915,9,4,2,0,2,2
190915,8,18,5,1,13,4
190915,7,14,2,0,12,2
190915,6,11,5,1,6,4
190915,3,3,1,0,2,1
129295,10,4,4,0,0,4
129295,8,8,3,0,5,3
129295,7,10,3,0,7,3
129295,6,26,4,0,22,4
129295,5,17,3,0,14,3
129295,4,5,1,0,4,1
129295,2,1,1,0,0,1
4567,10,1,1,0,0,1
4567,8,2,2,0,0,2
4567,6,10,2,0,8,2
4567,5,16,6,0,10,6
4567,4,16,5,0,11,5
4567,3,13,8,0,5,8
4567,2,7,1,0,6,1
4567,1,4,1,0,3,1
162223,8,10,2,0,8,2
162223,5,12,2,0,10,2
3993,10,1,1,0,0,1
3993,8,4,2,0,2,2
3993,7,17,7,0,10,7
3993,6,34,11,0,23,11
3993,5,11,4,0,7,4
3993,4,3,1,0,2,1
3993,3,3,1,0,2,1
75991,7,6,1,0,5,1
75991,6,12,1,0,11,1
75991,5,25,4,0,21,4
75991,4,14,4,0,10,4
75991,3,9,4,0,5,4
75991,2,2,1,0,1,1
75991,1,3,3,0,0,3
144955,7,17,5,0,12,5
144955,6,26,7,0,19,7
144955,5,9,3,0,6,3
11525,10,2,1,0,1,1
11525,8,7,1,0,6,1
11525,7,12,5,0,7,5
11525,6,25,13,0,12,13
11525,5,17,2,0,15,2
11525,4,8,4,0,4,4
11525,3,2,1,0,1,1
2410,8,9,4,0,5,4
2410,7,19,7,0,12,7
2410,6,15,3,0,12,3
2410,5,8,4,0,4,4
175274,7,17,2,0,15,2
175274,6,22,1,0,21,1
175274,5,6,1,0,5,1
175274,4,6,1,0,5,1
175274,2,4,1,0,3,1
175274,1,1,1,0,0,1
6355,9,3,3,0,0,3
6355,7,12,2,0,10,2
6355,6,29,7,0,22,7
6355,5,7,1,0,6,1
6355,4,9,5,0,4,5
6355,3,7,3,0,4,3
6355,2,2,1,0,1,1
81561,10,1,1,0,0,1
81561,9,2,2,0,0,2
81561,7,9,4,0,5,4
81561,5,15,3,0,12,3
81561,4,9,1,0,8,1
203845,10,5,2,0,3,2
203845,9,4,3,1,1,2
203845,8,12,2,0,10,2
203845,7,27,3,2,24,1
203845,6,15,3,2,12,1
203845,4,4,1,0,3,1
203845,3,2,1,0,1,1
21749,7,5,1,0,4,1
21749,6,23,3,0,20,3
21749,5,21,6,0,15,6
21749,4,12,7,0,5,7
21749,3,5,1,0,4,1
21749,2,4,3,0,1,3
21749,1,2,1,0,1,1
25925,8,4,3,0,1,3
25925,7,20,8,0,12,8
25925,6,19,5,0,14,5
25925,5,12,6,0,6,6
25925,4,7,2,0,5,2
25925,3,4,2,0,2,2
25925,2,5,3,0,2,3
3459,10,3,2,0,1,2
3459,9,1,1,0,0,1
3459,8,9,4,0,5,4
3459,7,18,13,0,5,13
3459,6,28,11,0,17,11
3459,5,9,5,0,4,5
3459,4,4,1,0,3,1
3459,2,2,1,0,1,1
259809,10,3,1,0,2,1
259809,7,16,4,0,12,4
20771,9,2,1,0,1,1
20771,7,7,2,0,5,2
20771,6,23,2,0,21,2
20771,5,15,7,0,8,7
20771,4,14,5,0,9,5
20771,3,4,3,0,1,3
20771,2,4,1,0,3,1
20771,1,2,2,0,0,2
2814,8,15,4,0,11,4
2814,7,17,4,0,13,4
2814,6,16,6,0,10,6
2814,5,16,3,0,13,3
2814,4,8,5,0,3,5
3985,10,6,2,0,4,2
3985,9,3,1,0,2,1
3985,8,18,7,0,11,7
3985,7,15,4,0,11,4
3985,6,24,6,0,18,6
3985,4,1,1,0,0,1
204461,10,2,1,0,1,1
204461,8,17,7,0,10,7
204461,7,23,2,0,21,2
204461,6,24,5,1,19,4
204461,5,6,3,0,3,3
249410,9,3,1,0,2,1
249410,8,22,4,0,18,4
249410,7,25,4,0,21,4
249410,6,17,1,0,16,1
229241,8,15,1,0,14,1
229241,7,20,5,0,15,5
229241,6,23,6,0,17,6
229241,5,9,2,0,7,2
229241,4,4,1,0,3,1
137244,7,12,1,0,11,1
137244,6,23,5,0,18,5
137244,5,20,4,0,16,4
137244,4,10,2,0,8,2
19902,10,2,1,0,1,1
19902,9,8,6,0,2,6
19902,8,23,7,0,16,7
19902,7,20,5,0,15,5
19902,6,11,4,0,7,4
19902,5,4,3,0,1,3
19902,4,3,3,0,0,3
19902,3,2,1,0,1,1
31053,8,15,3,0,12,3
31053,7,24,1,0,23,1
31053,6,19,5,0,14,5
31053,4,4,1,0,3,1
31053,2,1,1,0,0,1
84783,10,2,1,0,1,1
84783,9,1,1,0,0,1
84783,8,23,10,0,13,10
84783,7,16,7,0,9,7
84783,6,17,5,0,12,5
84783,5,8,3,0,5,3
84783,4,5,3,0,2,3
84783,3,2,2,0,0,2
4874,9,5,2,0,3,2
4874,8,7,4,0,3,4
4874,7,16,7,0,9,7
4874,6,28,9,0,19,9
4874,5,9,3,0,6,3
4874,4,2,1,0,1,1
4874,1,1,1,0,0,1
183360,10,11,4,0,7,4
183360,9,7,4,0,3,4
183360,8,14,4,0,10,4
183360,6,23,5,0,18,5
183360,5,3,1,0,2,1
224656,10,11,9,0,2,9
224656,9,10,6,0,4,6
224656,8,13,3,0,10,3
224656,6,10,2,0,8,2
224656,2,4,2,0,2,2
224656,1,8,4,0,4,4
124589,7,14,2,0,12,2
124589,6,25,5,0,20,5
124589,5,13,2,0,11,2
124589,4,9,2,0,7,2
129309,9,2,1,0,1,1
129309,8,12,6,0,6,6
129309,7,29,9,0,20,9
129309,6,18,9,0,9,9
129309,5,10,3,0,7,3
129309,4,1,1,0,0,1
129309,3,1,1,0,0,1
129309,1,1,1,0,0,1
195515,8,20,9,0,11,9
195515,7,26,5,0,21,5
195515,6,18,4,0,14,4
195515,5,7,2,0,5,2
144460,10,6,2,0,4,2
144460,8,14,3,1,11,2
144460,7,24,4,0,20,4
144460,6,17,3,0,14,3
144460,4,3,1,0,2,1
144460,3,3,1,0,2,1
40619,9,2,1,0,1,1
40619,8,10,5,0,5,5
40619,7,15,4,0,11,4
40619,6,27,4,0,23,4
40619,5,12,4,0,8,4
40619,4,6,2,0,4,2
40619,2,2,1,0,1,1
182172,10,5,1,0,4,1
182172,9,3,2,0,1,2
182172,8,5,1,0,4,1
182172,7,20,6,0,14,6
182172,6,28,4,0,24,4
182172,5,10,2,0,8,2
182172,4,3,1,0,2,1
227995,10,25,12,0,13,12
227995,9,20,7,0,13,7
227995,8,22,7,0,15,7
227995,7,4,1,0,3,1
227995,4,1,1,0,0,1
180598,9,1,1,0,0,1
180598,8,14,4,0,10,4
180598,7,19,2,0,17,2
180598,6,23,3,0,20,3
180598,5,8,3,0,5,3
180598,4,3,1,0,2,1
254713,10,12,4,1,8,3
254713,9,11,4,2,7,2
254713,8,24,6,2,18,4
254713,7,14,2,0,12,2
254713,6,8,2,0,6,2
254713,1,1,1,0,0,1
39834,8,6,2,0,4,2
39834,7,17,6,0,11,6
39834,6,22,4,0,18,4
39834,5,12,3,0,9,3
39834,4,12,3,0,9,3
39834,3,2,1,0,1,1
39834,2,2,2,0,0,2
9916,9,3,2,0,1,2
9916,8,9,4,0,5,4
9916,7,21,7,0,14,7
9916,6,27,4,0,23,4
9916,5,8,5,0,3,5
9916,4,3,3,0,0,3
9916,3,1,1,0,0,1
228882,10,2,1,0,1,1
228882,9,5,3,0,2,3
228882,8,11,1,0,10,1
228882,7,14,2,0,12,2
228882,6,18,1,0,17,1
228882,5,10,1,0,9,1
228882,4,10,4,0,6,4
228882,3,3,1,0,2,1
202296,9,3,3,0,0,3
202296,8,13,3,0,10,3
202296,7,19,5,0,14,5
202296,6,21,2,0,19,2
202296,3,1,1,0,0,1
175221,10,2,1,0,1,1
175221,8,10,3,0,7,3
175221,7,18,2,0,16,2
175221,6,26,4,0,22,4
175221,5,7,1,0,6,1
1632,9,1,1,0,0,1
1632,8,15,6,0,9,6
1632,7,12,6,0,6,6
1632,6,25,11,0,14,11
1632,5,7,4,0,3,4
1632,4,8,3,0,5,3
1632,3,6,3,0,3,3
240926,7,23,3,1,20,2
240926,6,23,4,2,19,2
240926,5,7,3,1,4,2
240926,1,1,1,0,0,1
97377,10,7,3,0,4,3
97377,9,13,4,0,9,4
97377,8,24,3,0,21,3
97377,7,14,2,0,12,2
97377,6,7,1,0,6,1
97377,4,2,1,0,1,1
97377,2,1,1,0,0,1
24487,8,6,3,0,3,3
24487,7,9,6,0,3,6
24487,6,23,3,0,20,3
24487,5,20,6,0,14,6
24487,3,6,3,0,3,3
24487,2,3,2,0,1,2
94822,10,2,1,0,1,1
94822,9,3,1,0,2,1
94822,8,20,3,0,17,3
94822,7,18,3,0,15,3
94822,6,17,5,0,12,5
94822,5,5,1,0,4,1
11930,10,5,1,0,4,1
11930,9,8,1,0,7,1
11930,8,6,2,0,4,2
11930,7,13,7,0,6,7
11930,6,11,2,0,9,2
11930,5,15,9,0,6,9
11930,4,8,3,0,5,3
11930,3,5,1,0,4,1
11930,2,2,1,0,1,1
11930,1,1,1,0,0,1
220276,9,3,1,0,2,1
220276,8,11,4,0,7,4
220276,7,17,2,0,15,2
220276,6,25,1,0,24,1
220276,5,12,2,0,10,2
179629,9,2,1,0,1,1
179629,8,5,3,0,2,3
179629,7,11,4,0,7,4
179629,6,17,3,0,14,3
179629,5,20,4,0,16,4
179629,4,9,2,0,7,2
179629,2,4,2,0,2,2
94615,9,2,1,0,1,1
94615,8,18,13,0,5,13
94615,7,19,8,0,11,8
94615,6,15,3,0,12,3
94615,5,18,5,0,13,5
37777,10,1,1,0,0,1
37777,7,17,2,0,15,2
37777,6,23,2,0,21,2
37777,5,15,3,0,12,3
37777,4,3,1,0,2,1
133518,9,7,1,0,6,1
133518,8,30,7,0,23,7
133518,7,26,8,0,18,8
133518,5,2,1,0,1,1
1985,8,12,5,0,7,5
1985,7,13,5,0,8,5
1985,6,25,6,0,19,6
1985,5,18,6,0,12,6
1985,4,4,1,0,3,1
156843,10,11,4,0,7,4
156843,9,13,3,0,10,3
156843,8,28,10,0,18,10
156843,7,7,3,0,4,3
156843,6,5,2,0,3,2
156843,5,2,1,0,1,1
156843,4,5,4,0,1,4
257836,8,13,4,0,9,4
257836,7,19,2,0,17,2
257836,6,26,6,0,20,6
257836,3,1,1,0,0,1
257836,1,1,1,0,0,1
5453,8,8,3,0,5,3
5453,7,22,8,0,14,8
5453,6,19,8,0,11,8
5453,5,14,2,0,12,2
5453,4,8,6,0,2,6
5453,1,1,1,0,0,1
1673,8,1,1,0,0,1
1673,7,4,1,0,3,1
1673,6,14,4,0,10,4
1673,5,23,3,0,20,3
1673,4,18,7,0,11,7
1673,3,9,3,0,6,3
1673,2,3,1,0,2,1
27945,9,4,1,0,3,1
27945,8,17,6,0,11,6
27945,7,20,7,0,13,7
27945,6,18,6,0,12,6
27945,5,10,7,0,3,7
27945,4,3,3,0,0,3
27945,2,2,2,0,0,2
648,7,7,1,0,6,1
648,6,14,4,0,10,4
648,4,14,4,0,10,4
648,3,12,4,0,8,4
648,2,7,5,0,2,5
648,1,3,2,0,1,2
140829,10,3,2,0,1,2
140829,8,8,3,1,5,2
140829,7,8,2,0,6,2
140829,6,16,5,1,11,4
140829,5,9,1,0,8,1
140829,4,15,1,0,14,1
140829,3,6,1,0,5,1
140829,2,4,1,0,3,1
140829,1,4,3,0,1,3
149970,9,4,1,0,3,1
149970,8,26,7,3,19,4
149970,7,13,2,0,11,2
149970,6,18,3,0,15,3
149970,5,8,1,0,7,1
149970,4,4,1,0,3,1
165737,8,6,1,0,5,1
165737,7,15,6,0,9,6
165737,6,33,7,0,26,7
165737,5,12,7,0,5,7
165737,4,5,1,0,4,1
165737,2,1,1,0,0,1
11508,8,4,3,0,1,3
11508,7,9,2,0,7,2
11508,6,27,6,0,21,6
11508,5,20,12,0,8,12
11508,4,9,4,0,5,4
11508,3,4,1,0,3,1
11508,2,1,1,0,0,1
228142,8,18,1,0,17,1
228142,7,21,4,0,17,4
228142,6,21,4,0,17,4
202096,10,11,1,0,10,1
202096,8,23,2,0,21,2
202096,7,24,2,0,22,2
202096,5,5,1,0,4,1
202096,2,1,1,0,0,1
233048,10,19,7,0,12,7
233048,9,5,5,0,0,5
233048,8,15,7,0,8,7
233048,7,13,4,0,9,4
233048,6,10,2,0,8,2
233048,2,1,1,0,0,1
233048,1,2,2,0,0,2
10525,10,24,13,0,11,13
10525,9,3,2,0,1,2
10525,8,5,3,0,2,3
10525,7,9,3,0,6,3
10525,6,7,1,0,6,1
10525,5,8,1,0,7,1
10525,4,10,4,0,6,4
10525,3,4,1,0,3,1
10525,2,3,2,0,1,2
10525,1,1,1,0,0,1
158232,8,2,2,0,0,2
158232,7,7,2,0,5,2
158232,6,21,4,0,17,4
158232,5,10,2,0,8,2
158232,4,16,6,0,10,6
158232,2,4,2,0,2,2
158232,1,4,1,0,3,1
10304,8,7,2,0,5,2
10304,7,17,5,0,12,5
10304,6,11,2,0,9,2
10304,5,13,1,0,12,1
10304,4,8,3,0,5,3
1341,8,9,4,0,5,4
1341,7,13,4,0,9,4
1341,6,28,10,0,18,10
1341,5,10,4,0,6,4
1341,4,7,1,0,6,1
1341,3,4,3,0,1,3
1656,8,6,4,0,2,4
1656,7,5,4,0,1,4
1656,6,17,6,0,11,6
1656,5,9,4,0,5,4
1656,4,20,9,0,11,9
1656,3,8,2,0,6,2
1656,2,5,1,0,4,1
171424,6,26,2,0,24,2
171424,5,15,2,0,13,2
171424,3,9,1,0,8,1
11632,9,1,1,0,0,1
11632,8,12,6,0,6,6
11632,7,26,9,0,17,9
11632,6,21,3,0,18,3
11632,5,8,1,0,7,1
11632,4,3,2,0,1,2
11632,2,2,1,0,1,1
5173,10,3,1,0,2,1
5173,9,3,3,0,0,3
5173,8,7,2,0,5,2
5173,7,22,2,0,20,2
5173,6,24,5,0,19,5
5173,5,7,2,0,5,2
5173,4,4,1,0,3,1
5173,3,2,1,0,1,1
5483,10,3,2,0,1,2
5483,9,4,2,0,2,2
5483,8,11,5,0,6,5
5483,7,17,8,0,9,8
5483,6,21,6,0,15,6
5483,5,7,1,0,6,1
5483,4,6,2,0,4,2
5483,2,1,1,0,0,1
4381,8,4,1,0,3,1
4381,7,8,2,0,6,2
4381,6,21,10,0,11,10
4381,5,17,3,0,14,3
4381,4,10,5,0,5,5
4381,3,7,2,0,5,2
4381,2,5,2,0,3,2
11528,9,1,1,0,0,1
11528,8,3,1,0,2,1
11528,7,10,2,0,8,2
11528,6,19,9,0,10,9
11528,5,22,6,0,16,6
11528,4,8,1,0,7,1
11528,3,3,1,0,2,1
11528,2,5,3,0,2,3
183839,7,22,2,0,20,2
183839,6,29,7,0,22,7
183839,5,14,3,0,11,3
183839,4,6,1,0,5,1
298,7,15,2,0,13,2
298,5,18,6,0,12,6
298,4,11,1,0,10,1
298,3,7,2,0,5,2
298,1,2,1,0,1,1
100089,8,37,19,0,18,19
100089,7,13,6,0,7,6
100089,6,16,6,0,10,6
100089,5,2,1,0,1,1
121471,8,8,4,0,4,4
121471,7,11,3,0,8,3
121471,6,13,4,0,9,4
121471,5,14,6,0,8,6
121471,4,13,4,0,9,4
121471,3,7,1,0,6,1
121471,2,4,1,0,3,1
121471,1,1,1,0,0,1
188825,10,10,5,0,5,5
188825,9,10,7,0,3,7
188825,8,19,7,0,12,7
188825,7,17,5,0,12,5
188825,6,9,3,0,6,3
188825,5,3,2,0,1,2
188825,4,1,1,0,0,1
188825,1,1,1,0,0,1
41017,9,1,1,0,0,1
41017,8,3,1,0,2,1
41017,6,19,3,0,16,3
41017,5,15,2,0,13,2
41017,4,17,2,0,15,2
41017,3,9,2,0,7,2
41017,2,3,1,0,2,1
41844,7,13,1,0,12,1
41844,6,33,6,0,27,6
41844,4,5,2,0,3,2
41844,3,2,2,0,0,2
169502,9,2,1,0,1,1
169502,8,5,2,0,3,2
169502,7,12,3,0,9,3
169502,6,20,6,0,14,6
169502,5,10,1,0,9,1
169502,4,7,2,0,5,2
169502,3,6,2,0,4,2
169502,2,6,1,0,5,1
169502,1,4,3,0,1,3
86445,9,5,3,0,2,3
86445,8,20,5,0,15,5
86445,7,29,14,0,15,14
86445,6,14,4,0,10,4
86445,5,1,1,0,0,1
86445,4,3,1,0,2,1
207347,10,3,1,0,2,1
207347,8,10,1,0,9,1
207347,7,20,3,0,17,3
207347,6,24,4,0,20,4
207347,5,7,1,0,6,1
207347,4,7,2,0,5,2
20586,10,3,2,0,1,2
20586,9,10,3,0,7,3
20586,8,22,8,0,14,8
20586,7,16,2,0,14,2
20586,6,13,6,0,7,6
20586,5,5,1,0,4,1
20586,4,1,1,0,0,1
6049,9,2,2,0,0,2
6049,8,6,1,0,5,1
6049,7,14,4,0,10,4
6049,6,31,11,0,20,11
6049,5,8,3,0,5,3
6049,3,3,1,0,2,1
6049,2,1,1,0,0,1
4379,8,6,1,0,5,1
4379,7,12,7,0,5,7
4379,6,30,9,0,21,9
4379,5,14,4,0,10,4
4379,4,3,1,0,2,1
4379,3,3,1,0,2,1
4379,2,1,1,0,0,1
4379,1,1,1,0,0,1
5051,10,2,1,0,1,1
5051,9,3,2,0,1,2
5051,8,8,3,0,5,3
5051,7,6,2,0,4,2
5051,6,15,2,0,13,2
5051,5,12,2,0,10,2
5051,4,4,3,0,1,3
5051,3,13,10,0,3,10
5051,2,9,5,0,4,5
5051,1,1,1,0,0,1
29848,10,4,2,0,2,2
29848,9,7,5,0,2,5
29848,8,16,6,0,10,6
29848,7,17,10,0,7,10
29848,6,19,6,0,13,6
29848,5,4,2,0,2,2
29848,4,3,2,0,1,2
29848,3,2,2,0,0,2
3673,8,2,2,0,0,2
3673,7,7,3,0,4,3
3673,6,27,11,0,16,11
3673,5,20,4,0,16,4
3673,3,6,1,0,5,1
3673,1,2,1,0,1,1
8751,10,6,3,0,3,3
8751,9,3,2,0,1,2
8751,8,16,8,0,8,8
8751,7,24,10,0,14,10
8751,6,15,4,0,11,4
8751,5,7,4,0,3,4
2418,8,2,1,0,1,1
2418,6,23,4,0,19,4
2418,5,18,4,0,14,4
2418,4,14,5,0,9,5
2418,2,1,1,0,0,1
24485,8,8,2,0,6,2
24485,7,19,7,0,12,7
24485,6,22,8,0,14,8
24485,5,11,3,0,8,3
24485,4,5,2,0,3,2
24485,3,3,1,0,2,1
236360,9,3,1,0,2,1
236360,8,7,1,0,6,1
236360,7,9,1,0,8,1
236360,6,20,2,0,18,2
236360,3,5,2,0,3,2
236360,1,14,5,0,9,5
40507,8,3,1,0,2,1
40507,7,8,3,0,5,3
40507,6,24,4,0,20,4
40507,5,21,3,0,18,3
40507,4,11,2,0,9,2
40507,2,3,1,0,2,1
7080,9,1,1,0,0,1
7080,8,7,4,0,3,4
7080,7,11,3,0,8,3
7080,6,27,7,0,20,7
7080,5,16,2,0,14,2
7080,4,7,1,0,6,1
7080,3,3,1,0,2,1
7080,2,1,1,0,0,1
33140,8,8,5,0,3,5
33140,7,20,9,0,11,9
33140,6,32,15,0,17,15
33140,5,7,2,0,5,2
33140,4,3,2,0,1,2
309,9,2,2,0,0,2
309,7,22,7,0,15,7
309,6,22,5,0,17,5
309,5,15,5,0,10,5
309,4,5,3,0,2,3
50764,10,6,4,0,2,4
50764,9,6,1,0,5,1
50764,8,19,12,0,7,12
50764,7,19,2,0,17,2
50764,6,16,3,0,13,3
50764,4,2,2,0,0,2
50764,3,1,1,0,0,1
50764,2,1,1,0,0,1
54300,10,4,3,0,1,3
54300,9,8,4,0,4,4
54300,8,20,10,0,10,10
54300,7,20,10,0,10,10
54300,6,15,6,0,9,6
54300,5,2,1,0,1,1
54300,4,3,1,0,2,1
6909,7,16,2,0,14,2
6909,6,18,4,0,14,4
6909,5,7,1,0,6,1
6909,3,2,1,0,1,1
248909,10,3,1,0,2,1
248909,8,16,3,0,13,3
248909,7,17,1,0,16,1
248909,6,22,4,0,18,4
248909,5,8,2,0,6,2
17158,10,1,1,0,0,1
17158,8,4,2,0,2,2
17158,7,15,5,0,10,5
17158,6,24,5,0,19,5
17158,5,14,4,0,10,4
17158,4,8,6,0,2,6
17158,3,6,3,0,3,3
41004,10,2,1,0,1,1
41004,9,5,4,0,1,4
41004,8,29,11,0,18,11
41004,7,20,7,0,13,7
41004,6,11,6,0,5,6
41004,5,4,3,0,1,3
41004,4,2,1,0,1,1
111855,7,29,3,0,26,3
111855,6,23,2,0,21,2
111855,4,6,1,0,5,1
111855,3,1,1,0,0,1
871,8,8,4,0,4,4
871,7,22,12,0,10,12
871,6,21,11,0,10,11
871,5,9,6,0,3,6
871,4,9,4,0,5,4
871,3,3,3,0,0,3
152761,8,3,1,0,2,1
152761,7,15,4,0,11,4
152761,6,28,7,0,21,7
152761,5,15,6,0,9,6
152761,4,9,1,0,8,1
152761,3,1,1,0,0,1
66641,8,9,2,0,7,2
66641,7,16,1,0,15,1
66641,6,30,3,0,27,3
66641,4,2,1,0,1,1
66641,3,3,1,0,2,1
216282,9,4,1,0,3,1
216282,8,10,1,1,9,0
216282,7,25,2,0,23,2
216282,6,21,3,0,18,3
216282,5,5,2,1,3,1
216282,4,4,2,0,2,2
122831,10,10,5,1,5,4
122831,9,4,2,0,2,2
122831,8,20,7,2,13,5
122831,7,16,6,0,10,6
122831,6,15,4,0,11,4
122831,5,6,1,0,5,1
122831,1,1,1,0,0,1
1984,8,5,1,0,4,1
1984,7,14,7,0,7,7
1984,6,27,11,0,16,11
1984,5,12,3,0,9,3
1984,4,8,1,0,7,1
1984,3,4,2,0,2,2
1984,2,1,1,0,0,1
9117,9,5,2,0,3,2
9117,8,15,6,0,9,6
9117,7,22,6,0,16,6
9117,6,19,2,0,17,2
9117,5,7,2,0,5,2
94346,9,1,1,0,0,1
94346,7,9,1,0,8,1
94346,6,29,6,0,23,6
94346,5,16,5,0,11,5
94346,4,10,3,0,7,3
94346,3,5,2,0,3,2
257957,9,3,2,0,1,2
257957,8,8,1,0,7,1
257957,7,22,5,0,17,5
257957,6,21,1,0,20,1
257957,5,8,4,0,4,4
257957,4,8,1,0,7,1
257957,3,2,1,0,1,1
163099,8,12,2,0,10,2
163099,7,18,6,0,12,6
163099,6,24,7,0,17,7
163099,4,6,2,0,4,2
163099,3,3,1,0,2,1
1581,8,7,3,0,4,3
1581,7,13,5,0,8,5
1581,6,24,8,0,16,8
1581,5,13,5,0,8,5
1581,4,8,6,0,2,6
1581,3,5,3,0,2,3
1581,2,2,1,0,1,1
2826,9,3,1,0,2,1
2826,8,7,2,0,5,2
2826,7,11,4,0,7,4
2826,6,29,10,0,19,10
2826,5,17,6,0,11,6
2826,4,4,1,0,3,1
257273,7,22,3,0,19,3
257273,6,27,4,0,23,4
257273,5,9,4,0,5,4
257273,3,1,1,0,0,1
257273,2,4,2,0,2,2
3504,5,3,1,0,2,1
3504,4,5,2,0,3,2
3504,3,9,2,0,7,2
3504,2,21,12,0,9,12
3504,1,33,19,0,14,19
3390,10,1,1,0,0,1
3390,7,4,2,0,2,2
3390,6,9,1,0,8,1
3390,5,15,4,0,11,4
3390,4,12,4,0,8,4
3390,3,11,3,0,8,3
3390,2,13,2,0,11,2
3390,1,7,4,0,3,4
18983,8,4,1,0,3,1
18983,6,29,11,0,18,11
18983,5,13,3,0,10,3
18983,4,10,4,0,6,4
18983,3,3,1,0,2,1
27853,10,2,1,0,1,1
27853,8,5,2,0,3,2
27853,7,9,7,0,2,7
27853,6,25,10,0,15,10
27853,5,14,2,0,12,2
27853,4,8,3,0,5,3
27853,3,6,3,0,3,3
27853,2,2,1,0,1,1
139747,10,15,3,0,12,3
139747,9,16,3,0,13,3
139747,8,30,8,2,22,6
139747,7,10,4,0,6,4
10376,9,9,4,0,5,4
10376,8,33,14,0,19,14
10376,7,16,6,0,10,6
10376,6,8,3,0,5,3
121987,9,2,1,0,1,1
121987,8,8,1,0,7,1
121987,7,23,5,0,18,5
121987,4,7,1,0,6,1
121987,3,2,1,0,1,1
22644,10,4,2,0,2,2
22644,9,3,1,0,2,1
22644,8,5,1,0,4,1
22644,7,12,1,0,11,1
22644,6,24,8,0,16,8
22644,5,10,4,0,6,4
22644,4,7,2,0,5,2
22644,3,7,1,0,6,1
114,9,2,2,0,0,2
114,8,5,2,0,3,2
114,7,25,7,0,18,7
114,6,23,6,0,17,6
114,2,1,1,0,0,1
18701,10,3,1,0,2,1
18701,9,5,1,0,4,1
18701,8,6,3,0,3,3
18701,7,14,6,0,8,6
18701,6,18,8,0,10,8
18701,5,15,7,0,8,7
18701,4,7,4,0,3,4
18701,3,5,4,0,1,4
27682,10,4,2,0,2,2
27682,9,6,2,0,4,2
27682,8,15,6,0,9,6
27682,7,14,6,0,8,6
27682,6,15,5,0,10,5
27682,5,3,1,0,2,1
27682,4,5,2,0,3,2
27682,2,4,1,0,3,1
27682,1,4,1,0,3,1
77148,8,9,2,0,7,2
77148,7,15,3,0,12,3
77148,6,23,3,0,20,3
77148,5,10,2,0,8,2
77148,3,6,1,0,5,1
77148,2,3,2,0,1,2
77148,1,1,1,0,0,1
25196,8,10,1,0,9,1
25196,7,26,5,0,21,5
25196,6,19,1,0,18,1
25196,5,11,1,0,10,1
25196,4,4,1,0,3,1
8470,9,3,2,0,1,2
8470,8,5,3,0,2,3
8470,7,11,1,0,10,1
8470,6,18,7,0,11,7
8470,5,15,6,0,9,6
8470,4,11,5,0,6,5
8470,3,6,1,0,5,1
8470,2,2,1,0,1,1
8470,1,1,1,0,0,1
21457,8,4,1,0,3,1
21457,7,17,7,0,10,7
21457,6,35,19,0,16,19
21457,5,10,4,0,6,4
21457,4,6,3,0,3,3
21457,3,1,1,0,0,1
5878,10,1,1,0,0,1
5878,8,2,1,1,1,0
5878,7,5,1,0,4,1
5878,6,11,2,0,9,2
5878,5,16,5,0,11,5
5878,4,13,6,0,7,6
5878,3,6,2,0,4,2
5878,2,10,4,0,6,4
5878,1,7,3,0,4,3
2433,8,1,1,0,0,1
2433,7,4,1,0,3,1
2433,5,12,2,0,10,2
2433,4,16,2,0,14,2
2433,3,7,4,0,3,4
2433,2,17,6,0,11,6
2433,1,8,3,0,5,3
42727,10,7,4,0,3,4
42727,9,5,1,0,4,1
42727,8,19,4,0,15,4
42727,6,22,7,0,15,7
42727,4,1,1,0,0,1
42727,3,4,2,0,2,2
42727,1,1,1,0,0,1
164446,10,9,5,1,4,4
164446,9,16,4,1,12,3
164446,8,29,5,1,24,4
164446,6,6,3,1,3,2
164446,5,3,1,0,2,1
12957,10,3,2,0,1,2
12957,9,4,1,0,3,1
12957,8,18,3,0,15,3
12957,7,20,4,0,16,4
12957,6,14,4,0,10,4
12957,5,9,3,0,6,3
12957,4,4,2,0,2,2
858,7,10,3,0,7,3
858,6,19,5,0,14,5
858,5,10,3,0,7,3
858,4,9,3,0,6,3
858,3,5,1,0,4,1
858,2,4,3,0,1,3
118567,10,3,1,0,2,1
118567,8,19,1,0,18,1
118567,7,9,2,0,7,2
118567,6,15,2,0,13,2
118567,5,10,2,0,8,2
118567,3,7,2,0,5,2
118567,2,2,1,0,1,1
6272,8,5,2,0,3,2
6272,7,10,2,0,8,2
6272,6,22,4,0,18,4
6272,5,16,2,0,14,2
6272,4,11,6,0,5,6
6272,3,7,3,0,4,3
19630,10,1,1,0,0,1
19630,9,2,1,0,1,1
19630,8,5,2,0,3,2
19630,7,16,4,0,12,4
19630,6,24,4,0,20,4
19630,5,10,4,0,6,4
19630,4,10,6,0,4,6
19630,3,3,3,0,0,3
19630,1,1,1,0,0,1
245085,10,3,3,0,0,3
245085,9,3,1,0,2,1
245085,8,11,1,0,10,1
245085,7,21,2,0,19,2
245085,6,24,3,0,21,3
245085,5,6,2,0,4,2
2911,9,1,1,0,0,1
2911,7,10,5,0,5,5
2911,6,31,12,0,19,12
2911,5,14,7,0,7,7
2911,4,11,3,0,8,3
2911,3,3,1,0,2,1
2911,2,1,1,0,0,1
144607,10,12,5,0,7,5
144607,9,17,6,0,11,6
144607,8,28,11,0,17,11
144607,7,11,5,0,6,5
144607,6,3,2,0,1,2
37694,9,2,1,0,1,1
37694,8,8,2,0,6,2
37694,7,15,4,0,11,4
37694,6,24,9,0,15,9
37694,5,8,1,0,7,1
37694,4,9,3,0,6,3
37694,3,5,4,0,1,4
37694,2,2,1,0,1,1
40656,10,1,1,0,0,1
40656,7,16,7,0,9,7
40656,6,17,6,0,11,6
40656,5,22,4,0,18,4
40656,4,11,2,0,9,2
40656,3,4,1,0,3,1
40656,2,1,1,0,0,1
186212,10,2,1,0,1,1
186212,8,6,3,0,3,3
186212,7,8,3,0,5,3
186212,6,24,4,0,20,4
186212,5,9,2,0,7,2
186212,4,6,2,0,4,2
186212,3,8,3,1,5,2
186212,2,5,2,1,3,1
186212,1,4,1,0,3,1
73960,10,1,1,0,0,1
73960,9,8,3,0,5,3
73960,8,31,15,0,16,15
73960,7,21,8,0,13,8
73960,6,9,7,0,2,7
73960,5,2,2,0,0,2
4353,8,4,1,0,3,1
4353,7,5,4,0,1,4
4353,6,27,8,0,19,8
4353,5,14,2,0,12,2
4353,4,12,4,0,8,4
4353,3,4,1,0,3,1
4353,2,3,1,0,2,1
35137,8,13,1,0,12,1
35137,7,13,3,0,10,3
35137,6,18,1,0,17,1
35137,5,13,1,0,12,1
35137,4,6,1,0,5,1
35137,3,5,1,0,4,1
27813,10,1,1,0,0,1
27813,9,3,1,0,2,1
27813,8,16,7,0,9,7
27813,7,23,14,0,9,14
27813,6,18,8,0,10,8
27813,5,8,3,0,5,3
27813,4,3,2,0,1,2
209541,10,1,1,0,0,1
209541,7,17,2,0,15,2
209541,6,20,4,2,16,2
209541,5,11,2,0,9,2
209541,4,10,2,0,8,2
209541,3,6,1,0,5,1
209541,2,1,1,0,0,1
5203,8,1,1,0,0,1
5203,7,5,3,0,2,3
5203,6,20,6,0,14,6
5203,5,20,5,0,15,5
5203,4,13,4,0,9,4
5203,3,5,4,0,1,4
5203,2,7,2,0,5,2
10203,8,4,2,0,2,2
10203,7,9,2,0,7,2
10203,6,21,4,0,17,4
10203,5,17,2,0,15,2
10203,4,9,2,0,7,2
10203,3,8,5,0,3,5
17994,7,23,2,0,21,2
17994,6,19,4,0,15,4
17994,5,4,1,0,3,1
17994,4,2,1,0,1,1
37498,6,24,3,0,21,3
37498,5,16,2,0,14,2
37498,4,11,2,0,9,2
37498,2,4,1,0,3,1
92188,8,18,10,0,8,10
92188,7,17,4,0,13,4
92188,6,14,5,0,9,5
92188,5,6,1,0,5,1
92188,4,4,1,0,3,1
92188,2,1,1,0,0,1
235533,10,3,1,0,2,1
235533,9,5,2,0,3,2
235533,8,29,5,0,24,5
235533,7,18,6,0,12,6
235533,6,12,3,0,9,3
235533,4,3,1,0,2,1
530,8,8,1,0,7,1
530,7,12,1,0,11,1
530,6,28,8,0,20,8
530,5,10,1,0,9,1
530,4,8,2,0,6,2
530,3,4,1,0,3,1
235944,9,6,2,0,4,2
235944,7,20,2,0,18,2
235944,6,20,3,0,17,3
235944,5,4,1,0,3,1
6597,8,1,1,0,0,1
6597,6,7,3,0,4,3
6597,5,7,2,0,5,2
6597,4,15,4,0,11,4
6597,3,23,8,0,15,8
6597,2,11,2,0,9,2
6597,1,5,3,0,2,3
146937,10,1,1,0,0,1
146937,9,2,1,0,1,1
146937,8,19,3,0,16,3
146937,7,22,4,0,18,4
146937,6,22,1,0,21,1
13584,9,5,2,0,3,2
13584,8,8,1,0,7,1
13584,7,19,2,0,17,2
13584,6,19,4,0,15,4
13584,5,13,4,0,9,4
13584,4,4,1,0,3,1
21835,8,2,1,0,1,1
21835,7,8,1,0,7,1
21835,6,15,1,0,14,1
21835,5,13,2,0,11,2
21835,4,19,2,0,17,2
21835,3,7,1,0,6,1
21835,2,6,1,0,5,1
31074,9,1,1,0,0,1
31074,8,10,1,0,9,1
31074,7,19,3,0,16,3
31074,6,28,4,0,24,4
31074,5,11,1,0,10,1
31074,4,2,2,0,0,2
4997,8,9,1,0,8,1
4997,7,7,1,0,6,1
4997,6,24,3,0,21,3
4997,5,20,6,0,14,6
4997,4,8,1,0,7,1
7973,8,4,2,0,2,2
7973,7,13,3,0,10,3
7973,6,29,8,0,21,8
7973,5,15,4,0,11,4
7973,3,4,1,0,3,1
7973,2,1,1,0,0,1
62478,10,1,1,0,0,1
62478,7,9,3,0,6,3
62478,6,19,2,0,17,2
62478,5,17,1,0,16,1
62478,4,9,1,0,8,1
62478,1,7,2,0,5,2
156836,9,5,2,0,3,2
156836,6,22,3,0,19,3
156836,4,6,2,0,4,2
156836,1,1,1,0,0,1
168446,8,8,3,0,5,3
168446,7,16,3,0,13,3
168446,6,24,5,0,19,5
168446,5,11,1,0,10,1
168446,3,2,1,0,1,1
168446,1,2,1,0,1,1
7590,10,3,2,0,1,2
7590,9,10,5,0,5,5
7590,8,15,5,0,10,5
7590,7,28,10,0,18,10
7590,6,9,2,0,7,2
7590,4,2,1,0,1,1
187719,9,3,2,1,1,1
187719,7,14,3,1,11,2
187719,6,20,5,0,15,5
187719,5,9,4,0,5,4
187719,4,8,1,0,7,1
187719,3,6,5,0,1,5
187719,2,3,1,0,2,1
187719,1,4,1,0,3,1
13384,8,2,1,0,1,1
13384,7,14,5,0,9,5
13384,6,21,13,0,8,13
13384,5,6,1,0,5,1
13384,4,13,6,0,7,6
13384,3,10,6,0,4,6
13384,2,3,3,0,0,3
2495,7,9,4,0,5,4
2495,6,26,9,0,17,9
2495,5,19,6,0,13,6
2495,4,10,2,0,8,2
10581,10,8,2,0,6,2
10581,9,9,1,0,8,1
10581,8,17,1,0,16,1
10581,7,19,6,0,13,6
10581,6,7,2,0,5,2
10581,5,4,2,0,2,2
10581,4,4,3,0,1,3
10581,3,3,3,0,0,3
13490,8,4,1,0,3,1
13490,7,8,2,0,6,2
13490,6,19,5,0,14,5
13490,5,16,3,0,13,3
13490,4,15,3,0,12,3
13490,3,7,4,0,3,4
13490,2,1,1,0,0,1
26293,7,10,1,0,9,1
26293,5,12,2,0,10,2
26293,4,8,4,0,4,4
26293,3,5,3,0,2,3
7090,10,6,5,0,1,5
7090,9,17,8,0,9,8
7090,8,17,13,0,4,13
7090,7,14,8,0,6,8
7090,6,13,2,0,11,2
7090,5,2,2,0,0,2
7090,4,2,2,0,0,2
5923,10,3,2,0,1,2
5923,9,2,2,0,0,2
5923,8,19,10,0,9,10
5923,7,16,5,0,11,5
5923,6,18,3,0,15,3
5923,5,8,3,0,5,3
5923,4,5,1,0,4,1
5923,3,1,1,0,0,1
228944,10,18,11,1,7,10
228944,9,9,2,0,7,2
228944,8,23,5,1,18,4
228944,7,8,1,0,7,1
228944,6,11,2,0,9,2
228944,5,2,1,0,1,1
228944,3,1,1,0,0,1
1184,8,5,1,0,4,1
1184,7,10,2,0,8,2
1184,6,17,4,0,13,4
1184,5,16,5,0,11,5
1184,4,15,5,0,10,5
1184,3,5,1,0,4,1
1184,2,3,2,0,1,2
7995,9,1,1,0,0,1
7995,8,4,2,0,2,2
7995,7,14,6,0,8,6
7995,6,29,14,0,15,14
7995,5,13,3,0,10,3
7995,4,9,4,0,5,4
7995,3,1,1,0,0,1
183459,10,3,2,0,1,2
183459,8,8,4,3,4,1
183459,7,14,3,0,11,3
183459,6,20,6,3,14,3
183459,5,15,4,1,11,3
183459,4,12,4,0,8,4
183459,2,1,1,0,0,1
69721,9,1,1,0,0,1
69721,7,16,7,0,9,7
69721,6,31,2,0,29,2
69721,5,14,4,0,10,4
4177,8,5,2,0,3,2
4177,7,21,10,0,11,10
4177,6,22,10,0,12,10
4177,5,14,6,0,8,6
4177,4,5,2,0,3,2
4177,3,3,3,0,0,3
4177,2,2,1,0,1,1
4363,9,11,4,0,7,4
4363,8,25,6,0,19,6
4363,7,20,5,0,15,5
4363,6,10,2,0,8,2
4363,3,1,1,0,0,1
7938,9,5,2,0,3,2
7938,8,6,4,0,2,4
7938,7,17,5,0,12,5
7938,6,25,1,0,24,1
7938,5,11,6,0,5,6
7938,3,4,2,0,2,2
6004,8,2,2,0,0,2
6004,7,7,3,0,4,3
6004,6,26,9,0,17,9
6004,5,19,6,0,13,6
6004,4,9,1,0,8,1
6004,3,4,2,0,2,2
6004,2,1,1,0,0,1
6004,1,2,2,0,0,2
163983,10,7,3,0,4,3
163983,7,16,2,0,14,2
163983,6,25,7,0,18,7
163983,5,9,2,0,7,2
163983,4,4,1,0,3,1
3901,10,8,7,0,1,7
3901,9,5,4,0,1,4
3901,8,13,6,0,7,6
3901,7,19,8,0,11,8
3901,6,11,1,0,10,1
3901,5,5,3,0,2,3
3901,4,7,1,0,6,1
3901,2,1,1,0,0,1
208661,9,3,1,0,2,1
208661,8,8,1,0,7,1
208661,7,18,2,0,16,2
208661,5,14,2,0,12,2
208661,4,5,1,0,4,1
208661,2,2,1,0,1,1
36615,7,8,3,0,5,3
36615,6,25,10,0,15,10
36615,5,15,4,0,11,4
36615,4,9,5,0,4,5
36615,3,6,2,0,4,2
36615,2,3,1,0,2,1
36615,1,1,1,0,0,1
14119,8,2,2,0,0,2
14119,7,11,6,0,5,6
14119,6,28,7,0,21,7
14119,5,17,2,0,15,2
14119,4,9,3,0,6,3
14119,3,3,2,0,1,2
14119,2,1,1,0,0,1
41185,7,24,3,0,21,3
41185,6,20,1,0,19,1
41185,4,6,4,0,2,4
41185,2,1,1,0,0,1
11456,10,2,2,0,0,2
11456,8,9,2,0,7,2
11456,7,11,5,0,6,5
11456,6,23,10,0,13,10
11456,5,12,4,0,8,4
11456,4,10,4,0,6,4
11456,3,3,2,0,1,2
11456,2,2,1,0,1,1
1790,8,6,1,0,5,1
1790,7,8,3,0,5,3
1790,6,22,5,0,17,5
1790,5,12,6,0,6,6
1790,4,13,1,0,12,1
1790,3,5,3,0,2,3
1790,1,2,1,0,1,1
62979,10,5,2,0,3,2
62979,8,9,2,0,7,2
62979,7,10,2,0,8,2
62979,5,11,1,0,10,1
62979,4,10,1,0,9,1
62979,3,3,2,0,1,2
5335,8,7,3,0,4,3
5335,7,15,6,0,9,6
5335,6,26,11,0,15,11
5335,5,11,1,0,10,1
5335,4,7,2,0,5,2
5335,3,2,1,0,1,1
149332,7,22,5,0,17,5
149332,6,20,3,0,17,3
149332,5,12,2,0,10,2
149332,4,2,1,0,1,1
149332,2,2,1,0,1,1
2326,8,4,2,0,2,2
2326,7,8,4,0,4,4
2326,6,16,6,0,10,6
2326,5,17,11,0,6,11
2326,4,16,10,0,6,10
2326,3,6,3,0,3,3
2326,2,3,1,0,2,1
11514,10,3,2,0,1,2
11514,8,11,6,0,5,6
11514,7,18,5,0,13,5
11514,6,26,15,0,11,15
11514,5,8,2,0,6,2
11514,4,3,2,0,1,2
141896,8,6,3,2,3,1
141896,7,5,1,0,4,1
141896,6,20,2,1,18,1
141896,5,17,2,0,15,2
141896,4,12,2,0,10,2
141896,3,6,1,0,5,1
208533,10,2,1,0,1,1
208533,8,9,2,0,7,2
208533,7,12,4,0,8,4
208533,6,16,1,0,15,1
208533,5,18,6,0,12,6
208533,4,11,4,0,7,4
208533,3,4,1,0,3,1
208533,2,1,1,0,0,1
209849,8,19,2,0,17,2
209849,7,26,3,0,23,3
209849,6,23,2,0,21,2
209849,5,2,1,0,1,1
163048,10,13,2,0,11,2
163048,9,14,1,0,13,1
163048,8,23,3,0,20,3
163048,7,12,1,0,11,1
163048,4,2,2,0,0,2
3021,10,1,1,0,0,1
3021,8,6,2,0,4,2
3021,7,4,1,0,3,1
3021,6,15,4,0,11,4
3021,5,19,3,0,16,3
3021,4,10,1,0,9,1
3021,3,11,7,0,4,7
3021,2,4,2,0,2,2
3021,1,2,1,0,1,1
24025,9,1,1,0,0,1
24025,8,8,4,0,4,4
24025,7,17,10,0,7,10
24025,6,26,11,0,15,11
24025,5,9,3,0,6,3
24025,4,4,2,0,2,2
24025,2,1,1,0,0,1
155208,10,7,1,0,6,1
155208,6,14,3,0,11,3
155208,5,20,4,0,16,4
155208,4,14,4,0,10,4
155208,3,9,2,0,7,2
155208,2,5,1,0,4,1
155208,1,2,1,0,1,1
169984,8,6,3,1,3,2
169984,7,14,5,0,9,5
169984,6,27,6,0,21,6
169984,5,13,1,0,12,1
169984,3,2,2,0,0,2
169984,2,2,1,0,1,1
28738,8,17,7,0,10,7
28738,7,20,2,0,18,2
28738,6,19,3,0,16,3
28738,5,9,4,0,5,4
5822,10,2,1,0,1,1
5822,9,6,1,0,5,1
5822,8,14,4,0,10,4
5822,7,17,5,0,12,5
5822,6,20,5,0,15,5
5822,5,7,3,0,4,3
5822,4,4,2,0,2,2
158586,10,2,1,0,1,1
158586,9,4,1,0,3,1
158586,8,10,2,0,8,2
158586,7,23,4,0,19,4
158586,6,20,5,1,15,4
158586,4,6,3,0,3,3
158586,3,1,1,0,0,1
11047,10,3,2,0,1,2
11047,8,2,2,0,0,2
11047,7,12,2,0,10,2
11047,6,17,4,0,13,4
11047,5,20,3,0,17,3
11047,4,8,3,0,5,3
11047,3,4,2,0,2,2
11047,2,4,3,0,1,3
11047,1,2,1,0,1,1
18652,9,5,4,0,1,4
18652,8,18,9,0,9,9
18652,7,31,15,0,16,15
18652,6,15,9,0,6,9
224662,9,5,1,0,4,1
224662,8,6,1,0,5,1
224662,7,11,1,0,10,1
224662,6,26,4,0,22,4
90968,8,4,2,0,2,2
90968,7,14,4,0,10,4
90968,6,25,6,0,19,6
90968,5,17,3,0,14,3
90968,4,8,3,0,5,3
179804,9,10,2,0,8,2
179804,8,17,3,0,14,3
179804,7,20,3,0,17,3
179804,6,13,4,0,9,4
179804,4,2,2,0,0,2
179804,3,1,1,0,0,1
179804,2,2,2,1,0,1
193584,10,6,2,0,4,2
193584,9,5,2,0,3,2
193584,8,29,8,2,21,6
193584,7,14,1,1,13,0
193584,6,14,4,1,10,3
193584,4,2,1,0,1,1
28678,10,15,4,0,11,4
28678,9,9,3,0,6,3
28678,8,21,6,0,15,6
28678,7,10,3,0,7,3
28678,6,10,3,0,7,3
28678,5,6,1,0,5,1
19083,6,19,2,0,17,2
19083,5,12,3,0,9,3
19083,4,9,3,0,6,3
19083,3,4,1,0,3,1
19083,2,11,5,0,6,5
19083,1,6,4,0,2,4
19083,0,1,1,0,0,1
116046,10,7,2,0,5,2
116046,9,9,3,0,6,3
116046,8,34,13,0,21,13
116046,7,13,5,0,8,5
116046,6,5,2,0,3,2
163040,9,3,1,0,2,1
163040,8,11,2,0,9,2
163040,6,24,3,0,21,3
163040,5,12,2,0,10,2
163040,3,1,1,0,0,1
3615,8,10,3,0,7,3
3615,7,13,5,0,8,5
3615,6,27,10,0,17,10
3615,5,13,5,0,8,5
3615,4,3,2,0,1,2
3615,2,2,1,0,1,1
3615,1,1,1,0,0,1
238136,10,5,1,0,4,1
238136,9,10,1,0,9,1
238136,8,22,4,0,18,4
238136,7,15,2,0,13,2
238136,6,10,3,0,7,3
238136,4,3,1,0,2,1
254923,10,5,2,0,3,2
254923,9,3,1,0,2,1
254923,8,11,3,0,8,3
254923,7,9,5,0,4,5
254923,6,17,3,1,14,2
254923,5,10,3,0,7,3
254923,4,6,3,0,3,3
254923,2,6,2,0,4,2
254923,1,3,2,0,1,2
5193,10,1,1,0,0,1
5193,9,2,1,0,1,1
5193,8,7,3,0,4,3
5193,7,9,3,0,6,3
5193,6,28,6,0,22,6
5193,5,14,3,0,11,3
5193,4,7,4,0,3,4
5193,3,2,1,0,1,1
3070,10,3,2,0,1,2
3070,9,2,2,0,0,2
3070,8,15,4,0,11,4
3070,7,23,6,0,17,6
3070,6,18,6,0,12,6
3070,5,7,1,0,6,1
3070,4,2,1,0,1,1
20302,9,5,1,0,4,1
20302,8,10,5,0,5,5
20302,7,15,10,0,5,10
20302,6,22,10,0,12,10
20302,5,12,4,0,8,4
20302,4,5,3,0,2,3
20302,3,1,1,0,0,1
20302,2,1,1,0,0,1
117908,7,7,1,0,6,1
117908,6,25,6,0,19,6
117908,5,13,4,0,9,4
117908,4,10,3,0,7,3
117908,3,4,1,0,3,1
138869,10,2,2,0,0,2
138869,9,4,1,0,3,1
138869,8,19,5,1,14,4
138869,7,16,3,1,13,2
138869,6,17,2,0,15,2
138869,5,7,3,0,4,3
138869,4,3,1,0,2,1
138869,3,4,1,0,3,1
100795,10,3,3,0,0,3
100795,7,28,7,0,21,7
100795,6,21,2,0,19,2
100795,5,6,1,0,5,1
100795,4,2,1,0,1,1
1043,7,17,8,0,9,8
1043,6,24,7,0,17,7
1043,5,13,3,0,10,3
1043,4,5,2,0,3,2
1043,2,1,1,0,0,1
1959,9,2,1,0,1,1
1959,7,4,1,0,3,1
1959,6,6,4,0,2,4
1959,4,19,4,0,15,4
1959,3,13,3,0,10,3
1959,2,12,6,0,6,6
1959,1,3,2,0,1,2
30246,9,8,2,0,6,2
30246,8,21,12,0,9,12
30246,7,19,7,0,12,7
30246,6,12,5,0,7,5
30246,5,4,3,0,1,3
30246,4,2,1,0,1,1
30246,3,1,1,0,0,1
30246,2,3,2,0,1,2
230785,9,9,1,0,8,1
230785,8,22,6,0,16,6
230785,7,19,5,0,14,5
207796,9,6,4,0,2,4
207796,8,12,4,3,8,1
207796,7,13,1,0,12,1
207796,6,27,4,0,23,4
207796,5,8,2,0,6,2
207796,4,3,2,0,1,2
207230,10,14,10,0,4,10
207230,9,18,6,0,12,6
207230,8,24,7,0,17,7
207230,7,8,3,0,5,3
207230,6,2,1,0,1,1
207230,4,1,1,0,0,1
207230,3,2,1,0,1,1
192909,8,10,1,0,9,1
192909,7,14,3,0,11,3
192909,6,19,3,0,16,3
192909,5,12,1,0,11,1
192909,1,4,2,0,2,2
235251,8,4,2,0,2,2
235251,7,16,2,0,14,2
235251,6,23,4,0,19,4
235251,5,13,1,0,12,1
235251,4,6,2,0,4,2
56197,8,8,2,0,6,2
56197,7,12,3,0,9,3
56197,6,23,5,0,18,5
56197,5,13,1,0,12,1
56197,4,8,3,0,5,3
56197,1,1,1,0,0,1
135812,10,3,1,0,2,1
135812,9,3,1,1,2,0
135812,8,10,4,0,6,4
135812,7,20,2,0,18,2
135812,6,27,4,0,23,4
135812,5,6,2,1,4,1
135812,2,1,1,0,0,1
146451,10,11,1,1,10,0
146451,9,13,5,0,8,5
146451,8,22,5,2,17,3
146451,7,14,3,1,11,2
146451,3,1,1,0,0,1
146451,2,1,1,0,0,1
212687,10,1,1,0,0,1
212687,9,4,1,1,3,0
212687,8,16,4,1,12,3
212687,7,17,3,0,14,3
212687,6,23,5,0,18,5
212687,5,4,3,0,1,3
212687,4,4,1,0,3,1
137498,10,4,1,0,3,1
137498,9,3,1,0,2,1
137498,8,24,9,0,15,9
137498,7,16,6,0,10,6
137498,6,13,7,0,6,7
137498,5,3,2,0,1,2
137498,4,6,1,0,5,1
137498,3,2,1,0,1,1
102631,10,4,2,0,2,2
102631,8,15,2,0,13,2
102631,6,20,5,0,15,5
102631,3,2,1,0,1,1
102631,1,1,1,0,0,1
25037,9,12,6,0,6,6
25037,8,12,4,0,8,4
25037,7,21,5,0,16,5
25037,6,14,4,0,10,4
25037,5,5,3,0,2,3
25037,3,1,1,0,0,1
2225,8,3,1,0,2,1
2225,7,7,3,0,4,3
2225,6,15,4,0,11,4
2225,5,24,8,0,16,8
2225,4,13,5,0,8,5
2225,3,5,2,0,3,2
2225,2,2,1,0,1,1
2225,1,3,3,0,0,3
35508,8,6,2,0,4,2
35508,7,22,10,0,12,10
35508,6,20,6,0,14,6
35508,5,10,3,0,7,3
35508,4,3,1,0,2,1
35508,3,5,1,0,4,1
35508,1,2,1,0,1,1
94338,9,2,1,0,1,1
94338,8,10,7,0,3,7
94338,7,17,4,0,13,4
94338,6,24,6,0,18,6
94338,3,4,1,0,3,1
94338,2,2,1,0,1,1
4294,10,3,2,0,1,2
4294,8,12,4,0,8,4
4294,7,24,9,0,15,9
4294,6,14,3,0,11,3
4294,5,11,1,0,10,1
4294,4,3,1,0,2,1
4294,3,3,2,0,1,2
4293,10,4,3,0,1,3
4293,9,3,2,0,1,2
4293,8,11,4,0,7,4
4293,7,26,6,0,20,6
4293,6,15,6,0,9,6
4293,5,8,3,0,5,3
69785,10,13,3,0,10,3
69785,9,14,3,0,11,3
69785,8,7,1,0,6,1
69785,7,8,3,0,5,3
69785,6,5,2,0,3,2
69785,5,5,1,0,4,1
69785,4,3,1,0,2,1
69785,3,7,3,0,4,3
69785,2,3,2,0,1,2
69785,1,6,3,0,3,3
9093,10,6,3,0,3,3
9093,8,15,7,0,8,7
9093,7,25,5,0,20,5
9093,6,6,2,0,4,2
9093,5,12,1,0,11,1
9093,4,2,1,0,1,1
9093,3,3,3,0,0,3
11091,10,7,2,0,5,2
11091,9,15,1,0,14,1
11091,8,26,4,0,22,4
11091,7,13,2,0,11,2
11091,6,7,2,0,5,2
5959,10,2,1,0,1,1
5959,8,1,1,0,0,1
5959,7,2,1,0,1,1
5959,6,12,6,0,6,6
5959,5,10,4,0,6,4
5959,4,8,2,0,6,2
5959,3,11,5,0,6,5
5959,2,13,10,0,3,10
5959,1,10,6,0,4,6
5959,0,1,1,0,0,1
2116,8,3,2,0,1,2
2116,7,5,2,0,3,2
2116,6,28,7,0,21,7
2116,5,22,6,0,16,6
2116,4,8,1,0,7,1
2116,3,4,1,0,3,1
23388,10,3,3,0,0,3
23388,8,1,1,0,0,1
23388,6,9,4,0,5,4
23388,5,6,5,0,1,5
23388,4,7,3,0,4,3
23388,3,13,4,0,9,4
23388,2,9,8,0,1,8
23388,1,22,10,0,12,10
29106,8,10,3,0,7,3
29106,7,18,4,0,14,4
29106,6,27,11,0,16,11
29106,5,7,4,0,3,4
29106,3,2,1,0,1,1
29106,2,1,1,0,0,1
29106,1,1,1,0,0,1
165044,10,10,4,0,6,4
165044,9,13,2,0,11,2
165044,8,9,2,0,7,2
165044,6,14,1,0,13,1
165044,3,2,2,0,0,2
165044,2,2,1,0,1,1
165044,1,1,1,0,0,1
18724,10,2,2,0,0,2
18724,8,21,12,0,9,12
18724,7,26,15,0,11,15
18724,6,9,4,0,5,4
18724,5,9,6,0,3,6
3532,10,2,2,0,0,2
3532,7,16,2,0,14,2
3532,6,28,11,0,17,11
3532,5,12,2,0,10,2
3532,4,2,1,0,1,1
3532,2,1,1,0,0,1
959,10,3,1,0,2,1
959,9,8,5,0,3,5
959,8,14,9,0,5,9
959,7,21,9,0,12,9
959,6,17,5,0,12,5
959,5,4,1,0,3,1
959,4,4,1,0,3,1
232414,10,13,4,0,9,4
232414,9,18,5,2,13,3
232414,8,19,5,0,14,5
232414,7,11,4,0,7,4
232414,6,4,2,0,2,2
7457,10,1,1,0,0,1
7457,7,8,2,0,6,2
7457,6,15,2,0,13,2
7457,5,19,3,0,16,3
7457,4,8,4,0,4,4
7457,3,8,4,0,4,4
7457,1,4,1,0,3,1
7950,10,5,1,0,4,1
7950,9,9,2,0,7,2
7950,8,11,2,0,9,2
7950,7,16,5,0,11,5
7950,6,17,2,0,15,2
7950,5,11,6,0,5,6
48863,10,7,1,0,6,1
48863,8,20,4,0,16,4
48863,7,19,4,0,15,4
139388,10,14,9,0,5,9
139388,9,1,1,0,0,1
139388,8,3,2,0,1,2
139388,6,1,1,0,0,1
139388,3,5,3,1,2,2
139388,2,4,3,0,1,3
139388,1,43,16,0,27,16
3554,9,5,3,0,2,3
3554,8,6,2,0,4,2
3554,7,6,2,0,4,2
3554,6,22,6,0,16,6
3554,5,15,5,0,10,5
3554,4,10,3,0,7,3
3554,3,4,2,0,2,2
3554,2,1,1,0,0,1
154681,8,7,2,0,5,2
154681,7,15,6,0,9,6
154681,6,32,5,0,27,5
154681,5,9,2,0,7,2
154681,1,1,1,0,0,1
246531,10,5,4,0,1,4
246531,8,11,1,0,10,1
246531,7,23,3,0,20,3
246531,6,22,2,0,20,2
246531,5,4,2,0,2,2
246531,2,2,1,0,1,1
109922,10,5,4,0,1,4
109922,9,13,7,0,6,7
109922,8,25,10,1,15,9
109922,7,14,4,0,10,4
109922,6,4,3,1,1,2
109922,5,4,2,0,2,2
109922,4,1,1,0,0,1
109922,3,4,2,0,2,2
11166,10,11,3,0,8,3
11166,9,11,3,0,8,3
11166,8,27,5,0,22,5
11166,7,7,1,0,6,1
11166,6,8,1,0,7,1
11166,5,5,1,0,4,1
11166,2,1,1,0,0,1
22770,6,10,3,0,7,3
22770,5,8,2,0,6,2
22770,4,24,7,0,17,7
22770,3,8,3,0,5,3
22770,2,11,5,0,6,5
22770,1,8,5,0,3,5
6902,9,3,2,0,1,2
6902,8,5,1,0,4,1
6902,7,13,1,0,12,1
6902,6,20,2,0,18,2
6902,5,12,6,0,6,6
6902,4,9,2,0,7,2
6902,3,4,2,0,2,2
6902,2,5,1,0,4,1
256538,10,2,1,0,1,1
256538,9,6,1,0,5,1
256538,8,19,6,0,13,6
256538,7,13,4,0,9,4
256538,6,20,2,0,18,2
256538,5,4,1,0,3,1
256538,1,1,1,0,0,1
172382,10,10,6,0,4,6
172382,9,9,2,0,7,2
172382,8,13,4,0,9,4
172382,7,15,1,0,14,1
172382,6,10,3,0,7,3
172382,5,3,1,0,2,1
172382,4,5,1,0,4,1
172382,3,3,1,0,2,1
222741,10,1,1,0,0,1
222741,9,3,2,0,1,2
222741,8,13,1,0,12,1
222741,7,14,3,2,11,1
222741,6,17,2,0,15,2
222741,5,11,1,0,10,1
222741,4,7,2,0,5,2
222741,3,2,2,0,0,2
222741,1,3,1,0,2,1
3604,10,3,1,0,2,1
3604,9,5,1,0,4,1
3604,8,7,2,0,5,2
3604,7,14,2,0,12,2
3604,6,18,6,0,12,6
3604,5,15,3,0,12,3
3604,4,7,1,0,6,1
3604,2,1,1,0,0,1
3751,10,3,1,0,2,1
3751,9,5,3,0,2,3
3751,8,13,4,0,9,4
3751,7,23,9,0,14,9
3751,6,16,4,0,12,4
3751,5,5,2,0,3,2
3751,4,3,2,0,1,2
13980,10,2,1,0,1,1
13980,9,2,1,0,1,1
13980,8,19,12,0,7,12
13980,7,15,7,0,8,7
13980,6,23,8,0,15,8
13980,5,3,1,0,2,1
13980,4,4,3,0,1,3
13980,3,1,1,0,0,1
13980,2,2,2,0,0,2
232478,10,3,1,0,2,1
232478,9,8,3,0,5,3
232478,8,20,2,0,18,2
232478,7,20,3,1,17,2
232478,6,13,5,0,8,5
232478,5,4,1,0,3,1
232478,2,1,1,0,0,1
28231,8,4,1,0,3,1
28231,6,9,2,0,7,2
28231,5,12,4,0,8,4
28231,4,15,4,0,11,4
28231,3,11,7,0,4,7
28231,2,14,7,0,7,7
28231,1,5,2,0,3,2
6487,10,3,1,0,2,1
6487,9,5,2,0,3,2
6487,8,15,2,0,13,2
6487,7,9,3,0,6,3
6487,6,21,7,0,14,7
6487,5,9,3,0,6,3
6487,4,7,2,0,5,2
886,8,5,3,0,2,3
886,7,20,8,0,12,8
886,6,24,5,0,19,5
886,5,13,5,0,8,5
886,3,2,1,0,1,1
886,2,1,1,0,0,1
153830,8,5,1,0,4,1
153830,6,25,4,0,21,4
153830,5,14,1,0,13,1
9475,10,1,1,0,0,1
9475,7,11,4,0,7,4
9475,6,15,3,0,12,3
9475,5,15,2,0,13,2
9475,4,12,3,0,9,3
9475,3,6,4,0,2,4
193912,10,7,3,1,4,2
193912,9,2,2,1,0,1
193912,8,24,3,0,21,3
193912,7,20,5,0,15,5
193912,6,10,2,1,8,1
193912,5,3,1,0,2,1
193912,4,3,1,1,2,0
193912,2,1,1,0,0,1
148040,10,3,1,0,2,1
148040,7,11,2,0,9,2
148040,6,19,2,0,17,2
148040,5,20,2,0,18,2
148040,3,5,2,0,3,2
55828,8,6,1,0,5,1
55828,7,14,1,0,13,1
55828,6,17,4,0,13,4
55828,5,19,5,0,14,5
55828,3,6,2,0,4,2
55756,7,25,4,0,21,4
55756,6,22,3,0,19,3
55756,5,5,2,0,3,2
55756,4,2,2,0,0,2
12763,8,5,1,0,4,1
12763,6,20,3,0,17,3
12763,5,9,3,0,6,3
12763,4,9,1,0,8,1
12763,3,11,4,0,7,4
12763,2,9,3,0,6,3
255805,9,4,1,0,3,1
255805,8,14,1,0,13,1
255805,7,23,2,0,21,2
255805,5,6,1,0,5,1
255805,3,2,1,0,1,1
180943,10,2,1,0,1,1
180943,8,11,2,0,9,2
180943,7,20,5,0,15,5
180943,6,21,2,0,19,2
180943,4,7,1,0,6,1
2036,7,4,2,0,2,2
2036,6,12,6,0,6,6
2036,5,20,5,0,15,5
2036,4,14,1,0,13,1
2036,3,13,5,0,8,5
2036,2,4,1,0,3,1
11765,9,1,1,0,0,1
11765,8,1,1,0,0,1
11765,7,4,2,0,2,2
11765,6,18,6,0,12,6
11765,5,16,5,0,11,5
11765,4,13,1,0,12,1
11765,3,12,6,0,6,6
11765,2,6,1,0,5,1
18464,8,4,1,0,3,1
18464,7,6,4,0,2,4
18464,6,28,5,0,23,5
18464,5,16,5,0,11,5
18464,4,9,2,0,7,2
18464,1,1,1,0,0,1
38361,9,7,5,0,2,5
38361,8,20,12,0,8,12
38361,7,23,8,0,15,8
38361,6,14,2,0,12,2
38361,4,3,1,0,2,1
228943,10,4,2,0,2,2
228943,9,9,2,0,7,2
228943,8,16,2,0,14,2
228943,7,19,3,0,16,3
228943,6,12,4,0,8,4
252776,8,30,5,0,25,5
252776,7,22,1,0,21,1
252776,6,10,2,0,8,2
7181,9,4,2,0,2,2
7181,8,5,2,0,3,2
7181,7,13,4,0,9,4
7181,6,17,7,0,10,7
7181,5,12,5,0,7,5
7181,4,6,2,0,4,2
7181,3,6,2,0,4,2
7181,2,2,1,0,1,1
32124,10,24,6,0,18,6
32124,9,2,2,0,0,2
32124,7,1,1,0,0,1
32124,4,1,1,0,0,1
32124,3,4,1,0,3,1
32124,2,6,5,0,1,5
32124,1,27,5,0,22,5
123604,9,2,2,0,0,2
123604,8,28,12,0,16,12
123604,7,22,5,0,17,5
123604,6,15,6,0,9,6
123604,5,1,1,0,0,1
86003,9,5,2,0,3,2
86003,8,10,3,0,7,3
86003,7,14,4,0,10,4
86003,6,17,6,0,11,6
86003,5,9,4,0,5,4
86003,4,3,1,0,2,1
86003,2,1,1,0,0,1
86003,1,2,2,2,0,0
253074,10,4,1,0,3,1
253074,9,6,3,0,3,3
253074,8,10,2,0,8,2
253074,7,18,3,0,15,3
253074,6,18,4,0,14,4
253074,5,6,1,0,5,1
253074,4,3,2,0,1,2
253074,3,4,2,0,2,2
253074,1,2,1,0,1,1
4917,10,2,1,0,1,1
4917,9,3,2,0,1,2
4917,8,17,6,0,11,6
4917,7,22,7,0,15,7
4917,6,18,5,0,13,5
4917,5,5,1,0,4,1
4917,4,2,1,0,1,1
22122,7,8,2,0,6,2
22122,6,25,6,0,19,6
22122,5,17,5,0,12,5
22122,4,13,4,0,9,4
118340,8,2,1,0,1,1
118340,7,5,2,0,3,2
118340,6,20,2,0,18,2
118340,5,10,2,0,8,2
118340,4,13,2,0,11,2
118340,3,9,3,0,6,3
118340,2,8,3,0,5,3
35040,9,3,3,0,0,3
35040,8,11,2,0,9,2
35040,7,17,7,0,10,7
35040,6,20,6,0,14,6
35040,5,9,4,0,5,4
35040,4,7,5,0,2,5
35040,3,1,1,0,0,1
35040,2,2,1,0,1,1
218637,10,1,1,0,0,1
218637,9,1,1,0,0,1
218637,8,5,1,0,4,1
218637,7,14,2,0,12,2
218637,6,28,2,0,26,2
218637,5,10,2,0,8,2
218637,4,9,3,0,6,3
22991,8,9,6,0,3,6
22991,7,13,6,0,7,6
22991,6,18,13,0,5,13
22991,5,11,2,0,9,2
22991,4,11,4,0,7,4
22991,2,1,1,0,0,1
212807,10,2,1,0,1,1
212807,9,6,1,0,5,1
212807,8,13,2,0,11,2
212807,7,32,11,0,21,11
212807,6,10,3,1,7,2
212807,5,6,3,0,3,3
49010,7,6,4,0,2,4
49010,6,18,6,0,12,6
49010,5,18,6,0,12,6
49010,4,14,3,0,11,3
49010,3,9,3,0,6,3
49010,2,3,2,0,1,2
3569,8,2,1,0,1,1
3569,7,7,4,0,3,4
3569,6,31,7,0,24,7
3569,5,15,8,0,7,8
3569,4,5,3,0,2,3
3569,2,2,2,0,0,2
2734,9,5,1,0,4,1
2734,8,10,2,0,8,2
2734,7,19,7,0,12,7
2734,6,23,3,0,20,3
2734,5,5,3,0,2,3
2734,4,1,1,0,0,1
2734,3,1,1,0,0,1
2734,2,2,1,0,1,1
2734,1,3,2,0,1,2
21061,10,1,1,0,0,1
21061,8,8,2,0,6,2
21061,7,16,5,0,11,5
21061,6,25,8,0,17,8
21061,5,9,2,0,7,2
21061,2,1,1,0,0,1
21061,1,1,1,0,0,1
80503,10,1,1,0,0,1
80503,8,4,1,0,3,1
80503,6,17,4,0,13,4
80503,5,9,1,0,8,1
80503,4,13,3,0,10,3
80503,3,14,5,0,9,5
80503,2,3,1,0,2,1
80503,1,3,1,0,2,1
7823,9,11,4,0,7,4
7823,8,24,6,0,18,6
7823,7,13,1,0,12,1
7823,6,13,4,0,9,4
7823,4,2,1,0,1,1
7823,3,1,1,0,0,1
175265,8,8,4,0,4,4
175265,7,23,7,0,16,7
175265,6,18,4,0,14,4
175265,5,14,4,0,10,4
175265,3,2,1,0,1,1
13881,10,3,2,0,1,2
13881,9,3,2,0,1,2
13881,8,6,2,0,4,2
13881,7,14,7,0,7,7
13881,6,23,6,0,17,6
13881,5,17,8,0,9,8
13881,4,3,2,0,1,2
13881,3,1,1,0,0,1
9360,10,4,3,0,1,3
9360,9,6,4,0,2,4
9360,8,22,8,0,14,8
9360,7,23,8,0,15,8
9360,6,10,2,0,8,2
9360,5,4,1,0,3,1
9360,4,1,1,0,0,1
2207,8,7,2,0,5,2
2207,7,13,1,0,12,1
2207,6,28,6,0,22,6
2207,5,15,3,0,12,3
2207,4,4,1,0,3,1
252153,10,14,2,0,12,2
252153,9,14,3,0,11,3
252153,8,28,3,0,25,3
252153,7,6,2,0,4,2
252153,4,1,1,0,0,1
153388,8,4,1,0,3,1
153388,7,12,1,0,11,1
153388,6,31,3,0,28,3
153388,5,14,3,0,11,3
153388,4,4,1,0,3,1
153388,3,3,1,0,2,1
21991,10,1,1,0,0,1
21991,9,1,1,0,0,1
21991,8,13,7,0,6,7
21991,7,24,7,0,17,7
21991,6,18,4,0,14,4
21991,5,9,2,0,7,2
21991,4,4,1,0,3,1
91440,8,5,1,0,4,1
91440,7,15,7,0,8,7
91440,6,26,7,0,19,7
91440,5,11,4,0,7,4
91440,4,10,2,0,8,2
30363,8,4,1,0,3,1
30363,7,9,2,0,7,2
30363,6,16,3,0,13,3
30363,5,15,3,0,12,3
30363,4,10,4,0,6,4
30363,3,11,1,0,10,1
30363,2,3,1,0,2,1
21566,7,6,4,0,2,4
21566,6,24,4,0,20,4
21566,4,13,3,0,10,3
21566,3,4,1,0,3,1
21566,2,4,2,0,2,2
18699,10,3,2,0,1,2
18699,9,5,4,0,1,4
18699,8,13,4,0,9,4
18699,7,18,5,0,13,5
18699,6,18,8,0,10,8
18699,5,7,3,0,4,3
18699,4,6,1,0,5,1
167604,10,5,2,0,3,2
167604,9,4,1,0,3,1
167604,8,25,6,0,19,6
167604,7,14,1,0,13,1
167604,6,13,4,0,9,4
167604,5,7,1,0,6,1
63779,9,1,1,0,0,1
63779,8,8,2,0,6,2
63779,7,12,4,0,8,4
63779,6,30,11,0,19,11
63779,4,5,3,0,2,3
63779,2,1,1,0,0,1
63779,1,1,1,0,0,1
258665,10,1,1,0,0,1
258665,8,10,2,0,8,2
258665,7,11,2,0,9,2
258665,6,32,5,0,27,5
258665,4,6,1,0,5,1
258665,2,4,2,0,2,2
12795,8,10,5,0,5,5
12795,7,11,3,0,8,3
12795,6,23,5,0,18,5
12795,5,12,3,0,9,3
12795,3,3,2,0,1,2
12795,1,1,1,0,0,1
33958,8,6,1,0,5,1
33958,7,16,5,0,11,5
33958,6,21,4,0,17,4
33958,5,16,7,0,9,7
33958,3,1,1,0,0,1
238102,6,20,2,0,18,2
238102,5,18,2,0,16,2
182799,8,9,1,0,8,1
182799,7,16,1,0,15,1
182799,6,24,4,0,20,4
182799,4,8,1,0,7,1
182799,3,3,1,0,2,1
182799,1,1,1,0,0,1
24484,6,29,12,0,17,12
24484,5,10,3,0,7,3
24484,4,12,6,0,6,6
24484,2,4,2,0,2,2
3174,10,2,1,0,1,1
3174,8,5,3,0,2,3
3174,7,8,3,0,5,3
3174,6,24,5,0,19,5
3174,5,17,6,0,11,6
3174,4,10,1,0,9,1
3174,3,1,1,0,0,1
3174,2,2,1,0,1,1
85857,8,24,9,0,15,9
85857,7,21,5,0,16,5
85857,6,12,5,0,7,5
85857,5,6,3,0,3,3
85857,4,3,1,0,2,1
85857,3,2,2,0,0,2
85857,1,1,1,0,0,1
96703,8,14,8,0,6,8
96703,7,13,7,0,6,7
96703,6,29,9,0,20,9
96703,5,5,3,0,2,3
96703,4,4,2,0,2,2
96703,3,3,2,0,1,2
96703,2,1,1,0,0,1
207975,8,5,1,0,4,1
207975,7,9,1,0,8,1
207975,6,14,5,0,9,5
207975,5,15,3,0,12,3
207975,4,12,1,0,11,1
207975,3,8,1,0,7,1
139607,6,24,3,0,21,3
139607,4,3,1,0,2,1
193161,9,6,2,0,4,2
193161,8,9,4,0,5,4
193161,7,11,2,0,9,2
193161,6,26,4,0,22,4
193161,5,12,1,0,11,1
86587,8,11,3,0,8,3
86587,7,7,2,0,5,2
86587,6,26,1,0,25,1
86587,5,15,1,0,14,1
86587,4,6,1,0,5,1
86587,3,4,2,0,2,2
86587,2,1,1,0,0,1
33723,9,1,1,0,0,1
33723,8,6,3,0,3,3
33723,7,15,3,0,12,3
33723,6,28,11,0,17,11
33723,5,10,4,0,6,4
33723,4,7,4,0,3,4
33723,3,1,1,0,0,1
33723,2,1,1,0,0,1
33723,1,1,1,0,0,1
124954,6,26,3,0,23,3
124954,5,13,1,0,12,1
124954,4,11,1,0,10,1
124954,3,4,1,0,3,1
4405,10,3,1,0,2,1
4405,8,4,2,0,2,2
4405,7,7,3,0,4,3
4405,6,20,6,0,14,6
4405,5,12,6,0,6,6
4405,4,11,1,0,10,1
4405,3,7,2,0,5,2
4405,2,5,2,0,3,2
12736,10,5,1,0,4,1
12736,9,3,2,0,1,2
12736,8,16,7,0,9,7
12736,7,24,11,0,13,11
12736,6,16,3,0,13,3
12736,5,2,1,0,1,1
12736,4,3,1,0,2,1
165984,8,15,1,0,14,1
165984,7,31,4,0,27,4
165984,6,18,3,0,15,3
165984,4,1,1,0,0,1
165984,3,1,1,0,0,1
13915,9,3,1,0,2,1
13915,8,5,3,0,2,3
13915,7,18,9,0,9,9
13915,6,25,9,0,16,9
13915,5,14,9,0,5,9
13915,4,4,1,0,3,1
154901,8,7,2,0,5,2
154901,7,7,2,0,5,2
154901,6,15,3,0,12,3
154901,5,9,3,1,6,2
154901,4,13,3,1,10,2
154901,3,5,1,0,4,1
154901,2,12,4,0,8,4
1396,9,3,1,0,2,1
1396,8,15,3,0,12,3
1396,7,19,3,0,16,3
1396,6,20,3,0,17,3
1396,5,5,2,0,3,2
1396,4,3,1,0,2,1
1396,3,3,3,0,0,3
218769,8,7,1,0,6,1
218769,7,14,3,0,11,3
218769,6,27,7,0,20,7
218769,5,8,1,0,7,1
218769,2,2,1,0,1,1
20580,8,2,1,0,1,1
20580,7,5,1,0,4,1
20580,6,10,4,0,6,4
20580,5,21,3,0,18,3
20580,4,15,9,0,6,9
20580,3,6,2,0,4,2
20580,2,6,3,0,3,3
20580,1,4,1,0,3,1
3036,9,3,1,0,2,1
3036,8,10,5,0,5,5
3036,7,18,5,0,13,5
3036,6,18,10,0,8,10
3036,5,13,1,0,12,1
3036,4,3,1,0,2,1
3036,3,3,1,0,2,1
112694,10,12,4,0,8,4
112694,9,15,8,0,7,8
112694,8,23,3,0,20,3
112694,7,14,1,0,13,1
112694,3,1,1,0,0,1
235362,10,7,3,0,4,3
235362,9,10,2,0,8,2
235362,8,36,7,0,29,7
235362,3,2,2,0,0,2
1011,7,6,1,0,5,1
1011,5,20,2,0,18,2
1011,4,13,2,0,11,2
1011,3,6,3,0,3,3
1011,2,5,1,0,4,1
76668,10,2,1,0,1,1
76668,6,18,4,0,14,4
76668,5,14,2,0,12,2
76668,4,13,3,0,10,3
76668,3,11,3,0,8,3
76668,2,3,1,0,2,1
76668,1,3,1,0,2,1
37477,8,6,2,0,4,2
37477,7,21,5,0,16,5
37477,6,29,8,0,21,8
37477,5,8,4,0,4,4
342,9,1,1,0,0,1
342,8,2,1,0,1,1
342,7,13,7,0,6,7
342,6,30,11,0,19,11
342,5,11,1,0,10,1
342,4,10,4,0,6,4
342,3,3,1,0,2,1
18117,10,3,1,0,2,1
18117,8,4,1,0,3,1
18117,6,26,3,0,23,3
18117,5,11,3,0,8,3
18117,4,13,5,0,8,5
18117,3,2,1,0,1,1
57215,8,2,1,0,1,1
57215,7,6,1,0,5,1
57215,6,10,1,0,9,1
57215,5,15,2,0,13,2
57215,4,18,3,0,15,3
57215,3,9,1,0,8,1
57215,2,8,1,0,7,1
57215,1,1,1,0,0,1
158487,8,18,7,1,11,6
158487,7,17,3,1,14,2
158487,6,17,4,0,13,4
158487,5,3,1,0,2,1
158487,4,7,1,0,6,1
158487,1,2,1,1,1,0
137626,10,5,3,0,2,3
137626,9,7,3,0,4,3
137626,8,29,15,0,14,15
137626,7,21,10,0,11,10
137626,6,8,4,0,4,4
137626,4,1,1,0,0,1
10244,10,19,7,0,12,7
10244,9,9,4,0,5,4
10244,8,17,6,0,11,6
10244,7,11,5,0,6,5
10244,6,4,1,0,3,1
10244,5,5,1,0,4,1
194960,7,5,1,0,4,1
194960,6,22,3,0,19,3
194960,5,17,2,0,15,2
194960,4,18,4,0,14,4
194960,3,5,1,0,4,1
133425,7,4,1,0,3,1
133425,6,11,1,0,10,1
133425,5,18,5,0,13,5
217581,8,10,1,0,9,1
217581,7,27,6,0,21,6
217581,6,18,4,0,14,4
217581,5,8,1,0,7,1
11950,6,15,2,0,13,2
11950,5,19,5,0,14,5
11950,4,11,3,0,8,3
11950,3,6,3,0,3,3
11950,2,7,1,0,6,1
11950,1,4,2,0,2,2
19161,10,10,6,0,4,6
19161,9,7,2,0,5,2
19161,8,18,11,0,7,11
19161,7,14,6,0,8,6
19161,6,9,1,0,8,1
19161,5,5,2,0,3,2
19161,4,2,1,0,1,1
19161,1,1,1,0,0,1
11973,10,2,1,0,1,1
11973,6,20,2,0,18,2
11973,4,7,2,0,5,2
11973,2,1,1,0,0,1
150923,10,1,1,0,0,1
150923,9,1,1,1,0,0
150923,8,17,6,1,11,5
150923,7,12,3,1,9,2
150923,6,21,4,2,17,2
150923,5,13,1,0,12,1
150923,4,1,1,0,0,1
150923,2,3,1,1,2,0
7600,7,3,1,0,2,1
7600,5,17,2,0,15,2
7600,4,18,6,0,12,6
7600,3,15,4,0,11,4
7600,2,8,4,0,4,4
7600,1,3,2,0,1,2
203104,8,7,1,0,6,1
203104,7,18,1,0,17,1
203104,6,23,3,0,20,3
203104,5,14,1,0,13,1
185241,10,8,2,0,6,2
185241,9,12,6,1,6,5
185241,8,19,9,0,10,9
185241,7,14,4,1,10,3
185241,6,8,1,0,7,1
185241,5,1,1,1,0,0
185241,4,3,1,0,2,1
185241,2,1,1,0,0,1
185241,1,3,2,0,1,2
3860,10,1,1,0,0,1
3860,9,2,1,0,1,1
3860,8,21,12,0,9,12
3860,7,15,11,0,4,11
3860,6,23,9,0,14,9
3860,4,3,3,0,0,3
12600,9,5,2,0,3,2
12600,8,7,2,0,5,2
12600,7,10,3,0,7,3
12600,6,14,6,0,8,6
12600,5,15,6,0,9,6
12600,4,7,4,0,3,4
12600,3,6,4,0,2,4
12600,2,4,2,0,2,2
228370,10,61,40,0,21,40
228370,7,2,1,0,1,1
228370,1,2,1,0,1,1
186755,7,19,7,1,12,6
186755,6,15,3,0,12,3
186755,5,15,3,1,12,2
186755,4,7,2,0,5,2
67144,7,9,3,0,6,3
67144,6,27,4,0,23,4
67144,5,11,2,0,9,2
67144,4,4,1,0,3,1
67144,3,5,1,0,4,1
67144,2,2,1,0,1,1
203997,10,4,1,0,3,1
203997,8,10,1,0,9,1
203997,7,23,4,0,19,4
203997,6,6,1,0,5,1
203997,5,13,1,0,12,1
203997,4,8,1,0,7,1
156350,7,8,2,0,6,2
156350,6,6,2,0,4,2
156350,5,19,2,0,17,2
156350,4,16,4,0,12,4
156350,2,7,3,0,4,3
156350,1,7,2,0,5,2
167190,9,3,2,1,1,1
167190,8,10,1,0,9,1
167190,7,20,4,0,16,4
167190,6,25,4,1,21,3
167190,5,6,1,0,5,1
167190,4,5,1,0,4,1
167190,3,1,1,1,0,0
161886,9,6,1,0,5,1
161886,8,26,12,0,14,12
161886,7,15,5,0,10,5
161886,6,16,5,0,11,5
161886,5,4,1,0,3,1
7549,8,3,2,0,1,2
7549,7,9,7,0,2,7
7549,6,21,7,0,14,7
7549,5,19,5,0,14,5
7549,4,14,4,0,10,4
7549,2,1,1,0,0,1
40005,8,15,3,0,12,3
40005,7,18,7,0,11,7
40005,6,22,4,0,18,4
40005,5,6,4,0,2,4
40005,4,6,1,0,5,1
183315,9,9,5,0,4,5
183315,8,26,8,0,18,8
183315,7,21,4,0,17,4
183315,6,13,3,0,10,3
183315,5,1,1,0,0,1
4058,9,5,2,0,3,2
4058,8,3,1,0,2,1
4058,7,6,1,0,5,1
4058,6,18,7,0,11,7
4058,5,14,4,0,10,4
4058,4,11,4,0,7,4
4058,3,4,1,0,3,1
4058,2,5,3,0,2,3
4058,1,4,2,0,2,2
168654,8,10,2,0,8,2
168654,7,12,1,0,11,1
168654,5,10,4,0,6,4
168654,4,9,1,0,8,1
168654,3,5,2,0,3,2
168654,2,1,1,0,0,1
37633,8,10,5,0,5,5
37633,7,22,7,0,15,7
37633,6,17,4,0,13,4
37633,5,14,5,0,9,5
37633,4,4,2,0,2,2
37633,3,2,1,0,1,1
192762,10,2,2,0,0,2
192762,8,9,3,0,6,3
192762,7,22,3,0,19,3
192762,6,20,1,0,19,1
192762,5,5,2,0,3,2
192762,3,1,1,0,0,1
192762,2,2,1,0,1,1
928,8,1,1,0,0,1
928,7,10,1,0,9,1
928,6,19,3,0,16,3
928,5,15,4,0,11,4
928,4,12,3,0,9,3
928,3,7,3,0,4,3
928,2,4,1,0,3,1
197928,9,7,1,0,6,1
197928,8,13,2,0,11,2
197928,6,15,6,1,9,5
197928,5,8,3,1,5,2
197928,4,7,2,1,5,1
197928,3,2,1,0,1,1
17819,8,3,1,0,2,1
17819,7,7,2,0,5,2
17819,6,16,5,0,11,5
17819,5,15,5,0,10,5
17819,4,11,2,0,9,2
17819,3,9,2,0,7,2
17819,2,6,3,0,3,3
17819,1,3,1,0,2,1
12289,7,10,2,0,8,2
12289,6,30,12,0,18,12
12289,5,16,8,0,8,8
12289,4,6,3,0,3,3
12289,3,3,1,0,2,1
12289,1,1,1,0,0,1
9865,10,5,1,0,4,1
9865,9,8,3,0,5,3
9865,8,25,13,0,12,13
9865,7,25,8,0,17,8
9865,5,4,1,0,3,1
2089,10,1,1,0,0,1
2089,7,12,3,0,9,3
2089,6,19,3,0,16,3
2089,5,11,1,0,10,1
2089,4,18,6,0,12,6
2089,2,2,1,0,1,1
1707,8,2,2,0,0,2
1707,7,3,1,0,2,1
1707,6,19,5,0,14,5
1707,5,19,9,0,10,9
1707,4,10,3,0,7,3
1707,3,10,3,0,7,3
1707,2,5,2,0,3,2
1707,1,2,2,0,0,2
4476,10,1,1,0,0,1
4476,8,1,1,0,0,1
4476,7,3,1,0,2,1
4476,6,10,1,0,9,1
4476,5,16,3,0,13,3
4476,4,20,6,0,14,6
4476,3,8,3,0,5,3
4476,1,6,1,0,5,1
4683,8,6,1,0,5,1
4683,7,20,10,0,10,10
4683,6,27,12,0,15,12
4683,5,11,4,0,7,4
4683,4,3,1,0,2,1
72460,9,6,4,0,2,4
72460,8,33,16,0,17,16
72460,7,19,5,0,14,5
72460,6,5,1,0,4,1
72460,5,2,1,0,1,1
72460,4,2,1,0,1,1
72460,1,1,1,0,0,1
195232,10,3,2,0,1,2
195232,9,19,7,0,12,7
195232,8,22,4,0,18,4
195232,7,12,4,0,8,4
195232,6,9,3,0,6,3
195232,5,2,1,0,1,1
195232,2,1,1,0,0,1
163478,9,3,2,0,1,2
163478,7,9,3,0,6,3
163478,6,20,4,0,16,4
163478,5,11,3,0,8,3
163478,1,1,1,0,0,1
206082,9,2,2,0,0,2
206082,8,6,4,0,2,4
206082,7,10,1,0,9,1
206082,6,25,2,0,23,2
206082,5,12,1,0,11,1
206082,4,7,1,0,6,1
206082,3,4,2,0,2,2
206082,1,1,1,0,0,1
246873,10,7,3,0,4,3
246873,9,22,11,0,11,11
246873,8,25,6,0,19,6
246873,7,11,4,0,7,4
246873,4,1,1,0,0,1
25569,8,12,3,0,9,3
25569,7,12,2,0,10,2
25569,6,23,7,0,16,7
25569,5,9,2,0,7,2
25569,4,7,1,0,6,1
25569,2,1,1,0,0,1
173100,10,1,1,0,0,1
173100,9,2,1,0,1,1
173100,6,23,4,0,19,4
173100,5,15,2,0,13,2
173100,4,10,1,0,9,1
173100,3,3,2,0,1,2
2104,8,6,4,0,2,4
2104,7,12,4,0,8,4
2104,6,22,2,0,20,2
2104,5,17,4,0,13,4
2104,4,8,3,0,5,3
2104,2,1,1,0,0,1
192605,9,5,1,0,4,1
192605,8,10,2,0,8,2
192605,7,17,2,0,15,2
192605,6,19,5,1,14,4
192605,5,11,2,0,9,2
57310,8,6,2,0,4,2
57310,7,21,5,0,16,5
57310,6,20,2,0,18,2
57310,5,14,4,0,10,4
57310,4,5,1,0,4,1
57310,3,2,1,0,1,1
3667,10,4,2,0,2,2
3667,9,10,3,0,7,3
3667,8,15,6,0,9,6
3667,7,10,5,0,5,5
3667,6,22,8,0,14,8
3667,5,8,1,0,7,1
156097,10,6,1,0,5,1
156097,8,32,4,0,28,4
156097,7,20,2,0,18,2
156097,6,7,2,0,5,2
37260,8,15,3,0,12,3
37260,7,21,8,0,13,8
37260,6,16,5,0,11,5
37260,5,9,4,0,5,4
37260,4,3,1,0,2,1
37260,3,1,1,0,0,1
37260,2,2,2,0,0,2
37168,5,21,4,0,17,4
38466,10,2,1,0,1,1
38466,8,4,3,0,1,3
38466,7,13,4,0,9,4
38466,6,29,10,0,19,10
38466,5,14,6,0,8,6
38466,4,5,1,0,4,1
38466,3,2,2,0,0,2
165292,10,11,3,0,8,3
165292,9,11,2,0,9,2
165292,8,31,9,0,22,9
165292,7,6,2,0,4,2
165292,6,7,1,0,6,1
165292,4,1,1,0,0,1
19903,10,6,2,0,4,2
19903,9,13,3,0,10,3
19903,8,17,5,0,12,5
19903,7,13,4,0,9,4
19903,4,1,1,0,0,1
141636,10,6,3,0,3,3
141636,8,3,1,0,2,1
141636,6,9,1,0,8,1
141636,5,9,2,0,7,2
141636,3,9,4,0,5,4
141636,2,7,3,1,4,2
141636,1,22,11,4,11,7
1779,6,9,1,0,8,1
1779,5,21,4,0,17,4
1779,4,14,6,0,8,6
1779,3,9,5,0,4,5
1779,2,6,5,0,1,5
1779,1,3,3,0,0,3
34902,8,2,1,0,1,1
34902,7,4,1,0,3,1
34902,6,16,5,0,11,5
34902,5,11,6,0,5,6
34902,4,21,9,0,12,9
34902,3,6,3,0,3,3
34902,2,5,2,0,3,2
34902,1,3,1,0,2,1
222885,8,6,1,0,5,1
222885,7,14,2,0,12,2
222885,6,33,9,1,24,8
222885,3,1,1,0,0,1
222885,2,1,1,1,0,0
26315,10,5,1,0,4,1
26315,9,7,3,0,4,3
26315,8,21,6,0,15,6
26315,7,13,3,0,10,3
26315,6,12,4,0,8,4
26315,5,7,2,0,5,2
26315,4,1,1,0,0,1
29405,6,7,2,0,5,2
29405,5,1,1,0,0,1
29405,4,16,6,0,10,6
29405,3,11,5,0,6,5
29405,2,16,10,0,6,10
29405,1,12,9,0,3,9
1611,9,3,1,0,2,1
1611,8,5,1,0,4,1
1611,7,7,2,0,5,2
1611,6,19,7,0,12,7
1611,5,17,6,0,11,6
1611,4,9,5,0,4,5
1611,3,4,2,0,2,2
1611,2,4,1,0,3,1
1611,1,1,1,0,0,1
1954,8,7,1,0,6,1
1954,7,13,1,0,12,1
1954,6,19,4,0,15,4
1954,4,12,2,0,10,2
1954,3,3,2,0,1,2
1954,2,1,1,0,0,1
16160,8,4,2,0,2,2
16160,7,10,5,0,5,5
16160,6,15,4,0,11,4
16160,5,15,2,0,13,2
16160,4,14,1,0,13,1
16160,3,5,1,0,4,1
1945,9,1,1,0,0,1
1945,8,12,6,0,6,6
1945,7,7,1,0,6,1
1945,6,18,5,0,13,5
1945,4,7,3,0,4,3
1945,3,4,1,0,3,1
152488,5,10,1,0,9,1
152488,3,12,6,0,6,6
152488,2,13,3,0,10,3
152488,1,9,3,0,6,3
3691,10,2,1,0,1,1
3691,9,6,4,0,2,4
3691,8,6,3,0,3,3
3691,7,20,9,0,11,9
3691,6,20,6,0,14,6
3691,5,9,1,0,8,1
3691,3,3,1,0,2,1
10102,8,17,8,0,9,8
10102,7,22,7,0,15,7
10102,6,20,8,0,12,8
10102,5,3,1,0,2,1
10102,4,2,1,0,1,1
10102,1,1,1,0,0,1
180599,10,4,3,0,1,3
180599,8,8,2,0,6,2
180599,7,20,5,0,15,5
180599,6,22,4,0,18,4
180599,5,9,1,0,8,1
180599,4,3,2,0,1,2
7522,8,10,3,0,7,3
7522,7,17,4,0,13,4
7522,6,18,1,0,17,1
7522,5,9,1,0,8,1
7522,4,9,2,0,7,2
7522,1,2,2,0,0,2
109612,8,13,3,0,10,3
109612,7,17,2,0,15,2
109612,6,24,8,0,16,8
109612,5,9,4,0,5,4
5759,10,3,1,0,2,1
5759,8,6,2,0,4,2
5759,7,10,4,0,6,4
5759,6,10,2,0,8,2
5759,5,16,4,0,12,4
5759,4,7,1,0,6,1
5759,3,6,1,0,5,1
5759,2,7,1,0,6,1
5759,1,3,2,0,1,2
158122,10,5,4,1,1,3
158122,9,7,3,0,4,3
158122,8,23,6,2,17,4
158122,7,11,4,0,7,4
158122,6,12,3,0,9,3
158122,5,7,2,0,5,2
158122,4,3,3,0,0,3
18056,7,20,3,0,17,3
18056,6,19,3,0,16,3
18056,5,5,1,0,4,1
18056,4,3,1,0,2,1
18056,3,1,1,0,0,1
147920,9,2,1,0,1,1
147920,8,13,4,0,9,4
147920,7,21,4,0,17,4
147920,6,20,3,0,17,3
147920,5,6,1,0,5,1
147920,3,3,1,0,2,1
83907,10,2,2,0,0,2
83907,9,6,6,0,0,6
83907,8,23,17,0,6,17
83907,7,10,6,0,4,6
83907,6,13,3,0,10,3
183649,10,4,1,0,3,1
183649,9,4,1,0,3,1
183649,8,15,2,0,13,2
183649,7,12,3,0,9,3
183649,6,13,2,0,11,2
183649,5,9,3,0,6,3
183649,4,5,1,0,4,1
183649,2,4,1,0,3,1
183649,1,2,1,0,1,1
192315,10,4,1,1,3,0
192315,9,5,2,0,3,2
192315,8,25,3,2,22,1
192315,7,17,1,1,16,0
192315,6,9,1,0,8,1
192315,5,4,1,0,3,1
192315,4,4,1,0,3,1
173344,9,1,1,0,0,1
173344,7,16,1,0,15,1
173344,6,20,2,0,18,2
173344,5,16,3,0,13,3
173344,4,4,2,0,2,2
173344,2,2,1,0,1,1
6122,10,1,1,0,0,1
6122,8,2,1,0,1,1
6122,7,3,1,0,2,1
6122,6,12,5,0,7,5
6122,5,17,5,0,12,5
6122,4,13,1,0,12,1
6122,3,14,6,0,8,6
53279,8,4,1,0,3,1
53279,7,14,4,0,10,4
53279,6,16,2,0,14,2
53279,5,15,5,0,10,5
163031,10,3,2,0,1,2
163031,9,8,5,1,3,4
163031,8,10,5,1,5,4
163031,7,13,5,1,8,4
163031,6,15,2,1,13,1
163031,5,8,2,0,6,2
6499,8,4,3,0,1,3
6499,7,8,4,0,4,4
6499,6,20,5,0,15,5
6499,5,20,6,0,14,6
6499,4,9,3,0,6,3
6499,3,4,1,0,3,1
6499,2,3,1,0,2,1
5958,10,4,1,0,3,1
5958,9,5,1,0,4,1
5958,8,19,8,0,11,8
5958,7,17,7,0,10,7
5958,6,12,2,0,10,2
5958,5,9,2,0,7,2
5958,4,2,1,0,1,1
208217,8,12,1,0,11,1
208217,6,12,1,0,11,1
208217,4,5,2,0,3,2
208217,1,1,1,0,0,1
183881,6,24,2,0,22,2
183881,5,8,1,0,7,1
183881,4,5,2,0,3,2
183881,2,3,1,0,2,1
97990,9,3,1,0,2,1
97990,7,7,3,0,4,3
97990,6,25,6,0,19,6
97990,5,12,1,0,11,1
97990,4,12,3,0,9,3
97990,2,1,1,0,0,1
25993,10,3,1,0,2,1
25993,9,8,2,0,6,2
25993,8,18,8,0,10,8
25993,7,14,7,0,7,7
25993,6,19,5,0,14,5
25993,5,2,2,0,0,2
25993,4,3,1,0,2,1
25993,2,1,1,0,0,1
25993,1,1,1,0,0,1
38868,8,18,3,0,15,3
38868,7,18,5,0,13,5
38868,6,14,7,0,7,7
38868,5,7,2,0,5,2
38868,4,5,2,0,3,2
38868,2,1,1,0,0,1
38868,1,2,1,0,1,1
19274,9,1,1,0,0,1
19274,8,2,1,0,1,1
19274,7,5,2,0,3,2
19274,6,16,5,0,11,5
19274,5,12,5,0,7,5
19274,4,10,4,0,6,4
19274,3,6,2,0,4,2
19274,2,12,6,0,6,6
19274,1,5,3,0,2,3
282,10,1,1,0,0,1
282,9,1,1,0,0,1
282,8,9,5,0,4,5
282,7,18,4,0,14,4
282,6,19,1,0,18,1
282,5,10,3,0,7,3
282,4,7,3,0,4,3
282,2,2,2,0,0,2
257306,9,8,2,0,6,2
257306,8,20,5,0,15,5
257306,7,15,1,0,14,1
257306,6,16,1,0,15,1
6000,8,6,3,0,3,3
6000,7,11,1,0,10,1
6000,6,22,10,0,12,10
6000,5,18,2,0,16,2
6000,4,5,1,0,4,1
6000,3,2,1,0,1,1
6000,1,1,1,0,0,1
16271,10,5,2,0,3,2
16271,9,4,2,0,2,2
16271,8,15,7,0,8,7
16271,7,10,5,0,5,5
16271,6,16,7,0,9,7
16271,5,13,7,0,6,7
16271,4,4,2,0,2,2
148434,7,12,5,0,7,5
148434,6,23,1,0,22,1
148434,5,12,3,0,9,3
148434,4,9,3,0,6,3
148434,3,4,1,0,3,1
148434,2,2,1,0,1,1
17284,8,4,2,0,2,2
17284,7,17,4,0,13,4
17284,6,18,6,0,12,6
17284,5,14,7,0,7,7
17284,4,9,6,0,3,6
17284,3,4,3,0,1,3
17284,2,3,2,0,1,2
30795,9,7,2,0,5,2
30795,8,27,5,0,22,5
30795,7,19,4,0,15,4
30795,6,12,2,0,10,2
30795,4,1,1,0,0,1
5220,8,10,6,0,4,6
5220,7,15,3,0,12,3
5220,6,26,7,0,19,7
5220,5,11,4,0,7,4
5220,4,4,2,0,2,2
196122,9,2,2,1,0,1
196122,8,7,1,0,6,1
196122,7,13,5,0,8,5
196122,6,29,6,0,23,6
196122,5,10,1,1,9,0
196122,4,5,3,0,2,3
196122,1,1,1,0,0,1
151450,10,3,2,0,1,2
151450,9,5,3,0,2,3
151450,8,31,10,0,21,10
151450,7,17,5,0,12,5
151450,6,9,3,0,6,3
151450,5,4,2,0,2,2
253766,10,6,2,1,4,1
253766,8,14,5,0,9,5
253766,6,15,3,1,12,2
253766,5,7,2,0,5,2
147590,9,2,2,0,0,2
147590,7,19,4,0,15,4
147590,6,23,5,0,18,5
147590,5,10,1,0,9,1
147590,3,2,1,0,1,1
137328,7,22,5,0,17,5
137328,6,26,7,0,19,7
137328,5,12,2,0,10,2
10564,10,4,2,0,2,2
10564,9,4,1,0,3,1
10564,7,28,11,0,17,11
10564,6,17,3,0,14,3
10564,5,4,3,0,1,3
10564,4,3,1,0,2,1
10564,3,1,1,0,0,1
8180,9,2,1,0,1,1
8180,8,4,1,0,3,1
8180,7,22,10,0,12,10
8180,6,26,10,0,16,10
8180,5,10,5,0,5,5
8180,4,3,1,0,2,1
116124,8,6,3,0,3,3
116124,6,26,3,0,23,3
116124,5,17,3,0,14,3
127324,10,28,11,0,17,11
127324,9,15,7,0,8,7
127324,8,14,4,0,10,4
127324,7,7,1,0,6,1
127324,6,2,1,1,1,0
127324,4,1,1,0,0,1
127324,1,1,1,0,0,1
204504,10,5,1,0,4,1
204504,8,19,2,0,17,2
204504,7,18,2,0,16,2
204504,6,18,4,0,14,4
204504,5,3,1,0,2,1
204504,4,2,1,0,1,1
10551,9,2,1,0,1,1
10551,8,13,3,0,10,3
10551,7,19,6,0,13,6
10551,6,20,7,0,13,7
10551,5,12,5,0,7,5
10551,4,2,2,0,0,2
4316,9,3,1,0,2,1
4316,8,8,2,0,6,2
4316,7,8,3,0,5,3
4316,6,29,8,0,21,8
4316,5,13,2,0,11,2
4316,4,4,2,0,2,2
4316,3,2,1,0,1,1
4316,1,2,2,0,0,2
6007,10,2,1,0,1,1
6007,9,1,1,0,0,1
6007,8,6,3,0,3,3
6007,7,26,8,0,18,8
6007,6,22,5,0,17,5
6007,5,8,1,0,7,1
6007,4,2,1,0,1,1
241760,9,4,1,1,3,0
241760,7,18,2,0,16,2
241760,6,21,3,0,18,3
3736,8,1,1,0,0,1
3736,6,10,5,0,5,5
3736,5,14,3,0,11,3
3736,4,12,4,0,8,4
3736,3,14,4,0,10,4
3736,2,5,3,0,2,3
3736,1,9,2,0,7,2
40236,9,1,1,0,0,1
40236,8,8,4,0,4,4
40236,7,9,2,0,7,2
40236,6,16,5,0,11,5
40236,5,14,4,0,10,4
40236,4,10,3,0,7,3
40236,3,4,1,0,3,1
40236,2,5,1,0,4,1
63011,9,6,5,0,1,5
63011,8,16,8,0,8,8
63011,7,14,7,0,7,7
63011,6,22,7,0,15,7
63011,5,7,2,0,5,2
63011,1,1,1,0,0,1
11500,10,2,1,0,1,1
11500,9,4,3,0,1,3
11500,8,8,4,0,4,4
11500,7,16,6,0,10,6
11500,6,22,3,0,19,3
11500,5,12,5,0,7,5
11500,4,3,1,0,2,1
36623,8,25,5,0,20,5
36623,7,17,4,0,13,4
36623,6,13,2,0,11,2
36623,5,5,3,0,2,3
36623,1,1,1,0,0,1
2764,7,9,4,0,5,4
2764,6,14,5,0,9,5
2764,5,15,2,0,13,2
2764,4,16,3,0,13,3
2764,2,4,2,0,2,2
787,7,15,4,0,11,4
787,6,26,4,0,22,4
787,5,16,6,0,10,6
787,4,4,1,0,3,1
787,3,2,1,0,1,1
13114,8,4,2,0,2,2
13114,7,7,3,0,4,3
13114,6,14,3,0,11,3
13114,5,19,6,0,13,6
13114,4,13,4,0,9,4
13114,3,4,2,0,2,2
13114,2,8,5,0,3,5
153745,10,1,1,0,0,1
153745,9,2,1,0,1,1
153745,8,12,3,0,9,3
153745,7,18,2,1,16,1
153745,6,20,3,0,17,3
153745,5,11,3,0,8,3
153745,4,3,1,0,2,1
153745,3,2,1,0,1,1
129751,9,2,1,0,1,1
129751,8,15,2,0,13,2
129751,7,24,3,0,21,3
129751,6,20,5,0,15,5
129751,5,6,1,0,5,1
572,9,1,1,0,0,1
572,8,5,1,0,4,1
572,7,8,6,0,2,6
572,6,23,6,0,17,6
572,5,16,5,0,11,5
572,4,7,2,0,5,2
572,3,3,2,0,1,2
572,2,2,1,0,1,1
572,1,4,1,0,3,1
39290,10,1,1,0,0,1
39290,8,15,7,0,8,7
39290,7,20,11,0,9,11
39290,6,23,11,0,12,11
39290,5,5,1,0,4,1
39290,3,2,2,0,0,2
6548,10,18,10,0,8,10
6548,8,14,5,0,9,5
6548,7,7,4,0,3,4
6548,6,8,1,0,7,1
6548,5,5,2,0,3,2
6548,4,7,2,0,5,2
6548,3,3,2,0,1,2
160601,10,2,1,0,1,1
160601,9,4,2,0,2,2
160601,8,10,1,0,9,1
160601,7,20,2,0,18,2
160601,6,18,3,0,15,3
160601,5,8,2,0,6,2
170337,10,3,1,0,2,1
170337,8,5,2,0,3,2
170337,6,27,1,0,26,1
170337,4,8,2,0,6,2
170337,3,4,1,0,3,1
170337,2,1,1,0,0,1
2811,7,6,3,0,3,3
2811,6,19,6,0,13,6
2811,5,12,3,0,9,3
2811,4,16,6,0,10,6
2811,3,6,1,0,5,1
2811,2,6,2,0,4,2
2811,1,1,1,0,0,1
41021,10,1,1,0,0,1
41021,7,9,1,0,8,1
41021,6,24,4,0,20,4
41021,5,20,7,0,13,7
41021,4,9,4,0,5,4
41021,2,2,1,0,1,1
6020,6,13,5,0,8,5
6020,5,17,5,0,12,5
6020,4,9,2,0,7,2
6020,3,10,8,0,2,8
6020,2,6,3,0,3,3
6020,1,8,6,0,2,6
1364,10,3,2,0,1,2
1364,9,3,2,0,1,2
1364,8,6,2,0,4,2
1364,7,12,6,0,6,6
1364,6,24,6,0,18,6
1364,5,11,6,0,5,6
1364,4,5,3,0,2,3
1364,3,4,1,0,3,1
128999,8,28,5,0,23,5
128999,7,15,3,0,12,3
128999,6,11,3,0,8,3
128999,5,3,1,0,2,1
257834,9,4,1,0,3,1
257834,8,8,1,0,7,1
257834,7,20,2,0,18,2
257834,6,22,1,0,21,1
257834,2,3,2,0,1,2
203584,10,14,3,0,11,3
203584,9,8,3,0,5,3
203584,8,16,3,0,13,3
203584,7,19,4,0,15,4
203584,6,7,1,0,6,1
225645,10,8,5,0,3,5
225645,9,16,10,0,6,10
225645,8,14,7,0,7,7
225645,7,9,1,0,8,1
225645,6,7,2,0,5,2
225645,4,6,1,0,5,1
225645,3,2,1,0,1,1
8903,8,5,1,0,4,1
8903,7,6,2,0,4,2
8903,6,29,11,0,18,11
8903,5,9,1,0,8,1
8903,4,11,3,0,8,3
8903,3,2,2,0,0,2
8903,2,3,1,0,2,1
8903,1,1,1,0,0,1
148000,10,3,1,0,2,1
148000,9,4,3,0,1,3
148000,8,19,8,0,11,8
148000,7,16,4,0,12,4
148000,6,18,5,0,13,5
148000,5,7,2,0,5,2
148000,2,2,1,0,1,1
3825,10,1,1,0,0,1
3825,9,8,4,0,4,4
3825,8,10,3,0,7,3
3825,7,14,6,0,8,6
3825,6,16,11,0,5,11
3825,5,12,5,0,7,5
3825,4,5,3,0,2,3
3825,3,1,1,0,0,1
6702,7,13,5,0,8,5
6702,6,17,4,0,13,4
6702,5,12,1,0,11,1
6702,4,9,3,0,6,3
6702,3,8,3,0,5,3
6702,2,2,1,0,1,1
6702,1,2,2,0,0,2
2656,8,3,1,0,2,1
2656,7,5,3,0,2,3
2656,6,21,8,0,13,8
2656,5,16,2,0,14,2
2656,4,8,2,0,6,2
2656,3,11,5,0,6,5
24127,9,2,1,0,1,1
24127,8,12,4,0,8,4
24127,7,10,6,0,4,6
24127,6,20,7,0,13,7
24127,5,11,2,0,9,2
24127,4,6,3,0,3,3
24127,3,2,1,0,1,1
3067,10,3,2,0,1,2
3067,9,2,2,0,0,2
3067,8,13,2,0,11,2
3067,7,14,6,0,8,6
3067,6,9,3,0,6,3
3067,5,16,2,0,14,2
3067,4,5,1,0,4,1
3067,3,3,2,0,1,2
3067,2,2,2,0,0,2
3067,1,1,1,0,0,1
2839,8,1,1,0,0,1
2839,7,13,4,0,9,4
2839,6,32,5,0,27,5
2839,5,14,3,0,11,3
2839,1,1,1,0,0,1
2405,10,1,1,0,0,1
2405,9,8,5,0,3,5
2405,8,6,3,0,3,3
2405,7,24,7,0,17,7
2405,6,12,4,0,8,4
2405,5,7,4,0,3,4
2405,4,5,2,0,3,2
2405,3,4,2,0,2,2
173093,10,8,1,1,7,0
173093,9,5,2,0,3,2
173093,8,11,3,0,8,3
173093,7,10,4,0,6,4
173093,4,5,3,1,2,2
173093,3,8,3,1,5,2
173093,2,2,1,0,1,1
173093,1,3,2,0,1,2
1013,8,12,2,0,10,2
1013,7,25,12,0,13,12
1013,6,18,7,0,11,7
1013,5,5,2,0,3,2
1013,3,3,1,0,2,1
14585,8,10,2,0,8,2
14585,7,12,3,0,9,3
14585,6,18,5,0,13,5
14585,5,10,2,0,8,2
14585,4,10,1,0,9,1
14585,3,3,1,0,2,1
14585,2,1,1,0,0,1
27712,8,4,1,0,3,1
27712,6,23,2,0,21,2
27712,4,5,2,0,3,2
109285,10,4,1,0,3,1
109285,9,11,2,0,9,2
109285,8,16,6,0,10,6
109285,7,14,4,0,10,4
109285,6,16,4,0,12,4
109285,4,3,1,0,2,1
109285,3,3,3,0,0,3
109285,1,1,1,0,0,1
3051,10,1,1,0,0,1
3051,8,16,7,0,9,7
3051,7,15,6,0,9,6
3051,6,18,10,0,8,10
3051,5,8,4,0,4,4
3051,4,2,1,0,1,1
3051,1,2,1,0,1,1
94375,10,5,4,0,1,4
94375,9,7,4,0,3,4
94375,8,23,9,0,14,9
94375,7,13,5,0,8,5
94375,6,10,4,0,6,4
94375,5,4,1,0,3,1
94375,4,1,1,0,0,1
94375,3,3,2,0,1,2
94375,2,2,2,0,0,2
5265,8,5,1,0,4,1
5265,7,14,7,0,7,7
5265,6,13,3,0,10,3
5265,5,15,7,0,8,7
5265,4,5,1,0,4,1
5265,3,9,4,0,5,4
5265,2,2,1,0,1,1
206757,10,11,7,1,4,6
206757,9,17,8,0,9,8
206757,8,28,15,2,13,13
206757,7,10,3,0,7,3
163144,7,10,4,0,6,4
163144,6,23,5,0,18,5
163144,5,14,4,0,10,4
163144,4,4,1,0,3,1
163144,2,4,2,0,2,2
163144,1,2,2,0,0,2
32996,8,6,2,0,4,2
32996,7,13,2,0,11,2
32996,6,17,4,0,13,4
32996,5,11,1,0,10,1
32996,4,13,4,0,9,4
32996,3,2,2,0,0,2
32996,2,2,2,0,0,2
32996,1,3,1,0,2,1
256479,8,4,2,0,2,2
256479,7,11,1,0,10,1
256479,5,13,1,0,12,1
256479,1,3,2,0,1,2
209450,9,7,2,0,5,2
209450,7,20,5,0,15,5
209450,6,25,5,0,20,5
76487,10,2,2,0,0,2
76487,8,9,1,0,8,1
76487,7,22,3,0,19,3
76487,6,17,2,0,15,2
76487,5,6,2,0,4,2
76487,4,6,5,0,1,5
76487,3,4,1,0,3,1
1008,8,6,5,0,1,5
1008,7,8,3,0,5,3
1008,6,26,5,0,21,5
1008,5,14,3,0,11,3
1008,4,9,1,0,8,1
1008,3,5,3,0,2,3
4568,8,3,1,0,2,1
4568,6,23,6,0,17,6
4568,5,17,4,0,13,4
4568,4,8,1,0,7,1
4568,3,3,1,0,2,1
197528,9,4,2,0,2,2
197528,8,24,6,0,18,6
197528,7,12,3,0,9,3
197528,6,17,3,0,14,3
197528,5,6,1,0,5,1
24988,7,7,6,0,1,6
24988,6,18,5,0,13,5
24988,5,21,9,0,12,9
24988,4,16,5,0,11,5
24988,3,4,1,0,3,1
24988,2,2,2,0,0,2
1718,10,1,1,0,0,1
1718,8,1,1,0,0,1
1718,6,12,3,0,9,3
1718,5,15,4,0,11,4
1718,4,11,5,0,6,5
1718,3,14,3,0,11,3
1718,2,9,6,0,3,6
33020,6,22,6,0,16,6
33020,5,11,2,0,9,2
33020,4,24,6,0,18,6
3698,8,4,3,0,1,3
3698,7,8,4,0,4,4
3698,6,24,7,0,17,7
3698,5,15,5,0,10,5
3698,4,10,3,0,7,3
3698,3,3,2,0,1,2
3698,2,2,1,0,1,1
257074,7,18,2,0,16,2
257074,6,15,2,0,13,2
257074,5,15,1,0,14,1
257074,3,4,2,0,2,2
257074,2,2,2,0,0,2
257074,1,1,1,0,0,1
1865,7,5,1,0,4,1
1865,6,17,1,0,16,1
1865,5,12,3,0,9,3
1865,4,13,1,0,12,1
1865,3,9,1,0,8,1
1865,2,9,1,0,8,1
99313,10,7,4,0,3,4
99313,9,19,6,0,13,6
99313,8,19,6,0,13,6
99313,7,14,4,0,10,4
99313,6,5,2,0,3,2
99313,3,2,1,0,1,1
99313,1,1,1,0,0,1
7635,10,5,2,0,3,2
7635,9,6,2,0,4,2
7635,8,11,5,0,6,5
7635,7,28,7,0,21,7
7635,6,11,3,0,8,3
7635,5,7,2,0,5,2
1531,8,2,2,0,0,2
1531,7,4,1,0,3,1
1531,6,12,3,0,9,3
1531,5,18,4,0,14,4
1531,4,10,2,0,8,2
1531,3,10,3,0,7,3
1531,2,6,1,0,5,1
1531,1,6,4,0,2,4
130548,9,5,1,0,4,1
130548,8,16,2,0,14,2
130548,6,18,2,0,16,2
130548,5,5,2,0,3,2
179600,9,5,3,0,2,3
179600,8,15,1,0,14,1
179600,7,15,6,0,9,6
179600,6,9,2,0,7,2
179600,5,8,1,0,7,1
179600,3,7,1,1,6,0
179600,2,3,1,0,2,1
120000,10,4,1,0,3,1
120000,9,5,1,0,4,1
120000,8,5,3,0,2,3
120000,7,14,2,0,12,2
120000,6,17,5,0,12,5
120000,5,6,1,0,5,1
120000,4,4,1,0,3,1
120000,1,9,2,0,7,2
228740,10,7,4,0,3,4
228740,9,1,1,0,0,1
228740,8,9,3,0,6,3
228740,7,10,1,0,9,1
228740,6,17,3,0,14,3
228740,5,7,1,0,6,1
228740,4,7,2,0,5,2
228740,3,9,3,0,6,3
169555,9,9,4,0,5,4
169555,8,17,4,0,13,4
169555,7,15,4,0,11,4
169555,6,14,3,0,11,3
169555,2,3,3,0,0,3
169555,1,1,1,0,0,1
9194,8,12,1,0,11,1
9194,7,12,2,0,10,2
9194,6,20,2,0,18,2
9194,5,10,2,0,8,2
9194,3,4,1,0,3,1
688,10,2,1,0,1,1
688,8,7,4,0,3,4
688,7,15,9,0,6,9
688,6,16,8,0,8,8
688,5,12,4,0,8,4
688,4,13,1,0,12,1
688,3,2,1,0,1,1
174517,8,20,3,0,17,3
174517,7,17,1,0,16,1
174517,6,12,2,0,10,2
174517,5,4,1,0,3,1
265226,10,12,7,4,5,3
265226,9,32,17,2,15,15
265226,8,12,1,0,11,1
265226,7,6,1,0,5,1
265226,6,5,1,0,4,1
265226,2,1,1,0,0,1
208,8,1,1,0,0,1
208,7,8,2,0,6,2
208,6,27,6,0,21,6
208,5,19,2,0,17,2
208,4,9,2,0,7,2
208,3,2,1,0,1,1
208,2,2,1,0,1,1
18867,10,16,8,0,8,8
18867,9,9,6,0,3,6
18867,8,14,9,0,5,9
18867,7,8,4,0,4,4
18867,6,14,5,0,9,5
18867,5,4,3,0,1,3
18867,4,2,2,0,0,2
116422,7,3,2,0,1,2
116422,6,17,5,0,12,5
116422,5,17,1,0,16,1
116422,4,14,2,0,12,2
116422,3,10,7,0,3,7
116422,2,5,2,0,3,2
6701,8,2,1,0,1,1
6701,7,14,4,0,10,4
6701,6,23,6,0,17,6
6701,4,6,1,0,5,1
6701,3,7,3,0,4,3
6701,2,2,2,0,0,2
151847,9,2,1,0,1,1
151847,8,4,1,0,3,1
151847,7,7,2,0,5,2
151847,6,24,3,0,21,3
151847,5,12,3,0,9,3
151847,4,9,3,0,6,3
151847,2,3,3,0,0,3
8042,9,2,1,0,1,1
8042,8,12,2,0,10,2
8042,7,15,3,0,12,3
8042,6,22,7,0,15,7
8042,5,9,1,0,8,1
8042,4,4,2,0,2,2
8042,1,2,1,0,1,1
40083,8,3,1,0,2,1
40083,6,30,4,0,26,4
40083,5,15,6,0,9,6
40083,4,5,2,0,3,2
40083,3,2,1,0,1,1
63067,10,7,1,0,6,1
63067,9,2,1,0,1,1
63067,8,6,2,0,4,2
63067,7,8,2,0,6,2
63067,6,16,3,0,13,3
63067,5,13,2,0,11,2
63067,4,11,6,1,5,5
63067,2,2,1,0,1,1
201281,9,7,2,0,5,2
201281,8,11,2,0,9,2
201281,7,21,8,0,13,8
201281,6,18,5,0,13,5
201281,5,6,4,0,2,4
201281,4,4,3,0,1,3
30820,7,7,2,0,5,2
30820,6,17,3,0,14,3
30820,5,22,5,0,17,5
30820,4,12,4,0,8,4
30820,3,4,1,0,3,1
30820,2,3,2,0,1,2
212378,9,2,1,0,1,1
212378,8,12,2,0,10,2
212378,7,22,4,0,18,4
212378,6,20,2,0,18,2
212378,4,5,3,0,2,3
199689,8,16,1,0,15,1
199689,7,12,3,0,9,3
199689,6,19,1,0,18,1
199689,4,4,1,0,3,1
199689,3,3,1,0,2,1
193831,7,14,3,0,11,3
193831,6,25,3,0,22,3
193831,5,9,2,0,7,2
193831,4,5,1,0,4,1
247191,9,4,1,0,3,1
247191,8,9,2,0,7,2
247191,7,20,4,0,16,4
247191,6,29,4,0,25,4
10506,10,2,1,0,1,1
10506,8,3,1,0,2,1
10506,7,4,1,0,3,1
10506,6,13,2,0,11,2
10506,5,15,2,0,13,2
10506,4,10,2,0,8,2
10506,3,10,1,0,9,1
10506,2,4,1,0,3,1
41006,10,3,1,0,2,1
41006,9,7,2,0,5,2
41006,8,24,7,0,17,7
41006,7,22,7,0,15,7
41006,6,6,4,0,2,4
41006,5,3,3,0,0,3
41006,3,1,1,0,0,1
149618,9,10,3,0,7,3
149618,7,15,2,0,13,2
149618,6,10,2,0,8,2
149618,5,3,1,0,2,1
149618,4,5,2,0,3,2
149618,2,1,1,0,0,1
3210,9,2,1,0,1,1
3210,8,15,6,0,9,6
3210,7,16,6,0,10,6
3210,6,21,6,0,15,6
3210,5,10,3,0,7,3
3210,4,2,1,0,1,1
165447,9,2,1,0,1,1
165447,8,7,3,0,4,3
165447,7,14,3,0,11,3
165447,6,22,3,0,19,3
165447,5,10,1,0,9,1
165447,4,6,1,0,5,1
165447,2,2,1,0,1,1
5018,7,5,1,0,4,1
5018,6,12,3,0,9,3
5018,5,11,4,0,7,4
5018,4,18,10,0,8,10
5018,3,7,2,0,5,2
5018,2,8,3,0,5,3
5018,1,3,2,0,1,2
13128,6,22,5,0,17,5
13128,5,17,5,0,12,5
13128,4,18,6,0,12,6
13128,3,4,2,0,2,2
9319,9,3,2,0,1,2
9319,8,1,1,0,0,1
9319,7,13,6,0,7,6
9319,6,23,3,0,20,3
9319,5,12,2,0,10,2
9319,4,7,4,0,3,4
9319,3,7,5,0,2,5
9319,2,1,1,0,0,1
26999,9,2,1,0,1,1
26999,8,13,8,0,5,8
26999,7,23,8,0,15,8
26999,6,18,6,0,12,6
26999,5,6,1,0,5,1
26999,4,3,1,0,2,1
26999,3,1,1,0,0,1
5964,9,5,2,0,3,2
5964,8,11,3,0,8,3
5964,7,12,2,0,10,2
5964,6,16,7,0,9,7
5964,5,13,3,0,10,3
5964,4,5,2,0,3,2
5964,3,3,1,0,2,1
133337,8,5,2,0,3,2
133337,6,26,5,0,21,5
133337,5,13,1,0,12,1
133337,4,8,3,0,5,3
133337,3,3,1,0,2,1
133337,2,2,1,0,1,1
7329,10,3,1,0,2,1
7329,8,5,3,0,2,3
7329,7,8,3,0,5,3
7329,6,11,1,0,10,1
7329,5,20,7,0,13,7
7329,4,15,4,0,11,4
7329,3,2,1,0,1,1
7329,2,2,1,0,1,1
26137,7,5,2,0,3,2
26137,6,13,3,0,10,3
26137,5,13,3,0,10,3
26137,4,11,3,0,8,3
26137,3,6,1,0,5,1
26137,2,7,2,0,5,2
26137,1,7,3,0,4,3
202477,9,2,1,0,1,1
202477,8,11,2,0,9,2
202477,7,22,2,0,20,2
202477,6,16,2,0,14,2
202477,5,9,1,0,8,1
124758,10,1,1,0,0,1
124758,7,8,2,0,6,2
124758,6,26,7,0,19,7
124758,5,11,2,0,9,2
124758,4,8,1,0,7,1
124758,3,3,1,0,2,1
124758,2,4,2,0,2,2
124758,1,3,1,0,2,1
161913,10,3,1,0,2,1
161913,9,3,2,0,1,2
161913,8,9,2,0,7,2
161913,7,16,3,0,13,3
161913,6,24,4,0,20,4
161913,5,7,4,0,3,4
161913,4,3,1,0,2,1
161913,2,2,1,0,1,1
18563,8,3,1,0,2,1
18563,7,16,6,0,10,6
18563,6,24,4,0,20,4
18563,5,11,3,0,8,3
18563,4,4,2,0,2,2
18563,3,8,3,0,5,3
254230,10,10,9,0,1,9
254230,9,6,1,0,5,1
254230,8,18,5,0,13,5
254230,6,9,1,0,8,1
254230,4,2,1,0,1,1
254230,2,4,1,0,3,1
254230,1,3,1,0,2,1
209344,10,6,1,0,5,1
209344,9,5,3,0,2,3
209344,8,7,1,0,6,1
209344,7,14,4,0,10,4
209344,6,14,4,0,10,4
209344,5,9,4,0,5,4
209344,4,9,4,1,5,3
209344,3,1,1,0,0,1
209344,2,1,1,0,0,1
103077,7,9,1,0,8,1
103077,6,19,5,0,14,5
103077,4,11,3,0,8,3
103077,3,2,1,0,1,1
8283,9,3,1,0,2,1
8283,8,9,3,0,6,3
8283,7,15,5,0,10,5
8283,6,22,4,0,18,4
8283,5,7,2,0,5,2
8283,4,9,4,0,5,4
8283,3,1,1,0,0,1
5054,8,6,3,0,3,3
5054,7,14,6,0,8,6
5054,6,18,8,0,10,8
5054,5,10,1,0,9,1
5054,4,12,4,0,8,4
5054,1,2,2,0,0,2
151078,8,7,1,0,6,1
151078,7,16,4,0,12,4
151078,6,22,2,0,20,2
151078,5,10,1,0,9,1
151078,4,8,2,0,6,2
151078,3,3,1,0,2,1
84864,9,5,2,0,3,2
84864,7,19,3,0,16,3
84864,6,19,4,0,15,4
84864,5,10,3,0,7,3
84864,4,4,2,0,2,2
84864,3,1,1,0,0,1
84864,2,1,1,0,0,1
120269,10,16,11,0,5,11
120269,9,21,7,0,14,7
120269,8,20,5,0,15,5
120269,7,7,3,0,4,3
120269,6,2,1,0,1,1
42101,10,7,2,0,5,2
42101,9,13,5,0,8,5
42101,8,19,6,0,13,6
42101,7,13,5,0,8,5
42101,6,8,1,0,7,1
2806,9,4,2,0,2,2
2806,8,2,1,0,1,1
2806,7,11,6,0,5,6
2806,6,18,6,0,12,6
2806,5,15,7,0,8,7
2806,4,6,2,0,4,2
2806,3,6,1,0,5,1
2806,1,2,2,0,0,2
96608,8,7,1,0,6,1
96608,7,4,2,0,2,2
96608,6,29,2,0,27,2
96608,3,2,1,0,1,1
160560,10,1,1,0,0,1
160560,9,3,1,0,2,1
160560,8,12,3,1,9,2
160560,7,17,3,0,14,3
160560,6,23,5,1,18,4
160560,4,3,1,0,2,1
3290,9,3,1,0,2,1
3290,8,5,2,0,3,2
3290,7,10,2,0,8,2
3290,6,21,4,0,17,4
3290,5,9,3,0,6,3
3290,4,7,1,0,6,1
3290,3,7,3,0,4,3
3290,2,3,2,0,1,2
3290,1,2,1,0,1,1
8803,8,8,1,0,7,1
8803,7,18,8,0,10,8
8803,6,21,9,0,12,9
8803,5,8,5,0,3,5
8803,4,9,5,0,4,5
8803,2,1,1,0,0,1
183720,9,5,2,0,3,2
183720,8,13,2,0,11,2
183720,7,12,1,0,11,1
183720,5,13,2,0,11,2
183720,4,3,1,0,2,1
183720,2,1,1,0,0,1
11111,10,6,4,0,2,4
11111,9,13,5,0,8,5
11111,8,23,8,0,15,8
11111,7,10,4,0,6,4
11111,6,10,2,0,8,2
153516,7,10,2,0,8,2
153516,6,30,4,0,26,4
1271,8,13,7,0,6,7
1271,7,26,9,0,17,9
1271,6,18,3,0,15,3
1271,5,4,1,0,3,1
1271,4,3,2,0,1,2
100447,8,6,1,0,5,1
100447,7,17,4,0,13,4
100447,6,24,3,0,21,3
4373,7,5,1,0,4,1
4373,6,15,6,0,9,6
4373,5,21,4,0,17,4
4373,4,12,3,0,9,3
4373,3,5,1,0,4,1
4373,2,4,3,0,1,3
4373,1,3,2,0,1,2
29010,8,2,1,0,1,1
29010,7,8,3,0,5,3
29010,6,20,8,0,12,8
29010,5,20,7,0,13,7
29010,4,7,1,0,6,1
29010,3,5,2,0,3,2
29010,2,2,1,0,1,1
125832,9,5,3,0,2,3
125832,7,10,2,0,8,2
125832,6,15,3,0,12,3
125832,4,4,1,0,3,1
125832,3,5,1,0,4,1
125832,2,5,1,0,4,1
125832,1,2,1,0,1,1
26106,6,14,6,0,8,6
26106,5,17,6,0,11,6
26106,4,16,2,0,14,2
26106,3,9,3,0,6,3
26106,2,7,1,0,6,1
139807,9,5,1,0,4,1
139807,8,11,3,0,8,3
139807,7,14,2,0,12,2
139807,6,26,3,0,23,3
139807,5,8,5,0,3,5
140693,10,4,2,1,2,1
140693,9,5,1,1,4,0
140693,8,10,5,0,5,5
140693,7,18,6,0,12,6
140693,6,17,4,0,13,4
140693,5,10,1,0,9,1
33812,10,1,1,0,0,1
33812,9,1,1,0,0,1
33812,8,11,7,0,4,7
33812,7,14,10,0,4,10
33812,6,28,9,0,19,9
33812,5,6,3,0,3,3
33812,4,5,3,0,2,3
33812,3,1,1,0,0,1
166661,7,9,2,0,7,2
166661,6,20,3,0,17,3
166661,5,9,4,0,5,4
166661,4,16,6,0,10,6
166661,3,7,4,0,3,4
166661,2,2,1,0,1,1
257667,10,5,1,0,4,1
257667,9,5,1,0,4,1
257667,8,20,5,0,15,5
257667,7,20,3,0,17,3
257667,6,11,3,0,8,3
257667,5,5,3,0,2,3
146245,10,3,1,0,2,1
146245,9,6,1,0,5,1
146245,8,9,4,0,5,4
146245,7,13,2,0,11,2
146245,6,15,4,0,11,4
146245,5,6,1,0,5,1
146245,4,11,4,0,7,4
6942,10,5,3,0,2,3
6942,9,5,1,0,4,1
6942,8,12,6,0,6,6
6942,7,18,7,0,11,7
6942,6,14,5,0,9,5
6942,5,8,1,0,7,1
6942,4,3,1,0,2,1
6942,2,2,1,0,1,1
228409,10,7,2,0,5,2
228409,9,11,3,0,8,3
228409,8,25,5,0,20,5
228409,7,13,2,0,11,2
228409,5,2,1,0,1,1
174231,8,18,1,0,17,1
174231,7,13,2,1,11,1
174231,6,12,3,0,9,3
174231,3,1,1,1,0,0
257669,8,16,3,0,13,3
257669,7,18,2,0,16,2
257669,6,19,3,0,16,3
257669,5,7,1,0,6,1
3161,8,7,2,0,5,2
3161,7,11,4,0,7,4
3161,6,32,10,0,22,10
3161,5,8,1,0,7,1
10916,9,10,1,0,9,1
10916,8,13,3,0,10,3
10916,7,17,4,0,13,4
10916,6,15,3,0,12,3
10916,5,6,2,0,4,2
10916,4,1,1,0,0,1
10916,3,3,1,0,2,1
10916,2,2,1,0,1,1
7944,9,1,1,0,0,1
7944,8,3,2,0,1,2
7944,7,7,5,0,2,5
7944,6,27,5,0,22,5
7944,5,13,2,0,11,2
7944,4,3,1,0,2,1
7944,3,8,4,0,4,4
7944,2,3,1,0,2,1
231954,5,13,1,0,12,1
231954,4,11,3,0,8,3
231954,3,11,3,0,8,3
231954,2,10,3,0,7,3
231954,1,5,1,0,4,1
218235,9,4,2,0,2,2
218235,8,9,2,0,7,2
218235,7,11,1,0,10,1
218235,6,21,2,0,19,2
218235,5,9,3,0,6,3
218235,4,10,1,0,9,1
200500,9,2,1,0,1,1
200500,8,13,4,2,9,2
200500,7,21,6,3,15,3
200500,6,21,5,2,16,3
17157,10,2,1,0,1,1
17157,8,7,3,0,4,3
17157,7,14,5,0,9,5
17157,6,27,7,0,20,7
17157,5,10,3,0,7,3
17157,4,6,4,0,2,4
17157,3,1,1,0,0,1
127533,6,6,4,0,2,4
127533,5,20,5,0,15,5
127533,4,13,4,0,9,4
127533,3,9,1,0,8,1
127533,2,9,5,0,4,5
127533,1,8,5,0,3,5
148730,8,10,3,0,7,3
148730,7,27,6,0,21,6
148730,6,21,1,0,20,1
270673,10,1,1,0,0,1
270673,9,9,1,0,8,1
270673,8,23,3,0,20,3
270673,7,21,3,0,18,3
205506,8,10,3,0,7,3
205506,7,16,2,0,14,2
205506,6,22,3,0,19,3
205506,5,14,1,0,13,1
205790,8,12,4,0,8,4
205790,7,21,3,0,18,3
205790,6,17,5,0,12,5
205790,4,5,1,0,4,1
46800,8,6,3,0,3,3
46800,7,10,3,0,7,3
46800,6,27,7,0,20,7
46800,4,7,4,0,3,4
46800,2,2,1,0,1,1
4310,8,4,3,0,1,3
4310,7,6,2,0,4,2
4310,6,18,8,0,10,8
4310,5,20,6,0,14,6
4310,4,12,3,0,9,3
4310,3,3,2,0,1,2
4310,2,3,2,0,1,2
33803,10,4,1,0,3,1
33803,8,10,6,0,4,6
33803,7,15,8,0,7,8
33803,6,17,12,0,5,12
33803,5,10,7,0,3,7
33803,4,4,1,0,3,1
33803,3,4,1,0,3,1
33803,2,2,2,0,0,2
205544,9,4,3,0,1,3
205544,8,15,3,1,12,2
205544,7,23,4,0,19,4
205544,6,12,1,0,11,1
205544,5,4,1,0,3,1
205544,4,2,1,0,1,1
205544,3,3,1,0,2,1
205544,1,1,1,0,0,1
223322,9,9,5,1,4,4
223322,8,13,1,0,12,1
223322,7,10,1,0,9,1
223322,6,26,7,1,19,6
223322,5,4,1,0,3,1
223322,3,1,1,0,0,1
169987,8,4,1,0,3,1
169987,6,15,8,0,7,8
169987,5,16,5,0,11,5
169987,4,11,2,0,9,2
169987,3,9,3,0,6,3
169987,1,5,2,0,3,2
118568,9,4,1,0,3,1
118568,8,12,2,0,10,2
118568,7,27,7,0,20,7
118568,5,8,2,0,6,2
31794,8,4,1,0,3,1
31794,5,18,3,0,15,3
31794,4,13,1,0,12,1
31794,2,3,1,0,2,1
11826,9,1,1,0,0,1
11826,8,5,3,0,2,3
11826,7,10,2,0,8,2
11826,6,17,5,0,12,5
11826,5,9,2,0,7,2
11826,4,16,7,0,9,7
11826,3,7,6,0,1,6
11826,2,1,1,0,0,1
11826,1,1,1,0,0,1
1599,10,1,1,0,0,1
1599,8,5,3,0,2,3
1599,7,12,5,0,7,5
1599,6,23,5,0,18,5
1599,5,14,3,0,11,3
1599,4,4,1,0,3,1
1599,3,7,3,0,4,3
219359,8,9,2,0,7,2
219359,7,12,1,0,11,1
219359,6,22,5,0,17,5
219359,5,9,1,0,8,1
219359,3,7,1,0,6,1
142980,9,1,1,0,0,1
142980,8,9,1,0,8,1
142980,7,25,7,0,18,7
142980,6,15,1,0,14,1
142980,5,9,1,0,8,1
174975,9,1,1,0,0,1
174975,8,11,1,0,10,1
174975,7,18,5,0,13,5
174975,6,19,5,0,14,5
174975,5,8,1,0,7,1
174975,4,7,1,0,6,1
174975,3,3,1,0,2,1
181574,10,1,1,0,0,1
181574,9,1,1,0,0,1
181574,8,5,3,0,2,3
181574,7,17,9,1,8,8
181574,6,27,3,0,24,3
181574,5,11,1,0,10,1
181574,4,5,1,0,4,1
214879,10,5,2,0,3,2
214879,9,2,1,0,1,1
214879,8,13,4,0,9,4
214879,7,21,4,0,17,4
214879,6,17,2,0,15,2
214879,5,4,2,0,2,2
214879,4,2,1,0,1,1
193301,8,9,2,0,7,2
193301,7,6,5,0,1,5
193301,6,22,3,0,19,3
193301,5,18,1,0,17,1
193301,4,8,3,0,5,3
193301,3,2,1,0,1,1
193301,2,1,1,0,0,1
182259,9,6,2,0,4,2
182259,8,12,2,0,10,2
182259,7,11,1,0,10,1
182259,6,17,2,0,15,2
182259,5,8,1,0,7,1
182259,2,1,1,0,0,1
169045,9,1,1,0,0,1
169045,8,3,1,0,2,1
169045,7,7,2,0,5,2
169045,6,20,6,0,14,6
169045,5,18,6,0,12,6
169045,4,12,2,0,10,2
163186,10,3,1,0,2,1
163186,9,4,1,0,3,1
163186,8,16,6,0,10,6
163186,7,11,1,0,10,1
163186,6,19,2,0,17,2
163186,5,7,1,0,6,1
163186,3,4,2,0,2,2
164702,10,31,10,0,21,10
164702,9,16,6,0,10,6
164702,8,6,1,0,5,1
164702,7,5,1,0,4,1
164702,5,3,1,0,2,1
164702,1,2,1,0,1,1
96061,9,4,2,0,2,2
96061,8,30,10,0,20,10
96061,7,21,7,0,14,7
96061,5,3,2,0,1,2
96061,3,1,1,0,0,1
155494,7,7,2,0,5,2
155494,6,19,3,0,16,3
155494,5,12,2,1,10,1
155494,4,8,3,1,5,2
155494,3,3,2,1,1,1
155494,2,4,2,0,2,2
155494,1,4,3,0,1,3
28063,10,1,1,0,0,1
28063,7,8,1,0,7,1
28063,6,21,6,0,15,6
28063,5,18,1,0,17,1
28063,4,8,2,0,6,2
28063,3,6,3,0,3,3
28063,2,2,1,0,1,1
4518,8,7,2,0,5,2
4518,7,12,3,0,9,3
4518,6,25,4,0,21,4
4518,4,8,2,0,6,2
4518,2,2,1,0,1,1
8736,9,3,3,0,0,3
8736,8,11,5,0,6,5
8736,7,26,13,0,13,13
8736,6,18,4,0,14,4
8736,5,4,1,0,3,1
8736,3,3,2,0,1,2
5181,8,1,1,0,0,1
5181,7,6,4,0,2,4
5181,6,20,5,0,15,5
5181,5,14,5,0,9,5
5181,4,10,4,0,6,4
5181,3,9,6,0,3,6
5181,2,4,4,0,0,4
5181,1,1,1,0,0,1
124991,9,13,5,0,8,5
124991,8,26,7,0,19,7
124991,7,15,4,0,11,4
124991,6,4,2,0,2,2
124991,4,3,2,0,1,2
19552,7,11,6,0,5,6
19552,6,15,4,0,11,4
19552,5,17,7,0,10,7
19552,4,6,2,0,4,2
19552,3,6,3,0,3,3
19552,2,1,1,0,0,1
19552,1,3,1,0,2,1
237860,10,40,34,0,6,34
237860,9,2,1,0,1,1
237860,8,13,9,0,4,9
237860,7,5,1,0,4,1
237860,6,5,2,0,3,2
237860,5,2,1,0,1,1
218632,9,2,1,0,1,1
218632,8,12,3,0,9,3
218632,7,13,1,0,12,1
218632,6,14,2,0,12,2
218632,5,12,2,0,10,2
43332,9,3,1,0,2,1
43332,8,18,8,0,10,8
43332,7,20,3,0,17,3
43332,6,17,7,0,10,7
43332,5,6,2,0,4,2
38001,8,3,1,0,2,1
38001,6,15,1,0,14,1
38001,5,13,2,0,11,2
38001,3,8,1,0,7,1
38001,2,7,3,0,4,3
38001,1,4,1,0,3,1
3275,10,7,3,0,4,3
3275,9,11,4,0,7,4
3275,8,18,4,0,14,4
3275,7,10,1,0,9,1
3275,6,13,2,0,11,2
3275,2,1,1,0,0,1
19540,9,2,1,0,1,1
19540,8,6,4,0,2,4
19540,7,15,4,0,11,4
19540,6,28,8,0,20,8
19540,5,4,1,0,3,1
19540,4,8,4,0,4,4
19540,3,3,1,0,2,1
19540,2,1,1,0,0,1
156648,7,11,1,0,10,1
156648,6,16,2,0,14,2
156648,5,11,3,0,8,3
156648,4,13,3,0,10,3
156648,3,5,1,0,4,1
156648,2,2,1,0,1,1
156648,1,4,1,0,3,1
106978,10,11,6,0,5,6
106978,9,11,4,0,7,4
106978,8,18,8,0,10,8
106978,7,14,1,0,13,1
106978,6,7,2,0,5,2
106978,5,5,1,0,4,1
106978,3,1,1,0,0,1
29,9,7,2,0,5,2
29,8,13,3,0,10,3
29,7,15,1,0,14,1
29,6,20,3,0,17,3
29,5,6,1,0,5,1
29,4,5,2,0,3,2
610,7,7,2,0,5,2
610,6,16,7,0,9,7
610,5,16,3,0,13,3
610,4,11,2,0,9,2
610,3,9,2,0,7,2
610,2,6,3,0,3,3
11110,9,4,3,0,1,3
11110,8,12,3,0,9,3
11110,7,14,2,0,12,2
11110,6,20,6,0,14,6
11110,5,11,3,0,8,3
11110,4,4,2,0,2,2
11110,3,1,1,0,0,1
22035,7,6,2,0,4,2
22035,6,24,7,0,17,7
22035,5,14,4,0,10,4
22035,4,7,2,0,5,2
22035,2,3,2,0,1,2
22035,1,2,1,0,1,1
11414,10,2,1,0,1,1
11414,9,4,3,0,1,3
11414,8,7,3,0,4,3
11414,6,14,5,0,9,5
11414,5,12,5,0,7,5
11414,4,10,4,0,6,4
11414,3,4,1,0,3,1
11414,2,5,3,0,2,3
14451,10,9,5,0,4,5
14451,9,3,2,0,1,2
14451,8,20,8,0,12,8
14451,7,11,2,0,9,2
14451,6,11,2,0,9,2
14451,5,7,2,0,5,2
14451,4,3,1,0,2,1
14451,2,2,1,0,1,1
40455,10,7,1,0,6,1
40455,9,11,2,0,9,2
40455,8,16,5,0,11,5
40455,7,13,3,0,10,3
40455,6,12,6,0,6,6
40455,5,3,2,0,1,2
40455,4,3,2,0,1,2
74936,7,6,1,0,5,1
74936,6,18,2,0,16,2
74936,5,13,2,0,11,2
74936,4,10,2,0,8,2
74936,3,8,3,0,5,3
156101,10,3,1,0,2,1
156101,9,4,1,0,3,1
156101,8,25,7,0,18,7
156101,7,17,2,0,15,2
156101,6,11,1,0,10,1
113070,10,6,3,0,3,3
113070,9,6,4,1,2,3
113070,8,6,2,0,4,2
113070,6,11,3,0,8,3
113070,5,4,2,0,2,2
113070,4,11,2,0,9,2
113070,3,5,1,0,4,1
113070,2,7,5,1,2,4
132717,6,25,4,0,21,4
132717,5,15,3,0,12,3
132717,2,1,1,0,0,1
1122,8,7,3,0,4,3
1122,7,9,2,0,7,2
1122,6,20,6,0,14,6
1122,5,10,4,0,6,4
1122,4,7,3,0,4,3
1122,3,7,4,0,3,4
1122,2,4,2,0,2,2
1122,1,2,1,0,1,1
139471,10,3,3,0,0,3
139471,8,20,9,3,11,6
139471,7,10,1,0,9,1
139471,6,8,2,0,6,2
139471,3,7,2,1,5,1
139471,2,2,1,0,1,1
234860,10,2,1,0,1,1
234860,9,8,1,0,7,1
234860,8,11,2,0,9,2
234860,7,27,1,0,26,1
234860,6,11,2,0,9,2
234860,1,1,1,0,0,1
54457,8,18,10,0,8,10
54457,7,27,11,0,16,11
54457,6,11,8,0,3,8
54457,5,6,2,0,4,2
1682,9,1,1,0,0,1
1682,8,5,2,0,3,2
1682,7,9,2,0,7,2
1682,6,29,8,0,21,8
1682,5,14,3,0,11,3
1682,4,6,3,0,3,3
1682,3,2,1,0,1,1
124372,8,6,1,0,5,1
124372,7,16,4,0,12,4
124372,6,22,3,0,19,3
124372,5,9,2,0,7,2
7248,9,1,1,0,0,1
7248,8,3,2,0,1,2
7248,7,8,3,0,5,3
7248,6,29,10,0,19,10
7248,5,11,5,0,6,5
7248,4,7,4,0,3,4
7248,3,6,2,0,4,2
4139,8,5,2,0,3,2
4139,7,12,4,0,8,4
4139,6,24,7,0,17,7
4139,5,14,2,0,12,2
4139,4,6,3,0,3,3
4139,3,3,1,0,2,1
13951,9,1,1,0,0,1
13951,8,3,2,0,1,2
13951,7,5,5,0,0,5
13951,6,19,8,0,11,8
13951,5,18,7,0,11,7
13951,4,11,7,0,4,7
13951,3,5,3,0,2,3
13951,2,3,1,0,2,1
84453,8,11,3,0,8,3
84453,7,12,3,0,9,3
84453,6,17,1,0,16,1
84453,5,17,6,0,11,6
84453,4,7,3,0,4,3
84453,3,2,1,0,1,1
137404,7,8,2,0,6,2
137404,6,25,3,0,22,3
137404,5,13,2,0,11,2
137404,4,12,2,0,10,2
137404,2,4,3,0,1,3
144346,8,7,2,0,5,2
144346,7,13,2,0,11,2
144346,6,18,1,0,17,1
144346,5,10,2,0,8,2
144346,4,8,4,0,4,4
144346,3,5,1,0,4,1
144346,2,3,2,0,1,2
158256,7,16,4,0,12,4
158256,6,18,3,0,15,3
158256,5,16,6,0,10,6
158256,3,3,1,0,2,1
158256,1,1,1,0,0,1
250539,9,1,1,0,0,1
250539,8,13,4,0,9,4
250539,7,22,4,0,18,4
250539,6,18,2,0,16,2
250539,5,5,2,0,3,2
250539,3,2,1,0,1,1
209014,10,3,2,0,1,2
209014,9,7,2,0,5,2
209014,8,9,2,0,7,2
209014,7,8,1,0,7,1
209014,6,19,5,0,14,5
209014,3,7,1,0,6,1
209014,1,2,1,0,1,1
224478,10,2,1,0,1,1
224478,9,4,3,0,1,3
224478,8,7,2,0,5,2
224478,6,23,6,0,17,6
224478,5,8,1,0,7,1
134255,8,2,1,0,1,1
134255,6,16,4,0,12,4
134255,5,17,5,0,12,5
134255,4,7,3,0,4,3
134255,3,11,5,0,6,5
8447,8,2,1,0,1,1
8447,7,8,2,0,6,2
8447,6,20,4,0,16,4
8447,5,13,4,0,9,4
8447,4,8,3,0,5,3
8447,3,8,4,0,4,4
8447,2,3,3,0,0,3
8447,1,2,2,0,0,2
1939,6,24,3,0,21,3
1939,5,17,6,0,11,6
1939,4,10,2,0,8,2
1939,3,3,1,0,2,1
9867,9,4,1,0,3,1
9867,8,23,6,0,17,6
9867,7,20,5,0,15,5
9867,6,9,1,0,8,1
9867,5,4,1,0,3,1
9867,4,1,1,0,0,1
8531,10,2,2,0,0,2
8531,9,5,3,0,2,3
8531,8,8,4,0,4,4
8531,7,9,2,0,7,2
8531,6,25,10,0,15,10
8531,5,12,3,0,9,3
8531,4,4,3,0,1,3
8531,3,1,1,0,0,1
194079,6,25,1,0,24,1
194079,5,15,4,0,11,4
194079,4,8,1,0,7,1
194079,2,1,1,0,0,1
276,10,4,2,0,2,2
276,9,2,2,0,0,2
276,8,12,4,0,8,4
276,7,10,3,0,7,3
276,6,20,7,0,13,7
276,5,8,2,0,6,2
276,4,8,1,0,7,1
8191,10,1,1,0,0,1
8191,8,2,1,0,1,1
8191,6,26,5,0,21,5
8191,5,17,10,0,7,10
8191,4,11,3,0,8,3
8191,3,3,2,0,1,2
8191,2,4,1,0,3,1
8191,1,1,1,0,0,1
151985,8,4,1,0,3,1
151985,7,18,1,0,17,1
151985,5,9,1,0,8,1
151985,4,8,1,0,7,1
146152,8,10,3,0,7,3
146152,7,15,3,0,12,3
146152,6,26,3,0,23,3
146152,5,9,2,0,7,2
146152,4,3,1,0,2,1
146152,3,1,1,0,0,1
4349,10,3,1,0,2,1
4349,9,3,2,0,1,2
4349,8,9,6,0,3,6
4349,7,16,4,0,12,4
4349,6,18,7,0,11,7
4349,5,9,4,0,5,4
16674,10,5,3,0,2,3
16674,9,2,1,0,1,1
16674,8,21,11,0,10,11
16674,7,14,6,0,8,6
16674,6,15,8,0,7,8
16674,5,6,5,0,1,5
16674,1,2,1,0,1,1
26250,10,7,2,0,5,2
26250,9,7,1,0,6,1
26250,8,14,6,0,8,6
26250,7,14,7,0,7,7
26250,6,15,8,0,7,8
26250,5,5,3,0,2,3
26250,3,1,1,0,0,1
26250,1,1,1,0,0,1
40514,8,3,1,0,2,1
40514,7,8,4,0,4,4
40514,6,20,6,0,14,6
40514,5,7,1,0,6,1
40514,4,17,3,0,14,3
40514,3,3,1,0,2,1
40514,2,4,1,0,3,1
194874,10,2,1,0,1,1
194874,9,4,1,0,3,1
194874,8,11,4,1,7,3
194874,7,12,2,0,10,2
194874,6,21,7,3,14,4
194874,5,9,2,0,7,2
194874,4,4,3,1,1,2
194874,3,2,2,0,0,2
31764,9,3,1,0,2,1
31764,8,8,2,0,6,2
31764,6,21,2,0,19,2
31764,5,13,3,0,10,3
31764,4,4,1,0,3,1
31764,2,1,1,0,0,1
6988,8,3,1,0,2,1
6988,6,19,5,0,14,5
6988,5,11,4,0,7,4
6988,4,7,2,0,5,2
6988,3,3,1,0,2,1
136286,7,8,4,0,4,4
136286,6,24,6,0,18,6
136286,5,15,2,0,13,2
136286,4,11,2,0,9,2
136286,3,3,2,0,1,2
62854,9,2,1,0,1,1
62854,8,4,2,0,2,2
62854,7,10,3,0,7,3
62854,6,11,4,0,7,4
62854,5,16,5,0,11,5
62854,4,12,4,0,8,4
62854,3,9,3,0,6,3
62854,2,1,1,0,0,1
176651,9,3,2,0,1,2
176651,8,10,2,0,8,2
176651,7,18,2,0,16,2
176651,6,13,4,0,9,4
176651,5,9,2,0,7,2
176651,4,4,1,0,3,1
176651,3,5,2,1,3,1
176651,2,2,1,0,1,1
179876,7,9,1,1,8,0
179876,6,22,5,0,17,5
179876,4,9,3,1,6,2
179876,3,3,1,0,2,1
179876,2,3,1,0,2,1
179876,1,2,1,0,1,1
10589,8,15,5,0,10,5
10589,7,18,7,0,11,7
10589,6,18,3,0,15,3
10589,5,4,2,0,2,2
10589,4,8,3,0,5,3
10589,3,1,1,0,0,1
10589,2,2,2,0,0,2
89931,7,6,2,0,4,2
89931,6,21,6,0,15,6
89931,5,19,1,0,18,1
89931,4,7,4,0,3,4
89931,3,9,3,0,6,3
124378,7,11,2,0,9,2
124378,6,24,6,0,18,6
124378,5,18,2,0,16,2
124378,4,6,2,0,4,2
11699,10,3,2,0,1,2
11699,9,2,2,0,0,2
11699,8,13,7,0,6,7
11699,7,26,9,0,17,9
11699,6,12,4,0,8,4
11699,5,5,1,0,4,1
11699,1,1,1,0,0,1
20192,7,11,4,0,7,4
20192,6,30,5,0,25,5
20192,5,15,6,0,9,6
20192,4,2,2,0,0,2
20192,3,4,2,0,2,2
6573,9,3,1,0,2,1
6573,8,3,1,0,2,1
6573,7,11,3,0,8,3
6573,6,24,3,0,21,3
6573,5,9,3,0,6,3
6573,4,10,1,0,9,1
6573,3,2,1,0,1,1
6573,2,4,2,0,2,2
245700,10,1,1,0,0,1
245700,9,5,1,0,4,1
245700,8,5,1,0,4,1
245700,7,19,3,0,16,3
245700,6,22,6,0,16,6
245700,5,7,1,0,6,1
245700,4,5,1,0,4,1
31066,9,1,1,0,0,1
31066,8,5,4,0,1,4
31066,7,6,3,0,3,3
31066,6,16,7,0,9,7
31066,5,24,11,0,13,11
31066,4,9,5,0,4,5
31066,3,2,1,0,1,1
31066,2,1,1,0,0,1
31066,1,2,1,0,1,1
249814,10,16,7,0,9,7
249814,9,6,3,0,3,3
249814,8,19,4,0,15,4
249814,7,18,1,0,17,1
249814,6,7,1,0,6,1
136566,8,6,1,0,5,1
136566,7,9,1,0,8,1
136566,6,27,8,0,19,8
136566,5,13,5,0,8,5
136566,4,5,2,0,3,2
136566,1,1,1,0,0,1
11283,8,15,8,0,7,8
11283,7,23,7,0,16,7
11283,6,13,5,0,8,5
11283,5,4,2,0,2,2
11283,4,3,2,0,1,2
11283,2,2,1,0,1,1
235252,10,4,2,0,2,2
235252,9,4,1,0,3,1
235252,7,12,2,0,10,2
235252,6,25,3,0,22,3
235252,4,7,2,0,5,2
235252,3,6,3,0,3,3
224986,9,4,2,0,2,2
224986,8,9,1,0,8,1
224986,7,14,1,0,13,1
224986,6,21,2,0,19,2
224986,5,14,1,0,13,1
224986,4,3,1,0,2,1
15211,10,2,1,0,1,1
15211,8,11,3,0,8,3
15211,7,14,5,0,9,5
15211,6,27,8,0,19,8
15211,5,7,4,0,3,4
15211,2,2,1,0,1,1
169246,10,4,2,0,2,2
169246,9,6,1,0,5,1
169246,8,15,6,0,9,6
169246,7,9,4,0,5,4
169246,6,16,2,0,14,2
169246,5,4,1,1,3,0
169246,4,5,1,0,4,1
169246,3,6,1,0,5,1
3140,7,6,2,0,4,2
3140,6,11,5,0,6,5
3140,5,16,1,0,15,1
3140,4,11,4,0,7,4
3140,3,15,1,0,14,1
3140,2,3,1,0,2,1
1618,10,5,3,0,2,3
1618,9,8,2,0,6,2
1618,8,21,11,0,10,11
1618,7,14,5,0,9,5
1618,6,13,5,0,8,5
1618,4,2,1,0,1,1
1618,2,1,1,0,0,1
84825,10,2,1,0,1,1
84825,8,3,1,0,2,1
84825,7,2,1,0,1,1
84825,6,19,5,0,14,5
84825,5,8,2,0,6,2
84825,4,9,2,0,7,2
84825,3,7,1,0,6,1
84825,2,7,2,0,5,2
84825,1,7,4,0,3,4
83283,9,12,6,0,6,6
83283,8,27,9,0,18,9
83283,7,11,1,0,10,1
83283,6,9,4,0,5,4
83283,4,1,1,0,0,1
91512,10,1,1,0,0,1
91512,7,12,3,0,9,3
91512,6,32,4,0,28,4
91512,5,10,2,0,8,2
91512,4,1,1,0,0,1
91512,3,3,1,0,2,1
250488,10,8,2,0,6,2
250488,9,10,5,0,5,5
250488,8,24,6,0,18,6
250488,7,11,2,0,9,2
250488,6,6,4,0,2,4
250488,5,5,2,0,3,2
2011,9,1,1,0,0,1
2011,8,6,1,0,5,1
2011,7,19,4,0,15,4
2011,6,22,6,0,16,6
2011,5,11,5,0,6,5
6686,9,1,1,0,0,1
6686,7,3,1,0,2,1
6686,6,13,3,0,10,3
6686,5,13,1,0,12,1
6686,4,17,7,0,10,7
6686,3,12,2,0,10,2
6686,2,5,3,0,2,3
6686,1,1,1,0,0,1
5769,10,6,1,0,5,1
5769,9,6,1,0,5,1
5769,8,14,4,0,10,4
5769,7,27,8,0,19,8
225759,10,11,3,0,8,3
225759,9,21,7,0,14,7
225759,8,25,6,1,19,5
225759,6,5,3,0,2,3
219807,10,11,4,0,7,4
219807,9,13,2,0,11,2
219807,8,23,8,0,15,8
219807,7,11,1,0,10,1
219807,6,6,1,0,5,1
219807,5,1,1,0,0,1
38975,10,1,1,0,0,1
38975,9,1,1,0,0,1
38975,8,12,5,0,7,5
38975,7,19,12,0,7,12
38975,6,19,8,0,11,8
38975,5,10,2,0,8,2
38975,4,3,1,0,2,1
9663,10,1,1,0,0,1
9663,9,6,2,0,4,2
9663,8,18,7,0,11,7
9663,7,27,13,0,14,13
9663,6,11,2,0,9,2
9663,5,2,2,0,0,2
9663,4,1,1,0,0,1
3430,10,1,1,0,0,1
3430,8,2,1,0,1,1
3430,7,9,5,0,4,5
3430,6,12,5,0,7,5
3430,5,14,3,0,11,3
3430,4,14,4,0,10,4
3430,3,6,5,0,1,5
3430,1,2,1,0,1,1
8036,10,2,1,0,1,1
8036,8,10,4,0,6,4
8036,7,21,7,0,14,7
8036,6,20,7,0,13,7
8036,5,4,2,0,2,2
8036,4,5,1,0,4,1
8036,3,2,1,0,1,1
233502,10,3,2,0,1,2
233502,9,8,3,0,5,3
233502,8,24,3,0,21,3
233502,7,20,2,0,18,2
233502,6,11,1,0,10,1
215565,10,24,8,0,16,8
215565,9,21,6,0,15,6
215565,8,18,8,0,10,8
215565,7,3,1,0,2,1
10096,10,3,2,0,1,2
10096,6,28,1,0,27,1
10096,5,10,2,0,8,2
849,7,5,3,0,2,3
849,6,15,3,0,12,3
849,5,20,8,0,12,8
849,4,16,4,0,12,4
849,3,3,2,0,1,2
849,2,4,1,0,3,1
4472,8,6,2,0,4,2
4472,7,20,5,0,15,5
4472,6,22,6,0,16,6
4472,5,12,2,0,10,2
4472,4,2,1,0,1,1
4472,2,1,1,0,0,1
158891,10,5,2,0,3,2
158891,9,7,2,0,5,2
158891,8,14,2,0,12,2
158891,6,18,1,0,17,1
158891,5,5,2,0,3,2
25299,9,2,1,0,1,1
25299,8,13,6,0,7,6
25299,7,15,3,0,12,3
25299,6,23,6,0,17,6
25299,5,6,2,0,4,2
25299,4,4,2,0,2,2
25299,3,1,1,0,0,1
5052,9,3,1,0,2,1
5052,8,8,5,0,3,5
5052,7,18,5,0,13,5
5052,6,22,9,0,13,9
5052,5,10,4,0,6,4
5052,4,2,2,0,0,2
5052,1,2,1,0,1,1
12253,10,7,5,0,2,5
12253,9,11,7,0,4,7
12253,8,21,6,0,15,6
12253,7,15,5,0,10,5
12253,5,2,1,0,1,1
12253,3,1,1,0,0,1
12253,1,4,1,0,3,1
288,10,3,1,0,2,1
288,9,8,3,0,5,3
288,8,19,8,0,11,8
288,7,17,2,0,15,2
288,6,12,2,0,10,2
288,5,5,2,0,3,2
288,4,2,1,0,1,1
182960,7,19,1,0,18,1
182960,6,21,1,0,20,1
182960,5,12,1,0,11,1
24783,7,1,1,0,0,1
24783,6,5,2,0,3,2
24783,5,5,2,0,3,2
24783,3,6,1,0,5,1
24783,2,15,5,0,10,5
24783,1,33,17,0,16,17
7748,10,6,2,0,4,2
7748,9,7,3,0,4,3
7748,8,26,8,0,18,8
7748,7,15,3,0,12,3
7748,6,11,3,0,8,3
38772,10,4,2,0,2,2
38772,9,5,1,0,4,1
38772,8,11,2,0,9,2
38772,7,16,1,0,15,1
38772,6,17,2,0,15,2
38772,5,9,2,0,7,2
38772,4,2,2,0,0,2
38772,2,1,1,0,0,1
149793,10,6,1,0,5,1
149793,8,27,8,0,19,8
149793,7,22,6,0,16,6
149793,6,5,2,0,3,2
25462,9,4,1,0,3,1
25462,8,9,3,0,6,3
25462,7,17,7,0,10,7
25462,6,23,9,0,14,9
25462,5,9,6,0,3,6
25462,4,2,1,0,1,1
16439,9,2,1,0,1,1
16439,8,8,2,0,6,2
16439,7,13,4,0,9,4
16439,6,21,3,0,18,3
16439,5,13,3,0,10,3
16439,3,1,1,0,0,1
197783,9,2,1,0,1,1
197783,8,16,6,0,10,6
197783,7,19,4,0,15,4
197783,6,17,3,0,14,3
197783,5,3,2,0,1,2
197783,3,2,1,0,1,1
256422,10,16,3,0,13,3
256422,9,21,3,0,18,3
256422,8,13,1,0,12,1
256422,7,9,1,0,8,1
256422,1,2,2,0,0,2
217270,10,22,11,0,11,11
217270,9,2,1,0,1,1
217270,8,5,2,0,3,2
217270,7,6,1,0,5,1
217270,6,10,1,0,9,1
217270,5,3,1,0,2,1
217270,3,1,1,0,0,1
217270,2,2,1,0,1,1
217270,1,14,4,0,10,4
10065,10,6,2,0,4,2
10065,9,4,1,0,3,1
10065,8,9,4,0,5,4
10065,7,12,1,0,11,1
10065,6,17,5,0,12,5
10065,5,11,1,0,10,1
10065,4,7,3,0,4,3
130347,7,4,3,0,1,3
130347,6,15,7,0,8,7
130347,5,12,1,0,11,1
130347,3,6,1,0,5,1
130347,2,9,1,0,8,1
130347,1,2,1,0,1,1
264196,10,15,7,0,8,7
264196,9,17,4,0,13,4
264196,8,21,7,0,14,7
264196,7,11,4,0,7,4
264196,5,1,1,0,0,1
162578,8,9,2,0,7,2
162578,7,17,6,0,11,6
162578,6,20,6,0,14,6
162578,4,4,2,2,2,0
162578,3,2,1,0,1,1
162578,2,1,1,0,0,1
267652,10,45,6,1,39,5
267652,9,10,2,0,8,2
267652,8,7,1,0,6,1
267652,1,4,2,2,2,0
247034,9,2,1,0,1,1
247034,8,9,1,0,8,1
247034,7,14,2,1,12,1
247034,6,24,3,0,21,3
247034,5,7,1,0,6,1
247034,4,5,2,0,3,2
247034,2,3,1,0,2,1
141249,9,9,2,0,7,2
141249,8,20,3,0,17,3
141249,6,16,1,0,15,1
141249,2,1,1,0,0,1
24186,9,2,1,0,1,1
24186,8,8,3,0,5,3
24186,7,13,8,0,5,8
24186,6,26,10,0,16,10
24186,5,8,2,0,6,2
24186,4,6,4,0,2,4
24186,3,2,1,0,1,1
61477,8,7,1,0,6,1
61477,7,16,7,0,9,7
61477,6,24,9,0,15,9
61477,5,11,4,0,7,4
61477,4,4,3,0,1,3
207202,10,9,4,2,5,2
207202,9,14,5,2,9,3
207202,8,21,6,1,15,5
207202,7,9,2,0,7,2
207202,6,7,3,0,4,3
207202,4,1,1,0,0,1
207202,3,1,1,0,0,1
207202,1,1,1,0,0,1
646,7,9,3,0,6,3
646,6,13,7,0,6,7
646,5,17,4,0,13,4
646,4,11,3,0,8,3
646,3,3,1,0,2,1
646,2,10,4,0,6,4
646,1,3,3,0,0,3
14131,7,6,1,0,5,1
14131,6,22,3,0,19,3
14131,5,9,1,0,8,1
14131,4,13,3,0,10,3
14131,3,8,3,0,5,3
14131,2,6,4,0,2,4
14131,1,2,1,0,1,1
12276,6,7,2,0,5,2
12276,5,13,4,0,9,4
12276,4,17,5,0,12,5
12276,3,14,6,0,8,6
12276,2,10,4,0,6,4
12276,1,3,3,0,0,3
13645,9,2,1,0,1,1
13645,8,11,6,0,5,6
13645,7,28,9,0,19,9
13645,6,16,6,0,10,6
13645,5,4,1,0,3,1
13645,4,2,1,0,1,1
13645,3,1,1,0,0,1
2295,7,9,3,0,6,3
2295,6,15,1,0,14,1
2295,5,17,1,0,16,1
2295,4,15,5,0,10,5
2295,3,5,2,0,3,2
2295,2,1,1,0,0,1
161813,10,5,2,0,3,2
161813,9,9,4,0,5,4
161813,8,22,4,0,18,4
161813,7,10,1,0,9,1
161813,6,13,3,0,10,3
161813,4,3,1,0,2,1
157452,10,10,2,0,8,2
157452,9,2,1,0,1,1
157452,8,10,2,0,8,2
157452,7,12,3,0,9,3
157452,6,11,5,0,6,5
157452,5,6,1,0,5,1
157452,4,4,3,0,1,3
157452,3,6,3,0,3,3
157452,2,2,2,0,0,2
204601,10,5,4,0,1,4
204601,9,13,9,0,4,9
204601,8,24,12,1,12,11
204601,7,14,5,0,9,5
204601,6,6,3,0,3,3
204601,5,2,1,0,1,1
2317,7,14,2,0,12,2
2317,6,15,9,0,6,9
2317,5,20,8,0,12,8
2317,3,6,2,0,4,2
1142,10,1,1,0,0,1
1142,8,4,1,0,3,1
1142,7,10,5,0,5,5
1142,6,24,9,0,15,9
1142,5,12,5,0,7,5
1142,4,8,4,0,4,4
1142,3,2,1,0,1,1
1142,2,2,2,0,0,2
187420,8,19,3,0,16,3
187420,7,14,1,0,13,1
187420,6,14,1,0,13,1
187420,5,5,1,0,4,1
187420,4,3,1,0,2,1
5200,8,4,2,0,2,2
5200,7,24,5,0,19,5
5200,6,24,10,0,14,10
5200,5,8,3,0,5,3
5200,4,3,1,0,2,1
6705,9,1,1,0,0,1
6705,7,13,6,0,7,6
6705,6,16,10,0,6,10
6705,5,21,12,0,9,12
6705,2,1,1,0,0,1
6705,1,2,2,0,0,2
757,9,1,1,0,0,1
757,8,10,6,0,4,6
757,7,25,9,0,16,9
757,6,17,1,0,16,1
757,5,3,2,0,1,2
757,4,5,2,0,3,2
757,3,2,2,0,0,2
2175,10,1,1,0,0,1
2175,7,11,2,0,9,2
2175,6,23,3,0,20,3
2175,5,16,3,0,13,3
2175,4,8,3,0,5,3
2175,3,2,1,0,1,1
2175,2,2,1,0,1,1
37743,10,5,5,0,0,5
37743,8,8,4,0,4,4
37743,7,16,6,0,10,6
37743,6,18,6,0,12,6
37743,5,8,2,0,6,2
37743,4,5,3,0,2,3
37743,3,3,1,0,2,1
24782,6,8,3,0,5,3
24782,5,16,5,0,11,5
24782,4,14,2,0,12,2
24782,3,17,7,0,10,7
24782,2,3,1,0,2,1
24782,1,2,1,0,1,1
23695,9,2,1,0,1,1
23695,8,5,3,0,2,3
23695,7,10,3,0,7,3
23695,6,24,5,0,19,5
23695,5,11,4,0,7,4
23695,4,7,2,0,5,2
23695,3,5,4,0,1,4
5058,10,6,3,0,3,3
5058,9,7,3,0,4,3
5058,8,18,6,0,12,6
5058,7,21,8,0,13,8
140600,8,11,1,0,10,1
140600,7,13,4,0,9,4
140600,6,21,3,0,18,3
140600,5,11,2,0,9,2
140600,4,5,1,0,4,1
140600,3,3,1,0,2,1
36413,8,8,5,0,3,5
36413,7,14,3,0,11,3
36413,6,21,3,0,18,3
36413,5,10,3,0,7,3
36413,4,7,2,0,5,2
36413,3,1,1,0,0,1
36413,2,1,1,0,0,1
209383,10,2,2,0,0,2
209383,8,11,1,0,10,1
209383,7,20,4,2,16,2
209383,6,15,1,1,14,0
209383,5,7,2,0,5,2
209383,4,6,2,0,4,2
209383,3,3,1,0,2,1
129053,8,5,1,0,4,1
129053,6,21,5,0,16,5
129053,5,14,2,0,12,2
129053,4,13,1,0,12,1
129053,2,2,1,0,1,1
5167,8,6,1,0,5,1
5167,7,11,5,0,6,5
5167,6,25,8,0,17,8
5167,5,13,4,0,9,4
182225,9,4,1,0,3,1
182225,8,10,2,0,8,2
182225,7,14,2,0,12,2
182225,6,19,1,0,18,1
182225,5,9,1,0,8,1
182225,4,4,1,0,3,1
49454,6,22,3,0,19,3
49454,5,16,2,0,14,2
49454,3,5,2,0,3,2
984,10,2,1,0,1,1
984,8,11,2,0,9,2
984,7,15,4,0,11,4
984,6,15,6,0,9,6
984,5,13,2,0,11,2
984,4,5,2,0,3,2
245389,8,23,6,0,17,6
245389,7,23,2,0,21,2
245389,6,11,2,0,9,2
245389,4,2,1,0,1,1
187550,10,4,2,0,2,2
187550,8,8,2,0,6,2
187550,7,13,2,0,11,2
187550,6,12,2,0,10,2
187550,5,9,1,0,8,1
187550,4,6,3,0,3,3
187550,3,6,2,0,4,2
187550,1,1,1,0,0,1
109143,10,3,2,0,1,2
109143,9,2,1,0,1,1
109143,8,21,7,0,14,7
109143,7,14,4,0,10,4
109143,6,16,11,0,5,11
129224,10,4,1,0,3,1
129224,8,6,1,0,5,1
129224,7,11,1,0,10,1
129224,6,19,1,1,18,0
129224,5,17,1,0,16,1
129224,4,3,1,0,2,1
129224,2,1,1,0,0,1
8109,10,1,1,0,0,1
8109,9,1,1,0,0,1
8109,8,9,6,0,3,6
8109,7,23,7,0,16,7
8109,6,18,8,0,10,8
8109,5,11,3,0,8,3
89915,7,4,3,0,1,3
89915,6,23,8,0,15,8
89915,5,22,8,0,14,8
89915,4,8,1,0,7,1
89915,3,3,1,0,2,1
89915,2,3,1,0,2,1
193278,9,5,2,0,3,2
193278,8,9,2,0,7,2
193278,7,25,4,0,21,4
193278,4,1,1,0,0,1
193278,3,1,1,0,0,1
1937,7,6,1,0,5,1
1937,6,22,3,0,19,3
1937,5,21,5,0,16,5
1937,4,8,2,0,6,2
1937,3,5,3,0,2,3
229477,10,4,2,0,2,2
229477,9,4,1,0,3,1
229477,8,12,5,0,7,5
229477,7,19,4,0,15,4
229477,6,18,5,0,13,5
229477,5,3,1,0,2,1
229477,4,1,1,0,0,1
229477,3,3,1,0,2,1
193428,10,49,15,1,34,14
193428,9,4,4,0,0,4
193428,5,3,1,0,2,1
8542,7,4,2,0,2,2
8542,6,17,3,0,14,3
8542,5,13,1,0,12,1
8542,4,16,6,0,10,6
8542,3,6,1,0,5,1
8542,2,7,2,0,5,2
146144,10,16,8,1,8,7
146144,9,11,4,0,7,4
146144,8,16,6,1,10,5
146144,7,9,1,0,8,1
146144,6,7,2,0,5,2
146144,5,4,1,0,3,1
146144,3,1,1,0,0,1
2193,7,5,2,0,3,2
2193,6,28,7,0,21,7
2193,5,11,1,0,10,1
2193,4,14,5,0,9,5
2193,3,3,1,0,2,1
2193,2,2,2,0,0,2
9063,8,19,11,0,8,11
9063,7,12,5,0,7,5
9063,6,17,6,0,11,6
9063,4,6,2,0,4,2
9063,3,3,1,0,2,1
9063,2,1,1,0,0,1
9063,1,1,1,0,0,1
172278,8,14,2,0,12,2
172278,7,15,1,0,14,1
172278,6,15,1,0,14,1
172278,5,5,1,0,4,1
172278,4,4,2,0,2,2
172278,3,2,1,0,1,1
2336,8,4,1,0,3,1
2336,7,8,1,0,7,1
2336,6,18,4,0,14,4
2336,5,13,4,0,9,4
2336,4,9,2,0,7,2
2336,3,8,2,0,6,2
2336,1,1,1,0,0,1
257598,9,5,1,0,4,1
257598,7,14,3,0,11,3
257598,6,20,2,0,18,2
257598,3,3,1,0,2,1
257598,2,2,1,0,1,1
257598,1,6,4,0,2,4
265489,10,2,1,0,1,1
265489,9,8,4,0,4,4
265489,8,19,10,0,9,10
265489,7,13,4,0,9,4
265489,6,7,1,0,6,1
265489,3,1,1,0,0,1
36903,10,8,1,0,7,1
36903,9,14,4,0,10,4
36903,8,24,7,0,17,7
36903,7,9,2,0,7,2
36903,5,4,2,0,2,2
36903,2,1,1,0,0,1
99880,10,2,2,0,0,2
99880,9,3,3,0,0,3
99880,7,14,5,0,9,5
99880,6,19,2,0,17,2
99880,5,10,2,0,8,2
99880,4,11,4,0,7,4
260212,10,5,1,0,4,1
260212,8,10,3,0,7,3
260212,7,17,6,0,11,6
260212,6,15,3,0,12,3
260212,5,9,1,0,8,1
260212,4,7,2,0,5,2
2367,7,3,1,0,2,1
2367,6,15,4,0,11,4
2367,5,15,3,0,12,3
2367,4,21,7,0,14,7
2367,3,4,3,0,1,3
2367,2,4,2,0,2,2
2367,1,1,1,0,0,1
177053,10,10,3,2,7,1
177053,9,2,1,0,1,1
177053,8,22,4,2,18,2
177053,7,13,3,3,10,0
177053,6,12,3,0,9,3
177053,4,2,1,0,1,1
347,8,5,1,0,4,1
347,7,11,3,0,8,3
347,6,20,6,0,14,6
347,5,20,5,0,15,5
347,1,1,1,0,0,1
11646,10,2,1,0,1,1
11646,8,13,6,0,7,6
11646,7,12,4,0,8,4
11646,6,21,11,0,10,11
11646,5,4,3,0,1,3
11646,4,4,2,0,2,2
11646,3,2,2,0,0,2
6543,7,9,5,0,4,5
6543,6,19,6,0,13,6
6543,5,19,3,0,16,3
6543,4,11,3,0,8,3
6543,3,3,2,0,1,2
6543,1,2,1,0,1,1
202223,10,4,1,0,3,1
202223,9,10,4,0,6,4
202223,8,5,1,0,4,1
202223,7,11,1,0,10,1
202223,6,17,1,0,16,1
202223,4,6,1,0,5,1
202223,3,1,1,0,0,1
235467,10,5,4,0,1,4
235467,9,6,5,0,1,5
235467,7,14,4,0,10,4
235467,6,14,3,0,11,3
235467,5,7,2,0,5,2
7982,8,2,1,0,1,1
7982,6,26,8,0,18,8
7982,5,18,3,0,15,3
7982,4,10,4,0,6,4
227582,8,13,1,0,12,1
227582,7,25,5,2,20,3
227582,6,17,5,1,12,4
227582,5,4,2,0,2,2
227582,3,1,1,0,0,1
9704,7,5,3,0,2,3
9704,6,7,3,0,4,3
9704,5,18,8,0,10,8
9704,4,17,6,0,11,6
9704,3,15,9,0,6,9
9704,2,2,1,0,1,1
7008,10,10,6,0,4,6
7008,9,9,5,0,4,5
7008,8,15,6,0,9,6
7008,7,11,5,0,6,5
7008,5,5,2,0,3,2
7008,4,5,3,0,2,3
7008,2,1,1,0,0,1
5185,10,3,1,0,2,1
5185,8,7,3,0,4,3
5185,7,11,7,0,4,7
5185,6,19,5,0,14,5
5185,5,14,4,0,10,4
5185,4,9,7,0,2,7
11629,10,2,2,0,0,2
11629,9,3,2,0,1,2
11629,8,12,6,0,6,6
11629,7,7,2,0,5,2
11629,6,16,4,0,12,4
11629,5,4,2,0,2,2
11629,4,2,1,0,1,1
14935,9,1,1,0,0,1
14935,7,5,3,0,2,3
14935,6,21,13,0,8,13
14935,5,20,11,0,9,11
14935,4,13,7,0,6,7
14935,3,3,3,0,0,3
38678,8,5,3,0,2,3
38678,7,8,1,0,7,1
38678,6,21,6,0,15,6
38678,5,10,2,0,8,2
38678,4,13,5,0,8,5
38678,3,6,2,0,4,2
38678,2,2,1,0,1,1
146253,9,3,1,0,2,1
146253,6,11,3,0,8,3
146253,5,16,4,0,12,4
146253,3,6,2,0,4,2
146253,2,8,2,0,6,2
146253,1,4,1,0,3,1
68387,10,9,8,0,1,8
68387,9,7,3,0,4,3
68387,8,20,10,0,10,10
68387,7,8,2,0,6,2
68387,6,14,5,0,9,5
68387,5,6,2,0,4,2
68387,4,1,1,0,0,1
21569,10,7,3,0,4,3
21569,9,11,1,0,10,1
21569,8,21,4,0,17,4
21569,7,16,2,0,14,2
21569,6,7,2,0,5,2
256792,9,2,1,0,1,1
256792,7,16,1,0,15,1
256792,6,17,6,0,11,6
256792,5,11,3,0,8,3
256792,3,4,3,0,1,3
14410,10,7,3,0,4,3
14410,8,10,4,0,6,4
14410,7,13,6,0,7,6
14410,6,18,7,0,11,7
14410,5,11,5,0,6,5
14410,4,2,1,0,1,1
193818,10,5,1,0,4,1
193818,9,15,2,0,13,2
193818,8,17,2,0,15,2
193818,7,17,3,0,14,3
193818,6,7,1,0,6,1
13367,8,3,2,0,1,2
13367,7,6,4,0,2,4
13367,6,17,8,0,9,8
13367,5,20,8,0,12,8
13367,4,15,2,0,13,2
9545,6,16,2,0,14,2
9545,5,11,1,0,10,1
9545,4,13,3,0,10,3
9545,3,8,2,0,6,2
9545,2,7,4,0,3,4
9545,1,3,3,0,0,3
17958,8,7,5,0,2,5
17958,7,18,11,0,7,11
17958,6,17,9,0,8,9
17958,5,10,4,0,6,4
17958,4,9,5,0,4,5
17958,3,1,1,0,0,1
17958,2,1,1,0,0,1
95679,8,7,3,0,4,3
95679,7,21,3,0,18,3
95679,6,28,4,0,24,4
95679,3,1,1,0,0,1
252892,7,16,1,0,15,1
252892,6,22,4,0,18,4
252892,5,4,1,0,3,1
252892,3,5,1,0,4,1
31975,9,1,1,0,0,1
31975,8,13,3,0,10,3
31975,7,15,5,0,10,5
31975,6,26,8,0,18,8
31975,5,4,2,0,2,2
31975,3,4,4,0,0,4
233262,10,29,2,0,27,2
233262,9,16,3,0,13,3
233262,8,9,1,1,8,0
30364,7,9,3,0,6,3
30364,6,17,6,0,11,6
30364,5,12,2,0,10,2
30364,4,8,2,0,6,2
30364,3,8,3,0,5,3
30364,2,5,2,0,3,2
260239,10,6,4,0,2,4
260239,9,8,4,0,4,4
260239,8,18,2,0,16,2
260239,7,13,3,0,10,3
260239,6,5,2,0,3,2
260239,5,7,2,0,5,2
260239,4,5,3,0,2,3
260239,3,3,3,0,0,3
15678,10,4,3,0,1,3
15678,9,2,2,0,0,2
15678,8,12,8,0,4,8
15678,7,11,4,0,7,4
15678,6,17,4,0,13,4
15678,5,14,5,0,9,5
15678,1,1,1,0,0,1
56410,8,7,4,0,3,4
56410,7,15,1,0,14,1
56410,6,21,4,0,17,4
56410,3,4,1,0,3,1
89611,7,13,1,0,12,1
89611,6,35,6,0,29,6
89611,4,5,1,0,4,1
17208,8,13,9,0,4,9
17208,7,20,7,0,13,7
17208,6,18,10,0,8,10
17208,5,8,3,0,5,3
17208,3,2,1,0,1,1
13260,6,17,4,0,13,4
13260,5,13,2,0,11,2
13260,4,16,5,0,11,5
13260,3,5,2,0,3,2
13260,2,4,1,0,3,1
4814,10,1,1,0,0,1
4814,9,1,1,0,0,1
4814,8,3,2,0,1,2
4814,7,10,1,0,9,1
4814,6,17,5,0,12,5
4814,5,20,6,0,14,6
4814,4,10,2,0,8,2
4814,3,3,2,0,1,2
1625,8,3,1,0,2,1
1625,7,4,3,0,1,3
1625,6,12,3,0,9,3
1625,5,17,5,0,12,5
1625,4,15,4,0,11,4
1625,3,4,1,0,3,1
1625,2,6,1,0,5,1
254695,10,5,2,0,3,2
254695,8,13,7,2,6,5
254695,7,12,4,0,8,4
254695,6,20,4,0,16,4
254695,3,4,1,0,3,1
254695,1,1,1,0,0,1
5999,8,5,3,0,2,3
5999,7,10,2,0,8,2
5999,6,23,10,0,13,10
5999,5,17,4,0,13,4
5999,3,3,2,0,1,2
5999,1,1,1,0,0,1
3527,10,2,1,0,1,1
3527,8,3,1,0,2,1
3527,7,10,3,0,7,3
3527,6,21,8,0,13,8
3527,5,9,1,0,8,1
3527,4,7,2,0,5,2
3527,3,2,1,0,1,1
3527,2,3,2,0,1,2
120547,10,2,1,0,1,1
120547,9,4,2,0,2,2
120547,8,13,7,0,6,7
120547,7,20,5,0,15,5
120547,6,16,5,0,11,5
120547,5,7,2,0,5,2
120547,4,3,2,0,1,2
245824,9,3,1,0,2,1
245824,8,18,5,0,13,5
245824,7,22,6,1,16,5
245824,6,11,1,0,10,1
245824,5,6,2,0,4,2
260986,10,1,1,0,0,1
260986,9,8,2,0,6,2
260986,8,19,4,0,15,4
260986,7,13,1,0,12,1
260986,6,14,3,0,11,3
260986,5,5,1,0,4,1
2635,7,7,4,0,3,4
2635,6,18,2,0,16,2
2635,5,12,2,0,10,2
2635,4,14,6,0,8,6
2635,3,9,5,0,4,5
2635,2,3,1,0,2,1
67022,7,24,2,0,22,2
67022,6,25,1,0,24,1
67022,3,3,1,0,2,1
193291,10,1,1,0,0,1
193291,9,4,1,0,3,1
193291,8,18,5,0,13,5
193291,7,17,6,0,11,6
193291,6,12,1,0,11,1
193291,3,1,1,0,0,1
2867,8,2,1,0,1,1
2867,7,13,6,0,7,6
2867,6,15,3,0,12,3
2867,5,21,10,0,11,10
2867,4,10,2,0,8,2
2867,3,4,2,0,2,2
7112,10,2,1,0,1,1
7112,8,8,3,0,5,3
7112,7,16,5,0,11,5
7112,6,22,7,0,15,7
7112,5,8,2,0,6,2
7112,4,7,1,0,6,1
7112,3,1,1,0,0,1
7112,1,1,1,0,0,1
132229,10,19,9,0,10,9
132229,9,19,8,0,11,8
132229,8,14,2,0,12,2
132229,7,3,1,0,2,1
132229,6,3,2,0,1,2
74987,10,3,1,0,2,1
74987,9,5,2,1,3,1
74987,8,15,5,0,10,5
74987,7,11,3,1,8,2
74987,6,19,10,1,9,9
74987,5,9,3,0,6,3
74987,1,1,1,0,0,1
249550,10,41,11,0,30,11
249550,9,11,1,0,10,1
249550,8,8,3,0,5,3
1053,9,2,1,0,1,1
1053,7,21,4,0,17,4
1053,6,16,3,0,13,3
1053,5,7,2,0,5,2
1053,4,3,3,0,0,3
1053,3,2,1,0,1,1
1053,2,2,1,0,1,1
204803,8,30,3,0,27,3
204803,6,5,2,0,3,2
204803,2,2,1,0,1,1
30306,6,13,5,0,8,5
30306,4,7,2,0,5,2
30306,3,13,5,0,8,5
30306,1,5,1,0,4,1
4680,8,5,2,0,3,2
4680,7,10,5,0,5,5
4680,6,21,8,0,13,8
4680,5,14,5,0,9,5
4680,4,8,1,0,7,1
4680,3,4,1,0,3,1
4680,1,1,1,0,0,1
260269,9,3,1,0,2,1
260269,8,9,1,0,8,1
260269,7,23,2,0,21,2
260269,6,17,3,0,14,3
1684,7,5,2,0,3,2
1684,6,6,5,0,1,5
1684,5,16,5,0,11,5
1684,4,11,3,0,8,3
1684,3,12,1,0,11,1
1684,2,7,3,0,4,3
9504,10,5,1,0,4,1
9504,8,14,5,0,9,5
9504,7,18,3,0,15,3
9504,6,20,1,0,19,1
27071,8,4,1,0,3,1
27071,7,10,2,0,8,2
27071,6,31,2,0,29,2
27071,5,12,2,0,10,2
27071,4,4,2,0,2,2
27071,3,1,1,0,0,1
198855,8,12,4,0,8,4
198855,7,11,1,0,10,1
198855,6,15,2,0,13,2
198855,5,10,3,0,7,3
198855,4,8,2,0,6,2
198855,3,6,2,0,4,2
198855,1,2,2,0,0,2
176071,10,4,2,0,2,2
176071,9,1,1,0,0,1
176071,7,12,3,1,9,2
176071,6,22,4,0,18,4
176071,5,11,1,1,10,0
176071,4,4,1,0,3,1
3973,10,2,1,0,1,1
3973,8,14,4,0,10,4
3973,7,16,1,0,15,1
3973,6,15,1,0,14,1
3973,4,5,2,0,3,2
3973,3,2,2,0,0,2
3973,1,1,1,0,0,1
6958,10,2,1,0,1,1
6958,9,1,1,0,0,1
6958,8,1,1,0,0,1
6958,7,5,2,0,3,2
6958,5,12,2,0,10,2
6958,4,12,2,0,10,2
6958,3,7,1,0,6,1
6958,2,5,1,0,4,1
6958,1,2,1,0,1,1
32993,8,1,1,0,0,1
32993,7,9,2,0,7,2
32993,6,16,7,0,9,7
32993,5,12,4,0,8,4
32993,4,18,3,0,15,3
32993,3,7,2,0,5,2
32993,1,1,1,0,0,1
219622,8,15,1,0,14,1
219622,7,18,5,0,13,5
219622,6,15,6,0,9,6
219622,5,8,2,2,6,0
219622,3,1,1,0,0,1
219622,2,1,1,1,0,0
20153,8,5,2,0,3,2
20153,7,11,5,0,6,5
20153,6,17,2,0,15,2
20153,4,9,2,0,7,2
20153,2,2,1,0,1,1
1411,8,14,3,0,11,3
1411,7,14,3,0,11,3
1411,6,15,3,0,12,3
1411,5,11,4,0,7,4
1411,4,4,1,0,3,1
1411,2,1,1,0,0,1
199790,7,18,2,0,16,2
199790,6,17,1,0,16,1
118559,10,3,1,0,2,1
118559,9,12,6,0,6,6
118559,8,22,9,0,13,9
118559,7,13,4,0,9,4
118559,6,9,3,0,6,3
118559,4,1,1,0,0,1
10508,8,6,2,0,4,2
10508,7,16,4,0,12,4
10508,6,24,6,0,18,6
10508,5,12,4,0,8,4
10508,3,2,1,0,1,1
10508,2,2,1,0,1,1
35219,10,9,3,0,6,3
35219,9,12,3,0,9,3
35219,8,15,6,0,9,6
35219,7,12,3,0,9,3
35219,6,9,6,0,3,6
35219,5,4,2,0,2,2
35219,4,1,1,0,0,1
15081,10,6,5,0,1,5
15081,9,15,8,0,7,8
15081,8,22,11,0,11,11
15081,7,8,4,0,4,4
15081,6,7,2,0,5,2
15081,5,3,2,0,1,2
59060,8,3,1,0,2,1
59060,7,7,1,0,6,1
59060,6,21,5,0,16,5
59060,5,15,1,0,14,1
4068,8,1,1,0,0,1
4068,7,4,2,0,2,2
4068,6,10,2,0,8,2
4068,5,12,3,0,9,3
4068,4,15,6,0,9,6
4068,3,11,6,0,5,6
4068,2,5,2,0,3,2
4068,1,6,3,0,3,3
21941,10,1,1,0,0,1
21941,8,2,1,0,1,1
21941,6,14,5,0,9,5
21941,5,16,5,0,11,5
21941,4,17,6,0,11,6
21941,3,7,2,0,5,2
6993,8,13,3,0,10,3
6993,7,16,3,0,13,3
6993,6,22,8,0,14,8
6993,4,3,1,0,2,1
6993,2,2,1,0,1,1
30640,8,1,1,0,0,1
30640,7,5,1,0,4,1
30640,6,14,6,0,8,6
30640,3,5,1,0,4,1
30640,2,4,1,0,3,1
30640,1,10,7,0,3,7
201510,9,3,1,0,2,1
201510,8,16,3,0,13,3
201510,7,16,4,0,12,4
201510,6,15,2,0,13,2
201510,5,9,2,0,7,2
201510,1,1,1,0,0,1
6638,9,2,1,0,1,1
6638,8,16,4,0,12,4
6638,7,21,8,0,13,8
6638,6,10,2,0,8,2
6638,4,5,1,0,4,1
6638,2,1,1,0,0,1
40411,10,4,1,0,3,1
40411,9,6,1,0,5,1
40411,8,20,2,0,18,2
40411,7,16,2,0,14,2
40411,6,9,2,0,7,2
40411,3,1,1,0,0,1
219502,10,4,2,0,2,2
219502,9,4,1,0,3,1
219502,7,9,2,0,7,2
219502,6,23,4,0,19,4
219502,5,11,1,0,10,1
219502,2,2,1,0,1,1
245382,8,13,4,0,9,4
245382,7,15,2,0,13,2
245382,6,21,2,0,19,2
245382,5,9,2,0,7,2
245382,4,4,1,0,3,1
105024,10,12,5,0,7,5
105024,9,16,6,0,10,6
105024,8,23,6,0,17,6
105024,6,3,2,0,1,2
105024,5,1,1,0,0,1
229491,10,20,5,0,15,5
229491,9,8,2,0,6,2
229491,8,17,7,2,10,5
229491,7,7,1,1,6,0
229491,6,5,1,0,4,1
174552,9,3,1,0,2,1
174552,8,13,4,0,9,4
174552,7,14,2,0,12,2
174552,6,16,4,0,12,4
174552,5,8,1,0,7,1
174552,3,1,1,0,0,1
15396,8,5,2,0,3,2
15396,7,6,2,0,4,2
15396,6,26,12,0,14,12
15396,5,10,3,0,7,3
15396,4,8,3,0,5,3
15396,2,5,3,0,2,3
13647,9,6,3,0,3,3
13647,8,14,5,0,9,5
13647,7,14,5,0,9,5
13647,6,18,7,0,11,7
13647,3,2,2,0,0,2
3295,8,5,1,0,4,1
3295,7,10,2,0,8,2
3295,6,17,6,0,11,6
3295,5,21,3,0,18,3
3295,4,6,2,0,4,2
3295,3,5,2,0,3,2
10765,10,4,4,0,0,4
10765,9,2,2,0,0,2
10765,8,6,5,0,1,5
10765,7,8,5,0,3,5
10765,6,14,5,0,9,5
10765,5,15,4,0,11,4
10765,4,9,3,0,6,3
10765,3,3,3,0,0,3
10765,2,2,1,0,1,1
10765,1,1,1,0,0,1
5830,10,3,1,0,2,1
5830,9,5,1,0,4,1
5830,8,16,6,0,10,6
5830,7,23,7,0,16,7
5830,6,12,3,0,9,3
148592,10,7,2,0,5,2
148592,9,4,1,0,3,1
148592,8,15,3,1,12,2
148592,7,14,3,0,11,3
148592,6,13,4,2,9,2
148592,5,5,1,1,4,0
148592,4,3,1,0,2,1
148592,3,2,1,0,1,1
178285,9,4,1,1,3,0
178285,8,11,4,0,7,4
178285,6,13,1,0,12,1
178285,5,4,1,0,3,1
178285,4,5,2,0,3,2
178285,3,3,1,0,2,1
178285,2,2,1,0,1,1
194102,10,7,2,0,5,2
194102,9,9,7,2,2,5
194102,8,21,7,1,14,6
194102,7,13,4,0,9,4
194102,6,7,1,0,6,1
6971,8,3,1,0,2,1
6971,6,14,5,0,9,5
6971,5,15,4,0,11,4
6971,4,13,6,0,7,6
6971,3,8,3,0,5,3
6971,2,5,1,0,4,1
20731,10,11,9,0,2,9
20731,9,9,4,0,5,4
20731,8,17,11,0,6,11
20731,7,13,6,0,7,6
20731,6,10,3,0,7,3
20731,4,1,1,0,0,1
20731,3,1,1,0,0,1
244258,9,12,2,0,10,2
244258,8,17,2,0,15,2
244258,7,14,4,0,10,4
6598,7,5,3,0,2,3
6598,6,14,5,0,9,5
6598,5,19,4,0,15,4
6598,4,14,4,0,10,4
6598,3,9,1,0,8,1
6598,2,3,1,0,2,1
42789,9,4,2,0,2,2
42789,8,15,4,0,11,4
42789,7,14,4,0,10,4
42789,6,16,6,0,10,6
42789,5,11,5,0,6,5
42789,4,3,1,0,2,1
6860,10,7,1,0,6,1
6860,8,22,3,0,19,3
6860,7,21,5,0,16,5
6860,6,7,2,0,5,2
6860,5,2,1,0,1,1
6860,1,1,1,0,0,1
2605,9,2,2,0,0,2
2605,8,11,2,0,9,2
2605,7,14,6,0,8,6
2605,6,21,4,0,17,4
2605,5,8,2,0,6,2
2605,4,6,3,0,3,3
2605,3,1,1,0,0,1
9104,9,5,2,0,3,2
9104,8,16,6,0,10,6
9104,7,17,3,0,14,3
9104,6,12,2,0,10,2
9104,4,4,1,0,3,1
9104,3,1,1,0,0,1
68947,8,18,6,0,12,6
68947,7,18,6,0,12,6
68947,6,17,5,0,12,5
68947,5,8,2,0,6,2
12672,9,3,1,0,2,1
12672,8,9,2,0,7,2
12672,7,16,8,0,8,8
12672,6,12,2,0,10,2
12672,5,7,2,0,5,2
12672,3,5,2,0,3,2
12672,2,3,1,0,2,1
3030,10,1,1,0,0,1
3030,7,5,2,0,3,2
3030,6,17,10,0,7,10
3030,5,26,6,0,20,6
3030,4,8,1,0,7,1
9368,8,3,1,0,2,1
9368,6,23,5,0,18,5
9368,5,14,3,0,11,3
9368,4,5,1,0,4,1
9368,3,9,4,0,5,4
9368,2,1,1,0,0,1
198832,10,13,2,1,11,1
198832,9,13,3,0,10,3
198832,8,27,10,1,17,9
198832,7,4,3,0,1,3
198832,6,9,5,0,4,5
198832,5,2,1,0,1,1
198832,1,2,1,0,1,1
5199,9,1,1,0,0,1
5199,7,16,5,0,11,5
5199,6,21,8,0,13,8
5199,5,9,3,0,6,3
5199,4,7,2,0,5,2
101118,10,3,2,0,1,2
101118,9,7,3,0,4,3
101118,8,25,8,0,17,8
101118,7,9,1,0,8,1
101118,6,9,1,0,8,1
101118,5,6,3,1,3,2
101118,4,2,1,0,1,1
101118,3,3,2,0,1,2
217230,6,21,1,0,20,1
217230,5,13,2,0,11,2
217230,4,8,1,0,7,1
217230,3,5,1,0,4,1
182178,10,5,1,0,4,1
182178,9,11,1,0,10,1
182178,8,21,2,0,19,2
182178,7,16,2,0,14,2
182178,6,7,2,0,5,2
182178,4,2,1,0,1,1
4851,9,4,4,0,0,4
4851,8,5,2,0,3,2
4851,7,12,4,0,8,4
4851,6,14,9,0,5,9
4851,5,15,4,0,11,4
4851,4,10,5,0,5,5
4851,3,3,3,0,0,3
4851,2,1,1,0,0,1
36944,10,2,1,0,1,1
36944,9,4,1,0,3,1
36944,8,6,1,0,5,1
36944,7,12,3,0,9,3
36944,6,21,7,0,14,7
36944,5,8,2,0,6,2
25516,10,3,1,0,2,1
25516,9,3,1,0,2,1
25516,8,16,6,0,10,6
25516,7,12,6,0,6,6
25516,6,12,1,0,11,1
25516,5,10,3,0,7,3
25516,4,3,1,0,2,1
25516,3,4,3,0,1,3
206437,8,11,2,0,9,2
206437,7,11,2,0,9,2
206437,6,21,2,1,19,1
206437,5,8,1,0,7,1
235839,10,25,13,0,12,13
235839,9,19,7,0,12,7
235839,8,9,1,0,8,1
235839,7,3,1,0,2,1
235839,4,1,1,0,0,1
147168,8,9,1,0,8,1
147168,7,8,1,0,7,1
6008,9,3,1,0,2,1
6008,8,6,3,0,3,3
6008,7,18,9,0,9,9
6008,6,17,8,0,9,8
6008,5,14,5,0,9,5
6008,4,4,1,0,3,1
7547,8,3,1,0,2,1
7547,7,2,1,0,1,1
7547,6,14,4,0,10,4
7547,5,21,3,0,18,3
7547,4,16,8,0,8,8
7547,3,5,2,0,3,2
7547,2,3,1,0,2,1
224141,10,15,3,1,12,2
224141,9,26,5,0,21,5
224141,8,13,2,0,11,2
224141,6,3,1,0,2,1
224141,1,1,1,1,0,0
2713,9,4,1,0,3,1
2713,8,10,4,0,6,4
2713,7,14,2,0,12,2
2713,6,21,7,0,14,7
2713,5,5,3,0,2,3
2713,3,3,1,0,2,1
2713,2,3,1,0,2,1
18858,7,14,1,0,13,1
18858,6,19,6,0,13,6
18858,5,14,3,0,11,3
33406,8,2,1,0,1,1
33406,6,27,3,0,24,3
33406,5,15,3,0,12,3
33406,4,6,2,0,4,2
33406,3,3,1,0,2,1
76920,9,2,1,0,1,1
76920,8,9,2,0,7,2
76920,7,16,3,0,13,3
76920,6,19,4,0,15,4
76920,5,11,4,0,7,4
76920,4,5,2,0,3,2
76920,3,1,1,0,0,1
32288,10,3,1,0,2,1
32288,9,6,2,0,4,2
32288,8,17,6,0,11,6
32288,7,14,2,0,12,2
32288,6,15,9,0,6,9
32288,5,5,1,0,4,1
32288,3,1,1,0,0,1
176306,10,8,6,0,2,6
176306,9,9,5,0,4,5
176306,8,15,8,1,7,7
176306,7,13,1,0,12,1
176306,6,11,4,0,7,4
176306,5,4,1,0,3,1
176306,4,2,1,0,1,1
7327,8,2,2,0,0,2
7327,7,4,2,0,2,2
7327,6,10,1,0,9,1
7327,5,15,9,0,6,9
7327,4,13,6,0,7,6
7327,3,11,2,0,9,2
7327,2,6,3,0,3,3
7327,1,2,2,0,0,2
21294,10,1,1,0,0,1
21294,8,3,1,0,2,1
21294,7,11,5,0,6,5
21294,6,21,4,0,17,4
21294,5,15,4,0,11,4
21294,4,7,2,0,5,2
21294,2,2,1,0,1,1
39034,9,3,3,0,0,3
39034,8,6,3,0,3,3
39034,7,15,5,0,10,5
39034,6,26,8,0,18,8
39034,5,9,2,0,7,2
39034,4,4,2,0,2,2
93594,7,10,3,0,7,3
93594,6,16,1,0,15,1
93594,5,8,2,0,6,2
93594,4,8,2,0,6,2
93594,3,4,1,0,3,1
93594,2,4,1,0,3,1
1785,8,3,1,0,2,1
1785,7,11,2,0,9,2
1785,6,22,8,0,14,8
1785,5,16,4,0,12,4
1785,4,7,2,0,5,2
1785,2,1,1,0,0,1
1785,1,1,1,0,0,1
6119,10,3,1,0,2,1
6119,9,3,1,0,2,1
6119,8,8,3,0,5,3
6119,7,9,5,0,4,5
6119,6,15,6,0,9,6
6119,5,13,3,0,10,3
6119,4,9,2,0,7,2
6119,3,1,1,0,0,1
6119,2,2,1,0,1,1
6119,1,1,1,0,0,1
232134,10,16,7,1,9,6
232134,9,14,9,2,5,7
232134,8,23,4,0,19,4
232134,4,2,1,0,1,1
232134,1,2,1,1,1,0
4272,8,2,1,0,1,1
4272,7,14,5,0,9,5
4272,6,25,10,0,15,10
4272,5,10,5,0,5,5
4272,4,7,3,0,4,3
4272,2,2,1,0,1,1
709,9,3,1,0,2,1
709,8,5,2,0,3,2
709,7,15,3,0,12,3
709,6,25,11,0,14,11
709,5,10,4,0,6,4
709,4,5,1,0,4,1
709,3,1,1,0,0,1
42901,8,11,5,0,6,5
42901,7,26,3,0,23,3
42901,6,18,2,0,16,2
42901,5,4,1,0,3,1
42901,4,4,2,0,2,2
22511,10,4,1,0,3,1
22511,9,4,4,0,0,4
22511,8,12,6,0,6,6
22511,7,15,6,0,9,6
22511,6,14,6,0,8,6
22511,5,10,3,0,7,3
209951,10,19,11,1,8,10
209951,9,28,9,2,19,7
209951,8,10,4,0,6,4
209951,6,2,1,0,1,1
209951,1,1,1,0,0,1
42006,8,5,1,0,4,1
42006,7,10,2,0,8,2
42006,6,22,7,0,15,7
42006,5,12,4,0,8,4
42006,4,5,2,0,3,2
42006,3,9,4,0,5,4
42006,2,1,1,0,0,1
1938,6,12,1,0,11,1
1938,5,19,4,0,15,4
1938,3,9,1,0,8,1
1938,2,6,1,0,5,1
2264,10,1,1,0,0,1
2264,8,3,1,0,2,1
2264,7,16,2,0,14,2
2264,6,18,8,0,10,8
2264,5,11,3,0,8,3
2264,4,8,5,0,3,5
2264,3,3,1,0,2,1
2264,2,4,2,0,2,2
208995,10,4,1,0,3,1
208995,8,8,1,1,7,0
208995,7,22,2,0,20,2
208995,6,18,4,0,14,4
208995,5,6,2,0,4,2
208995,2,1,1,0,0,1
24704,8,6,1,0,5,1
24704,7,22,5,0,17,5
24704,6,25,5,0,20,5
24704,5,9,1,0,8,1
24704,4,1,1,0,0,1
24704,3,1,1,0,0,1
6940,9,1,1,0,0,1
6940,8,4,3,0,1,3
6940,7,23,9,0,14,9
6940,6,21,5,0,16,5
6940,5,7,1,0,6,1
6940,4,5,1,0,4,1
188576,9,2,1,0,1,1
188576,8,7,2,1,5,1
188576,6,15,2,0,13,2
188576,5,14,2,0,12,2
188576,3,4,1,0,3,1
188576,2,3,2,0,1,2
188576,1,1,1,0,0,1
253470,10,1,1,0,0,1
253470,9,5,2,0,3,2
253470,8,17,4,0,13,4
253470,7,17,1,0,16,1
253470,6,13,3,0,10,3
253470,2,1,1,0,0,1
22808,8,20,5,0,15,5
22808,7,18,5,0,13,5
22808,6,20,6,0,14,6
22808,5,2,1,0,1,1
22808,4,3,1,0,2,1
25429,5,15,4,0,11,4
25429,4,17,2,0,15,2
25429,3,11,1,0,10,1
25429,2,5,3,0,2,3
5208,10,1,1,0,0,1
5208,8,5,2,0,3,2
5208,7,8,1,0,7,1
5208,6,17,6,0,11,6
5208,5,15,4,0,11,4
5208,4,9,3,0,6,3
5208,2,3,2,0,1,2
2134,10,1,1,0,0,1
2134,9,2,1,0,1,1
2134,7,13,2,0,11,2
2134,6,21,7,0,14,7
2134,5,16,2,0,14,2
2134,3,3,2,0,1,2
2134,1,1,1,0,0,1
140940,8,8,3,0,5,3
140940,7,12,1,0,11,1
140940,6,19,1,0,18,1
140940,5,10,2,0,8,2
140940,4,5,3,0,2,3
140940,3,4,3,0,1,3
13416,9,1,1,0,0,1
13416,6,6,1,0,5,1
13416,5,14,4,0,10,4
13416,4,15,7,0,8,7
13416,3,9,2,0,7,2
13416,2,9,4,0,5,4
13416,1,5,4,0,1,4
207442,10,3,1,0,2,1
207442,8,18,4,0,14,4
207442,7,9,2,0,7,2
207442,6,24,2,0,22,2
8717,10,6,4,0,2,4
8717,9,5,2,0,3,2
8717,8,22,8,0,14,8
8717,7,14,4,0,10,4
8717,6,7,2,0,5,2
8717,5,7,1,0,6,1
8717,3,1,1,0,0,1
138127,9,3,1,0,2,1
138127,7,16,4,0,12,4
138127,6,23,6,0,17,6
138127,3,4,3,0,1,3
221408,10,6,1,0,5,1
221408,9,11,2,0,9,2
221408,8,19,2,0,17,2
221408,7,9,1,0,8,1
221408,6,8,2,0,6,2
221408,4,6,2,0,4,2
15845,7,7,3,0,4,3
15845,6,9,1,0,8,1
15845,5,16,4,0,12,4
15845,4,15,3,0,12,3
15845,3,13,4,0,9,4
114530,8,20,5,0,15,5
114530,7,19,5,0,14,5
114530,6,9,5,0,4,5
114530,5,1,1,0,0,1
114530,4,1,1,0,0,1
114530,2,1,1,0,0,1
114530,1,1,1,0,0,1
149323,7,6,1,0,5,1
149323,6,30,4,0,26,4
149323,5,15,2,0,13,2
149323,4,4,1,0,3,1
149323,3,8,3,0,5,3
25097,8,3,1,0,2,1
25097,6,11,3,0,8,3
25097,5,20,5,0,15,5
25097,4,10,3,0,7,3
25097,3,7,1,0,6,1
25097,2,4,1,0,3,1
25097,1,3,1,0,2,1
6700,10,4,2,0,2,2
6700,9,8,2,0,6,2
6700,8,9,3,0,6,3
6700,7,15,2,0,13,2
6700,6,15,2,0,13,2
6700,5,6,2,0,4,2
6700,4,4,2,0,2,2
5994,8,5,2,0,3,2
5994,7,8,2,0,6,2
5994,6,27,11,0,16,11
5994,5,11,5,0,6,5
5994,4,5,1,0,4,1
5994,3,3,1,0,2,1
5994,2,1,1,0,0,1
7612,6,15,3,0,12,3
7612,5,18,2,0,16,2
7612,4,13,4,0,9,4
7612,3,7,2,0,5,2
7612,2,5,2,0,3,2
243780,10,8,1,0,7,1
243780,9,12,3,0,9,3
243780,8,11,2,0,9,2
243780,7,13,2,0,11,2
243780,6,3,1,0,2,1
243780,2,2,1,0,1,1
243780,1,11,2,0,9,2
20467,8,9,3,0,6,3
20467,7,8,5,0,3,5
20467,6,11,5,0,6,5
20467,5,3,2,0,1,2
20467,4,5,1,0,4,1
223573,10,5,2,0,3,2
223573,8,13,6,0,7,6
223573,7,13,3,1,10,2
223573,6,17,2,1,15,1
223573,5,7,2,0,5,2
223573,3,3,1,0,2,1
11937,9,3,2,0,1,2
11937,7,20,7,0,13,7
11937,6,20,4,0,16,4
11937,5,10,6,0,4,6
11937,3,3,2,0,1,2
33605,9,6,4,0,2,4
33605,8,16,8,0,8,8
33605,7,19,4,0,15,4
33605,6,13,4,0,9,4
33605,5,6,3,0,3,3
33605,4,2,1,0,1,1
33605,2,1,1,0,0,1
9938,6,10,6,0,4,6
9938,5,14,5,0,9,5
9938,4,17,5,0,12,5
9938,3,14,8,0,6,8
9938,2,1,1,0,0,1
9938,1,4,2,0,2,2
1956,10,1,1,0,0,1
1956,9,1,1,0,0,1
1956,7,11,8,0,3,8
1956,6,19,6,0,13,6
1956,5,17,4,0,13,4
1956,4,5,1,0,4,1
1956,2,3,1,0,2,1
17457,7,10,3,0,7,3
17457,6,6,2,0,4,2
17457,5,15,3,0,12,3
17457,4,16,5,0,11,5
17457,3,11,3,0,8,3
17457,2,3,1,0,2,1
11585,10,1,1,0,0,1
11585,8,4,2,0,2,2
11585,7,9,5,0,4,5
11585,6,14,5,0,9,5
11585,5,22,9,0,13,9
11585,4,7,3,0,4,3
11585,2,2,1,0,1,1
8008,10,2,1,0,1,1
8008,8,6,2,0,4,2
8008,7,10,2,0,8,2
8008,6,24,2,0,22,2
8008,5,10,3,0,7,3
8008,4,7,1,0,6,1
8008,3,4,2,0,2,2
62637,10,5,5,0,0,5
62637,9,3,3,0,0,3
62637,8,6,2,0,4,2
62637,7,11,4,0,7,4
62637,6,13,4,0,9,4
62637,5,9,4,0,5,4
62637,4,7,3,0,4,3
62637,3,4,3,0,1,3
62637,2,4,4,0,0,4
209850,8,4,1,0,3,1
209850,7,20,4,0,16,4
209850,6,25,3,0,22,3
209850,5,4,1,0,3,1
96602,10,5,2,0,3,2
96602,9,18,7,0,11,7
96602,8,18,5,0,13,5
96602,7,13,1,0,12,1
96602,6,7,1,0,6,1
96602,5,1,1,0,0,1
11083,9,1,1,0,0,1
11083,8,3,2,0,1,2
11083,7,7,2,0,5,2
11083,6,29,8,0,21,8
11083,5,8,2,0,6,2
11083,4,9,4,0,5,4
11083,3,4,2,0,2,2
13779,8,14,10,0,4,10
13779,7,16,5,0,11,5
13779,6,22,8,0,14,8
13779,5,5,3,0,2,3
13779,4,2,2,0,0,2
100758,7,7,2,0,5,2
100758,6,29,1,0,28,1
100758,5,13,1,0,12,1
100758,4,9,1,0,8,1
11262,10,3,1,0,2,1
11262,8,4,1,0,3,1
11262,7,2,1,0,1,1
11262,6,15,4,0,11,4
11262,5,16,7,0,9,7
11262,4,9,1,0,8,1
11262,3,6,3,0,3,3
158445,9,1,1,0,0,1
158445,8,13,4,0,9,4
158445,7,21,3,0,18,3
158445,6,20,1,0,19,1
158445,5,4,1,0,3,1
158445,3,1,1,0,0,1
73245,8,8,2,0,6,2
73245,7,19,6,0,13,6
73245,6,17,7,0,10,7
73245,5,10,4,0,6,4
73245,4,4,1,0,3,1
73245,2,3,2,0,1,2
1193,8,3,3,0,0,3
1193,7,7,1,0,6,1
1193,6,24,6,0,18,6
1193,5,10,1,0,9,1
1193,4,11,1,0,10,1
1193,3,5,1,0,4,1
1193,2,3,2,0,1,2
8509,9,4,2,0,2,2
8509,8,11,4,0,7,4
8509,7,13,7,0,6,7
8509,6,21,5,0,16,5
8509,5,8,2,0,6,2
8509,4,4,2,0,2,2
10171,8,6,2,0,4,2
10171,7,17,2,0,15,2
10171,6,17,2,0,15,2
10171,4,8,2,0,6,2
55820,6,20,4,0,16,4
55820,5,18,3,0,15,3
55820,4,10,4,0,6,4
55820,3,5,2,0,3,2
18023,8,10,6,0,4,6
18023,7,9,5,0,4,5
18023,6,26,15,0,11,15
18023,5,12,5,0,7,5
18023,4,4,2,0,2,2
18023,3,2,2,0,0,2
15066,8,6,1,0,5,1
15066,7,13,2,0,11,2
15066,6,20,5,0,15,5
15066,5,11,2,0,9,2
15066,4,8,3,0,5,3
15066,3,1,1,0,0,1
155465,10,3,3,0,0,3
155465,9,2,1,0,1,1
155465,8,5,3,0,2,3
155465,7,11,4,1,7,3
155465,5,14,1,0,13,1
155465,4,7,4,1,3,3
155465,3,5,2,1,3,1
155465,2,2,1,0,1,1
155465,1,2,1,1,1,0
7314,10,3,1,0,2,1
7314,8,2,1,0,1,1
7314,7,6,2,0,4,2
7314,6,13,6,0,7,6
7314,5,7,4,0,3,4
7314,4,15,3,0,12,3
7314,3,10,3,0,7,3
7314,2,4,2,0,2,2
7314,1,3,1,0,2,1
5929,10,3,1,0,2,1
5929,8,24,9,0,15,9
5929,7,14,5,0,9,5
5929,6,12,5,0,7,5
5929,3,1,1,0,0,1
5929,2,2,1,0,1,1
12309,8,1,1,0,0,1
12309,7,6,4,0,2,4
12309,6,12,4,0,8,4
12309,5,15,8,0,7,8
12309,4,14,4,0,10,4
12309,3,9,2,0,7,2
12309,2,3,1,0,2,1
12309,1,3,2,0,1,2
127748,9,5,1,0,4,1
127748,7,3,1,0,2,1
127748,6,11,1,0,10,1
127748,4,13,3,0,10,3
127748,3,8,3,0,5,3
127748,2,5,1,0,4,1
127748,1,4,3,1,1,2
90016,10,1,1,0,0,1
90016,7,9,1,0,8,1
90016,6,29,10,0,19,10
90016,5,15,3,0,12,3
90016,4,7,1,0,6,1
107372,10,2,1,0,1,1
107372,8,11,6,0,5,6
107372,7,27,9,0,18,9
107372,6,15,5,0,10,5
107372,5,6,1,0,5,1
5120,9,2,1,0,1,1
5120,8,5,5,0,0,5
5120,7,8,5,0,3,5
5120,6,30,15,0,15,15
5120,5,9,4,0,5,4
5120,4,5,4,0,1,4
5120,3,3,2,0,1,2
37175,10,2,2,0,0,2
37175,8,4,3,0,1,3
37175,6,7,1,0,6,1
37175,5,6,1,0,5,1
37175,4,12,1,0,11,1
37175,3,16,8,0,8,8
37175,2,8,4,0,4,4
37175,1,5,3,0,2,3
4676,10,2,1,0,1,1
4676,8,4,1,0,3,1
4676,7,9,3,0,6,3
4676,6,16,8,0,8,8
4676,5,13,2,0,11,2
4676,4,9,3,0,6,3
4676,3,3,1,0,2,1
4676,2,4,3,0,1,3
168250,10,12,4,0,8,4
168250,9,8,3,0,5,3
168250,8,11,1,0,10,1
168250,7,10,2,0,8,2
168250,6,11,2,0,9,2
168250,1,1,1,0,0,1
2963,10,2,2,0,0,2
2963,9,8,1,0,7,1
2963,8,10,4,0,6,4
2963,7,17,5,0,12,5
2963,6,13,7,0,6,7
2963,5,9,2,0,7,2
21072,9,2,1,0,1,1
21072,7,18,3,0,15,3
21072,6,21,4,0,17,4
21072,5,5,2,0,3,2
3558,10,2,1,0,1,1
3558,9,1,1,0,0,1
3558,8,6,5,0,1,5
3558,7,6,2,0,4,2
3558,6,18,5,0,13,5
3558,5,16,7,0,9,7
3558,4,9,2,0,7,2
3558,3,3,2,0,1,2
3558,2,1,1,0,0,1
3558,1,1,1,0,0,1
26697,10,5,4,0,1,4
26697,8,15,9,0,6,9
26697,7,21,7,0,14,7
26697,6,9,2,0,7,2
26697,5,2,1,0,1,1
26697,4,5,3,0,2,3
26697,3,2,2,0,0,2
26697,2,1,1,0,0,1
104775,10,2,1,0,1,1
104775,8,5,2,0,3,2
104775,7,15,10,0,5,10
104775,6,29,5,0,24,5
104775,5,7,2,0,5,2
104775,4,3,1,0,2,1
209423,10,6,1,0,5,1
209423,9,3,1,0,2,1
209423,8,33,3,0,30,3
209423,7,10,1,0,9,1
15624,8,2,1,0,1,1
15624,7,10,2,0,8,2
15624,6,19,6,0,13,6
15624,5,19,1,0,18,1
15624,4,7,1,0,6,1
15624,3,2,1,0,1,1
186723,10,21,6,0,15,6
186723,9,12,3,0,9,3
186723,8,14,7,0,7,7
186723,7,5,1,0,4,1
186723,6,8,2,0,6,2
186723,4,1,1,0,0,1
4251,8,2,1,0,1,1
4251,7,4,1,0,3,1
4251,6,9,5,0,4,5
4251,4,15,8,0,7,8
4251,3,8,4,0,4,4
4251,2,9,4,0,5,4
5234,6,12,3,0,9,3
5234,5,21,5,0,16,5
5234,4,16,3,0,13,3
5234,3,4,2,0,2,2
5234,2,3,2,0,1,2
38204,10,7,1,0,6,1
38204,9,4,1,0,3,1
38204,8,13,2,0,11,2
38204,7,21,3,0,18,3
38204,6,8,3,0,5,3
38204,5,7,4,0,3,4
38204,4,1,1,0,0,1
38204,3,2,1,0,1,1
8997,7,13,3,0,10,3
8997,6,19,3,0,16,3
8997,5,12,2,0,10,2
8997,4,10,2,0,8,2
8997,3,4,1,0,3,1
3812,9,4,3,0,1,3
3812,8,6,2,0,4,2
3812,7,10,2,0,8,2
3812,6,20,5,0,15,5
3812,5,13,6,0,7,6
3812,3,1,1,0,0,1
3812,2,1,1,0,0,1
60682,10,3,2,0,1,2
60682,9,2,1,0,1,1
60682,8,7,2,0,5,2
60682,7,18,1,0,17,1
60682,6,16,3,0,13,3
60682,5,10,3,0,7,3
60682,4,2,1,0,1,1
60682,3,3,2,0,1,2
60682,2,2,1,0,1,1
2395,10,2,2,0,0,2
2395,8,13,4,0,9,4
2395,7,12,1,0,11,1
2395,6,17,5,0,12,5
2395,5,10,5,0,5,5
2395,4,4,1,0,3,1
2395,3,4,2,0,2,2
2395,2,1,1,0,0,1
39312,9,2,1,0,1,1
39312,8,3,1,0,2,1
39312,7,7,2,0,5,2
39312,6,13,6,0,7,6
39312,5,12,3,0,9,3
39312,4,12,1,0,11,1
39312,3,6,1,0,5,1
39312,2,6,3,0,3,3
9640,9,11,3,0,8,3
9640,8,21,7,0,14,7
9640,7,18,1,0,17,1
9640,6,8,1,0,7,1
9640,5,2,1,0,1,1
8267,9,2,1,0,1,1
8267,7,10,4,0,6,4
8267,6,26,11,0,15,11
8267,5,10,4,0,6,4
8267,4,9,3,0,6,3
8267,3,2,1,0,1,1
8267,2,1,1,0,0,1
226878,7,9,2,0,7,2
226878,6,17,2,0,15,2
226878,4,12,4,0,8,4
226878,2,6,3,0,3,3
226878,1,2,1,0,1,1
7539,10,3,3,0,0,3
7539,9,3,2,0,1,2
7539,8,5,3,0,2,3
7539,7,9,3,0,6,3
7539,6,19,5,0,14,5
7539,5,10,4,0,6,4
7539,4,5,5,0,0,5
7539,3,4,3,0,1,3
7539,1,4,3,0,1,3
209714,10,9,7,0,2,7
209714,9,5,2,0,3,2
209714,8,15,3,0,12,3
209714,6,14,3,0,11,3
209714,5,2,1,0,1,1
209714,4,1,1,0,0,1
209714,3,1,1,0,0,1
99707,7,13,2,0,11,2
99707,6,24,4,0,20,4
99707,5,11,4,0,7,4
99707,4,10,1,0,9,1
26141,8,4,3,0,1,3
26141,7,27,9,0,18,9
26141,6,21,4,0,17,4
26141,5,7,4,0,3,4
12142,9,2,2,0,0,2
12142,8,10,4,0,6,4
12142,7,9,4,0,5,4
12142,6,23,8,0,15,8
12142,5,13,6,0,7,6
12142,3,2,1,0,1,1
12142,1,1,1,0,0,1
157487,10,2,1,0,1,1
157487,8,8,2,0,6,2
157487,7,13,2,0,11,2
157487,6,30,6,0,24,6
157487,4,2,1,0,1,1
575,7,12,1,0,11,1
575,6,24,4,0,20,4
575,5,12,4,0,8,4
575,4,7,2,0,5,2
575,3,2,1,0,1,1
575,2,3,1,0,2,1
20432,9,6,2,0,4,2
20432,8,17,9,0,8,9
20432,7,11,1,0,10,1
20432,6,16,1,0,15,1
20432,5,6,1,0,5,1
20432,4,2,2,0,0,2
20432,1,3,2,0,1,2
31711,9,1,1,0,0,1
31711,8,6,3,0,3,3
31711,7,15,4,0,11,4
31711,6,27,12,1,15,11
31711,5,11,5,0,6,5
31711,4,1,1,0,0,1
31711,3,1,1,0,0,1
10673,10,6,1,0,5,1
10673,9,2,1,0,1,1
10673,8,3,1,0,2,1
10673,6,12,3,0,9,3
10673,5,14,5,0,9,5
10673,4,10,3,0,7,3
10673,3,5,1,0,4,1
10673,1,5,1,0,4,1
132203,9,3,1,0,2,1
132203,8,9,1,0,8,1
132203,6,9,1,0,8,1
132203,4,9,1,0,8,1
132203,2,6,1,0,5,1
132203,1,7,2,0,5,2
8132,8,4,2,0,2,2
8132,7,11,6,0,5,6
8132,6,24,8,0,16,8
8132,5,12,6,0,6,6
8132,3,3,1,0,2,1
8132,2,2,1,0,1,1
41148,6,19,2,0,17,2
41148,5,10,1,0,9,1
26122,7,6,1,0,5,1
26122,6,17,2,0,15,2
26122,5,9,3,0,6,3
26122,4,11,2,0,9,2
26122,3,11,3,0,8,3
26620,10,3,1,0,2,1
26620,9,6,3,0,3,3
26620,8,16,4,0,12,4
26620,7,15,2,0,13,2
26620,6,14,2,0,12,2
26620,4,4,1,0,3,1
6374,9,3,1,0,2,1
6374,8,16,10,0,6,10
6374,7,14,4,0,10,4
6374,6,19,4,0,15,4
6374,5,5,3,0,2,3
6374,4,3,2,0,1,2
6374,3,2,1,0,1,1
186442,8,6,1,0,5,1
186442,7,11,4,0,7,4
186442,6,19,3,0,16,3
186442,4,7,1,0,6,1
186442,3,5,1,0,4,1
186442,2,2,2,0,0,2
2858,10,4,4,0,0,4
2858,9,3,2,0,1,2
2858,8,4,2,0,2,2
2858,7,5,2,0,3,2
2858,6,14,2,0,12,2
2858,5,11,3,0,8,3
2858,4,12,1,0,11,1
2858,3,5,3,0,2,3
2858,1,2,1,0,1,1
97751,8,5,1,0,4,1
97751,7,14,5,0,9,5
97751,6,32,8,0,24,8
97751,5,10,5,0,5,5
97751,4,2,1,0,1,1
8728,9,5,1,0,4,1
8728,8,9,4,0,5,4
8728,7,11,5,0,6,5
8728,6,20,8,0,12,8
8728,5,12,4,0,8,4
8728,4,3,1,0,2,1
8728,2,1,1,0,0,1
5449,7,9,1,0,8,1
5449,6,18,5,0,13,5
5449,5,13,2,0,11,2
5449,4,13,4,0,9,4
5449,3,5,2,0,3,2
1735,10,1,1,0,0,1
1735,8,5,5,0,0,5
1735,7,10,2,0,8,2
1735,6,20,7,0,13,7
1735,5,21,8,0,13,8
1735,4,2,1,0,1,1
158895,9,5,1,0,4,1
158895,8,17,4,2,13,2
158895,7,8,1,0,7,1
158895,6,16,4,0,12,4
158895,5,5,1,0,4,1
158895,3,3,1,0,2,1
158895,1,2,1,0,1,1
7924,8,3,3,0,0,3
7924,7,7,5,0,2,5
7924,6,11,4,0,7,4
7924,5,15,8,0,7,8
7924,4,11,7,0,4,7
7924,3,9,3,0,6,3
7924,2,4,1,0,3,1
7924,1,2,1,0,1,1
39189,10,10,3,0,7,3
39189,9,5,3,0,2,3
39189,8,22,8,0,14,8
39189,7,11,3,0,8,3
39189,6,12,4,0,8,4
39189,3,1,1,0,0,1
1650,10,3,2,0,1,2
1650,9,4,3,0,1,3
1650,8,5,3,0,2,3
1650,7,7,2,0,5,2
1650,6,17,4,0,13,4
1650,5,19,7,0,12,7
37099,8,13,4,0,9,4
37099,7,12,4,0,8,4
37099,6,17,11,0,6,11
37099,5,10,5,0,5,5
37099,4,9,5,0,4,5
37099,3,2,1,0,1,1
613,10,2,1,0,1,1
613,7,4,1,0,3,1
613,6,24,5,0,19,5
613,5,16,2,0,14,2
613,4,7,4,0,3,4
613,3,4,3,0,1,3
613,2,1,1,0,0,1
6897,8,11,5,0,6,5
6897,7,16,5,0,11,5
6897,6,18,6,0,12,6
6897,5,8,3,0,5,3
6897,4,4,2,0,2,2
6897,3,2,1,0,1,1
143487,10,5,3,0,2,3
143487,9,13,4,0,9,4
143487,8,21,6,0,15,6
143487,7,12,1,0,11,1
143487,6,6,1,0,5,1
143487,4,1,1,0,0,1
237629,8,15,1,0,14,1
237629,7,22,2,0,20,2
237629,6,19,2,0,17,2
35492,8,11,2,0,9,2
35492,7,14,3,0,11,3
35492,5,12,2,0,10,2
35492,4,3,1,0,2,1
35492,3,4,2,0,2,2
6365,10,7,2,0,5,2
6365,9,5,3,0,2,3
6365,8,4,2,0,2,2
6365,6,9,2,0,7,2
6365,5,11,1,0,10,1
6365,4,7,1,0,6,1
6365,3,4,3,0,1,3
6365,2,3,2,0,1,2
6365,1,3,1,0,2,1
25312,8,18,1,0,17,1
25312,7,16,2,0,14,2
25312,6,10,1,0,9,1
25312,5,7,2,0,5,2
25312,4,1,1,0,0,1
25924,7,8,1,0,7,1
25924,6,24,3,0,21,3
25924,5,13,1,0,12,1
25924,3,2,1,0,1,1
25924,1,2,1,0,1,1
182101,9,4,1,0,3,1
182101,8,8,3,0,5,3
182101,6,26,4,0,22,4
182101,5,5,2,0,3,2
182101,3,3,1,0,2,1
126026,8,23,2,0,21,2
126026,7,18,6,0,12,6
126026,6,10,1,0,9,1
126026,5,3,2,0,1,2
126026,2,1,1,0,0,1
25618,9,8,4,0,4,4
25618,8,14,5,0,9,5
25618,7,13,2,0,11,2
25618,6,14,7,0,7,7
25618,5,4,2,0,2,2
25618,4,2,1,0,1,1
25618,3,3,1,0,2,1
25618,2,1,1,0,0,1
25618,1,1,1,0,0,1
15193,9,1,1,0,0,1
15193,8,16,8,0,8,8
15193,7,17,10,0,7,10
15193,6,16,11,0,5,11
15193,5,7,3,0,4,3
15193,4,3,2,0,1,2
15193,3,1,1,0,0,1
250865,10,1,1,0,0,1
250865,8,19,4,0,15,4
250865,7,16,3,1,13,2
250865,5,5,2,0,3,2
250865,4,1,1,0,0,1
250865,3,1,1,0,0,1
7296,8,6,2,0,4,2
7296,7,11,3,0,8,3
7296,6,14,6,0,8,6
7296,5,14,6,0,8,6
7296,3,5,2,0,3,2
162288,9,4,1,0,3,1
162288,8,9,3,2,6,1
162288,7,14,3,1,11,2
162288,6,18,2,0,16,2
162288,5,8,3,0,5,3
162288,4,4,3,0,1,3
162288,3,4,1,0,3,1
148309,9,5,2,0,3,2
148309,8,27,9,0,18,9
148309,7,21,8,0,13,8
148309,6,4,1,0,3,1
148309,5,4,2,0,2,2
21331,9,1,1,0,0,1
21331,7,4,2,0,2,2
21331,6,12,1,0,11,1
21331,5,13,2,0,11,2
21331,4,11,2,0,9,2
21331,2,4,1,0,3,1
627,9,1,1,0,0,1
627,8,14,4,0,10,4
627,7,20,8,0,12,8
627,6,13,5,0,8,5
627,5,6,2,0,4,2
627,4,5,2,0,3,2
627,3,1,1,0,0,1
259298,10,6,2,1,4,1
259298,9,16,1,1,15,0
259298,8,41,11,3,30,8
259298,7,10,3,0,7,3
259298,5,1,1,0,0,1
29142,8,2,1,0,1,1
29142,7,7,2,0,5,2
29142,6,10,4,0,6,4
29142,5,19,5,0,14,5
29142,4,15,4,0,11,4
29142,3,5,1,0,4,1
29142,1,2,1,0,1,1
6017,9,4,3,0,1,3
6017,8,7,4,0,3,4
6017,7,22,10,0,12,10
6017,6,17,5,0,12,5
6017,5,3,1,0,2,1
6017,4,6,2,0,4,2
202513,10,9,6,0,3,6
202513,9,4,1,1,3,0
202513,8,17,2,0,15,2
202513,7,13,2,0,11,2
202513,6,13,3,0,10,3
202513,5,2,1,0,1,1
233996,10,14,8,0,6,8
233996,8,18,5,0,13,5
233996,7,18,3,0,15,3
23373,8,5,3,0,2,3
23373,7,10,2,0,8,2
23373,6,20,8,0,12,8
23373,5,13,5,0,8,5
23373,4,8,5,0,3,5
23373,1,3,1,0,2,1
5045,10,3,1,0,2,1
5045,9,6,2,0,4,2
5045,8,18,6,0,12,6
5045,7,20,5,0,15,5
5045,6,11,4,0,7,4
5045,5,3,1,0,2,1
1071,10,2,1,0,1,1
1071,9,2,2,0,0,2
1071,8,15,3,0,12,3
1071,7,13,6,0,7,6
1071,6,18,3,0,15,3
1071,5,8,2,0,6,2
1071,4,3,2,0,1,2
246346,10,4,1,0,3,1
246346,8,5,2,0,3,2
246346,7,19,5,0,14,5
246346,6,21,3,1,18,2
246346,5,7,1,0,6,1
246346,3,2,1,0,1,1
246346,2,2,1,0,1,1
31516,8,15,6,0,9,6
31516,7,20,3,0,17,3
31516,6,17,1,0,16,1
31516,5,6,2,0,4,2
129988,8,4,1,0,3,1
129988,7,12,2,0,10,2
129988,5,16,6,0,10,6
129988,3,1,1,0,0,1
129988,2,1,1,0,0,1
9233,9,2,1,0,1,1
9233,8,3,1,0,2,1
9233,7,20,7,0,13,7
9233,6,17,1,0,16,1
9233,4,7,3,0,4,3
9233,3,4,2,0,2,2
9233,1,1,1,0,0,1
218465,8,8,2,0,6,2
218465,7,11,1,0,10,1
218465,6,22,2,0,20,2
218465,5,11,1,0,10,1
228452,9,6,2,0,4,2
228452,8,22,11,0,11,11
228452,7,12,2,0,10,2
228452,6,13,5,0,8,5
228452,5,1,1,0,0,1
228452,4,1,1,0,0,1
3241,10,1,1,0,0,1
3241,9,3,1,0,2,1
3241,8,9,4,0,5,4
3241,7,25,12,0,13,12
3241,6,18,4,0,14,4
3241,4,2,2,0,0,2
158747,10,4,1,0,3,1
158747,9,6,1,0,5,1
158747,8,9,3,0,6,3
158747,7,7,1,0,6,1
158747,6,13,7,2,6,5
158747,5,7,3,2,4,1
158747,4,7,3,0,4,3
158747,2,4,2,0,2,2
226457,9,5,1,0,4,1
226457,8,11,5,0,6,5
226457,7,14,6,0,8,6
226457,6,12,4,0,8,4
226457,4,5,1,0,4,1
226457,3,4,1,0,3,1
3020,9,1,1,0,0,1
3020,7,7,2,0,5,2
3020,6,12,3,0,9,3
3020,5,12,1,0,11,1
3020,4,12,4,0,8,4
3020,3,6,3,0,3,3
3020,2,5,1,0,4,1
92759,10,3,2,0,1,2
92759,9,9,4,0,5,4
92759,8,18,10,0,8,10
92759,7,15,4,0,11,4
92759,6,12,4,0,8,4
92759,5,3,2,0,1,2
9438,9,2,1,0,1,1
9438,8,6,3,0,3,3
9438,7,15,8,0,7,8
9438,6,25,11,0,14,11
9438,5,7,3,0,4,3
9438,4,4,4,0,0,4
9438,3,1,1,0,0,1
12494,8,1,1,0,0,1
12494,7,3,2,0,1,2
12494,6,18,11,0,7,11
12494,5,17,8,0,9,8
12494,4,10,4,0,6,4
12494,3,7,3,0,4,3
12494,1,2,2,0,0,2
195195,7,14,4,1,10,3
195195,6,16,2,1,14,1
195195,5,16,5,0,11,5
195195,3,4,3,0,1,3
195195,2,4,1,0,3,1
195195,1,1,1,0,0,1
181615,9,1,1,0,0,1
181615,8,16,3,0,13,3
181615,6,13,2,0,11,2
181615,5,9,3,0,6,3
181615,1,1,1,0,0,1
84989,10,4,1,0,3,1
84989,9,7,1,0,6,1
84989,8,17,1,0,16,1
84989,7,22,4,0,18,4
84989,6,7,2,0,5,2
84989,5,2,1,0,1,1
255332,10,3,1,0,2,1
255332,9,1,1,0,0,1
255332,8,21,4,0,17,4
255332,7,17,4,0,13,4
255332,6,11,4,0,7,4
255332,5,4,1,0,3,1
255332,4,2,1,0,1,1
255332,3,2,1,0,1,1
226643,9,3,1,0,2,1
226643,8,6,2,1,4,1
226643,7,16,3,1,13,2
226643,6,26,5,0,21,5
226643,5,6,1,0,5,1
226643,2,1,1,0,0,1
42704,8,22,5,0,17,5
42704,7,13,2,0,11,2
42704,6,13,2,0,11,2
42704,4,2,1,0,1,1
2352,7,4,3,0,1,3
2352,6,23,6,0,17,6
2352,5,20,4,0,16,4
2352,4,5,3,0,2,3
2352,3,5,4,0,1,4
2352,2,2,2,0,0,2
8679,10,10,4,0,6,4
8679,9,9,3,0,6,3
8679,8,18,4,0,14,4
8679,7,10,3,0,7,3
8679,6,9,1,0,8,1
8679,3,2,1,0,1,1
8679,1,2,1,0,1,1
246315,9,3,1,0,2,1
246315,7,15,2,0,13,2
246315,6,23,4,0,19,4
246315,5,8,3,0,5,3
246315,2,1,1,0,0,1
246315,1,1,1,0,0,1
175496,8,12,3,0,9,3
175496,7,13,4,0,9,4
175496,6,18,6,0,12,6
175496,5,11,3,0,8,3
175496,4,4,1,0,3,1
10518,8,2,2,0,0,2
10518,7,10,2,0,8,2
10518,6,7,3,0,4,3
10518,5,22,8,0,14,8
10518,4,9,2,0,7,2
10518,2,6,1,0,5,1
103806,9,5,2,0,3,2
103806,8,5,1,0,4,1
103806,7,13,5,0,8,5
103806,6,15,2,0,13,2
103806,5,11,2,0,9,2
103806,4,7,1,0,6,1
170195,10,7,3,1,4,2
170195,9,12,4,0,8,4
170195,8,16,2,0,14,2
170195,7,9,2,0,7,2
170195,6,12,2,0,10,2
170195,4,1,1,0,0,1
54073,8,5,3,0,2,3
54073,7,12,3,0,9,3
54073,6,27,5,0,22,5
54073,5,14,5,0,9,5
54073,4,2,1,0,1,1
8321,9,1,1,0,0,1
8321,7,5,4,0,1,4
8321,6,20,11,0,9,11
8321,5,15,7,0,8,7
8321,4,12,4,0,8,4
8321,3,5,1,0,4,1
8321,2,3,1,0,2,1
8321,1,1,1,0,0,1
2354,10,1,1,0,0,1
2354,8,6,3,0,3,3
2354,7,14,6,0,8,6
2354,6,15,3,0,12,3
2354,5,17,2,0,15,2
2354,4,1,1,0,0,1
2354,3,2,2,0,0,2
168840,6,22,5,0,17,5
168840,5,10,1,0,9,1
168840,4,12,3,0,9,3
168840,3,7,3,0,4,3
168840,2,1,1,0,0,1
168840,1,1,1,0,0,1
13218,10,3,1,0,2,1
13218,9,8,1,0,7,1
13218,8,24,10,0,14,10
13218,7,14,2,0,12,2
13218,6,8,1,0,7,1
13218,5,4,1,0,3,1
13218,4,1,1,0,0,1
92646,8,1,1,0,0,1
92646,7,6,1,0,5,1
92646,6,23,2,0,21,2
92646,5,15,1,0,14,1
92646,2,3,1,0,2,1
93555,9,1,1,0,0,1
93555,8,6,1,0,5,1
93555,7,16,3,0,13,3
93555,6,24,3,0,21,3
93555,5,8,2,0,6,2
93555,4,3,2,0,1,2
93555,1,1,1,0,0,1
80474,8,7,5,0,2,5
80474,7,21,9,0,12,9
80474,6,21,5,0,16,5
80474,5,8,5,0,3,5
80474,4,3,1,0,2,1
63161,9,8,2,0,6,2
63161,8,17,3,0,14,3
63161,7,15,7,0,8,7
63161,6,14,5,0,9,5
63161,5,3,3,0,0,3
63161,4,3,2,0,1,2
63161,3,2,2,0,0,2
62291,10,13,5,0,8,5
62291,9,18,5,0,13,5
62291,8,19,2,0,17,2
62291,7,6,2,0,4,2
62291,6,1,1,0,0,1
62291,1,3,1,0,2,1
145492,8,8,1,0,7,1
145492,7,21,4,0,17,4
145492,6,20,1,0,19,1
145492,5,7,1,0,6,1
37391,8,5,1,0,4,1
37391,7,12,2,0,10,2
37391,6,18,4,0,14,4
37391,5,8,1,0,7,1
37391,4,4,3,0,1,3
21990,10,6,3,0,3,3
21990,9,2,1,0,1,1
21990,8,7,3,0,4,3
21990,7,8,3,0,5,3
21990,6,15,7,0,8,7
21990,4,3,1,0,2,1
21990,3,5,2,0,3,2
21990,2,5,1,0,4,1
21990,1,4,1,0,3,1
6053,9,1,1,0,0,1
6053,7,13,2,0,11,2
6053,6,28,5,0,23,5
6053,4,4,1,0,3,1
6053,3,1,1,0,0,1
5322,8,5,3,0,2,3
5322,7,16,9,0,7,9
5322,6,16,2,0,14,2
5322,5,8,2,0,6,2
5322,4,7,4,0,3,4
5322,3,5,2,0,3,2
5322,2,2,1,0,1,1
249552,10,6,1,0,5,1
249552,9,10,1,0,9,1
249552,8,29,3,0,26,3
249552,7,12,3,0,9,3
249552,6,2,1,0,1,1
249552,5,3,2,0,1,2
148099,8,6,1,1,5,0
148099,7,9,1,0,8,1
148099,6,23,7,0,16,7
148099,5,11,3,1,8,2
148099,4,6,3,0,3,3
148099,2,3,1,0,2,1
148099,1,2,1,0,1,1
9174,8,3,1,0,2,1
9174,7,5,1,0,4,1
9174,6,26,3,0,23,3
9174,4,14,1,0,13,1
9174,3,4,1,0,3,1
9174,2,1,1,0,0,1
84922,8,23,3,0,20,3
84922,7,18,1,0,17,1
84922,6,11,4,0,7,4
84922,5,4,1,0,3,1
84922,3,3,1,0,2,1
17054,10,1,1,0,0,1
17054,9,7,4,0,3,4
17054,8,9,2,0,7,2
17054,7,11,2,0,9,2
17054,6,15,6,0,9,6
17054,5,5,2,0,3,2
17054,4,9,1,0,8,1
17054,3,3,2,0,1,2
17054,2,2,1,0,1,1
32004,9,1,1,0,0,1
32004,7,15,8,0,7,8
32004,6,21,6,0,15,6
32004,5,11,3,0,8,3
32004,4,6,3,0,3,3
32004,2,3,2,0,1,2
2308,6,8,3,0,5,3
2308,5,22,10,0,12,10
2308,4,16,8,0,8,8
2308,3,11,6,0,5,6
2308,2,3,1,0,2,1
2308,1,1,1,0,0,1
181906,8,13,2,0,11,2
181906,6,16,6,0,10,6
4011,10,2,2,0,0,2
4011,9,3,1,0,2,1
4011,8,16,8,0,8,8
4011,7,18,9,0,9,9
4011,6,13,5,0,8,5
4011,3,2,1,0,1,1
1861,9,1,1,0,0,1
1861,8,5,2,0,3,2
1861,7,8,3,0,5,3
1861,6,21,4,0,17,4
1861,5,11,4,0,7,4
1861,4,6,1,0,5,1
1861,3,6,1,0,5,1
5481,10,4,2,0,2,2
5481,9,4,3,0,1,3
5481,8,15,7,0,8,7
5481,7,19,7,0,12,7
5481,6,11,7,0,4,7
5481,5,5,1,0,4,1
5481,2,1,1,0,0,1
5481,1,2,2,0,0,2
3245,10,6,2,0,4,2
3245,8,4,2,0,2,2
3245,7,10,4,0,6,4
3245,6,21,6,0,15,6
3245,5,12,3,0,9,3
3245,4,3,1,0,2,1
3245,3,4,1,0,3,1
1537,8,4,1,0,3,1
1537,7,7,3,0,4,3
1537,6,20,5,0,15,5
1537,5,16,3,0,13,3
1537,4,10,6,0,4,6
1537,3,3,2,0,1,2
1537,2,2,1,0,1,1
207203,10,43,19,0,24,19
207203,9,8,1,0,7,1
207203,8,5,1,0,4,1
207203,1,3,2,0,1,2
136229,10,6,2,0,4,2
136229,9,3,3,0,0,3
136229,8,20,6,0,14,6
136229,7,15,5,0,10,5
136229,6,10,3,0,7,3
136229,5,3,1,0,2,1
156358,10,2,1,0,1,1
156358,9,6,1,0,5,1
156358,8,4,2,0,2,2
156358,7,7,1,0,6,1
156358,6,23,3,0,20,3
156358,5,7,2,0,5,2
156358,4,3,2,0,1,2
156358,3,5,1,0,4,1
156358,2,4,2,0,2,2
21987,9,1,1,0,0,1
21987,7,15,6,0,9,6
21987,6,25,6,0,19,6
21987,5,14,2,0,12,2
21987,4,4,1,0,3,1
35453,10,4,1,0,3,1
35453,9,18,5,0,13,5
35453,8,22,7,0,15,7
35453,7,12,3,0,9,3
35453,6,3,1,0,2,1
35453,4,1,1,0,0,1
247963,8,14,2,0,12,2
247963,7,17,2,0,15,2
247963,6,16,2,0,14,2
247963,4,3,1,0,2,1
247963,3,3,2,0,1,2
8651,7,17,2,0,15,2
8651,6,25,4,0,21,4
7253,9,6,2,0,4,2
7253,8,15,3,0,12,3
7253,7,20,5,0,15,5
7253,6,12,2,0,10,2
8461,9,4,1,0,3,1
8461,8,9,3,0,6,3
8461,7,18,10,0,8,10
8461,6,13,6,0,7,6
8461,5,7,1,0,6,1
8461,2,2,1,0,1,1
24884,8,4,1,0,3,1
24884,7,14,7,0,7,7
24884,6,18,8,0,10,8
24884,5,19,4,0,15,4
24884,4,4,1,0,3,1
28306,7,8,2,0,6,2
28306,6,26,9,0,17,9
28306,5,9,3,0,6,3
28306,4,8,4,0,4,4
130997,10,4,1,0,3,1
130997,9,9,2,0,7,2
130997,8,25,2,0,23,2
130997,7,9,3,0,6,3
130997,5,3,1,0,2,1
130997,2,1,1,0,0,1
30951,8,7,3,0,4,3
30951,7,12,3,0,9,3
30951,6,17,3,0,14,3
30951,5,12,2,0,10,2
30951,4,9,2,0,7,2
30951,3,3,3,0,0,3
13239,7,8,4,0,4,4
13239,6,16,6,0,10,6
13239,5,16,7,0,9,7
13239,4,7,2,0,5,2
13239,3,8,4,0,4,4
13239,2,2,2,0,0,2
230553,9,9,2,0,7,2
230553,8,22,4,0,18,4
230553,6,15,1,0,14,1
230553,4,1,1,0,0,1
6915,9,2,1,0,1,1
6915,7,9,2,0,7,2
6915,6,22,10,0,12,10
6915,5,12,5,0,7,5
6915,4,8,4,0,4,4
6915,3,2,2,0,0,2
135327,7,17,2,0,15,2
135327,6,26,1,0,25,1
135327,5,10,1,0,9,1
130223,8,6,2,0,4,2
130223,7,16,2,0,14,2
130223,6,21,3,0,18,3
130223,5,12,2,0,10,2
130223,4,4,1,0,3,1
130223,3,2,2,0,0,2
146388,10,2,2,0,0,2
146388,7,11,5,0,6,5
146388,6,17,4,0,13,4
146388,5,15,1,0,14,1
146388,4,8,3,0,5,3
146388,1,1,1,0,0,1
13017,10,2,1,0,1,1
13017,9,1,1,0,0,1
13017,8,3,2,0,1,2
13017,7,7,3,0,4,3
13017,6,25,5,0,20,5
13017,5,13,3,0,10,3
13017,4,7,1,0,6,1
13017,3,3,1,0,2,1
9870,9,9,2,0,7,2
9870,8,18,7,0,11,7
9870,7,16,6,0,10,6
9870,6,12,1,0,11,1
9870,4,2,1,0,1,1
239682,10,5,4,1,1,3
239682,9,3,2,0,1,2
239682,8,10,2,1,8,1
239682,7,18,4,1,14,3
239682,6,16,4,3,12,1
12511,7,3,1,0,2,1
12511,6,18,6,0,12,6
12511,5,7,4,0,3,4
12511,4,16,7,0,9,7
12511,3,10,5,0,5,5
12511,2,5,1,0,4,1
9878,9,2,1,0,1,1
9878,7,1,1,0,0,1
9878,6,8,1,0,7,1
9878,5,18,8,0,10,8
9878,4,15,1,0,14,1
9878,3,8,3,0,5,3
75890,10,7,2,0,5,2
75890,9,7,2,0,5,2
75890,8,20,8,0,12,8
75890,7,16,3,0,13,3
75890,6,10,6,0,4,6
1227,9,2,1,0,1,1
1227,7,14,4,0,10,4
1227,6,22,8,0,14,8
1227,5,7,1,0,6,1
1227,4,5,3,0,2,3
1227,3,5,1,0,4,1
1227,2,3,1,0,2,1
2430,9,1,1,0,0,1
2430,8,3,1,0,2,1
2430,7,5,2,0,3,2
2430,6,19,4,0,15,4
2430,5,16,6,0,10,6
2430,3,5,3,0,2,3
2430,1,1,1,0,0,1
4855,7,13,5,0,8,5
4855,6,22,7,0,15,7
4855,5,5,1,0,4,1
4855,4,2,1,0,1,1
14553,10,4,2,0,2,2
14553,7,15,1,0,14,1
14553,6,18,4,0,14,4
14553,5,3,1,0,2,1
14553,2,3,1,0,2,1
7082,9,5,2,0,3,2
7082,8,6,1,0,5,1
7082,7,23,10,0,13,10
7082,6,16,7,0,9,7
7082,5,7,3,0,4,3
7082,4,1,1,0,0,1
7082,2,2,2,0,0,2
7082,1,1,1,0,0,1
159685,10,2,1,0,1,1
159685,9,13,6,0,7,6
159685,8,16,5,2,11,3
159685,6,10,2,0,8,2
159685,5,4,2,0,2,2
695,10,1,1,0,0,1
695,8,9,4,0,5,4
695,7,17,7,0,10,7
695,6,20,6,0,14,6
695,5,6,5,0,1,5
695,4,6,1,0,5,1
2545,10,1,1,0,0,1
2545,9,2,1,0,1,1
2545,7,13,6,0,7,6
2545,6,15,5,0,10,5
2545,5,19,6,0,13,6
2545,4,7,2,0,5,2
2545,3,2,2,0,0,2
6003,9,2,1,0,1,1
6003,8,5,2,0,3,2
6003,7,12,2,0,10,2
6003,6,19,5,0,14,5
6003,5,14,4,0,10,4
6003,4,4,1,0,3,1
6003,3,3,1,0,2,1
6003,1,1,1,0,0,1
409,6,19,4,0,15,4
409,5,14,2,0,12,2
409,4,15,2,0,13,2
409,3,5,1,0,4,1
409,2,5,1,0,4,1
33646,8,4,2,0,2,2
33646,7,5,1,0,4,1
33646,6,23,6,0,17,6
33646,5,16,5,0,11,5
33646,4,7,3,0,4,3
33646,2,1,1,0,0,1
33646,1,1,1,0,0,1
138589,10,5,2,0,3,2
138589,9,10,5,0,5,5
138589,8,21,2,0,19,2
138589,7,11,2,0,9,2
138589,6,7,2,0,5,2
138589,4,2,1,0,1,1
138589,3,1,1,0,0,1
2690,7,11,2,0,9,2
2690,6,22,1,0,21,1
2690,5,15,3,0,12,3
2690,4,5,4,0,1,4
104351,8,2,1,0,1,1
104351,7,18,5,0,13,5
104351,6,20,5,0,15,5
104351,5,10,5,0,5,5
104351,4,6,4,0,2,4
104351,3,3,2,0,1,2
104351,2,2,1,0,1,1
143843,7,18,5,0,13,5
143843,6,21,4,0,17,4
143843,5,6,1,0,5,1
143843,2,2,1,0,1,1
14383,6,8,3,0,5,3
14383,4,16,4,0,12,4
14383,3,11,2,0,9,2
14383,2,9,2,0,7,2
14383,1,4,1,0,3,1
32025,8,6,1,0,5,1
32025,7,15,3,0,12,3
32025,6,22,8,0,14,8
32025,5,10,5,0,5,5
32025,4,6,1,0,5,1
4360,8,5,2,0,3,2
4360,7,8,2,0,6,2
4360,6,20,10,0,10,10
4360,5,18,10,0,8,10
4360,3,3,1,0,2,1
4360,2,2,1,0,1,1
30255,7,4,1,0,3,1
30255,6,9,3,0,6,3
30255,5,10,5,0,5,5
30255,4,19,5,0,14,5
30255,3,11,4,0,7,4
30255,2,5,1,0,4,1
30255,1,2,1,0,1,1
21563,9,3,2,0,1,2
21563,8,4,1,0,3,1
21563,7,7,2,0,5,2
21563,6,17,2,0,15,2
21563,5,12,2,0,10,2
21563,4,15,6,0,9,6
6611,10,2,2,0,0,2
6611,9,6,3,0,3,3
6611,8,13,9,0,4,9
6611,7,10,3,0,7,3
6611,6,15,5,0,10,5
6611,5,6,4,0,2,4
6611,4,4,2,0,2,2
6611,3,2,1,0,1,1
6611,2,1,1,0,0,1
6611,1,2,2,0,0,2
2589,8,4,3,0,1,3
2589,7,9,4,0,5,4
2589,6,15,8,0,7,8
2589,5,16,4,0,12,4
2589,4,11,1,0,10,1
2589,2,3,1,0,2,1
200257,10,4,2,0,2,2
200257,9,4,1,0,3,1
200257,8,12,5,0,7,5
200257,6,12,2,0,10,2
200257,5,10,3,0,7,3
200257,4,7,2,0,5,2
200257,3,2,1,0,1,1
40115,8,5,3,0,2,3
40115,7,9,2,0,7,2
40115,6,17,4,0,13,4
40115,5,11,1,0,10,1
40115,4,11,3,0,8,3
40115,3,2,1,0,1,1
40115,2,2,1,0,1,1
10022,10,3,2,0,1,2
10022,9,7,2,0,5,2
10022,8,18,8,0,10,8
10022,7,19,4,0,15,4
10022,6,7,1,0,6,1
10022,5,3,1,0,2,1
10022,4,2,1,0,1,1
31454,10,2,1,0,1,1
31454,8,7,3,0,4,3
31454,7,21,6,0,15,6
31454,6,20,3,0,17,3
29505,6,12,1,0,11,1
29505,5,13,1,0,12,1
29505,4,14,3,0,11,3
29505,3,5,1,0,4,1
29505,2,7,3,0,4,3
11532,7,5,2,0,3,2
11532,6,4,2,0,2,2
11532,5,9,4,0,5,4
11532,4,3,2,0,1,2
11532,3,7,4,0,3,4
11532,2,8,4,0,4,4
11532,1,20,12,0,8,12
4784,10,2,1,0,1,1
4784,9,3,2,0,1,2
4784,8,9,3,0,6,3
4784,7,9,1,0,8,1
4784,6,15,4,0,11,4
4784,5,9,5,0,4,5
4784,4,6,4,0,2,4
4784,3,7,1,0,6,1
2198,10,2,1,0,1,1
2198,9,1,1,0,0,1
2198,8,4,1,0,3,1
2198,7,11,8,0,3,8
2198,6,21,4,0,17,4
2198,5,11,3,0,8,3
2198,4,5,2,0,3,2
2198,3,1,1,0,0,1
2198,2,2,1,0,1,1
2198,1,1,1,0,0,1
3075,9,2,1,0,1,1
3075,8,7,3,0,4,3
3075,7,16,9,0,7,9
3075,6,14,6,0,8,6
3075,5,12,3,0,9,3
3075,4,6,2,0,4,2
3075,3,3,2,0,1,2
3075,1,1,1,0,0,1
211813,10,8,5,0,3,5
211813,9,14,4,0,10,4
211813,8,22,6,0,16,6
211813,7,8,1,0,7,1
211813,6,6,2,0,4,2
23378,9,4,1,0,3,1
23378,8,9,4,0,5,4
23378,7,16,7,0,9,7
23378,6,20,12,0,8,12
23378,5,8,3,0,5,3
47258,7,10,4,1,6,3
47258,6,15,5,0,10,5
47258,5,14,7,0,7,7
47258,4,12,4,0,8,4
47258,3,4,2,0,2,2
20441,10,4,3,0,1,3
20441,9,8,1,0,7,1
20441,8,12,4,0,8,4
20441,7,23,8,0,15,8
20441,6,7,1,0,6,1
20441,4,2,1,0,1,1
20441,3,2,1,0,1,1
80028,7,7,1,0,6,1
80028,6,24,4,0,20,4
80028,5,6,2,0,4,2
80028,3,4,1,0,3,1
80028,2,4,3,0,1,3
80028,1,1,1,0,0,1
141337,9,2,1,0,1,1
141337,8,2,1,0,1,1
141337,7,12,4,0,8,4
141337,6,19,2,0,17,2
141337,5,13,1,0,12,1
141337,4,4,2,0,2,2
141337,2,1,1,0,0,1
141337,1,1,1,0,0,1
85286,9,1,1,0,0,1
85286,8,2,2,0,0,2
85286,6,17,1,0,16,1
85286,5,10,1,0,9,1
85286,4,13,6,0,7,6
85286,3,7,4,0,3,4
13306,8,1,1,0,0,1
13306,6,13,4,0,9,4
13306,5,8,3,0,5,3
13306,4,7,2,0,5,2
13306,3,13,3,0,10,3
13306,2,10,5,0,5,5
13306,1,6,2,0,4,2
19478,9,2,2,0,0,2
19478,8,2,1,0,1,1
19478,7,3,2,0,1,2
19478,6,7,3,0,4,3
19478,5,9,2,0,7,2
19478,4,7,3,0,4,3
19478,3,15,7,0,8,7
19478,2,12,7,0,5,7
19478,1,4,3,0,1,3
234511,8,6,4,0,2,4
234511,7,12,2,0,10,2
234511,6,22,4,0,18,4
234511,5,10,1,0,9,1
234511,4,6,2,0,4,2
234511,2,1,1,0,0,1
70262,7,6,2,0,4,2
70262,6,28,3,0,25,3
14559,10,2,1,0,1,1
14559,9,10,2,0,8,2
14559,8,22,7,0,15,7
14559,7,15,4,0,11,4
14559,3,1,1,0,0,1
7562,10,2,1,0,1,1
7562,8,4,2,0,2,2
7562,7,22,4,0,18,4
7562,6,19,9,0,10,9
7562,5,7,2,0,5,2
7562,4,3,1,0,2,1
7562,2,2,1,0,1,1
219766,10,2,1,0,1,1
219766,9,4,1,0,3,1
219766,8,23,12,0,11,12
219766,7,14,4,0,10,4
219766,6,10,2,0,8,2
219766,5,3,2,0,1,2
219766,4,3,2,0,1,2
219766,2,1,1,0,0,1
258748,10,3,1,0,2,1
258748,8,12,2,0,10,2
258748,7,17,2,0,15,2
258748,6,18,4,0,14,4
258748,5,5,1,0,4,1
258748,4,6,3,0,3,3
217335,9,1,1,0,0,1
217335,7,18,1,0,17,1
217335,6,25,5,0,20,5
217335,5,8,1,0,7,1
217335,3,2,1,0,1,1
172312,10,1,1,0,0,1
172312,9,2,1,0,1,1
172312,8,4,1,0,3,1
172312,7,13,2,0,11,2
172312,6,27,4,0,23,4
172312,4,3,1,0,2,1
172312,3,2,1,0,1,1
3540,8,5,3,0,2,3
3540,7,14,6,0,8,6
3540,6,22,9,0,13,9
3540,5,12,3,0,9,3
3540,4,1,1,0,0,1
164778,8,7,4,0,3,4
164778,6,25,5,0,20,5
164778,5,13,5,0,8,5
164778,4,5,3,0,2,3
230514,10,5,4,0,1,4
230514,9,8,4,0,4,4
230514,8,19,3,0,16,3
230514,7,14,2,0,12,2
230514,6,8,1,0,7,1
230514,5,3,1,0,2,1
230514,4,2,1,0,1,1
230514,3,2,1,0,1,1
69205,7,6,1,0,5,1
69205,6,11,1,0,10,1
69205,5,15,5,0,10,5
69205,4,17,1,0,16,1
69205,3,9,2,0,7,2
161820,9,5,3,0,2,3
161820,8,25,8,0,17,8
161820,7,22,4,0,18,4
161820,6,5,2,0,3,2
148745,10,5,1,0,4,1
148745,9,17,6,0,11,6
148745,8,17,1,0,16,1
148745,7,14,1,0,13,1
148745,4,1,1,0,0,1
148745,3,2,1,0,1,1
148745,1,1,1,0,0,1
86433,8,8,2,0,6,2
86433,7,9,1,0,8,1
86433,6,26,4,0,22,4
86433,5,11,1,0,10,1
86433,2,1,1,0,0,1
228713,10,6,5,1,1,4
228713,9,3,1,0,2,1
228713,8,13,4,0,9,4
228713,7,16,4,0,12,4
228713,6,15,1,0,14,1
158816,10,16,9,0,7,9
158816,9,21,6,0,15,6
158816,8,18,9,0,9,9
158816,6,1,1,0,0,1
251349,7,16,2,1,14,1
251349,6,16,7,2,9,5
251349,5,7,2,0,5,2
251349,4,5,1,0,4,1
194400,10,4,1,0,3,1
194400,6,13,2,0,11,2
194400,5,4,1,0,3,1
34785,8,4,1,0,3,1
34785,7,3,1,0,2,1
34785,6,22,8,0,14,8
34785,5,14,1,0,13,1
34785,4,13,3,0,10,3
34785,3,2,1,0,1,1
27373,8,7,1,0,6,1
27373,7,13,1,0,12,1
27373,6,15,1,0,14,1
27373,4,2,1,0,1,1
266446,8,22,1,0,21,1
266446,7,16,2,0,14,2
266446,5,3,1,0,2,1
6360,7,25,11,0,14,11
6360,6,22,9,0,13,9
6360,5,4,1,0,3,1
6360,4,5,3,0,2,3
6360,3,1,1,0,0,1
28100,10,2,1,0,1,1
28100,7,4,1,0,3,1
28100,6,6,1,0,5,1
28100,5,16,3,0,13,3
28100,4,13,4,0,9,4
28100,3,8,4,0,4,4
28100,2,7,4,0,3,4
28100,1,3,1,0,2,1
255697,8,15,4,0,11,4
255697,7,11,4,0,7,4
255697,6,19,1,0,18,1
255697,5,12,3,0,9,3
3841,8,1,1,0,0,1
3841,7,2,1,0,1,1
3841,6,17,7,0,10,7
3841,5,10,2,0,8,2
3841,4,14,7,0,7,7
3841,3,8,4,0,4,4
3841,2,9,2,0,7,2
8499,8,1,1,0,0,1
8499,7,4,2,0,2,2
8499,6,11,3,0,8,3
8499,5,10,2,0,8,2
8499,4,16,4,0,12,4
8499,3,7,1,0,6,1
8499,2,4,2,0,2,2
8499,1,7,5,0,2,5
3219,9,4,1,0,3,1
3219,8,11,2,0,9,2
3219,7,18,2,0,16,2
3219,6,15,3,0,12,3
3219,5,8,2,0,6,2
3219,3,2,2,0,0,2
2649,7,4,1,0,3,1
2649,6,25,8,0,17,8
2649,5,15,5,0,10,5
2649,4,8,3,0,5,3
2649,3,5,1,0,4,1
2649,2,2,1,0,1,1
14662,8,7,3,0,4,3
14662,7,10,2,0,8,2
14662,6,10,2,0,8,2
14662,5,18,5,0,13,5
14662,4,12,4,0,8,4
8519,8,8,3,0,5,3
8519,7,10,5,0,5,5
8519,6,16,6,0,10,6
8519,5,13,1,0,12,1
8519,3,4,2,0,2,2
8519,2,5,3,0,2,3
20054,9,3,1,0,2,1
20054,8,13,7,0,6,7
20054,7,14,7,0,7,7
20054,6,17,6,0,11,6
20054,4,7,4,0,3,4
20054,3,2,1,0,1,1
3317,9,3,3,0,0,3
3317,8,9,3,0,6,3
3317,7,18,5,0,13,5
3317,6,17,5,0,12,5
3317,5,8,2,0,6,2
3317,4,6,2,0,4,2
72373,8,9,3,0,6,3
72373,7,15,4,0,11,4
72373,6,22,6,0,16,6
72373,5,9,1,0,8,1
72373,4,5,1,0,4,1
194992,10,11,4,0,7,4
194992,9,6,1,0,5,1
194992,8,17,3,0,14,3
194992,7,10,1,0,9,1
194992,3,1,1,0,0,1
7667,8,3,2,0,1,2
7667,7,10,4,0,6,4
7667,6,21,6,0,15,6
7667,5,16,7,0,9,7
7667,4,4,4,0,0,4
7667,3,5,3,0,2,3
7667,2,2,1,0,1,1
168653,10,6,3,0,3,3
168653,9,4,3,0,1,3
168653,8,15,8,4,7,4
168653,7,17,7,0,10,7
168653,6,10,2,0,8,2
168653,5,3,2,0,1,2
168653,4,3,1,0,2,1
168653,1,1,1,0,0,1
4790,7,5,2,0,3,2
4790,6,14,4,0,10,4
4790,5,13,2,0,11,2
4790,4,10,2,0,8,2
4790,3,3,3,0,0,3
4790,2,4,1,0,3,1
146384,10,1,1,0,0,1
146384,8,12,4,1,8,3
146384,7,11,1,0,10,1
146384,6,9,3,0,6,3
146384,5,10,2,0,8,2
146384,4,10,7,0,3,7
28861,10,1,1,0,0,1
28861,9,3,1,0,2,1
28861,7,7,4,0,3,4
28861,6,20,7,0,13,7
28861,5,9,2,0,7,2
28861,4,9,2,0,7,2
28861,2,5,3,0,2,3
94116,8,13,2,0,11,2
94116,7,12,1,0,11,1
94116,6,14,1,0,13,1
94116,4,3,1,0,2,1
11701,8,4,3,0,1,3
11701,7,8,1,0,7,1
11701,6,19,7,0,12,7
11701,5,13,5,0,8,5
11701,4,5,1,0,4,1
11701,2,2,2,0,0,2
11701,1,4,3,0,1,3
176631,10,13,11,0,2,11
176631,9,11,9,0,2,9
176631,8,10,6,0,4,6
176631,7,4,3,0,1,3
176631,2,2,1,0,1,1
176631,1,4,2,0,2,2
43340,7,7,2,0,5,2
43340,6,7,1,0,6,1
43340,5,9,4,0,5,4
43340,2,5,1,0,4,1
43340,1,7,3,0,4,3
12679,8,5,3,0,2,3
12679,7,10,3,0,7,3
12679,6,22,7,0,15,7
12679,5,12,5,0,7,5
12679,4,6,1,0,5,1
12679,3,1,1,0,0,1
14130,9,1,1,0,0,1
14130,8,2,1,0,1,1
14130,7,7,1,0,6,1
14130,6,13,5,0,8,5
14130,5,5,1,0,4,1
14130,4,13,5,0,8,5
14130,3,7,3,0,4,3
14130,2,10,3,0,7,3
58374,8,5,3,0,2,3
58374,7,5,1,0,4,1
58374,6,24,6,0,18,6
58374,5,9,2,0,7,2
58374,4,12,3,0,9,3
58374,3,4,2,0,2,2
58374,2,1,1,0,0,1
174618,9,3,1,0,2,1
174618,8,8,1,0,7,1
174618,7,16,3,0,13,3
174618,6,16,4,0,12,4
174618,4,4,1,0,3,1
174618,1,1,1,0,0,1
4232,8,3,2,0,1,2
4232,7,6,2,0,4,2
4232,6,25,9,0,16,9
4232,5,12,1,0,11,1
4232,4,6,2,0,4,2
4232,3,4,2,0,2,2
10355,7,3,1,0,2,1
10355,6,10,1,0,9,1
10355,5,17,5,0,12,5
10355,4,14,3,0,11,3
10355,3,8,5,0,3,5
10355,1,2,2,0,0,2
189610,8,20,3,0,17,3
189610,7,18,3,0,15,3
12699,10,5,2,0,3,2
12699,9,8,6,0,2,6
12699,8,17,5,0,12,5
12699,7,13,5,0,8,5
12699,6,7,1,0,6,1
12699,5,5,1,0,4,1
12699,3,3,3,0,0,3
197069,7,16,3,0,13,3
197069,6,23,3,0,20,3
197069,5,7,1,0,6,1
197069,4,6,4,1,2,3
23812,8,2,1,0,1,1
23812,7,6,2,0,4,2
23812,6,20,4,0,16,4
23812,5,13,5,0,8,5
23812,4,11,3,0,8,3
23812,2,5,3,0,2,3
16253,7,12,2,0,10,2
16253,6,28,8,0,20,8
16253,5,5,1,0,4,1
16253,4,10,1,0,9,1
16253,3,3,2,0,1,2
5377,8,3,1,0,2,1
5377,7,11,6,0,5,6
5377,6,26,4,0,22,4
5377,5,12,5,0,7,5
5377,4,6,2,0,4,2
171431,9,1,1,0,0,1
171431,8,12,4,0,8,4
171431,7,16,10,0,6,10
171431,6,17,9,0,8,9
171431,5,8,3,0,5,3
171431,4,4,1,0,3,1
171431,3,1,1,0,0,1
188124,10,32,14,0,18,14
188124,9,21,9,0,12,9
188124,8,3,2,0,1,2
188124,2,2,1,0,1,1
32429,8,9,4,0,5,4
32429,7,11,3,0,8,3
32429,6,21,9,0,12,9
32429,5,9,5,0,4,5
32429,4,5,1,0,4,1
169256,8,2,2,0,0,2
169256,7,8,1,0,7,1
169256,6,24,4,0,20,4
169256,4,8,1,0,7,1
169256,3,3,2,0,1,2
169256,2,2,1,0,1,1
134283,10,5,1,0,4,1
134283,9,9,3,0,6,3
134283,8,24,8,0,16,8
134283,7,16,7,0,9,7
134283,6,4,2,0,2,2
24264,9,10,3,0,7,3
24264,8,12,4,0,8,4
24264,7,8,2,0,6,2
24264,6,16,4,0,12,4
24264,5,4,2,0,2,2
24264,3,2,1,0,1,1
205961,10,4,2,0,2,2
205961,9,5,1,0,4,1
205961,8,20,6,0,14,6
205961,7,10,2,0,8,2
205961,6,8,2,0,6,2
205961,4,5,1,0,4,1
30248,7,5,3,0,2,3
30248,6,25,8,0,17,8
30248,5,14,1,0,13,1
30248,4,11,5,0,6,5
30248,3,2,1,0,1,1
31909,8,3,3,0,0,3
31909,6,19,3,0,16,3
31909,5,11,1,0,10,1
31909,4,9,2,0,7,2
31909,3,7,3,0,4,3
228101,8,7,1,0,6,1
228101,7,19,1,0,18,1
228101,6,22,4,0,18,4
465,9,1,1,0,0,1
465,8,7,1,0,6,1
465,7,16,3,0,13,3
465,6,24,7,0,17,7
465,5,8,1,0,7,1
465,4,4,2,0,2,2
34139,10,5,1,0,4,1
34139,9,11,1,0,10,1
34139,8,18,1,0,17,1
34139,7,17,3,0,14,3
34139,6,8,2,0,6,2
1433,7,12,4,0,8,4
1433,6,21,3,0,18,3
1433,5,11,3,0,8,3
1433,4,11,3,0,8,3
146161,7,12,1,0,11,1
146161,6,25,8,0,17,8
146161,5,15,3,0,12,3
146161,4,4,1,0,3,1
146161,3,2,1,0,1,1
26582,10,4,2,0,2,2
26582,9,2,1,0,1,1
26582,8,11,6,0,5,6
26582,7,7,6,0,1,6
26582,6,18,9,0,9,9
26582,5,11,4,0,7,4
26582,4,7,2,0,5,2
39940,10,15,5,0,10,5
39940,9,19,5,0,14,5
39940,8,17,3,0,14,3
39940,7,7,4,0,3,4
4570,8,2,1,0,1,1
4570,7,15,6,0,9,6
4570,6,16,5,0,11,5
4570,5,16,3,0,13,3
4570,4,5,1,0,4,1
4570,3,4,3,0,1,3
6710,10,1,1,0,0,1
6710,8,9,6,0,3,6
6710,7,6,1,0,5,1
6710,6,15,3,0,12,3
6710,5,18,5,0,13,5
6710,4,4,2,0,2,2
6710,3,4,2,0,2,2
6710,2,2,2,0,0,2
6785,8,1,1,0,0,1
6785,6,3,1,0,2,1
6785,5,8,5,0,3,5
6785,4,10,2,0,8,2
6785,3,14,5,0,9,5
6785,2,13,4,0,9,4
6785,1,11,3,0,8,3
28944,10,1,1,0,0,1
28944,9,13,1,0,12,1
28944,8,19,6,0,13,6
28944,7,10,4,0,6,4
28944,6,11,3,0,8,3
28944,5,3,2,0,1,2
28944,4,2,1,0,1,1
119872,7,8,3,0,5,3
119872,6,20,3,0,17,3
119872,5,18,1,0,17,1
119872,4,7,3,0,4,3
18966,9,1,1,0,0,1
18966,8,9,4,0,5,4
18966,7,17,12,0,5,12
18966,6,20,6,0,14,6
18966,5,8,6,0,2,6
18966,4,3,1,0,2,1
18966,3,2,2,0,0,2
6847,9,5,3,0,2,3
6847,8,7,2,0,5,2
6847,7,22,8,0,14,8
6847,6,10,2,0,8,2
9150,10,5,3,0,2,3
9150,9,1,1,0,0,1
9150,8,20,6,0,14,6
9150,7,19,5,0,14,5
9150,6,9,5,0,4,5
9150,5,6,2,0,4,2
42352,8,2,2,0,0,2
42352,7,15,6,0,9,6
42352,6,18,11,0,7,11
42352,5,16,4,0,12,4
42352,4,6,6,0,0,6
2102,7,9,2,0,7,2
2102,6,17,4,0,13,4
2102,5,21,6,0,15,6
2102,4,9,3,0,6,3
2102,3,4,1,0,3,1
22379,7,10,7,0,3,7
22379,6,18,3,0,15,3
22379,5,15,5,0,10,5
22379,4,7,5,0,2,5
22379,3,6,2,0,4,2
22379,2,1,1,0,0,1
22379,1,1,1,0,0,1
4641,10,1,1,0,0,1
4641,8,2,1,0,1,1
4641,7,6,2,0,4,2
4641,6,7,1,0,6,1
4641,5,14,4,0,10,4
4641,4,11,3,0,8,3
4641,3,9,1,0,8,1
4641,2,5,1,0,4,1
4641,1,5,2,0,3,2
32340,10,1,1,0,0,1
32340,6,9,3,0,6,3
32340,4,11,1,0,10,1
32340,2,9,3,0,6,3
5924,9,5,3,0,2,3
5924,8,3,2,0,1,2
5924,7,15,6,0,9,6
5924,6,17,6,0,11,6
5924,5,14,3,0,11,3
5924,4,3,1,0,2,1
5924,3,2,1,0,1,1
129310,8,4,3,0,1,3
129310,7,20,8,0,12,8
129310,6,21,10,0,11,10
129310,5,9,4,0,5,4
129310,4,4,2,0,2,2
129310,3,1,1,0,0,1
66416,8,2,1,0,1,1
66416,7,16,7,0,9,7
66416,6,18,7,0,11,7
66416,5,15,2,1,13,1
66416,3,4,2,0,2,2
66416,2,2,2,0,0,2
12788,9,4,3,0,1,3
12788,8,7,5,0,2,5
12788,7,12,4,0,8,4
12788,6,18,5,0,13,5
12788,5,6,6,0,0,6
12788,4,6,2,0,4,2
12788,3,4,1,0,3,1
12788,1,1,1,0,0,1
9086,10,2,1,0,1,1
9086,8,12,7,0,5,7
9086,7,18,6,0,12,6
9086,6,21,3,0,18,3
9086,5,3,1,0,2,1
9086,4,4,2,0,2,2
7142,8,9,5,0,4,5
7142,7,19,6,0,13,6
7142,6,19,7,0,12,7
7142,5,3,1,0,2,1
7142,3,3,1,0,2,1
6044,10,3,2,0,1,2
6044,8,7,3,0,4,3
6044,7,11,1,0,10,1
6044,6,13,2,0,11,2
6044,5,9,1,0,8,1
6044,4,5,2,0,3,2
169925,8,10,2,0,8,2
169925,7,19,6,0,13,6
169925,6,21,4,0,17,4
169925,5,4,1,0,3,1
156599,7,8,2,0,6,2
156599,6,15,2,0,13,2
156599,5,9,1,0,8,1
156599,4,10,2,0,8,2
156599,3,9,6,0,3,6
197071,8,15,4,0,11,4
197071,7,18,3,0,15,3
197071,6,18,1,0,17,1
197071,5,6,2,0,4,2
197071,4,1,1,0,0,1
143131,10,1,1,0,0,1
143131,9,7,1,0,6,1
143131,8,16,2,0,14,2
143131,7,13,4,0,9,4
143131,6,17,3,0,14,3
143131,4,3,1,0,2,1
143131,3,1,1,0,0,1
18857,8,1,1,0,0,1
18857,7,14,2,0,12,2
18857,6,20,2,0,18,2
18857,5,16,2,0,14,2
18857,4,5,1,0,4,1
18857,2,2,1,0,1,1
22265,7,7,1,0,6,1
22265,6,11,2,0,9,2
22265,5,15,3,0,12,3
22265,4,13,3,0,10,3
22265,3,8,3,0,5,3
22265,2,4,1,0,3,1
13978,10,5,2,0,3,2
13978,9,6,2,0,4,2
13978,8,6,2,0,4,2
13978,7,18,6,0,12,6
13978,6,14,6,0,8,6
13978,5,7,2,0,5,2
13978,4,2,1,0,1,1
13978,3,1,1,0,0,1
4866,8,3,2,0,1,2
4866,7,6,2,0,4,2
4866,6,16,6,0,10,6
4866,5,11,5,0,6,5
4866,4,9,3,0,6,3
4866,3,10,2,0,8,2
4866,2,2,1,0,1,1
130597,10,10,4,0,6,4
130597,9,4,2,0,2,2
130597,8,3,1,0,2,1
130597,7,3,1,0,2,1
130597,5,10,1,0,9,1
130597,4,9,3,0,6,3
130597,3,4,2,0,2,2
130597,2,8,4,0,4,4
134009,10,5,1,0,4,1
134009,9,16,3,0,13,3
134009,8,14,2,0,12,2
134009,7,10,3,0,7,3
134009,6,7,2,0,5,2
134009,2,1,1,0,0,1
134009,1,2,1,0,1,1
183452,9,2,1,0,1,1
183452,8,14,7,0,7,7
183452,7,17,4,0,13,4
183452,6,17,3,0,14,3
183452,3,2,1,0,1,1
127229,8,16,6,0,10,6
127229,7,16,8,0,8,8
127229,6,14,4,0,10,4
127229,5,5,4,0,1,4
127229,4,5,3,0,2,3
127229,3,3,1,0,2,1
127229,2,1,1,0,0,1
8295,6,15,6,0,9,6
8295,5,19,2,0,17,2
8295,4,17,3,0,14,3
8295,3,5,1,0,4,1
4120,10,12,5,0,7,5
4120,9,5,2,0,3,2
4120,8,12,5,0,7,5
4120,7,10,4,0,6,4
4120,6,6,3,0,3,3
4120,4,2,1,0,1,1
4120,3,1,1,0,0,1
4120,2,1,1,0,0,1
122435,10,7,4,1,3,3
122435,9,9,2,0,7,2
122435,8,21,4,1,17,3
122435,7,11,3,0,8,3
122435,6,8,3,0,5,3
122435,3,1,1,0,0,1
1199,8,3,3,0,0,3
1199,7,3,3,0,0,3
1199,6,11,4,0,7,4
1199,5,23,3,0,20,3
1199,4,17,7,0,10,7
1199,2,2,1,0,1,1
1199,1,1,1,0,0,1
13982,10,4,2,0,2,2
13982,9,2,1,0,1,1
13982,7,5,2,0,3,2
13982,6,13,2,0,11,2
13982,5,11,4,0,7,4
13982,4,13,6,0,7,6
23642,9,5,2,0,3,2
23642,8,16,9,0,7,9
23642,7,8,2,0,6,2
23642,6,10,5,0,5,5
23642,5,6,5,0,1,5
23642,4,5,3,0,2,3
23642,3,4,2,0,2,2
23642,1,4,3,0,1,3
248226,10,1,1,0,0,1
248226,9,3,1,0,2,1
248226,8,8,2,0,6,2
248226,7,14,2,0,12,2
248226,6,18,4,0,14,4
248226,5,8,1,0,7,1
248226,4,6,2,0,4,2
15791,10,2,1,0,1,1
15791,6,14,2,0,12,2
15791,5,15,4,0,11,4
15791,4,13,3,0,10,3
15791,3,7,1,0,6,1
13039,9,1,1,0,0,1
13039,7,4,1,0,3,1
13039,6,16,5,0,11,5
13039,5,18,5,0,13,5
13039,3,8,3,0,5,3
13039,2,3,1,0,2,1
1884,9,1,1,0,0,1
1884,7,20,4,0,16,4
1884,6,15,2,0,13,2
1884,5,13,1,0,12,1
1884,4,3,1,0,2,1
1884,3,3,1,0,2,1
1878,10,2,1,0,1,1
1878,9,4,2,0,2,2
1878,8,7,1,0,6,1
1878,7,11,3,0,8,3
1878,6,13,4,0,9,4
1878,5,11,6,0,5,6
1878,4,8,2,0,6,2
1878,2,1,1,0,0,1
3001,7,12,3,0,9,3
3001,6,21,3,0,18,3
3001,5,13,5,0,8,5
3001,4,9,4,0,5,4
16105,10,23,15,0,8,15
16105,9,8,3,0,5,3
16105,8,11,3,0,8,3
16105,7,6,1,0,5,1
16105,6,6,2,0,4,2
16105,5,2,1,0,1,1
5661,7,8,1,0,7,1
5661,6,8,1,0,7,1
5661,5,18,3,0,15,3
5661,4,10,2,0,8,2
5661,3,7,2,0,5,2
5661,2,4,1,0,3,1
211641,10,7,2,0,5,2
211641,9,8,1,0,7,1
211641,8,19,6,0,13,6
211641,7,16,2,0,14,2
211641,6,8,2,0,6,2
211641,5,2,1,0,1,1
36598,10,6,3,0,3,3
36598,9,3,1,0,2,1
36598,8,24,4,0,20,4
36598,7,15,7,0,8,7
36598,6,8,1,0,7,1
36598,5,1,1,0,0,1
126255,10,2,1,0,1,1
126255,9,2,2,0,0,2
126255,8,7,3,0,4,3
126255,7,12,4,0,8,4
126255,6,21,10,0,11,10
126255,5,7,2,0,5,2
126255,4,7,1,0,6,1
242324,10,4,2,0,2,2
242324,9,5,2,0,3,2
242324,8,17,4,0,13,4
242324,7,15,2,0,13,2
242324,6,16,6,1,10,5
242324,5,3,1,0,2,1
5663,10,2,2,0,0,2
5663,8,1,1,0,0,1
5663,7,5,1,0,4,1
5663,6,12,5,0,7,5
5663,5,17,7,0,10,7
5663,4,11,6,0,5,6
5663,3,4,2,0,2,2
5663,2,7,4,0,3,4
5663,1,1,1,0,0,1
100104,7,20,2,0,18,2
100104,6,24,5,0,19,5
100104,3,1,1,0,0,1
18695,8,3,1,0,2,1
18695,7,4,1,0,3,1
18695,6,20,7,0,13,7
18695,5,12,6,0,6,6
18695,4,8,2,0,6,2
18695,3,6,4,0,2,4
18695,2,5,3,0,2,3
31605,10,3,1,0,2,1
31605,9,7,3,0,4,3
31605,8,14,5,0,9,5
31605,7,13,6,0,7,6
31605,6,15,2,0,13,2
31605,5,2,1,0,1,1
31605,4,3,1,0,2,1
143200,10,2,1,0,1,1
143200,8,2,1,0,1,1
143200,7,18,4,0,14,4
143200,6,19,1,0,18,1
143200,4,5,3,0,2,3
143200,3,4,2,0,2,2
55250,9,5,2,0,3,2
55250,8,15,5,0,10,5
55250,7,12,1,0,11,1
55250,6,20,1,0,19,1
55250,5,3,1,0,2,1
55250,3,1,1,0,0,1
4778,10,4,1,0,3,1
4778,8,6,3,0,3,3
4778,7,12,1,0,11,1
4778,5,9,4,0,5,4
4778,4,9,2,0,7,2
4778,3,1,1,0,0,1
8705,9,2,1,0,1,1
8705,8,5,3,0,2,3
8705,7,20,9,0,11,9
8705,6,23,12,0,11,12
8705,5,5,1,0,4,1
8705,4,1,1,0,0,1
8705,3,2,1,0,1,1
86025,8,4,1,0,3,1
86025,7,10,2,0,8,2
86025,6,32,7,0,25,7
86025,5,5,1,0,4,1
86025,4,7,3,0,4,3
86025,3,1,1,0,0,1
41107,8,7,2,1,5,1
41107,7,14,3,0,11,3
41107,6,18,4,0,14,4
41107,5,11,2,0,9,2
41107,4,4,2,0,2,2
41107,3,2,1,0,1,1
41107,1,1,1,0,0,1
5380,8,11,4,0,7,4
5380,7,13,1,0,12,1
5380,6,16,4,0,12,4
5380,3,1,1,0,0,1
890,10,3,2,0,1,2
890,9,6,2,0,4,2
890,8,8,4,0,4,4
890,7,19,10,0,9,10
890,6,17,6,0,11,6
890,4,3,2,0,1,2
6005,8,2,1,0,1,1
6005,7,12,4,0,8,4
6005,6,22,6,0,16,6
6005,5,13,4,0,9,4
1264,7,4,1,0,3,1
1264,6,9,1,0,8,1
1264,5,11,1,0,10,1
1264,4,11,3,0,8,3
1264,3,11,5,0,6,5
1264,2,7,1,0,6,1
1264,1,6,3,0,3,3
164645,9,2,1,0,1,1
164645,8,5,3,2,2,1
164645,7,17,5,3,12,2
164645,6,20,1,0,19,1
164645,4,7,4,0,3,4
244333,9,2,1,0,1,1
244333,8,14,2,0,12,2
244333,7,19,2,0,17,2
244333,6,13,3,0,10,3
244333,4,2,1,0,1,1
75809,8,11,4,0,7,4
75809,7,23,11,0,12,11
75809,6,15,6,0,9,6
75809,4,3,2,0,1,2
10968,10,1,1,0,0,1
10968,8,10,4,0,6,4
10968,7,14,4,0,10,4
10968,6,18,10,0,8,10
10968,5,11,7,0,4,7
10968,4,4,2,0,2,2
15212,10,2,1,0,1,1
15212,8,8,5,0,3,5
15212,7,14,6,0,8,6
15212,6,22,11,0,11,11
184287,10,4,1,0,3,1
184287,9,4,3,0,1,3
184287,8,20,1,0,19,1
184287,7,11,2,0,9,2
184287,5,6,1,0,5,1
184287,3,3,1,0,2,1
28257,10,1,1,0,0,1
28257,6,1,1,0,0,1
28257,3,1,1,0,0,1
28257,2,3,1,0,2,1
28257,1,52,23,0,29,23
148528,8,15,3,0,12,3
148528,7,12,1,0,11,1
148528,6,17,3,0,14,3
148528,5,7,2,0,5,2
26025,8,5,4,0,1,4
26025,7,9,4,0,5,4
26025,6,18,4,0,14,4
26025,5,15,9,0,6,9
26025,4,7,4,0,3,4
26025,3,4,2,0,2,2
26025,2,1,1,0,0,1
174128,10,2,1,0,1,1
174128,8,8,1,0,7,1
174128,7,15,1,0,14,1
174128,6,21,4,0,17,4
174128,4,3,1,0,2,1
182869,9,5,1,0,4,1
182869,7,5,2,0,3,2
182869,6,18,3,0,15,3
182869,5,9,1,0,8,1
23613,8,6,2,0,4,2
23613,7,8,3,0,5,3
23613,6,14,3,0,11,3
23613,5,15,5,0,10,5
23613,4,6,3,0,3,3
23613,3,4,4,0,0,4
23613,2,5,5,0,0,5
34245,8,11,5,0,6,5
34245,6,18,2,0,16,2
34245,5,10,1,0,9,1
34245,4,4,1,0,3,1
194688,8,8,4,1,4,3
194688,7,12,3,0,9,3
194688,6,15,1,0,14,1
194688,5,7,2,0,5,2
6921,9,2,1,0,1,1
6921,8,9,1,0,8,1
6921,7,10,3,0,7,3
6921,6,11,4,0,7,4
6921,5,9,3,0,6,3
6921,4,8,3,0,5,3
6921,3,5,1,0,4,1
6921,2,4,2,0,2,2
4256,9,3,2,0,1,2
4256,8,12,5,0,7,5
4256,7,17,9,0,8,9
4256,6,18,8,0,10,8
225526,10,8,1,0,7,1
225526,9,6,2,1,4,1
225526,8,14,3,0,11,3
225526,7,17,7,0,10,7
225526,6,7,2,0,5,2
225526,5,5,1,0,4,1
4933,7,5,2,0,3,2
4933,6,15,5,0,10,5
4933,5,9,1,0,8,1
4933,4,14,7,0,7,7
4933,3,11,8,0,3,8
4933,2,3,2,0,1,2
181263,9,1,1,0,0,1
181263,8,4,1,0,3,1
181263,7,8,1,0,7,1
181263,6,16,3,0,13,3
181263,5,12,5,0,7,5
181263,4,9,5,0,4,5
181263,3,4,2,0,2,2
181263,2,5,4,0,1,4
3848,8,4,2,0,2,2
3848,7,9,2,0,7,2
3848,6,16,11,0,5,11
3848,5,7,2,0,5,2
3848,4,11,3,0,8,3
3848,3,7,2,0,5,2
3848,1,1,1,0,0,1
143703,10,3,2,0,1,2
143703,9,7,5,0,2,5
143703,8,11,2,1,9,1
143703,6,17,3,0,14,3
143703,5,8,3,0,5,3
143703,4,4,1,0,3,1
11127,10,2,1,0,1,1
11127,9,2,1,0,1,1
11127,8,3,2,0,1,2
11127,7,12,4,0,8,4
11127,6,21,10,0,11,10
11127,5,10,1,0,9,1
11127,4,5,4,0,1,4
11127,3,2,1,0,1,1
231878,10,3,2,1,1,1
231878,9,5,2,1,3,1
231878,8,14,3,0,11,3
231878,7,17,6,0,11,6
231878,6,10,3,1,7,2
231878,3,2,1,0,1,1
19554,10,1,1,0,0,1
19554,9,1,1,0,0,1
19554,8,6,3,0,3,3
19554,7,16,8,0,8,8
19554,6,18,8,0,10,8
19554,5,14,7,0,7,7
19554,4,2,1,0,1,1
19554,3,1,1,0,0,1
80833,9,1,1,0,0,1
80833,8,9,2,0,7,2
80833,7,16,5,0,11,5
80833,6,10,2,0,8,2
80833,5,9,2,0,7,2
80833,4,10,3,0,7,3
19414,10,3,1,0,2,1
19414,9,2,1,0,1,1
19414,8,6,1,0,5,1
19414,7,15,3,0,12,3
19414,6,14,3,0,11,3
19414,5,9,1,0,8,1
19414,4,3,1,0,2,1
19414,3,3,2,0,1,2
19414,2,2,1,0,1,1
19414,1,2,2,0,0,2
157449,10,4,2,0,2,2
157449,9,3,1,0,2,1
157449,8,22,9,0,13,9
157449,7,16,6,0,10,6
157449,6,9,3,0,6,3
157449,4,1,1,0,0,1
35054,9,2,2,0,0,2
35054,8,9,5,0,4,5
35054,7,13,8,0,5,8
35054,6,20,11,0,9,11
35054,5,8,1,0,7,1
35054,4,6,4,0,2,4
28444,10,4,1,0,3,1
28444,7,9,2,0,7,2
28444,6,9,5,0,4,5
28444,5,13,4,0,9,4
28444,4,8,4,0,4,4
28444,3,6,1,0,5,1
28444,2,3,1,0,2,1
26134,8,3,1,0,2,1
26134,7,6,1,0,5,1
26134,6,15,5,0,10,5
26134,5,13,1,0,12,1
26134,4,13,3,0,10,3
26134,3,5,1,0,4,1
26134,2,4,2,0,2,2
9673,10,5,2,0,3,2
9673,9,8,2,0,6,2
9673,8,23,8,0,15,8
9673,7,14,1,0,13,1
9673,6,6,1,0,5,1
9673,2,1,1,0,0,1
24820,10,2,1,0,1,1
24820,9,1,1,0,0,1
24820,8,8,2,0,6,2
24820,7,10,1,0,9,1
24820,6,17,7,0,10,7
24820,5,15,5,0,10,5
24820,4,5,2,0,3,2
184443,10,4,2,0,2,2
184443,9,4,1,0,3,1
184443,8,2,1,0,1,1
184443,7,7,2,0,5,2
184443,6,16,2,0,14,2
184443,5,14,4,0,10,4
184443,4,3,1,0,2,1
184443,3,6,3,0,3,3
184443,2,1,1,0,0,1
158198,6,15,6,0,9,6
158198,5,14,4,0,10,4
158198,4,7,3,0,4,3
158198,3,7,1,0,6,1
158198,2,5,2,0,3,2
33225,8,6,1,0,5,1
33225,7,12,1,0,11,1
33225,6,22,2,0,20,2
33225,5,12,4,0,8,4
133421,9,2,2,0,0,2
133421,8,15,4,0,11,4
133421,7,14,4,0,10,4
133421,6,16,1,0,15,1
133421,5,3,2,0,1,2
133421,4,5,1,0,4,1
133421,3,4,2,0,2,2
144110,2,3,1,0,2,1
144110,1,56,14,0,42,14
4473,9,2,1,0,1,1
4473,7,13,2,0,11,2
4473,6,17,4,0,13,4
4473,5,9,2,0,7,2
4473,4,7,4,0,3,4
4473,3,6,3,0,3,3
4473,2,2,1,0,1,1
105602,9,1,1,0,0,1
105602,8,7,1,0,6,1
105602,7,10,4,0,6,4
105602,6,21,3,0,18,3
105602,5,10,1,0,9,1
105602,4,7,2,0,5,2
105602,3,4,1,0,3,1
2186,5,18,2,0,16,2
2186,4,13,2,0,11,2
86538,9,3,1,0,2,1
86538,7,12,1,0,11,1
86538,4,4,1,0,3,1
86538,3,5,1,0,4,1
86538,1,3,1,0,2,1
128885,7,9,3,0,6,3
128885,6,22,1,0,21,1
128885,5,14,2,0,12,2
128885,4,7,3,0,4,3
128885,3,5,1,0,4,1
266810,10,18,3,1,15,2
266810,9,13,1,0,12,1
266810,8,13,4,1,9,3
266810,6,3,2,0,1,2
266810,4,1,1,0,0,1
85472,10,1,1,0,0,1
85472,9,4,1,0,3,1
85472,8,8,4,0,4,4
85472,7,13,1,0,12,1
85472,6,15,2,0,13,2
85472,5,8,1,0,7,1
85472,4,5,2,0,3,2
85472,3,4,1,0,3,1
85472,2,1,1,0,0,1
57691,8,12,6,0,6,6
57691,7,22,11,0,11,11
57691,6,16,7,0,9,7
57691,5,3,1,0,2,1
20117,10,2,1,0,1,1
20117,9,3,2,0,1,2
20117,8,14,6,0,8,6
20117,7,16,3,0,13,3
20117,6,13,4,0,9,4
20117,5,7,1,0,6,1
20117,2,1,1,0,0,1
2417,10,1,1,0,0,1
2417,8,3,1,0,2,1
2417,7,10,3,0,7,3
2417,6,20,9,0,11,9
2417,5,14,6,0,8,6
2417,4,7,3,0,4,3
2417,1,2,2,0,0,2
204055,10,9,6,2,3,4
204055,9,18,12,0,6,12
204055,8,21,12,1,9,11
204055,7,3,1,0,2,1
204055,6,6,2,0,4,2
259005,8,11,3,0,8,3
259005,7,17,1,0,16,1
259005,5,5,2,0,3,2
259005,3,1,1,0,0,1
249095,10,5,4,0,1,4
249095,9,9,5,0,4,5
249095,8,13,2,0,11,2
249095,7,14,5,0,9,5
249095,6,11,4,0,7,4
2044,5,8,4,0,4,4
2044,4,17,4,0,13,4
2044,3,6,2,0,4,2
2044,2,15,9,0,6,9
2044,1,12,7,0,5,7
4675,9,1,1,0,0,1
4675,8,8,3,0,5,3
4675,7,8,4,0,4,4
4675,6,21,9,0,12,9
4675,5,8,1,0,7,1
4675,4,10,3,0,7,3
4675,3,2,1,0,1,1
6466,7,13,6,0,7,6
6466,6,21,10,0,11,10
6466,5,14,6,0,8,6
6466,4,7,3,0,4,3
3645,8,2,1,0,1,1
3645,7,6,1,0,5,1
3645,6,9,2,0,7,2
3645,5,7,3,0,4,3
3645,4,11,7,0,4,7
3645,3,4,2,0,2,2
3645,2,10,3,0,7,3
3645,1,9,5,0,4,5
257707,8,17,2,0,15,2
257707,7,19,2,0,17,2
257707,6,13,4,0,9,4
257707,5,4,1,0,3,1
257955,8,5,1,0,4,1
257955,7,14,2,0,12,2
257955,6,23,5,0,18,5
257955,5,12,2,0,10,2
257955,4,3,1,0,2,1
7131,8,6,3,0,3,3
7131,7,11,6,0,5,6
7131,6,22,9,0,13,9
7131,5,12,6,0,6,6
7131,4,4,1,0,3,1
7131,3,3,2,0,1,2
7131,1,1,1,0,0,1
228372,8,19,5,0,14,5
228372,7,16,5,0,11,5
228372,6,13,3,0,10,3
228372,5,3,2,0,1,2
228372,4,3,1,0,2,1
192635,7,15,1,0,14,1
192635,6,20,1,0,19,1
192635,5,12,1,0,11,1
192635,2,1,1,0,0,1
4319,10,2,1,0,1,1
4319,9,1,1,0,0,1
4319,7,6,1,0,5,1
4319,6,24,3,0,21,3
4319,5,7,3,0,4,3
4319,4,10,4,0,6,4
4319,3,6,3,0,3,3
4319,2,1,1,0,0,1
4319,1,1,1,0,0,1
947,7,7,5,0,2,5
947,6,13,7,0,6,7
947,5,18,3,0,15,3
947,4,8,1,0,7,1
947,2,5,2,0,3,2
8408,10,2,1,0,1,1
8408,8,6,1,0,5,1
8408,7,14,4,0,10,4
8408,6,17,5,0,12,5
8408,5,8,4,0,4,4
8408,4,8,1,0,7,1
8408,2,2,1,0,1,1
500,9,3,2,0,1,2
500,8,9,4,0,5,4
500,7,9,2,0,7,2
500,6,19,4,0,15,4
500,5,10,3,0,7,3
500,4,6,2,0,4,2
30684,10,4,1,0,3,1
30684,8,15,6,0,9,6
30684,7,16,3,0,13,3
30684,6,10,2,0,8,2
30684,5,7,3,0,4,3
30684,4,3,1,0,2,1
30684,2,2,1,0,1,1
41198,9,2,1,0,1,1
41198,8,15,5,0,10,5
41198,7,21,3,0,18,3
41198,6,9,4,0,5,4
41198,5,4,1,0,3,1
41198,2,1,1,0,0,1
41198,1,5,1,0,4,1
9376,8,12,2,0,10,2
9376,7,11,4,0,7,4
9376,6,16,2,0,14,2
9376,5,11,1,0,10,1
9376,4,3,2,0,1,2
177477,10,4,1,0,3,1
177477,9,6,2,0,4,2
177477,8,12,3,0,9,3
177477,7,9,4,1,5,3
177477,6,18,3,0,15,3
177477,4,2,1,0,1,1
11465,9,3,2,0,1,2
11465,8,13,3,0,10,3
11465,7,18,2,0,16,2
11465,6,12,4,0,8,4
11465,5,8,2,0,6,2
8998,7,10,3,0,7,3
8998,6,23,4,0,19,4
8998,5,8,1,0,7,1
8998,4,13,1,0,12,1
195477,10,3,1,0,2,1
195477,8,12,2,0,10,2
195477,7,13,3,0,10,3
195477,6,18,3,0,15,3
195477,4,4,1,0,3,1
5479,10,6,2,0,4,2
5479,9,3,1,0,2,1
5479,8,5,3,0,2,3
5479,7,25,8,0,17,8
5479,6,10,3,0,7,3
5479,5,7,3,0,4,3
5479,4,3,1,0,2,1
67084,10,9,4,0,5,4
67084,9,11,2,0,9,2
67084,8,15,6,0,9,6
67084,7,5,1,0,4,1
67084,6,7,2,0,5,2
67084,5,2,2,0,0,2
67084,4,4,2,0,2,2
67084,3,2,1,0,1,1
67084,2,2,2,0,0,2
67084,1,2,1,0,1,1
124393,8,6,1,0,5,1
124393,7,9,1,0,8,1
124393,6,18,6,0,12,6
124393,5,11,1,0,10,1
124393,4,5,1,0,4,1
124393,2,4,2,0,2,2
3374,8,5,2,0,3,2
3374,7,9,5,0,4,5
3374,6,19,4,0,15,4
3374,5,9,1,0,8,1
3374,4,10,4,0,6,4
3374,3,3,1,0,2,1
205873,10,1,1,0,0,1
205873,8,3,1,0,2,1
205873,7,13,4,0,9,4
205873,6,16,2,0,14,2
205873,4,6,1,0,5,1
205873,3,7,2,0,5,2
205873,2,1,1,0,0,1
9041,9,10,1,0,9,1
9041,8,12,4,0,8,4
9041,7,10,3,0,7,3
9041,6,12,2,0,10,2
9041,2,1,1,0,0,1
35961,8,13,2,0,11,2
35961,7,10,1,0,9,1
35961,6,19,2,0,17,2
35961,5,10,2,0,8,2
35961,4,6,1,0,5,1
143674,7,12,2,0,10,2
143674,6,17,4,0,13,4
143674,5,7,1,0,6,1
164449,7,7,3,0,4,3
164449,6,8,1,0,7,1
164449,5,14,2,0,12,2
164449,4,13,1,0,12,1
164449,2,3,1,0,2,1
164449,1,5,1,0,4,1
129308,9,2,1,0,1,1
129308,7,10,5,0,5,5
129308,6,37,13,0,24,13
129308,5,6,3,0,3,3
129308,4,2,1,0,1,1
236108,10,13,7,0,6,7
236108,9,9,3,0,6,3
236108,8,23,10,1,13,9
236108,7,9,1,0,8,1
236108,6,3,1,0,2,1
183963,10,6,4,0,2,4
183963,9,4,3,0,1,3
183963,8,23,9,0,14,9
183963,7,9,3,0,6,3
183963,6,10,6,0,4,6
183963,5,2,1,0,1,1
183963,3,1,1,0,0,1
183963,2,1,1,0,0,1
131017,10,4,1,0,3,1
131017,9,14,5,0,9,5
131017,8,24,5,0,19,5
131017,7,12,2,0,10,2
131017,6,4,2,0,2,2
5727,10,1,1,0,0,1
5727,8,10,7,0,3,7
5727,7,13,5,0,8,5
5727,6,19,6,0,13,6
5727,5,11,4,0,7,4
5727,4,4,2,0,2,2
38266,10,5,4,0,1,4
38266,9,2,2,0,0,2
38266,8,17,12,0,5,12
38266,7,20,9,0,11,9
38266,6,10,3,0,7,3
38266,5,2,1,0,1,1
38266,4,3,1,0,2,1
87876,9,3,1,0,2,1
87876,8,10,5,1,5,4
87876,7,15,5,1,10,4
87876,6,13,5,0,8,5
87876,5,9,4,0,5,4
87876,3,2,2,0,0,2
4087,10,1,1,0,0,1
4087,8,13,7,0,6,7
4087,7,14,5,0,9,5
4087,6,20,10,0,10,10
4087,5,7,1,0,6,1
4087,4,1,1,0,0,1
156077,10,1,1,0,0,1
156077,8,6,2,0,4,2
156077,7,15,2,0,13,2
156077,6,18,3,0,15,3
156077,5,12,3,0,9,3
156077,4,3,1,0,2,1
2927,10,3,1,0,2,1
2927,8,5,1,0,4,1
2927,7,7,1,0,6,1
2927,6,17,9,0,8,9
2927,5,12,3,0,9,3
2927,4,8,2,0,6,2
2927,3,4,1,0,3,1
15090,9,1,1,0,0,1
15090,6,23,5,0,18,5
15090,5,19,5,0,14,5
15090,4,8,1,0,7,1
15090,3,2,1,0,1,1
267127,10,5,1,0,4,1
267127,9,10,2,0,8,2
267127,8,33,7,0,26,7
267127,7,18,3,0,15,3
267127,6,1,1,0,0,1
11790,8,5,2,0,3,2
11790,7,9,6,0,3,6
11790,6,19,10,0,9,10
11790,5,12,6,0,6,6
11790,4,6,2,0,4,2
11790,3,4,2,0,2,2
11790,2,2,1,0,1,1
10256,8,7,3,0,4,3
10256,7,14,3,0,11,3
10256,6,17,6,0,11,6
10256,5,6,2,0,4,2
10256,4,10,3,0,7,3
10256,2,2,1,0,1,1
6615,8,8,5,0,3,5
6615,7,14,6,0,8,6
6615,6,16,6,0,10,6
6615,5,14,3,0,11,3
6615,4,5,4,0,1,4
168457,9,3,1,0,2,1
168457,8,8,5,0,3,5
168457,7,13,3,0,10,3
168457,6,16,2,0,14,2
168457,5,12,2,0,10,2
168457,3,4,1,0,3,1
13169,8,3,1,0,2,1
13169,7,4,1,0,3,1
13169,6,18,6,0,12,6
13169,5,15,3,0,12,3
13169,4,11,6,0,5,6
13169,3,1,1,0,0,1
13169,2,5,2,0,3,2
110260,10,2,1,0,1,1
110260,9,3,3,0,0,3
110260,7,18,4,0,14,4
110260,6,19,5,0,14,5
110260,4,2,1,0,1,1
110260,3,1,1,0,0,1
93044,9,3,1,0,2,1
93044,8,4,1,0,3,1
93044,7,11,1,0,10,1
93044,6,18,4,0,14,4
93044,5,11,1,0,10,1
93044,4,9,1,0,8,1
93044,3,1,1,0,0,1
1853,8,2,1,0,1,1
1853,7,4,1,0,3,1
1853,6,12,5,0,7,5
1853,5,10,2,0,8,2
1853,4,17,3,0,14,3
1853,3,9,4,0,5,4
1560,7,8,3,0,5,3
1560,6,22,6,0,16,6
1560,5,14,3,0,11,3
1560,4,6,3,0,3,3
1560,3,4,1,0,3,1
36230,8,1,1,0,0,1
36230,7,9,6,0,3,6
36230,6,17,5,0,12,5
36230,5,7,2,0,5,2
36230,4,5,1,0,4,1
36230,3,3,1,0,2,1
36230,2,6,4,0,2,4
8806,10,1,1,0,0,1
8806,8,3,2,0,1,2
8806,7,11,3,0,8,3
8806,6,11,4,0,7,4
8806,5,14,4,0,10,4
8806,3,8,3,0,5,3
8806,1,1,1,0,0,1
104012,10,5,1,0,4,1
104012,9,5,2,0,3,2
104012,8,11,2,0,9,2
104012,7,10,3,0,7,3
104012,6,16,1,0,15,1
18103,10,5,3,0,2,3
18103,9,5,2,0,3,2
18103,8,21,2,0,19,2
18103,7,8,4,0,4,4
18103,6,9,3,0,6,3
18103,5,3,1,0,2,1
18103,4,5,1,0,4,1
18103,3,2,2,0,0,2
94596,8,8,2,0,6,2
94596,7,9,2,0,7,2
94596,6,21,4,0,17,4
94596,5,7,1,0,6,1
94596,4,6,1,0,5,1
94596,3,3,1,0,2,1
94596,2,1,1,0,0,1
5881,10,2,1,0,1,1
5881,9,1,1,0,0,1
5881,8,9,7,0,2,7
5881,7,15,9,0,6,9
5881,6,14,3,0,11,3
5881,5,9,1,0,8,1
5881,4,6,1,0,5,1
5881,3,2,1,0,1,1
155113,9,3,1,0,2,1
155113,8,10,2,0,8,2
155113,7,10,3,0,7,3
155113,6,19,2,0,17,2
155113,2,3,1,0,2,1
3984,9,2,1,0,1,1
3984,7,15,2,0,13,2
3984,6,22,6,0,16,6
3984,5,8,2,0,6,2
28834,7,8,3,0,5,3
28834,6,16,7,0,9,7
28834,5,15,6,0,9,6
28834,4,11,2,0,9,2
28834,3,3,1,0,2,1
28834,2,2,1,0,1,1
166767,8,17,8,3,9,5
166767,7,12,3,0,9,3
166767,6,17,3,0,14,3
166767,5,3,1,0,2,1
166767,4,3,1,1,2,0
166767,3,3,1,0,2,1
7418,10,3,1,0,2,1
7418,9,4,3,0,1,3
7418,8,6,2,0,4,2
7418,7,8,4,0,4,4
7418,6,15,5,0,10,5
7418,5,6,2,0,4,2
7418,4,9,4,0,5,4
7418,3,4,1,0,3,1
7418,2,3,1,0,2,1
5198,9,1,1,0,0,1
5198,8,6,3,0,3,3
5198,7,17,7,0,10,7
5198,6,16,6,0,10,6
5198,5,14,6,0,8,6
5198,4,3,1,0,2,1
8943,8,4,1,0,3,1
8943,7,3,2,0,1,2
8943,6,16,4,0,12,4
8943,5,14,6,0,8,6
8943,4,11,7,0,4,7
8943,3,6,2,0,4,2
8943,2,3,2,0,1,2
8943,1,1,1,0,0,1
255249,10,8,2,0,6,2
255249,9,19,6,1,13,5
255249,8,19,3,0,16,3
255249,7,11,1,0,10,1
255249,4,1,1,0,0,1
6582,10,1,1,0,0,1
6582,6,23,9,0,14,9
6582,5,17,4,0,13,4
6582,4,4,2,0,2,2
6582,3,2,1,0,1,1
6582,2,1,1,0,0,1
32702,7,6,2,0,4,2
32702,6,18,4,0,14,4
32702,5,16,6,0,10,6
32702,4,11,3,0,8,3
32702,3,2,1,0,1,1
103830,10,6,4,0,2,4
103830,9,6,3,0,3,3
103830,8,22,7,0,15,7
103830,7,10,2,0,8,2
103830,6,8,3,0,5,3
103830,4,3,2,0,1,2
88167,7,6,2,0,4,2
88167,6,19,2,0,17,2
88167,5,14,1,0,13,1
88167,3,3,1,0,2,1
67948,10,1,1,0,0,1
67948,7,4,1,0,3,1
67948,6,14,5,0,9,5
67948,5,11,4,0,7,4
67948,4,11,3,0,8,3
67948,3,5,1,0,4,1
67948,2,6,2,0,4,2
67948,1,3,2,0,1,2
8904,8,5,2,0,3,2
8904,7,3,1,0,2,1
8904,5,22,6,0,16,6
8904,4,8,4,0,4,4
8904,3,2,1,0,1,1
36237,8,5,2,0,3,2
36237,7,10,2,0,8,2
36237,6,16,6,0,10,6
36237,4,4,2,0,2,2
36237,3,3,1,0,2,1
36237,2,4,1,0,3,1
246532,10,5,2,0,3,2
246532,9,2,1,0,1,1
246532,8,15,4,0,11,4
246532,7,19,4,0,15,4
246532,6,13,3,0,10,3
246532,4,1,1,0,0,1
9173,8,2,1,0,1,1
9173,7,6,1,0,5,1
9173,6,8,1,0,7,1
9173,5,8,4,0,4,4
9173,4,11,3,0,8,3
9173,3,10,6,0,4,6
9173,2,7,3,0,4,3
9173,1,5,4,0,1,4
3571,8,5,3,0,2,3
3571,7,7,3,0,4,3
3571,6,17,8,0,9,8
3571,5,14,5,0,9,5
3571,4,6,2,0,4,2
3571,3,5,3,0,2,3
204138,6,13,3,0,10,3
204138,1,1,1,0,0,1
10308,10,1,1,0,0,1
10308,8,7,2,0,5,2
10308,7,13,5,0,8,5
10308,6,21,5,0,16,5
10308,5,9,1,0,8,1
10308,4,2,1,0,1,1
10308,3,1,1,0,0,1
10308,2,2,2,0,0,2
30102,9,2,1,0,1,1
30102,8,25,8,0,17,8
30102,7,14,3,0,11,3
30102,6,14,3,0,11,3
30102,5,1,1,0,0,1
30102,4,1,1,0,0,1
5284,6,7,3,0,4,3
5284,5,12,3,0,9,3
5284,4,11,4,0,7,4
5284,3,13,4,0,9,4
5284,2,12,2,0,10,2
5284,1,2,2,0,0,2
29408,7,3,1,0,2,1
29408,6,14,3,0,11,3
29408,5,11,1,0,10,1
29408,4,15,3,0,12,3
29408,2,4,1,0,3,1
191473,8,5,1,0,4,1
191473,7,16,2,0,14,2
191473,6,14,3,0,11,3
191473,5,9,2,0,7,2
191473,4,7,2,0,5,2
191473,2,2,1,0,1,1
191473,1,2,1,0,1,1
6006,7,6,1,0,5,1
6006,6,21,8,0,13,8
6006,5,14,4,0,10,4
6006,4,8,3,0,5,3
6006,3,4,1,0,3,1
6006,2,2,1,0,1,1
26446,9,3,3,0,0,3
26446,8,10,4,0,6,4
26446,7,13,7,0,6,7
26446,6,17,6,0,11,6
26446,5,7,1,0,6,1
26446,4,4,1,0,3,1
26446,1,1,1,0,0,1
4299,10,3,1,0,2,1
4299,8,5,3,0,2,3
4299,7,6,3,0,3,3
4299,6,10,3,0,7,3
4299,5,16,8,0,8,8
4299,4,10,7,0,3,7
4299,3,2,1,0,1,1
4299,2,4,3,0,1,3
6470,9,7,2,0,5,2
6470,8,7,2,0,5,2
6470,7,17,3,0,14,3
6470,6,19,6,0,13,6
6470,5,4,1,0,3,1
26976,7,13,3,0,10,3
26976,6,15,6,0,9,6
26976,5,10,4,0,6,4
26976,4,5,2,0,3,2
26976,3,4,2,0,2,2
26976,2,2,1,0,1,1
22297,10,4,2,0,2,2
22297,8,18,8,0,10,8
22297,7,19,9,0,10,9
22297,6,9,4,0,5,4
22297,5,3,2,0,1,2
19009,10,6,2,0,4,2
19009,9,9,2,0,7,2
19009,8,10,2,0,8,2
19009,7,14,5,0,9,5
19009,6,12,2,0,10,2
19009,5,5,1,0,4,1
19009,3,1,1,0,0,1
11708,10,5,2,0,3,2
11708,9,8,4,0,4,4
11708,7,19,4,0,15,4
11708,6,8,1,0,7,1
11708,5,3,2,0,1,2
11708,4,4,1,0,3,1
11708,3,2,2,0,0,2
1400,7,6,3,0,3,3
1400,6,19,5,0,14,5
1400,5,3,1,0,2,1
1400,4,4,1,0,3,1
3319,10,2,2,0,0,2
3319,8,5,1,0,4,1
3319,7,10,2,0,8,2
3319,6,21,2,0,19,2
3319,5,10,2,0,8,2
3319,4,7,4,0,3,4
248075,9,5,2,0,3,2
248075,7,22,4,0,18,4
248075,4,4,1,0,3,1
6088,8,6,5,0,1,5
6088,7,19,5,0,14,5
6088,6,17,5,0,12,5
6088,5,11,3,0,8,3
6088,2,1,1,0,0,1
745,10,6,4,0,2,4
745,9,5,1,0,4,1
745,8,14,5,0,9,5
745,7,11,2,0,9,2
745,6,12,2,0,10,2
745,4,4,2,0,2,2
745,2,1,1,0,0,1
3175,7,3,2,0,1,2
3175,6,11,3,0,8,3
3175,5,19,7,0,12,7
3175,4,11,1,0,10,1
3175,3,8,2,0,6,2
3175,2,1,1,0,0,1
61916,6,17,4,0,13,4
61916,5,15,2,0,13,2
61916,3,6,1,0,5,1
186974,8,10,3,0,7,3
186974,7,15,5,0,10,5
186974,6,22,8,0,14,8
186974,5,8,4,0,4,4
186974,4,1,1,0,0,1
186974,3,1,1,0,0,1
103402,7,4,2,0,2,2
103402,6,9,1,0,8,1
103402,5,8,1,0,7,1
103402,4,14,2,0,12,2
103402,3,12,2,0,10,2
103402,2,6,1,0,5,1
103402,1,3,2,0,1,2
6342,8,7,4,0,3,4
6342,7,6,3,0,3,3
6342,6,23,6,0,17,6
6342,5,8,3,0,5,3
6342,4,8,1,0,7,1
6342,3,3,2,0,1,2
10995,10,3,2,0,1,2
10995,9,3,2,0,1,2
10995,8,9,5,0,4,5
10995,7,21,10,0,11,10
10995,6,15,6,0,9,6
10995,5,5,1,0,4,1
150012,10,7,2,0,5,2
150012,9,13,2,0,11,2
150012,8,21,7,0,14,7
150012,7,8,4,0,4,4
150012,6,3,1,0,2,1
150012,5,3,1,0,2,1
150012,3,2,1,0,1,1
165095,10,2,1,0,1,1
165095,7,17,2,1,15,1
165095,6,21,4,1,17,3
165095,5,6,1,0,5,1
165095,3,2,1,0,1,1
165095,2,1,1,0,0,1
134596,8,7,1,0,6,1
134596,7,13,2,0,11,2
134596,6,19,1,0,18,1
134596,5,6,1,0,5,1
134596,4,7,2,0,5,2
11132,10,4,3,0,1,3
11132,9,3,2,0,1,2
11132,8,12,6,0,6,6
11132,7,12,7,0,5,7
11132,6,14,5,0,9,5
11132,5,8,3,0,5,3
11132,4,4,3,0,1,3
6036,8,9,2,0,7,2
6036,6,24,7,0,17,7
6036,5,11,1,0,10,1
6036,2,1,1,0,0,1
4393,8,6,2,0,4,2
4393,7,13,4,0,9,4
4393,6,17,3,0,14,3
4393,5,11,3,0,8,3
4393,2,2,1,0,1,1
4393,1,1,1,0,0,1
23421,9,13,3,0,10,3
23421,8,17,4,0,13,4
23421,7,17,7,0,10,7
23421,6,4,1,0,3,1
23421,5,3,2,0,1,2
204069,6,13,3,0,10,3
204069,5,13,1,0,12,1
204069,4,16,5,0,11,5
204069,3,6,1,0,5,1
204069,2,1,1,0,0,1
186142,9,5,1,0,4,1
186142,8,11,3,0,8,3
186142,7,10,4,0,6,4
186142,5,10,1,0,9,1
186142,4,6,1,0,5,1
186142,2,2,2,0,0,2
26840,8,13,6,0,7,6
26840,7,21,7,0,14,7
26840,6,18,8,0,10,8
26840,5,4,3,0,1,3
26840,2,1,1,0,0,1
217404,8,6,2,0,4,2
217404,7,17,4,0,13,4
217404,6,25,5,0,20,5
217404,5,3,1,0,2,1
223286,10,2,1,0,1,1
223286,9,4,1,0,3,1
223286,8,6,1,0,5,1
223286,7,17,2,1,15,1
223286,6,13,1,0,12,1
223286,5,10,1,0,9,1
223286,4,4,2,1,2,1
223286,3,3,3,0,0,3
23684,9,1,1,0,0,1
23684,7,6,2,0,4,2
23684,6,12,3,0,9,3
23684,5,17,4,0,13,4
23684,4,12,3,0,9,3
23684,2,3,1,0,2,1
23684,1,3,2,0,1,2
7552,7,6,3,0,3,3
7552,6,22,5,0,17,5
7552,5,11,5,0,6,5
7552,4,8,4,0,4,4
7552,3,4,2,0,2,2
7552,2,5,2,0,3,2
24209,8,12,2,0,10,2
24209,7,18,2,0,16,2
20624,8,3,1,0,2,1
20624,7,5,2,0,3,2
20624,6,13,8,0,5,8
20624,5,14,8,0,6,8
20624,4,9,2,0,7,2
20624,3,8,5,0,3,5
20624,2,3,1,0,2,1
20624,1,2,2,0,0,2
181670,8,13,4,2,9,2
181670,7,13,3,1,10,2
181670,6,10,2,0,8,2
181670,5,10,1,0,9,1
181670,4,4,1,0,3,1
20617,9,3,2,0,1,2
20617,8,6,3,0,3,3
20617,7,15,4,0,11,4
20617,6,21,8,0,13,8
20617,5,7,3,0,4,3
20617,4,5,3,0,2,3
75529,10,1,1,0,0,1
75529,8,14,6,0,8,6
75529,7,20,6,0,14,6
75529,6,19,6,0,13,6
75529,5,1,1,0,0,1
75529,4,3,1,0,2,1
150831,10,6,5,0,1,5
150831,8,20,10,0,10,10
150831,7,18,8,0,10,8
150831,6,6,2,0,4,2
150831,3,1,1,0,0,1
150831,2,2,1,0,1,1
209220,8,3,1,0,2,1
209220,7,9,2,0,7,2
209220,6,21,4,0,17,4
209220,5,12,1,0,11,1
209220,4,5,1,0,4,1
209220,3,5,3,0,2,3
42279,8,7,2,0,5,2
42279,7,15,6,0,9,6
42279,6,17,9,0,8,9
42279,5,10,4,0,6,4
42279,4,7,3,0,4,3
2701,10,1,1,0,0,1
2701,8,4,1,0,3,1
2701,7,7,3,0,4,3
2701,6,17,3,0,14,3
2701,5,18,2,0,16,2
2701,4,4,1,0,3,1
2701,3,5,2,0,3,2
21015,10,3,1,0,2,1
21015,9,3,1,0,2,1
21015,8,8,3,0,5,3
21015,7,17,4,0,13,4
21015,6,21,4,0,17,4
10573,8,9,3,0,6,3
10573,7,18,9,0,9,9
10573,6,21,8,0,13,8
10573,5,9,3,0,6,3
8637,8,3,1,0,2,1
8637,7,6,2,0,4,2
8637,6,16,4,0,12,4
8637,5,16,7,0,9,7
8637,4,8,4,0,4,4
8637,3,5,3,0,2,3
8637,2,4,2,0,2,2
24105,10,1,1,0,0,1
24105,8,3,3,0,0,3
24105,7,6,2,0,4,2
24105,6,18,2,0,16,2
24105,5,9,3,0,6,3
24105,4,4,1,0,3,1
24105,3,7,1,0,6,1
24105,2,5,2,0,3,2
24105,1,5,1,0,4,1
6879,8,6,1,0,5,1
6879,7,10,2,0,8,2
6879,6,24,6,0,18,6
6879,5,12,3,0,9,3
6879,3,1,1,0,0,1
6879,2,2,1,0,1,1
2373,6,18,2,0,16,2
2373,5,14,2,0,12,2
2373,4,4,2,0,2,2
3908,9,1,1,0,0,1
3908,8,3,1,0,2,1
3908,6,3,1,0,2,1
3908,5,12,5,0,7,5
3908,4,20,10,0,10,10
3908,3,6,3,0,3,3
3908,2,8,5,0,3,5
3908,1,4,3,0,1,3
184207,9,1,1,0,0,1
184207,8,22,4,0,18,4
184207,7,15,1,0,14,1
184207,6,15,1,0,14,1
184207,1,4,3,0,1,3
169393,10,5,2,0,3,2
169393,9,2,1,0,1,1
169393,8,4,2,1,2,1
169393,7,8,1,0,7,1
169393,6,15,3,0,12,3
169393,5,13,2,0,11,2
6052,7,5,1,0,4,1
6052,6,14,4,0,10,4
6052,5,11,1,0,10,1
6052,3,8,2,0,6,2
6052,2,3,1,0,2,1
6052,1,5,5,0,0,5
129851,8,8,2,0,6,2
129851,7,6,1,0,5,1
129851,6,14,2,0,12,2
129851,5,8,3,0,5,3
129851,4,17,4,0,13,4
230240,10,1,1,0,0,1
230240,9,5,2,0,3,2
230240,8,8,2,0,6,2
230240,7,18,3,0,15,3
230240,5,6,1,0,5,1
230240,4,4,1,0,3,1
181492,8,10,1,0,9,1
181492,7,8,3,0,5,3
181492,6,12,3,0,9,3
181492,5,9,1,0,8,1
181492,4,9,3,0,6,3
181492,2,4,2,0,2,2
6402,9,1,1,0,0,1
6402,8,9,4,0,5,4
6402,7,19,7,0,12,7
6402,6,16,7,0,9,7
6402,5,4,1,0,3,1
6402,4,4,1,0,3,1
6402,3,2,1,0,1,1
6402,2,1,1,0,0,1
224011,10,3,2,0,1,2
224011,9,2,1,0,1,1
224011,8,2,1,0,1,1
224011,7,12,1,0,11,1
224011,6,15,1,0,14,1
224011,5,13,4,0,9,4
224011,4,7,1,0,6,1
37382,7,9,1,0,8,1
37382,6,12,1,0,11,1
37382,5,17,5,0,12,5
37382,4,9,2,0,7,2
37382,3,2,1,0,1,1
197911,10,5,4,0,1,4
197911,8,15,6,1,9,5
197911,7,15,2,0,13,2
197911,6,7,2,0,5,2
197911,5,5,2,0,3,2
197911,4,6,3,0,3,3
9514,10,1,1,0,0,1
9514,9,2,1,0,1,1
9514,6,16,4,0,12,4
9514,5,8,4,0,4,4
9514,4,11,6,0,5,6
9514,3,9,3,0,6,3
9514,2,7,3,0,4,3
9514,1,2,2,0,0,2
18843,10,3,2,0,1,2
18843,9,4,2,0,2,2
18843,8,3,1,0,2,1
18843,7,11,3,0,8,3
18843,6,20,3,0,17,3
18843,4,6,1,0,5,1
18843,1,1,1,0,0,1
249677,10,17,10,1,7,9
249677,9,15,8,0,7,8
249677,8,18,14,2,4,12
249677,7,6,2,0,4,2
249677,5,1,1,0,0,1
9416,8,5,2,0,3,2
9416,7,7,4,0,3,4
9416,6,7,3,0,4,3
9416,5,12,4,0,8,4
9416,4,9,2,0,7,2
9416,3,10,5,0,5,5
9416,2,4,3,0,1,3
9416,1,4,2,0,2,2
151947,7,12,2,0,10,2
151947,6,18,3,0,15,3
151947,5,10,1,0,9,1
151947,4,8,2,0,6,2
239930,8,10,1,1,9,0
239930,6,18,5,0,13,5
239930,5,5,1,0,4,1
239930,3,1,1,0,0,1
88608,8,5,3,0,2,3
88608,7,2,1,0,1,1
88608,6,12,1,0,11,1
88608,5,16,2,0,14,2
88608,4,13,2,0,11,2
88608,2,6,1,0,5,1
103807,10,1,1,0,0,1
103807,7,18,3,0,15,3
103807,6,22,3,0,19,3
103807,5,7,3,0,4,3
23374,7,8,2,0,6,2
23374,6,27,9,0,18,9
23374,5,10,4,0,6,4
23374,4,6,2,0,4,2
23374,3,3,2,0,1,2
23374,2,1,1,0,0,1
22753,9,2,2,0,0,2
22753,8,3,1,0,2,1
22753,7,9,4,0,5,4
22753,6,21,11,0,10,11
22753,5,8,2,0,6,2
22753,4,9,3,0,6,3
22753,3,3,1,0,2,1
198044,10,1,1,0,0,1
198044,9,2,1,0,1,1
198044,8,9,1,0,8,1
198044,7,17,3,0,14,3
198044,6,15,5,0,10,5
198044,1,1,1,0,0,1
70096,10,3,1,0,2,1
70096,9,5,3,0,2,3
70096,7,12,2,0,10,2
70096,6,18,4,0,14,4
254135,9,3,1,0,2,1
254135,8,9,2,0,7,2
254135,7,26,5,0,21,5
254135,6,13,1,0,12,1
254135,4,3,1,0,2,1
254135,2,1,1,0,0,1
139728,3,4,1,0,3,1
200886,10,5,2,0,3,2
200886,9,8,6,0,2,6
200886,8,19,3,1,16,2
200886,7,7,1,0,6,1
200886,6,6,1,0,5,1
200886,3,3,1,0,2,1
10265,7,11,4,0,7,4
10265,6,26,15,0,11,15
10265,5,8,2,0,6,2
10265,4,3,2,0,1,2
10265,3,2,1,0,1,1
2263,9,2,1,0,1,1
2263,8,5,3,0,2,3
2263,7,20,8,0,12,8
2263,6,18,4,0,14,4
209284,10,2,1,0,1,1
209284,8,5,1,0,4,1
209284,7,7,2,0,5,2
209284,6,21,7,0,14,7
209284,5,7,1,0,6,1
209284,4,13,1,0,12,1
209284,3,2,1,0,1,1
6024,8,7,2,0,5,2
6024,7,10,4,0,6,4
6024,6,18,4,0,14,4
6024,5,13,5,0,8,5
6024,4,4,2,0,2,2
15806,8,2,2,0,0,2
15806,7,7,1,0,6,1
15806,6,17,4,0,13,4
15806,5,12,4,0,8,4
15806,4,10,2,0,8,2
15806,2,3,1,0,2,1
3049,8,5,2,0,3,2
3049,7,10,5,0,5,5
3049,6,23,7,0,16,7
3049,5,10,4,0,6,4
3049,4,6,1,0,5,1
3049,3,1,1,0,0,1
3049,2,1,1,0,0,1
220675,10,2,1,0,1,1
220675,9,3,1,0,2,1
220675,8,19,5,0,14,5
220675,7,15,2,0,13,2
220675,6,10,2,0,8,2
220675,5,4,2,0,2,2
220675,4,2,1,0,1,1
5303,10,2,2,0,0,2
5303,9,4,1,0,3,1
5303,8,10,3,0,7,3
5303,7,9,4,0,5,4
5303,6,12,3,0,9,3
5303,5,10,2,0,8,2
5303,3,3,1,0,2,1
5303,2,4,2,0,2,2
161148,9,1,1,0,0,1
161148,8,10,6,0,4,6
161148,7,15,1,0,14,1
161148,6,17,5,0,12,5
161148,5,10,3,0,7,3
161148,4,2,1,0,1,1
161148,1,2,1,0,1,1
63951,10,2,2,0,0,2
63951,9,10,6,0,4,6
63951,8,17,6,0,11,6
63951,7,10,3,0,7,3
63951,6,12,4,0,8,4
63951,4,3,1,0,2,1
63951,2,1,1,0,0,1
72200,10,2,1,0,1,1
72200,9,6,3,0,3,3
72200,8,21,7,0,14,7
72200,7,13,4,0,9,4
72200,6,7,2,0,5,2
72200,5,5,1,0,4,1
72200,3,2,2,0,0,2
72200,1,1,1,0,0,1
203408,10,4,1,0,3,1
203408,9,4,2,0,2,2
203408,8,14,1,0,13,1
203408,7,15,2,0,13,2
203408,5,4,2,0,2,2
7145,8,8,3,0,5,3
7145,7,8,3,0,5,3
7145,6,21,7,0,14,7
7145,5,10,4,0,6,4
7145,4,5,2,0,3,2
7145,3,3,3,0,0,3
7145,2,1,1,0,0,1
244153,10,3,1,0,2,1
244153,8,15,4,0,11,4
244153,7,11,1,0,10,1
244153,6,14,3,0,11,3
244153,5,6,1,0,5,1
244153,4,1,1,0,0,1
244153,3,4,4,0,0,4
25253,9,4,1,0,3,1
25253,8,11,6,0,5,6
25253,7,19,6,0,13,6
25253,6,12,5,0,7,5
25253,5,4,1,0,3,1
25253,4,4,3,0,1,3
2385,9,2,1,0,1,1
2385,8,6,4,0,2,4
2385,7,9,3,0,6,3
2385,6,12,2,0,10,2
2385,5,14,2,0,12,2
2385,4,7,2,0,5,2
2385,3,5,1,0,4,1
2385,2,2,1,0,1,1
250481,10,4,3,0,1,3
250481,9,8,3,0,5,3
250481,8,32,12,0,20,12
250481,6,5,1,0,4,1
10168,10,8,4,0,4,4
10168,9,10,5,0,5,5
10168,8,17,8,0,9,8
10168,7,10,5,0,5,5
10168,6,8,4,0,4,4
94493,10,4,1,0,3,1
94493,9,3,1,0,2,1
94493,8,17,4,0,13,4
94493,7,12,1,0,11,1
94493,6,19,5,0,14,5
58782,10,4,1,0,3,1
58782,9,3,2,0,1,2
58782,8,7,1,0,6,1
58782,7,21,1,0,20,1
58782,6,15,1,0,14,1
58782,5,5,1,0,4,1
58782,4,2,1,0,1,1
28096,10,9,4,0,5,4
28096,9,5,1,0,4,1
28096,8,11,1,0,10,1
28096,7,9,2,0,7,2
28096,6,4,1,0,3,1
28096,5,6,3,0,3,3
28096,4,5,5,0,0,5
28096,3,3,2,0,1,2
28096,2,3,1,0,2,1
236650,10,24,10,0,14,10
236650,9,20,7,0,13,7
236650,8,10,3,0,7,3
236650,7,3,2,0,1,2
173462,10,6,3,0,3,3
173462,9,6,3,0,3,3
173462,8,18,5,0,13,5
173462,7,9,3,2,6,1
173462,6,8,3,1,5,2
173462,3,4,1,0,3,1
1947,10,1,1,0,0,1
1947,8,5,1,0,4,1
1947,7,6,1,0,5,1
1947,6,12,3,0,9,3
1947,5,17,2,0,15,2
1947,3,4,3,0,1,3
1947,2,1,1,0,0,1
3046,9,1,1,0,0,1
3046,8,3,1,0,2,1
3046,7,6,1,0,5,1
3046,6,27,10,0,17,10
3046,5,13,3,0,10,3
3046,3,3,3,0,0,3
127433,10,8,3,0,5,3
127433,9,2,1,0,1,1
127433,8,12,2,0,10,2
127433,7,9,1,0,8,1
127433,6,14,4,0,10,4
127433,3,2,1,0,1,1
127433,2,2,2,0,0,2
181005,8,6,2,0,4,2
181005,7,12,1,0,11,1
181005,6,29,2,0,27,2
181005,5,7,1,0,6,1
130624,9,1,1,0,0,1
130624,8,2,1,0,1,1
130624,7,7,1,0,6,1
130624,6,17,6,0,11,6
130624,5,15,5,0,10,5
97332,9,10,1,0,9,1
97332,8,18,2,0,16,2
97332,7,14,1,0,13,1
97332,6,4,1,0,3,1
10884,9,10,3,0,7,3
10884,8,14,7,0,7,7
10884,7,10,3,0,7,3
10884,6,12,1,0,11,1
10884,5,5,3,0,2,3
197068,10,1,1,0,0,1
197068,9,2,2,0,0,2
197068,8,5,3,0,2,3
197068,6,16,2,0,14,2
197068,5,11,3,0,8,3
197068,4,9,3,0,6,3
197068,3,3,1,0,2,1
197068,2,5,1,0,4,1
165587,8,6,1,0,5,1
165587,7,12,1,0,11,1
165587,6,25,4,0,21,4
165587,4,3,2,0,1,2
165587,3,1,1,0,0,1
3631,8,7,2,0,5,2
3631,7,7,4,0,3,4
3631,6,12,4,0,8,4
3631,5,17,2,0,15,2
3631,4,7,2,0,5,2
3631,3,2,1,0,1,1
3631,2,4,1,0,3,1
1617,8,3,2,0,1,2
1617,7,14,5,0,9,5
1617,6,11,4,0,7,4
1617,5,17,9,0,8,9
1617,4,6,2,0,4,2
1617,3,5,1,0,4,1
1617,1,1,1,0,0,1
37912,10,5,1,0,4,1
37912,9,8,3,0,5,3
37912,8,19,4,0,15,4
37912,7,13,10,0,3,10
37912,6,5,3,0,2,3
37912,5,4,2,0,2,2
205884,7,11,3,0,8,3
205884,6,23,3,0,20,3
205884,5,9,2,0,7,2
205884,4,8,4,0,4,4
685,10,6,5,0,1,5
685,9,6,4,0,2,4
685,8,13,7,0,6,7
685,7,12,1,0,11,1
685,6,8,4,0,4,4
685,5,6,1,0,5,1
685,4,2,2,0,0,2
685,2,3,3,0,0,3
65557,7,7,3,0,4,3
65557,6,19,6,0,13,6
65557,5,14,3,0,11,3
65557,4,11,1,0,10,1
206681,9,1,1,0,0,1
206681,8,6,3,0,3,3
206681,6,20,5,1,15,4
206681,5,14,1,0,13,1
206681,4,7,1,0,6,1
212348,10,3,1,0,2,1
212348,9,1,1,0,0,1
212348,8,6,2,1,4,1
212348,7,10,3,1,7,2
212348,6,18,4,0,14,4
212348,5,6,1,0,5,1
212348,4,8,2,1,6,1
212348,2,1,1,0,0,1
212348,1,2,2,1,0,1
2625,7,7,3,0,4,3
2625,6,21,2,0,19,2
2625,5,11,1,0,10,1
2625,4,11,4,0,7,4
2625,3,4,1,0,3,1
33906,6,10,2,0,8,2
33906,5,16,1,0,15,1
49400,9,5,1,0,4,1
49400,8,14,1,0,13,1
49400,7,18,1,0,17,1
49400,6,9,3,0,6,3
49400,4,2,1,0,1,1
10744,10,1,1,0,0,1
10744,9,1,1,0,0,1
10744,8,3,1,0,2,1
10744,7,5,3,0,2,3
10744,6,10,3,0,7,3
10744,5,15,4,0,11,4
10744,4,12,4,0,8,4
10744,3,5,2,0,3,2
10744,2,3,3,0,0,3
10744,1,2,2,0,0,2
247585,10,26,3,0,23,3
247585,9,5,2,0,3,2
247585,7,3,1,0,2,1
247585,4,1,1,0,0,1
247585,1,11,9,0,2,9
251538,10,2,1,0,1,1
251538,8,8,1,0,7,1
251538,7,15,3,0,12,3
251538,6,14,1,0,13,1
251538,3,3,1,0,2,1
251538,2,2,1,0,1,1
71569,8,16,6,0,10,6
71569,7,14,3,0,11,3
71569,5,5,2,0,3,2
71569,4,6,2,0,4,2
43801,9,5,1,0,4,1
43801,8,22,7,0,15,7
43801,7,17,5,0,12,5
43801,5,2,1,0,1,1
43801,3,1,1,0,0,1
220975,10,24,11,0,13,11
220975,9,15,3,0,12,3
220975,8,12,2,0,10,2
220975,7,3,1,0,2,1
220975,5,1,1,0,0,1
6023,9,1,1,0,0,1
6023,8,5,1,0,4,1
6023,7,9,3,0,6,3
6023,6,19,3,0,16,3
6023,5,13,5,0,8,5
6023,4,7,3,0,4,3
6023,3,2,2,0,0,2
251442,9,3,2,0,1,2
251442,8,18,3,1,15,2
251442,7,16,4,0,12,4
251442,6,16,2,2,14,0
236459,10,2,1,0,1,1
236459,8,5,1,0,4,1
236459,7,13,1,0,12,1
236459,4,7,3,0,4,3
236459,3,6,2,0,4,2
236459,1,2,1,0,1,1
113436,9,1,1,0,0,1
113436,8,2,1,0,1,1
113436,7,2,1,0,1,1
113436,6,11,6,1,5,5
113436,4,7,3,0,4,3
113436,3,10,5,2,5,3
113436,2,9,2,1,7,1
113436,1,10,5,0,5,5
158793,10,13,5,0,8,5
158793,9,13,3,0,10,3
158793,8,16,5,0,11,5
158793,7,9,4,0,5,4
158793,6,1,1,0,0,1
158793,5,1,1,0,0,1
158793,3,3,2,0,1,2
112844,6,17,2,0,15,2
2137,9,3,3,0,0,3
2137,8,11,5,0,6,5
2137,7,6,2,0,4,2
2137,6,13,5,0,8,5
2137,5,16,6,0,10,6
2137,4,3,2,0,1,2
2137,3,2,2,0,0,2
198881,10,1,1,0,0,1
198881,9,3,3,1,0,2
198881,8,11,5,1,6,4
198881,7,16,6,0,10,6
198881,6,17,5,0,12,5
198881,5,5,2,0,3,2
198881,3,2,1,0,1,1
125765,8,4,1,0,3,1
125765,6,10,2,0,8,2
125765,5,15,4,0,11,4
125765,4,8,2,0,6,2
125765,2,6,5,0,1,5
137016,7,6,1,0,5,1
137016,6,22,2,0,20,2
137016,5,14,2,0,12,2
137016,4,9,3,0,6,3
137016,3,2,1,0,1,1
122236,10,7,3,0,4,3
122236,9,8,2,0,6,2
122236,8,25,7,0,18,7
122236,7,11,2,0,9,2
10578,7,9,1,0,8,1
10578,6,15,2,0,13,2
10578,5,15,4,0,11,4
10578,4,9,2,0,7,2
134815,7,3,2,0,1,2
134815,6,4,1,0,3,1
134815,5,7,1,0,6,1
134815,4,5,2,0,3,2
134815,3,13,4,0,9,4
134815,2,14,3,0,11,3
134815,1,10,3,0,7,3
4124,9,3,2,0,1,2
4124,8,10,5,0,5,5
4124,7,15,7,0,8,7
4124,6,23,6,0,17,6
4124,5,4,1,0,3,1
4124,4,1,1,0,0,1
140317,7,8,2,0,6,2
140317,5,10,1,0,9,1
140317,4,13,2,0,11,2
140317,3,3,1,0,2,1
140317,2,5,2,0,3,2
255029,9,9,2,0,7,2
255029,7,19,2,0,17,2
255029,6,9,3,0,6,3
255029,2,1,1,0,0,1
4118,7,7,2,0,5,2
4118,6,13,6,0,7,6
4118,5,16,5,0,11,5
4118,4,7,2,0,5,2
260335,9,4,3,0,1,3
260335,6,19,1,0,18,1
260335,5,8,2,0,6,2
212839,10,11,2,1,9,1
212839,9,11,3,1,8,2
212839,8,24,8,1,16,7
212839,7,11,1,0,10,1
212839,6,5,1,0,4,1
212839,2,1,1,0,0,1
5701,10,1,1,0,0,1
5701,8,3,1,0,2,1
5701,7,22,3,0,19,3
5701,6,22,6,0,16,6
5701,5,5,1,0,4,1
22629,8,1,1,0,0,1
22629,7,6,2,0,4,2
22629,6,13,6,0,7,6
22629,5,11,2,0,9,2
22629,4,14,5,0,9,5
22629,3,4,2,0,2,2
22629,2,5,2,0,3,2
22629,1,3,2,0,1,2
86458,9,5,2,0,3,2
86458,8,18,6,0,12,6
86458,7,20,5,0,15,5
86458,6,5,3,0,2,3
86458,5,2,1,0,1,1
86458,4,3,3,0,0,3
86458,3,1,1,0,0,1
31358,7,14,3,0,11,3
31358,6,18,6,0,12,6
31358,5,12,4,0,8,4
31358,4,7,5,0,2,5
31358,3,2,1,0,1,1
158771,10,2,1,0,1,1
158771,9,3,1,0,2,1
158771,8,10,2,2,8,0
158771,7,5,1,0,4,1
158771,6,13,2,0,11,2
158771,5,3,1,0,2,1
158771,4,4,2,0,2,2
158771,3,7,2,0,5,2
158771,2,8,2,0,6,2
158771,1,2,1,0,1,1
38747,8,12,3,0,9,3
38747,7,8,3,0,5,3
38747,6,17,5,0,12,5
38747,5,6,2,0,4,2
38747,4,5,3,0,2,3
38747,3,4,1,0,3,1
38747,2,1,1,0,0,1
264637,9,7,4,0,3,4
264637,8,26,3,0,23,3
264637,7,18,1,0,17,1
264637,5,1,1,0,0,1
207848,10,1,1,0,0,1
207848,9,2,1,0,1,1
207848,8,3,1,0,2,1
207848,7,5,2,0,3,2
207848,6,6,1,0,5,1
207848,5,12,1,1,11,0
207848,3,5,1,0,4,1
207848,2,7,3,0,4,3
207848,1,12,9,0,3,9
139390,10,4,1,0,3,1
139390,8,10,1,0,9,1
139390,7,17,4,0,13,4
139390,6,13,2,0,11,2
139390,2,2,1,0,1,1
69687,10,1,1,0,0,1
69687,8,7,4,0,3,4
69687,7,17,8,0,9,8
69687,6,12,6,0,6,6
69687,5,10,4,0,6,4
69687,4,2,2,0,0,2
69687,3,1,1,0,0,1
69687,1,3,2,0,1,2
11248,9,3,2,0,1,2
11248,7,3,1,0,2,1
11248,6,3,2,0,1,2
11248,5,10,2,0,8,2
11248,4,15,6,0,9,6
11248,3,15,4,0,11,4
11248,2,4,2,0,2,2
210113,10,11,7,0,4,7
210113,9,9,2,0,7,2
210113,8,18,4,1,14,3
210113,7,5,2,1,3,1
210113,6,8,1,0,7,1
210113,5,4,1,0,3,1
210113,1,2,1,0,1,1
705,8,15,3,0,12,3
705,7,16,4,0,12,4
705,6,16,4,0,12,4
705,5,6,3,0,3,3
705,4,1,1,0,0,1
146151,7,7,1,0,6,1
146151,6,25,4,0,21,4
146151,5,8,3,0,5,3
146151,4,12,3,0,9,3
146151,2,3,1,0,2,1
2875,8,20,5,0,15,5
2875,7,18,3,0,15,3
2875,6,9,2,0,7,2
2875,5,5,1,0,4,1
2875,4,1,1,0,0,1
2875,3,1,1,0,0,1
5786,9,1,1,0,0,1
5786,8,6,2,0,4,2
5786,7,9,3,0,6,3
5786,6,16,5,0,11,5
5786,5,11,2,0,9,2
5786,4,6,3,0,3,3
5786,3,4,3,0,1,3
4968,10,2,1,0,1,1
4968,8,7,4,0,3,4
4968,7,7,5,0,2,5
4968,6,15,5,0,10,5
4968,5,16,8,0,8,8
4968,4,5,1,0,4,1
4968,3,4,1,0,3,1
4968,1,1,1,0,0,1
106113,10,7,2,0,5,2
106113,9,10,4,0,6,4
106113,8,31,9,0,22,9
106113,7,7,1,0,6,1
18776,10,5,4,0,1,4
18776,8,16,9,0,7,9
18776,7,15,3,0,12,3
18776,6,8,1,0,7,1
18776,4,5,3,0,2,3
365,9,2,2,0,0,2
365,8,4,3,0,1,3
365,6,18,5,0,13,5
365,5,12,3,0,9,3
365,4,10,4,0,6,4
365,3,2,1,0,1,1
68816,9,7,4,0,3,4
68816,8,23,5,0,18,5
68816,7,13,5,0,8,5
68816,6,7,5,0,2,5
68816,5,3,1,0,2,1
68816,4,1,1,0,0,1
68816,3,2,1,0,1,1
191687,7,15,2,0,13,2
191687,6,15,2,0,13,2
191687,5,13,3,0,10,3
191687,3,4,1,0,3,1
2907,8,7,3,0,4,3
2907,7,8,2,0,6,2
2907,6,27,7,0,20,7
2907,5,7,1,0,6,1
2907,4,4,2,0,2,2
2907,1,1,1,0,0,1
3578,8,1,1,0,0,1
3578,6,15,8,0,7,8
3578,5,8,2,0,6,2
3578,4,12,6,0,6,6
3578,3,8,3,0,5,3
3578,2,6,4,0,2,4
3578,1,5,3,0,2,3
142158,9,1,1,0,0,1
142158,8,7,2,0,5,2
142158,7,13,4,0,9,4
142158,6,24,5,0,19,5
142158,5,6,1,0,5,1
142158,4,3,3,0,0,3
142158,3,1,1,0,0,1
142158,1,2,1,0,1,1
1616,9,1,1,0,0,1
1616,7,13,6,0,7,6
1616,6,19,7,0,12,7
1616,5,12,5,0,7,5
1616,4,5,1,0,4,1
1616,3,2,1,0,1,1
227326,10,12,7,0,5,7
227326,9,19,5,0,14,5
227326,8,14,2,0,12,2
227326,6,5,3,0,2,3
1857,10,1,1,0,0,1
1857,6,23,7,0,16,7
1857,5,20,3,0,17,3
1857,4,6,3,0,3,3
1857,3,3,1,0,2,1
1857,2,1,1,0,0,1
7750,10,5,3,0,2,3
7750,9,8,3,0,5,3
7750,8,22,5,0,17,5
7750,7,14,3,0,11,3
7750,6,5,1,0,4,1
7750,2,1,1,0,0,1
107917,10,2,1,0,1,1
107917,9,11,2,0,9,2
107917,8,14,6,0,8,6
107917,7,13,3,0,10,3
107917,6,7,2,0,5,2
107917,5,5,2,0,3,2
107917,3,2,2,0,0,2
166260,10,2,2,0,0,2
166260,9,7,2,0,5,2
166260,8,8,1,0,7,1
166260,7,10,3,0,7,3
166260,6,12,2,0,10,2
166260,5,9,1,0,8,1
166260,4,3,2,0,1,2
166260,3,5,1,0,4,1
166260,2,1,1,0,0,1
89926,7,10,1,0,9,1
89926,5,12,5,0,7,5
89926,4,17,5,0,12,5
89926,2,2,1,0,1,1
170043,8,18,6,0,12,6
170043,7,11,1,0,10,1
170043,6,22,2,0,20,2
170043,5,5,1,0,4,1
25758,8,4,2,0,2,2
25758,7,15,9,0,6,9
25758,6,23,10,0,13,10
25758,5,9,6,0,3,6
25758,2,3,1,0,2,1
157696,10,1,1,0,0,1
157696,7,8,1,0,7,1
157696,6,20,3,0,17,3
157696,4,5,1,0,4,1
135270,9,10,3,0,7,3
135270,8,16,8,0,8,8
135270,7,16,5,0,11,5
135270,6,6,1,0,5,1
23913,7,3,1,0,2,1
23913,6,11,5,0,6,5
23913,5,15,4,0,11,4
23913,4,12,4,0,8,4
23913,3,4,2,0,2,2
23913,2,9,7,0,2,7
23913,1,3,1,0,2,1
8246,8,7,5,0,2,5
8246,7,4,2,0,2,2
8246,6,17,6,0,11,6
8246,5,16,4,0,12,4
8246,4,7,3,0,4,3
7934,10,4,2,0,2,2
7934,9,2,2,0,0,2
7934,8,14,6,0,8,6
7934,7,16,4,0,12,4
7934,6,10,3,0,7,3
7934,5,7,2,0,5,2
7934,4,3,1,0,2,1
7934,3,1,1,0,0,1
3835,10,1,1,0,0,1
3835,9,1,1,0,0,1
3835,7,4,1,0,3,1
3835,6,10,3,0,7,3
3835,5,13,3,0,10,3
3835,4,11,5,0,6,5
3835,3,11,6,0,5,6
3835,1,4,2,0,2,2
38755,10,2,1,0,1,1
38755,9,9,8,0,1,8
38755,8,15,10,0,5,10
38755,7,9,5,0,4,5
38755,6,13,4,0,9,4
38755,5,7,3,0,4,3
38755,4,1,1,0,0,1
38755,2,1,1,0,0,1
158751,8,8,1,0,7,1
158751,7,8,2,0,6,2
257722,9,6,2,0,4,2
257722,7,17,5,0,12,5
257722,6,13,2,0,11,2
257722,5,5,1,0,4,1
204802,7,14,1,0,13,1
204802,6,11,3,0,8,3
204802,3,2,1,0,1,1
899,8,3,1,0,2,1
899,7,2,1,0,1,1
899,6,8,1,0,7,1
899,5,14,2,0,12,2
899,4,16,2,0,14,2
899,3,10,3,0,7,3
899,2,3,1,0,2,1
899,1,1,1,0,0,1
153077,7,10,3,0,7,3
153077,6,20,2,0,18,2
153077,5,11,1,0,10,1
153077,4,9,1,0,8,1
3643,8,5,1,0,4,1
3643,7,8,3,0,5,3
3643,6,18,8,0,10,8
3643,5,12,4,0,8,4
3643,4,6,4,0,2,4
3643,3,3,1,0,2,1
231038,10,12,4,1,8,3
231038,9,13,9,0,4,9
231038,8,23,7,1,16,6
231038,6,3,1,0,2,1
222462,8,12,3,0,9,3
222462,7,18,3,0,15,3
222462,6,19,5,0,14,5
222462,4,2,1,0,1,1
3840,8,3,1,0,2,1
3840,6,12,6,0,6,6
3840,5,10,1,0,9,1
3840,4,7,3,0,4,3
3840,3,12,4,0,8,4
3840,2,4,3,0,1,3
3840,1,4,2,0,2,2
228501,9,1,1,0,0,1
228501,8,6,1,0,5,1
228501,7,6,1,0,5,1
228501,6,13,3,0,10,3
228501,5,12,6,0,6,6
228501,4,8,2,0,6,2
228501,3,6,2,0,4,2
228501,2,2,1,0,1,1
228501,1,3,1,0,2,1
103922,8,1,1,0,0,1
103922,7,5,3,0,2,3
103922,6,14,3,0,11,3
103922,5,16,3,0,13,3
103922,4,12,3,0,9,3
103922,3,5,1,0,4,1
19145,10,7,4,0,3,4
19145,9,10,3,0,7,3
19145,8,17,1,0,16,1
19145,7,12,3,0,9,3
19145,6,7,2,0,5,2
19145,5,4,1,0,3,1
7278,10,8,7,0,1,7
7278,9,3,1,0,2,1
7278,8,22,9,0,13,9
7278,7,12,5,0,7,5
7278,6,5,3,0,2,3
7278,5,4,2,0,2,2
253149,9,4,1,0,3,1
253149,8,12,1,0,11,1
253149,7,16,1,0,15,1
253149,6,16,1,0,15,1
253149,5,5,1,0,4,1
253149,3,2,1,0,1,1
253149,1,1,1,0,0,1
40001,8,8,1,0,7,1
40001,7,10,1,0,9,1
40001,6,13,1,0,12,1
40001,4,7,4,0,3,4
40001,2,1,1,0,0,1
24803,7,13,4,0,9,4
24803,5,10,3,0,7,3
192345,8,9,3,0,6,3
192345,6,16,1,0,15,1
192345,5,7,2,0,5,2
91653,8,8,3,0,5,3
91653,5,14,2,0,12,2
220741,8,5,1,0,4,1
220741,7,10,1,0,9,1
220741,6,13,2,0,11,2
220741,5,12,1,0,11,1
220741,3,4,2,0,2,2
203788,7,12,1,0,11,1
203788,6,19,3,0,16,3
203788,5,9,3,0,6,3
203788,4,5,1,0,4,1
203788,3,1,1,0,0,1
149885,9,3,3,0,0,3
149885,8,8,2,0,6,2
149885,7,12,1,0,11,1
149885,6,20,4,0,16,4
149885,5,3,1,0,2,1
149885,4,6,1,0,5,1
149885,3,3,1,0,2,1
133862,9,3,1,0,2,1
133862,8,13,4,0,9,4
133862,7,14,2,0,12,2
133862,6,15,5,1,10,4
133862,3,1,1,0,0,1
1946,7,4,1,0,3,1
1946,5,16,2,0,14,2
1946,4,11,2,0,9,2
1946,3,4,2,0,2,2
1946,2,2,1,0,1,1
208918,10,7,2,0,5,2
208918,9,7,2,0,5,2
208918,8,15,1,0,14,1
208918,7,15,3,0,12,3
208918,6,9,1,0,8,1
208918,5,1,1,0,0,1
208918,3,1,1,0,0,1
208918,2,1,1,0,0,1
186089,8,8,2,0,6,2
186089,7,18,2,0,16,2
186089,6,14,1,0,13,1
186089,4,5,2,0,3,2
130603,7,16,5,0,11,5
130603,6,18,2,0,16,2
130603,5,9,2,0,7,2
130603,3,2,2,0,0,2
223597,10,4,1,0,3,1
223597,9,3,1,0,2,1
223597,8,5,3,0,2,3
223597,7,11,2,0,9,2
223597,6,21,4,0,17,4
223597,5,6,2,0,4,2
223597,4,4,2,0,2,2
223597,3,2,1,0,1,1
3253,8,4,1,0,3,1
3253,7,6,3,0,3,3
3253,6,16,8,0,8,8
3253,5,13,4,0,9,4
3253,4,9,3,0,6,3
3253,3,3,1,0,2,1
3253,2,5,2,0,3,2
9791,8,6,2,0,4,2
9791,7,11,3,0,8,3
9791,6,18,3,0,15,3
9791,5,9,3,0,6,3
9791,4,7,5,0,2,5
9791,3,3,2,0,1,2
2140,9,1,1,0,0,1
2140,8,6,3,0,3,3
2140,7,7,1,0,6,1
2140,6,12,3,0,9,3
2140,5,9,2,0,7,2
2140,4,12,7,0,5,7
2140,3,6,1,0,5,1
2140,1,2,1,0,1,1
42188,8,6,2,0,4,2
42188,7,12,7,0,5,7
42188,6,29,5,0,24,5
42188,5,2,2,0,0,2
5752,8,14,3,0,11,3
5752,7,16,5,0,11,5
5752,6,16,3,0,13,3
3359,10,3,3,0,0,3
3359,9,1,1,0,0,1
3359,8,11,4,0,7,4
3359,7,16,6,0,10,6
3359,6,15,8,0,7,8
3359,4,4,1,0,3,1
144236,7,5,3,1,2,2
144236,6,10,3,0,7,3
144236,5,14,3,0,11,3
144236,4,16,6,0,10,6
144236,3,4,1,0,3,1
144236,2,4,2,0,2,2
144236,1,2,2,0,0,2
220380,9,9,4,0,5,4
220380,8,12,7,0,5,7
220380,7,21,6,0,15,6
220380,6,11,6,0,5,6
220380,5,3,2,0,1,2
2160,9,1,1,0,0,1
2160,8,6,4,0,2,4
2160,7,14,5,0,9,5
2160,6,20,4,0,16,4
2160,5,10,3,0,7,3
2160,2,1,1,0,0,1
8787,7,14,9,0,5,9
8787,6,14,7,0,7,7
8787,5,8,4,0,4,4
8787,4,6,4,0,2,4
8787,3,3,2,0,1,2
4247,10,3,2,0,1,2
4247,9,1,1,0,0,1
4247,8,3,1,0,2,1
4247,7,3,1,0,2,1
4247,6,26,10,0,16,10
4247,5,12,5,0,7,5
4247,4,5,4,0,1,4
4247,3,2,1,0,1,1
4247,2,1,1,0,0,1
31401,8,8,1,0,7,1
31401,7,15,4,0,11,4
31401,6,16,1,0,15,1
31401,4,7,2,0,5,2
202265,9,3,1,0,2,1
202265,8,20,7,0,13,7
202265,7,14,3,0,11,3
202265,6,15,4,0,11,4
202265,4,1,1,0,0,1
202265,3,1,1,0,0,1
3838,10,3,2,0,1,2
3838,9,6,4,0,2,4
3838,8,8,4,0,4,4
3838,7,9,4,0,5,4
3838,6,13,4,0,9,4
3838,5,7,3,0,4,3
3838,4,4,1,0,3,1
3838,3,3,1,0,2,1
3838,2,3,2,0,1,2
13477,9,1,1,0,0,1
13477,7,4,1,0,3,1
13477,6,19,6,0,13,6
13477,5,15,5,0,10,5
13477,4,4,2,0,2,2
13477,2,5,3,0,2,3
13477,1,1,1,0,0,1
177062,10,2,1,0,1,1
177062,9,11,5,0,6,5
177062,8,19,7,0,12,7
177062,7,12,3,0,9,3
177062,6,9,5,0,4,5
177062,5,2,1,0,1,1
49396,9,7,1,0,6,1
49396,8,8,2,0,6,2
49396,6,14,5,0,9,5
49396,4,2,1,0,1,1
11988,8,17,8,0,9,8
11988,7,17,9,0,8,9
11988,6,13,7,0,6,7
258074,10,28,9,2,19,7
258074,9,7,2,0,5,2
258074,8,12,3,1,9,2
258074,1,3,1,0,2,1
214213,9,3,1,0,2,1
214213,8,12,4,0,8,4
214213,6,19,1,0,18,1
214213,5,11,1,0,10,1
214213,4,3,1,0,2,1
5860,8,8,3,0,5,3
5860,7,10,3,0,7,3
5860,6,15,8,0,7,8
5860,5,10,5,0,5,5
5860,4,7,2,0,5,2
5860,3,2,1,0,1,1
5860,2,2,1,0,1,1
64657,8,6,1,0,5,1
64657,7,12,2,0,10,2
64657,6,21,3,0,18,3
64657,5,9,3,0,6,3
64657,4,5,1,0,4,1
244948,7,17,3,0,14,3
244948,6,23,4,0,19,4
244948,5,10,3,0,7,3
157291,8,6,4,0,2,4
157291,7,14,2,0,12,2
157291,6,20,5,0,15,5
157291,5,11,3,0,8,3
157291,4,2,1,0,1,1
29055,10,7,3,0,4,3
29055,9,15,4,0,11,4
29055,8,22,3,0,19,3
29055,7,8,2,0,6,2
29055,6,2,1,1,1,0
39787,10,1,1,0,0,1
39787,9,1,1,0,0,1
39787,8,9,6,0,3,6
39787,7,12,9,0,3,9
39787,6,17,7,0,10,7
39787,5,10,6,0,4,6
39787,4,3,1,0,2,1
39787,3,2,1,0,1,1
179606,9,3,2,0,1,2
179606,8,8,1,0,7,1
179606,7,12,1,0,11,1
179606,6,18,2,0,16,2
179606,5,7,2,0,5,2
179606,2,2,1,0,1,1
209511,10,17,3,0,14,3
209511,9,20,5,0,15,5
209511,8,15,3,0,12,3
209511,7,2,1,0,1,1
16197,10,10,3,0,7,3
16197,9,12,5,0,7,5
16197,8,14,2,0,12,2
16197,7,11,3,0,8,3
7830,9,3,2,0,1,2
7830,8,7,4,0,3,4
7830,7,15,6,0,9,6
7830,6,19,3,0,16,3
7830,5,7,3,0,4,3
7830,2,1,1,0,0,1
21149,10,5,1,0,4,1
21149,9,7,1,0,6,1
21149,8,15,6,0,9,6
21149,7,12,1,0,11,1
21149,6,7,3,0,4,3
21149,5,5,3,0,2,3
21149,3,3,3,0,0,3
21149,2,1,1,0,0,1
26687,8,5,1,0,4,1
26687,7,8,6,0,2,6
26687,6,15,3,0,12,3
26687,5,13,5,0,8,5
26687,4,5,2,0,3,2
26687,3,6,2,0,4,2
26687,2,2,2,0,0,2
216301,7,15,3,0,12,3
216301,6,19,1,0,18,1
216301,5,10,2,0,8,2
216301,3,2,1,0,1,1
182544,10,18,6,0,12,6
182544,8,17,3,0,14,3
182544,6,1,1,0,0,1
128252,10,1,1,0,0,1
128252,9,6,4,0,2,4
128252,8,30,13,0,17,13
128252,7,13,3,0,10,3
128252,6,3,2,0,1,2
21277,10,2,1,0,1,1
21277,9,6,1,0,5,1
21277,8,13,3,0,10,3
21277,7,14,1,0,13,1
21277,6,14,4,0,10,4
21277,5,4,1,0,3,1
21277,2,3,1,0,2,1
20140,7,4,1,0,3,1
20140,6,8,4,0,4,4
20140,5,17,5,0,12,5
20140,4,12,1,0,11,1
20140,3,11,4,0,7,4
20140,2,2,2,0,0,2
20140,1,2,1,0,1,1
11357,8,5,1,0,4,1
11357,7,16,4,0,12,4
11357,6,17,9,0,8,9
11357,5,10,4,0,6,4
11357,4,3,1,0,2,1
2606,8,11,3,0,8,3
2606,7,12,5,0,7,5
2606,6,16,7,0,9,7
2606,5,9,2,0,7,2
2606,4,5,3,0,2,3
2606,3,2,1,0,1,1
13350,8,5,1,0,4,1
13350,7,8,1,0,7,1
13350,6,18,2,0,16,2
13350,5,7,1,0,6,1
13350,2,3,2,0,1,2
13350,1,2,1,0,1,1
76551,8,3,1,0,2,1
76551,7,10,2,0,8,2
76551,6,9,2,0,7,2
76551,5,15,2,0,13,2
76551,3,3,1,0,2,1
76551,2,7,5,0,2,5
76551,1,3,2,0,1,2
159536,9,2,1,0,1,1
159536,7,13,2,0,11,2
159536,6,17,5,0,12,5
159536,4,7,1,0,6,1
159536,2,1,1,0,0,1
257962,9,1,1,0,0,1
257962,8,4,1,0,3,1
257962,7,9,2,0,7,2
257962,6,15,1,0,14,1
257962,5,14,3,0,11,3
257962,3,3,1,0,2,1
191081,8,3,1,0,2,1
191081,7,10,1,0,9,1
191081,6,22,4,0,18,4
191081,4,3,1,0,2,1
191081,2,1,1,0,0,1
5274,10,3,1,0,2,1
5274,9,8,6,0,2,6
5274,8,17,2,0,15,2
5274,7,16,5,0,11,5
5274,6,7,1,0,6,1
5274,5,4,1,0,3,1
77548,8,5,1,0,4,1
77548,7,9,3,0,6,3
77548,6,20,9,0,11,9
77548,5,14,8,0,6,8
77548,4,3,3,0,0,3
77548,2,1,1,0,0,1
77548,1,3,1,0,2,1
76319,7,6,1,0,5,1
76319,6,9,4,0,5,4
76319,5,13,2,0,11,2
76319,4,10,2,0,8,2
76319,3,4,2,0,2,2
76319,2,6,1,0,5,1
76319,1,2,2,0,0,2
2037,7,9,3,0,6,3
2037,6,14,4,0,10,4
2037,5,6,3,0,3,3
2037,4,9,3,0,6,3
2037,3,8,4,0,4,4
2037,2,4,2,0,2,2
2037,1,4,3,0,1,3
177680,8,4,1,0,3,1
177680,7,8,4,0,4,4
177680,6,21,4,0,17,4
177680,5,11,1,0,10,1
177680,4,7,3,0,4,3
177680,3,3,2,0,1,2
8204,8,5,1,0,4,1
8204,7,3,2,0,1,2
8204,6,14,5,0,9,5
8204,5,12,2,0,10,2
8204,4,11,4,0,7,4
8204,3,7,1,0,6,1
2971,6,6,1,0,5,1
2971,4,16,4,0,12,4
2971,3,13,7,0,6,7
2971,2,5,2,0,3,2
2971,1,5,4,0,1,4
155484,8,8,4,1,4,3
155484,7,15,4,1,11,3
155484,6,21,5,2,16,3
155484,3,2,1,0,1,1
155484,2,2,1,0,1,1
8254,7,5,4,0,1,4
8254,6,15,6,0,9,6
8254,5,15,6,0,9,6
8254,4,14,9,0,5,9
8254,3,5,2,0,3,2
254846,9,4,1,0,3,1
254846,8,11,3,0,8,3
254846,6,13,2,0,11,2
254846,4,3,1,0,2,1
69819,10,2,2,0,0,2
69819,9,4,2,0,2,2
69819,8,4,2,0,2,2
69819,7,9,6,0,3,6
69819,6,12,4,0,8,4
69819,5,6,1,0,5,1
69819,4,7,2,0,5,2
69819,3,9,6,0,3,6
69819,1,2,2,0,0,2
193981,10,12,7,0,5,7
193981,9,5,2,0,3,2
193981,8,16,3,0,13,3
193981,7,9,1,0,8,1
193981,6,6,1,0,5,1
193981,5,4,3,0,1,3
193981,3,1,1,0,0,1
193981,1,2,1,0,1,1
3867,9,2,1,0,1,1
3867,8,4,1,0,3,1
3867,7,5,1,0,4,1
3867,6,11,3,0,8,3
3867,5,10,3,0,7,3
3867,4,9,5,0,4,5
3867,3,8,3,0,5,3
3867,2,3,2,0,1,2
3867,1,3,1,0,2,1
22571,9,2,1,0,1,1
22571,7,3,1,0,2,1
22571,6,26,8,0,18,8
22571,5,16,8,0,8,8
22571,4,5,2,0,3,2
22571,3,2,1,0,1,1
22571,2,2,2,0,0,2
36603,8,5,1,0,4,1
36603,7,7,2,0,5,2
36603,6,24,3,0,21,3
36603,4,6,3,0,3,3
36603,2,3,1,0,2,1
206686,9,11,1,0,10,1
206686,8,21,5,0,16,5
206686,6,11,1,0,10,1
206686,5,1,1,0,0,1
206686,2,1,1,0,0,1
78647,8,6,2,0,4,2
78647,7,15,4,0,11,4
78647,6,14,3,0,11,3
78647,5,9,3,0,6,3
78647,3,2,2,0,0,2
27495,6,6,3,0,3,3
27495,5,10,5,0,5,5
27495,4,17,6,0,11,6
27495,3,7,2,0,5,2
27495,2,10,5,0,5,5
27495,1,5,3,0,2,3
125318,10,4,1,0,3,1
125318,9,8,2,0,6,2
125318,8,30,10,0,20,10
125318,7,7,2,0,5,2
125318,6,5,1,0,4,1
7723,8,8,4,0,4,4
7723,7,14,5,0,9,5
7723,6,18,4,0,14,4
7723,5,5,1,0,4,1
7723,4,4,3,0,1,3
7723,3,5,1,0,4,1
742,8,10,2,0,8,2
742,7,21,5,0,16,5
742,6,17,6,0,11,6
5077,7,12,4,0,8,4
5077,6,20,8,0,12,8
5077,5,12,6,0,6,6
5077,4,9,4,0,5,4
5077,3,1,1,0,0,1
5077,2,2,1,0,1,1
42748,9,5,1,0,4,1
42748,8,21,9,0,12,9
42748,7,19,8,0,11,8
42748,6,6,2,0,4,2
42748,5,3,2,0,1,2
42748,3,1,1,0,0,1
600,7,4,2,0,2,2
600,6,12,4,0,8,4
600,5,9,2,0,7,2
600,4,7,1,0,6,1
600,2,2,2,0,0,2
16461,7,1,1,0,0,1
16461,6,12,3,0,9,3
16461,5,7,3,0,4,3
16461,4,15,6,0,9,6
16461,3,5,1,0,4,1
16461,2,6,2,0,4,2
16461,1,6,2,0,4,2
26292,9,1,1,0,0,1
26292,8,7,1,0,6,1
26292,6,19,5,0,14,5
26292,5,9,2,0,7,2
26292,4,11,2,0,9,2
9044,10,7,4,0,3,4
9044,9,8,3,0,5,3
9044,8,16,7,0,9,7
9044,7,10,4,0,6,4
9044,6,8,2,0,6,2
9044,5,6,2,0,4,2
3674,10,2,1,0,1,1
3674,8,8,6,0,2,6
3674,7,9,1,0,8,1
3674,6,15,6,0,9,6
3674,5,18,6,0,12,6
3674,4,1,1,0,0,1
14024,10,1,1,0,0,1
14024,8,9,3,0,6,3
14024,7,10,2,0,8,2
14024,6,9,3,0,6,3
14024,5,14,3,0,11,3
14024,3,4,2,0,2,2
7367,8,13,2,0,11,2
7367,7,16,4,0,12,4
7367,6,17,4,0,13,4
7367,5,4,2,0,2,2
7367,3,3,2,0,1,2
183976,8,15,7,1,8,6
183976,7,11,3,0,8,3
183976,6,10,4,0,6,4
183976,5,13,3,0,10,3
183976,4,2,1,0,1,1
183976,3,2,2,0,0,2
183976,2,1,1,0,0,1
183976,1,1,1,0,0,1
7269,10,3,1,0,2,1
7269,8,8,2,0,6,2
7269,7,4,1,0,3,1
7269,6,11,2,0,9,2
7269,5,8,3,0,5,3
7269,4,10,1,0,9,1
7269,3,5,1,0,4,1
7269,1,2,1,0,1,1
127883,9,8,1,0,7,1
127883,8,22,5,0,17,5
127883,7,8,1,0,7,1
127883,6,11,1,0,10,1
127883,5,5,1,0,4,1
155023,10,14,4,0,10,4
155023,9,5,2,0,3,2
155023,8,15,3,1,12,2
155023,7,9,3,0,6,3
155023,6,7,1,0,6,1
155023,4,3,1,0,2,1
155023,2,1,1,0,0,1
158876,10,11,3,0,8,3
158876,9,4,2,0,2,2
158876,8,13,3,0,10,3
158876,7,14,3,1,11,2
158876,6,8,3,2,5,1
158876,5,4,1,0,3,1
255,8,1,1,0,0,1
255,7,10,3,0,7,3
255,6,24,8,0,16,8
255,5,10,5,0,5,5
255,4,6,4,0,2,4
255,3,2,1,0,1,1
183532,8,1,1,0,0,1
183532,7,8,1,0,7,1
183532,6,20,3,0,17,3
183532,5,7,2,0,5,2
183532,4,9,1,0,8,1
183532,3,5,2,0,3,2
7465,8,3,1,0,2,1
7465,7,5,1,0,4,1
7465,6,19,9,0,10,9
7465,5,11,3,0,8,3
7465,4,12,5,0,7,5
7465,3,5,2,0,3,2
7465,2,1,1,0,0,1
38437,8,12,1,0,11,1
38437,7,22,8,0,14,8
38437,6,13,5,0,8,5
38437,5,5,1,0,4,1
117997,8,11,2,0,9,2
117997,7,15,3,0,12,3
117997,6,16,1,0,15,1
117997,5,9,1,0,8,1
154394,10,13,6,0,7,6
154394,9,12,4,0,8,4
154394,8,17,5,0,12,5
154394,7,5,1,0,4,1
154394,5,1,1,0,0,1
154394,4,2,1,0,1,1
202896,10,3,3,1,0,2
202896,9,5,3,0,2,3
202896,8,10,5,1,5,4
202896,7,10,2,0,8,2
202896,6,13,2,0,11,2
202896,5,5,1,0,4,1
202896,1,1,1,0,0,1
5870,10,1,1,0,0,1
5870,9,1,1,0,0,1
5870,8,10,2,0,8,2
5870,7,16,5,0,11,5
5870,6,13,7,0,6,7
5870,5,6,2,0,4,2
5870,4,6,2,0,4,2
5870,3,2,2,0,0,2
37724,8,12,7,0,5,7
37724,7,10,6,0,4,6
37724,6,22,9,0,13,9
37724,5,3,1,0,2,1
37724,4,2,1,0,1,1
37724,3,1,1,0,0,1
37724,2,2,2,0,0,2
37724,1,2,1,0,1,1
27471,6,8,1,0,7,1
27471,5,12,1,0,11,1
27471,4,14,2,0,12,2
27471,3,12,1,0,11,1
27471,2,6,1,0,5,1
172237,9,1,1,0,0,1
172237,7,4,1,0,3,1
172237,6,16,3,0,13,3
172237,4,14,2,0,12,2
172237,3,6,3,0,3,3
172237,2,3,2,0,1,2
5619,9,2,1,0,1,1
5619,8,4,2,0,2,2
5619,7,11,5,0,6,5
5619,6,12,6,0,6,6
5619,5,13,4,0,9,4
5619,4,7,4,0,3,4
5619,3,5,3,0,2,3
5619,2,1,1,0,0,1
182510,9,8,4,1,4,3
182510,8,21,6,0,15,6
182510,7,13,1,0,12,1
182510,6,8,3,0,5,3
3622,7,6,5,0,1,5
3622,6,14,7,0,7,7
3622,5,12,1,0,11,1
3622,4,14,3,0,11,3
3622,3,3,2,0,1,2
3622,2,2,2,0,0,2
3622,1,1,1,0,0,1
217344,8,4,2,0,2,2
217344,7,13,4,0,9,4
217344,6,27,5,0,22,5
217344,5,8,2,0,6,2
217344,4,4,2,0,2,2
166248,9,3,1,0,2,1
166248,8,6,1,0,5,1
166248,6,20,7,1,13,6
166248,5,10,1,0,9,1
166248,4,3,1,0,2,1
166248,3,3,3,0,0,3
166248,1,1,1,0,0,1
12414,10,11,2,0,9,2
12414,9,7,3,0,4,3
12414,8,24,1,0,23,1
12414,7,7,3,0,4,3
79413,8,4,2,0,2,2
79413,7,25,8,0,17,8
79413,6,21,3,0,18,3
79413,5,4,1,0,3,1
79413,2,2,1,0,1,1
157014,9,1,1,0,0,1
157014,8,7,3,1,4,2
157014,7,13,4,0,9,4
157014,6,16,3,0,13,3
157014,5,10,1,0,9,1
157014,3,3,1,0,2,1
55841,8,8,1,0,7,1
55841,7,15,3,0,12,3
55841,6,26,5,0,21,5
55841,4,3,1,0,2,1
179956,8,2,1,0,1,1
179956,6,22,4,0,18,4
179956,5,10,1,0,9,1
179956,4,10,5,0,5,5
179956,3,6,3,0,3,3
178053,8,7,2,0,5,2
178053,7,10,3,0,7,3
178053,6,22,5,0,17,5
178053,5,8,1,0,7,1
193592,8,5,2,0,3,2
193592,7,5,1,0,4,1
193592,6,10,1,0,9,1
193592,4,13,4,0,9,4
193592,3,9,1,0,8,1
193592,2,3,1,0,2,1
22445,8,5,2,0,3,2
22445,7,6,1,0,5,1
22445,6,15,3,0,12,3
22445,5,15,5,0,10,5
22445,4,5,2,0,3,2
22445,2,6,3,0,3,3
22445,1,2,1,0,1,1
105004,10,2,1,0,1,1
105004,8,3,1,0,2,1
105004,7,14,4,0,10,4
105004,6,27,6,0,21,6
105004,5,4,2,0,2,2
24475,8,13,4,0,9,4
24475,7,18,4,0,14,4
24475,6,14,5,0,9,5
24475,5,7,3,0,4,3
245136,9,4,1,0,3,1
245136,8,16,4,0,12,4
245136,7,16,1,0,15,1
245136,6,11,1,0,10,1
245136,5,5,2,0,3,2
245136,2,1,1,0,0,1
227837,9,1,1,0,0,1
227837,7,12,2,0,10,2
227837,6,14,3,0,11,3
227837,5,15,2,0,13,2
227837,4,4,3,0,1,3
227837,3,2,1,0,1,1
227837,2,1,1,0,0,1
11753,8,1,1,0,0,1
11753,6,6,2,0,4,2
11753,5,9,1,0,8,1
11753,4,13,9,0,4,9
11753,3,10,5,0,5,5
11753,2,8,1,0,7,1
11753,1,5,2,0,3,2
171087,8,7,3,0,4,3
171087,7,10,1,0,9,1
171087,6,18,5,0,13,5
171087,4,5,1,0,4,1
171087,3,5,2,0,3,2
233016,10,3,1,0,2,1
233016,9,9,5,0,4,5
233016,8,15,9,0,6,9
233016,7,13,5,0,8,5
233016,6,11,5,0,6,5
233016,5,4,3,0,1,3
55131,9,16,7,0,9,7
55131,8,18,9,0,9,9
55131,7,10,5,0,5,5
55131,6,7,5,0,2,5
160592,9,4,1,0,3,1
160592,8,10,2,0,8,2
160592,7,19,4,0,15,4
160592,6,15,5,0,10,5
160592,5,4,1,0,3,1
160592,2,1,1,0,0,1
6339,8,1,1,0,0,1
6339,7,6,3,0,3,3
6339,6,16,8,0,8,8
6339,5,8,4,0,4,4
6339,4,8,4,0,4,4
6339,3,8,2,0,6,2
6339,2,4,3,0,1,3
22407,10,2,1,0,1,1
22407,8,4,2,0,2,2
22407,7,12,5,0,7,5
22407,6,21,5,0,16,5
22407,4,6,2,0,4,2
22407,3,1,1,0,0,1
49397,9,5,1,0,4,1
49397,8,12,3,0,9,3
49397,6,13,5,1,8,4
141997,6,18,6,0,12,6
141997,4,4,2,0,2,2
141997,3,3,1,0,2,1
195205,10,1,1,0,0,1
195205,8,6,1,1,5,0
195205,7,7,1,0,6,1
195205,6,5,2,0,3,2
195205,3,2,2,0,0,2
195205,1,24,14,0,10,14
990,10,3,2,0,1,2
990,9,3,1,0,2,1
990,8,15,3,0,12,3
990,7,15,5,0,10,5
990,6,8,1,0,7,1
990,5,6,1,0,5,1
990,4,3,1,0,2,1
205478,10,4,1,0,3,1
205478,8,9,2,0,7,2
205478,7,8,1,0,7,1
205478,6,21,1,0,20,1
234673,9,7,2,0,5,2
234673,8,22,8,1,14,7
234673,7,15,4,0,11,4
234673,6,8,3,0,5,3
245371,10,9,1,0,8,1
245371,9,6,2,0,4,2
245371,8,16,1,0,15,1
245371,7,10,1,0,9,1
245371,6,10,2,1,8,1
245371,5,1,1,0,0,1
245371,4,1,1,0,0,1
245371,2,2,1,0,1,1
11766,10,1,1,0,0,1
11766,9,2,1,0,1,1
11766,8,11,2,0,9,2
11766,7,7,2,0,5,2
11766,6,19,5,0,14,5
11766,4,4,4,0,0,4
10248,10,10,6,0,4,6
10248,9,12,3,0,9,3
10248,8,16,3,0,13,3
10248,7,8,4,0,4,4
10248,6,5,2,0,3,2
10248,1,2,1,0,1,1
195545,10,2,1,0,1,1
195545,8,12,5,0,7,5
195545,7,4,1,0,3,1
195545,6,7,1,0,6,1
195545,5,11,1,0,10,1
195545,4,7,1,0,6,1
195545,3,3,1,0,2,1
195545,2,3,2,0,1,2
195545,1,5,2,0,3,2
3293,8,4,1,0,3,1
3293,7,13,3,0,10,3
3293,6,21,4,0,17,4
3293,5,7,1,0,6,1
3293,4,10,4,0,6,4
24743,8,2,1,0,1,1
24743,7,12,1,0,11,1
24743,6,16,2,0,14,2
24743,4,5,1,0,4,1
24743,3,4,1,0,3,1
24743,1,2,1,0,1,1
1003,8,6,1,0,5,1
1003,7,22,1,0,21,1
1003,6,17,4,0,13,4
1003,5,7,3,0,4,3
1003,2,1,1,0,0,1
26621,8,14,3,0,11,3
26621,7,8,3,0,5,3
26621,6,19,4,0,15,4
2540,7,2,2,0,0,2
2540,6,5,3,0,2,3
2540,5,13,7,0,6,7
2540,4,8,2,0,6,2
2540,3,12,1,0,11,1
2540,2,8,4,0,4,4
2540,1,6,2,0,4,2
33857,10,4,4,0,0,4
33857,9,4,2,0,2,2
33857,8,12,7,0,5,7
33857,7,10,3,0,7,3
33857,6,11,1,0,10,1
33857,5,5,2,0,3,2
33857,4,3,2,0,1,2
33857,3,4,2,0,2,2
33857,2,2,1,0,1,1
164284,9,3,1,0,2,1
164284,8,13,4,0,9,4
164284,7,15,3,0,12,3
164284,6,14,3,0,11,3
164284,5,7,2,0,5,2
194078,10,11,4,0,7,4
194078,9,16,8,0,8,8
194078,8,19,6,0,13,6
194078,5,1,1,0,0,1
7963,7,11,6,0,5,6
7963,6,19,8,0,11,8
7963,5,10,2,0,8,2
7963,4,8,5,0,3,5
7963,2,2,1,0,1,1
5854,8,5,4,0,1,4
5854,7,7,1,0,6,1
5854,6,24,8,0,16,8
5854,5,12,2,0,10,2
33959,7,8,2,0,6,2
33959,6,22,4,0,18,4
33959,5,12,3,0,9,3
33959,4,6,2,0,4,2
33959,3,5,1,0,4,1
145106,7,4,1,0,3,1
145106,6,8,1,0,7,1
145106,5,13,3,0,10,3
145106,3,11,3,0,8,3
179537,10,1,1,0,0,1
179537,6,22,2,0,20,2
179537,4,10,3,0,7,3
179537,2,1,1,0,0,1
4239,7,11,6,0,5,6
4239,6,21,6,0,15,6
4239,5,10,4,0,6,4
4239,4,6,4,0,2,4
4239,2,3,2,0,1,2
251433,9,6,1,1,5,0
251433,8,18,4,0,14,4
251433,7,21,3,0,18,3
251433,6,7,2,1,5,1
251433,5,4,1,1,3,0
176850,10,7,4,0,3,4
176850,9,17,2,0,15,2
176850,8,10,1,0,9,1
176850,7,3,1,1,2,0
176850,6,10,1,0,9,1
176850,5,3,2,0,1,2
176850,3,2,2,0,0,2
5527,8,2,1,0,1,1
5527,7,9,3,0,6,3
5527,6,14,5,0,9,5
5527,5,13,3,0,10,3
5527,4,6,5,0,1,5
5527,3,6,1,0,5,1
5527,2,2,1,0,1,1
5527,1,2,1,0,1,1
29860,9,7,2,0,5,2
29860,8,25,6,0,19,6
29860,7,14,6,0,8,6
29860,6,2,1,0,1,1
29860,5,1,1,0,0,1
29860,3,2,1,0,1,1
5285,6,11,4,0,7,4
5285,5,8,1,0,7,1
5285,4,12,6,0,6,6
5285,3,9,6,0,3,6
5285,2,10,5,0,5,5
5285,1,2,1,0,1,1
1303,8,1,1,0,0,1
1303,6,16,8,0,8,8
1303,5,18,3,0,15,3
1303,4,9,1,0,8,1
1303,3,3,1,0,2,1
1148,6,5,1,0,4,1
1148,5,6,3,0,3,3
1148,4,13,5,0,8,5
1148,3,10,4,0,6,4
1148,2,12,8,0,4,8
1148,1,8,7,0,1,7
21382,9,1,1,0,0,1
21382,8,5,1,0,4,1
21382,7,7,3,0,4,3
21382,6,20,7,0,13,7
21382,5,10,2,0,8,2
21382,4,6,4,0,2,4
21382,3,3,2,0,1,2
21382,2,2,1,0,1,1
21382,1,1,1,0,0,1
112233,10,3,2,1,1,1
112233,8,9,3,0,6,3
112233,7,6,1,0,5,1
112233,6,18,4,1,14,3
112233,5,7,2,1,5,1
112233,4,8,2,0,6,2
112233,3,3,1,0,2,1
3393,10,2,1,0,1,1
3393,9,1,1,0,0,1
3393,8,5,1,0,4,1
3393,7,5,1,0,4,1
3393,6,4,1,0,3,1
3393,5,10,4,0,6,4
3393,4,8,4,0,4,4
3393,3,7,4,0,3,4
3393,2,5,2,0,3,2
3393,1,8,3,0,5,3
180157,9,2,1,0,1,1
180157,7,15,6,0,9,6
180157,6,17,7,0,10,7
180157,5,5,2,0,3,2
180157,4,4,1,0,3,1
166556,7,8,1,0,7,1
166556,6,23,1,0,22,1
166556,5,13,2,0,11,2
166556,4,4,2,0,2,2
246693,8,8,4,0,4,4
246693,7,16,5,0,11,5
246693,6,20,4,0,16,4
18262,10,1,1,0,0,1
18262,8,7,5,0,2,5
18262,7,7,2,0,5,2
18262,6,16,4,0,12,4
18262,5,13,4,0,9,4
18262,4,4,2,0,2,2
18262,3,3,2,0,1,2
18262,1,3,2,0,1,2
240100,9,5,1,0,4,1
240100,8,14,5,0,9,5
240100,7,21,4,0,17,4
240100,6,9,1,0,8,1
192891,10,9,6,0,3,6
192891,9,15,9,0,6,9
192891,8,19,4,0,15,4
192891,7,3,1,0,2,1
192891,6,5,2,0,3,2
192891,5,2,1,0,1,1
192891,3,2,1,0,1,1
5810,8,4,1,0,3,1
5810,6,14,3,0,11,3
5810,5,13,3,0,10,3
5810,3,4,2,0,2,2
5810,2,3,1,0,2,1
25158,10,1,1,0,0,1
25158,9,1,1,0,0,1
25158,8,1,1,0,0,1
25158,7,7,3,0,4,3
25158,6,11,1,0,10,1
25158,5,9,4,0,5,4
25158,4,19,6,0,13,6
25158,2,4,1,0,3,1
1488,7,8,2,0,6,2
1488,6,14,3,0,11,3
1488,5,9,3,0,6,3
1488,4,9,1,0,8,1
1488,3,6,6,0,0,6
1488,2,6,5,0,1,5
86919,9,3,1,0,2,1
86919,8,19,9,0,10,9
86919,7,15,4,0,11,4
86919,6,8,3,0,5,3
86919,5,6,5,0,1,5
86919,3,1,1,0,0,1
86919,2,1,1,0,0,1
86919,1,2,2,0,0,2
209283,8,8,1,0,7,1
209283,7,22,2,0,20,2
209283,6,16,3,0,13,3
209283,5,5,1,0,4,1
137780,7,12,2,0,10,2
137780,6,18,1,0,17,1
137780,5,11,2,0,9,2
8038,8,4,1,0,3,1
8038,7,8,4,0,4,4
8038,6,11,3,0,8,3
8038,5,9,5,0,4,5
8038,4,10,4,0,6,4
8038,3,7,6,0,1,6
8038,2,4,2,0,2,2
8038,1,2,2,0,0,2
145344,10,10,4,0,6,4
145344,9,4,1,0,3,1
145344,8,10,2,0,8,2
145344,4,3,1,0,2,1
4460,10,4,3,0,1,3
4460,8,2,1,0,1,1
4460,7,6,6,0,0,6
4460,6,14,4,0,10,4
4460,5,7,4,0,3,4
4460,4,9,2,0,7,2
4460,3,5,4,0,1,4
4460,2,4,3,0,1,3
25967,8,4,1,0,3,1
25967,7,9,1,0,8,1
25967,6,17,3,0,14,3
25967,5,15,4,0,11,4
25967,4,6,2,0,4,2
25967,3,1,1,0,0,1
25967,1,1,1,0,0,1
4372,10,2,2,0,0,2
4372,8,4,4,0,0,4
4372,7,3,1,0,2,1
4372,6,13,3,0,10,3
4372,5,18,3,0,15,3
4372,4,9,1,0,8,1
4372,3,4,1,0,3,1
51250,9,3,1,0,2,1
51250,8,18,3,0,15,3
51250,7,14,7,0,7,7
51250,6,15,6,0,9,6
92591,9,1,1,0,0,1
92591,8,12,4,0,8,4
92591,7,14,1,0,13,1
92591,6,21,3,0,18,3
156557,8,5,2,0,3,2
156557,7,11,4,0,7,4
156557,6,17,4,0,13,4
156557,5,8,1,0,7,1
156557,4,6,4,0,2,4
194532,7,19,4,0,15,4
99042,10,3,1,0,2,1
99042,9,5,2,0,3,2
99042,8,16,6,0,10,6
99042,7,15,11,0,4,11
99042,6,11,8,0,3,8
99042,4,1,1,0,0,1
99042,1,1,1,0,0,1
7344,10,2,1,0,1,1
7344,9,2,1,0,1,1
7344,6,13,8,0,5,8
7344,5,17,5,0,12,5
7344,4,9,2,0,7,2
6770,10,1,1,0,0,1
6770,9,3,1,0,2,1
6770,8,6,3,0,3,3
6770,7,11,6,0,5,6
6770,6,15,2,0,13,2
154682,7,20,5,0,15,5
154682,6,10,1,0,9,1
154682,5,9,1,0,8,1
154682,4,8,4,0,4,4
212404,10,5,2,0,3,2
212404,8,18,1,0,17,1
212404,7,15,3,0,12,3
212404,6,9,1,0,8,1
212404,5,2,2,1,0,1
212404,2,1,1,0,0,1
82223,8,6,2,0,4,2
82223,7,14,5,0,9,5
82223,6,17,4,0,13,4
82223,5,12,2,0,10,2
11428,10,7,2,0,5,2
11428,9,6,1,0,5,1
11428,8,18,3,0,15,3
11428,7,13,2,0,11,2
11428,6,7,1,0,6,1
260934,10,30,17,2,13,15
260934,9,15,13,0,2,13
260934,8,5,2,0,3,2
260934,5,1,1,0,0,1
260934,4,1,1,0,0,1
260934,1,1,1,1,0,0
30009,6,14,9,0,5,9
30009,5,14,10,0,4,10
30009,4,10,5,0,5,5
30009,3,4,2,0,2,2
30009,2,7,5,0,2,5
28522,10,4,4,0,0,4
28522,9,7,4,0,3,4
28522,8,4,3,0,1,3
28522,7,6,3,0,3,3
28522,6,12,8,0,4,8
28522,5,10,4,0,6,4
28522,4,7,4,0,3,4
28522,3,3,1,0,2,1
28522,2,1,1,0,0,1
28522,1,1,1,0,0,1
165600,7,4,1,0,3,1
165600,6,16,1,0,15,1
165600,5,5,1,0,4,1
165600,4,13,4,0,9,4
165600,3,8,1,0,7,1
165600,2,6,1,0,5,1
165600,1,2,2,0,0,2
10471,9,1,1,0,0,1
10471,8,4,1,0,3,1
10471,7,6,2,0,4,2
10471,6,15,6,0,9,6
10471,5,8,3,0,5,3
10471,3,2,1,0,1,1
10471,2,1,1,0,0,1
7651,9,2,1,0,1,1
7651,8,6,2,0,4,2
7651,7,7,4,0,3,4
7651,6,15,4,0,11,4
7651,5,8,1,0,7,1
7651,4,10,7,0,3,7
7651,3,3,2,0,1,2
7651,1,1,1,0,0,1
158059,10,6,2,0,4,2
158059,9,6,4,0,2,4
158059,8,11,1,0,10,1
158059,7,7,4,0,3,4
158059,6,14,2,0,12,2
158059,3,1,1,0,0,1
9415,7,9,2,0,7,2
9415,6,14,6,0,8,6
9415,5,20,3,0,17,3
9415,4,7,1,0,6,1
9415,2,3,2,0,1,2
5028,8,3,1,0,2,1
5028,6,6,3,0,3,3
5028,4,12,3,0,9,3
5028,3,8,4,0,4,4
5028,2,8,4,0,4,4
12532,6,10,2,0,8,2
12532,5,8,5,0,3,5
12532,4,15,7,0,8,7
12532,3,9,3,0,6,3
12532,2,10,2,0,8,2
150323,8,14,2,0,12,2
150323,7,13,2,0,11,2
150323,6,16,4,0,12,4
150323,5,6,1,0,5,1
150323,4,2,1,0,1,1
150323,3,3,1,0,2,1
4017,9,3,1,0,2,1
4017,8,5,1,0,4,1
4017,7,17,7,0,10,7
4017,6,14,3,0,11,3
4017,5,11,2,0,9,2
4017,4,1,1,0,0,1
4017,3,1,1,0,0,1
150033,8,4,1,0,3,1
150033,7,14,2,0,12,2
150033,2,2,1,0,1,1
125547,8,6,2,0,4,2
125547,7,17,4,0,13,4
125547,6,19,2,0,17,2
125547,5,9,2,0,7,2
125547,3,1,1,0,0,1
25988,9,1,1,0,0,1
25988,7,10,2,0,8,2
25988,6,19,7,0,12,7
25988,5,11,1,0,10,1
25988,4,9,5,0,4,5
25988,3,4,1,0,3,1
25988,2,1,1,0,0,1
232924,10,1,1,0,0,1
232924,9,7,3,0,4,3
232924,8,29,6,0,23,6
232924,7,11,7,0,4,7
232924,6,5,2,0,3,2
232924,3,1,1,0,0,1
228371,8,15,5,0,10,5
228371,7,20,5,0,15,5
228371,6,13,5,0,8,5
228371,5,2,1,0,1,1
228371,3,1,1,0,0,1
25973,8,9,3,0,6,3
25973,7,19,4,0,15,4
25973,6,20,3,0,17,3
25973,5,4,1,0,3,1
25973,4,2,1,0,1,1
2917,9,2,1,0,1,1
2917,7,19,4,0,15,4
2917,6,19,2,0,17,2
2917,5,8,1,0,7,1
2917,3,3,2,0,1,2
1542,8,2,1,0,1,1
1542,7,7,3,0,4,3
1542,6,18,5,0,13,5
1542,5,12,4,0,8,4
1542,4,9,2,0,7,2
1542,3,4,2,0,2,2
1542,2,2,1,0,1,1
260348,8,9,2,0,7,2
260348,7,20,2,0,18,2
260348,6,16,3,0,13,3
260348,5,5,2,0,3,2
260348,2,2,1,0,1,1
215154,8,4,2,0,2,2
215154,7,9,1,0,8,1
215154,6,17,5,0,12,5
215154,4,14,4,0,10,4
7978,8,9,3,0,6,3
7978,7,14,5,0,9,5
7978,6,16,4,0,12,4
7978,5,7,2,0,5,2
7978,4,3,2,0,1,2
7978,2,2,1,0,1,1
26947,10,2,1,0,1,1
26947,9,3,2,0,1,2
26947,8,5,1,0,4,1
26947,7,10,2,0,8,2
26947,6,20,4,0,16,4
26947,5,4,1,0,3,1
26947,4,5,1,0,4,1
26947,3,4,2,0,2,2
26947,2,1,1,0,0,1
209447,10,2,1,0,1,1
209447,8,6,1,0,5,1
209447,7,13,3,0,10,3
209447,6,18,3,0,15,3
209447,5,6,2,0,4,2
209447,2,2,1,0,1,1
237106,10,2,1,0,1,1
237106,9,6,1,0,5,1
237106,8,21,6,0,15,6
237106,7,10,6,0,4,6
237106,6,11,4,0,7,4
237106,5,4,1,0,3,1
192324,10,4,1,0,3,1
192324,9,5,1,0,4,1
192324,8,10,2,0,8,2
192324,7,18,1,0,17,1
192324,6,13,3,0,10,3
192324,3,1,1,0,0,1
271693,8,16,1,0,15,1
271693,7,19,1,0,18,1
216630,10,7,3,1,4,2
216630,9,9,4,0,5,4
216630,8,17,8,1,9,7
216630,7,10,2,1,8,1
216630,6,8,2,0,6,2
216630,4,2,2,0,0,2
234949,9,3,2,0,1,2
234949,8,18,2,0,16,2
234949,7,18,2,0,16,2
234949,6,9,2,0,7,2
234949,4,4,1,0,3,1
3723,8,1,1,0,0,1
3723,7,6,4,0,2,4
3723,6,11,6,0,5,6
3723,5,17,4,0,13,4
3723,4,12,6,0,6,6
3723,3,3,1,0,2,1
3723,2,4,3,0,1,3
3723,1,1,1,0,0,1
200115,8,9,2,0,7,2
200115,7,9,2,0,7,2
200115,6,18,2,0,16,2
200115,5,8,1,0,7,1
200115,4,7,1,0,6,1
200115,3,2,1,0,1,1
3535,8,5,1,0,4,1
3535,7,11,3,0,8,3
3535,6,17,9,0,8,9
3535,5,12,6,0,6,6
3535,4,3,2,0,1,2
3535,3,5,5,0,0,5
182593,8,9,2,0,7,2
182593,7,19,2,0,17,2
182593,5,4,1,0,3,1
182593,3,2,1,0,1,1
12067,10,6,4,0,2,4
12067,9,4,3,0,1,3
12067,8,8,1,0,7,1
12067,7,15,9,0,6,9
12067,6,10,4,0,6,4
12067,5,10,3,0,7,3
12067,3,1,1,0,0,1
31561,9,4,3,0,1,3
31561,8,2,1,0,1,1
31561,7,4,1,0,3,1
31561,6,13,7,0,6,7
31561,5,8,3,0,5,3
31561,4,6,4,0,2,4
31561,3,11,6,0,5,6
31561,2,6,3,0,3,3
31561,1,1,1,0,0,1
2075,10,1,1,0,0,1
2075,8,2,1,0,1,1
2075,7,3,1,0,2,1
2075,6,20,5,0,15,5
2075,4,10,2,0,8,2
225610,10,8,1,0,7,1
225610,9,13,4,0,9,4
225610,8,23,7,0,16,7
225610,7,8,1,0,7,1
199882,10,3,1,0,2,1
199882,9,5,1,0,4,1
199882,8,10,4,0,6,4
199882,7,13,2,0,11,2
199882,5,5,1,0,4,1
199882,4,5,2,0,3,2
199882,3,2,1,0,1,1
131200,8,7,1,0,6,1
131200,7,10,2,0,8,2
131200,6,14,2,0,12,2
131200,5,10,3,1,7,2
131200,4,4,1,0,3,1
131200,1,2,1,0,1,1
8758,9,2,1,0,1,1
8758,8,17,4,0,13,4
8758,7,13,1,0,12,1
8758,6,13,3,0,10,3
8758,5,3,2,0,1,2
10325,10,1,1,0,0,1
10325,7,4,1,0,3,1
10325,6,14,5,0,9,5
10325,5,7,2,0,5,2
10325,4,14,4,0,10,4
10325,3,5,2,0,3,2
10325,2,8,3,0,5,3
11292,9,1,1,0,0,1
11292,8,4,2,0,2,2
11292,7,12,3,0,9,3
11292,6,16,5,0,11,5
11292,5,7,1,0,6,1
11292,4,6,3,0,3,3
11292,3,2,1,0,1,1
11292,2,5,3,0,2,3
230316,10,7,2,0,5,2
230316,8,6,1,0,5,1
230316,7,18,1,0,17,1
230316,6,15,1,1,14,0
230316,5,4,1,0,3,1
230316,4,2,2,0,0,2
244452,10,3,1,0,2,1
244452,9,10,6,2,4,4
244452,8,23,4,1,19,3
244452,7,12,5,1,7,4
244452,6,5,2,0,3,2
244452,1,2,1,1,1,0
118051,10,1,1,0,0,1
118051,8,4,1,0,3,1
118051,7,13,3,0,10,3
118051,6,24,6,0,18,6
118051,5,8,1,0,7,1
118051,4,3,1,0,2,1
118051,3,2,1,0,1,1
25344,8,14,4,0,10,4
25344,7,24,5,0,19,5
25344,6,10,1,0,9,1
25344,5,2,2,0,0,2
25344,4,2,1,0,1,1
25344,3,1,1,0,0,1
26093,7,6,2,0,4,2
26093,6,18,3,0,15,3
26093,5,13,1,0,12,1
26093,4,12,2,0,10,2
26093,3,2,1,0,1,1
26093,2,4,1,0,3,1
190264,10,2,1,0,1,1
190264,8,4,1,0,3,1
190264,7,16,4,0,12,4
190264,6,17,4,0,13,4
190264,5,11,2,0,9,2
190264,4,2,1,0,1,1
93094,6,13,1,0,12,1
93094,5,3,2,0,1,2
93094,3,2,2,0,0,2
93094,2,5,2,0,3,2
214758,10,6,4,0,2,4
214758,9,5,2,0,3,2
214758,8,22,7,0,15,7
214758,7,15,5,0,10,5
214758,6,5,2,0,3,2
242317,10,7,2,1,5,1
242317,9,3,2,0,1,2
242317,8,3,1,1,2,0
242317,7,13,3,1,10,2
242317,6,18,3,1,15,2
242317,5,8,2,1,6,1
184351,10,3,1,0,2,1
184351,8,9,6,2,3,4
184351,7,13,1,0,12,1
184351,6,11,4,1,7,3
184351,5,6,2,0,4,2
184351,4,7,1,1,6,0
184351,3,3,1,0,2,1
24483,8,8,1,0,7,1
24483,7,13,5,0,8,5
24483,6,19,4,0,15,4
24483,5,4,3,0,1,3
147418,8,4,1,0,3,1
147418,7,9,2,0,7,2
147418,5,10,2,0,8,2
147418,4,3,1,0,2,1
147418,2,2,1,0,1,1
172168,8,5,1,0,4,1
172168,7,10,1,0,9,1
172168,6,25,3,0,22,3
172168,5,12,2,0,10,2
172168,4,2,2,0,0,2
203739,6,2,1,0,1,1
203739,2,1,1,0,0,1
203739,1,42,24,6,18,18
2720,10,2,1,0,1,1
2720,9,2,1,0,1,1
2720,8,3,1,0,2,1
2720,7,14,6,0,8,6
2720,6,21,7,0,14,7
2720,5,7,1,0,6,1
177411,9,2,2,0,0,2
177411,8,8,4,1,4,3
177411,7,10,1,0,9,1
177411,6,13,7,1,6,6
177411,5,9,4,0,5,4
177411,3,3,1,0,2,1
177411,2,2,2,0,0,2
256643,9,4,1,0,3,1
256643,8,19,3,0,16,3
256643,7,11,1,0,10,1
256643,6,6,4,0,2,4
256643,4,2,1,0,1,1
256643,3,2,2,0,0,2
256643,1,2,1,0,1,1
5843,8,9,4,0,5,4
5843,7,13,7,0,6,7
5843,6,18,6,0,12,6
5843,5,6,2,0,4,2
5843,3,1,1,0,0,1
5843,2,2,1,0,1,1
148138,9,1,1,0,0,1
148138,8,8,3,0,5,3
148138,7,19,3,0,16,3
148138,6,15,3,0,12,3
148138,5,7,3,0,4,3
148138,3,1,1,0,0,1
99131,9,2,2,0,0,2
99131,8,9,2,0,7,2
99131,7,16,4,0,12,4
99131,6,20,8,0,12,8
99131,5,4,1,0,3,1
99131,4,2,2,0,0,2
99131,3,1,1,0,0,1
21209,7,6,2,0,4,2
21209,6,20,7,0,13,7
21209,5,14,7,0,7,7
21209,4,9,5,0,4,5
21209,3,4,3,0,1,3
21209,1,1,1,0,0,1
248918,10,29,5,1,24,4
248918,9,15,7,1,8,6
248918,8,9,1,1,8,0
124395,7,12,3,0,9,3
124395,6,17,5,0,12,5
124395,4,4,1,0,3,1
124395,3,6,1,0,5,1
129287,8,8,2,0,6,2
129287,7,9,1,0,8,1
129287,6,19,2,0,17,2
129287,4,7,1,0,6,1
129287,2,2,1,0,1,1
1896,10,3,2,0,1,2
1896,9,2,1,0,1,1
1896,8,4,2,0,2,2
1896,7,12,5,0,7,5
1896,6,21,5,0,16,5
1896,5,7,3,0,4,3
1896,4,3,3,0,0,3
1896,2,1,1,0,0,1
130202,10,8,5,0,3,5
130202,9,2,2,0,0,2
130202,8,10,4,0,6,4
130202,7,7,2,0,5,2
130202,6,10,2,0,8,2
130202,5,6,1,0,5,1
130202,4,7,2,0,5,2
130202,3,2,1,0,1,1
130202,2,2,1,0,1,1
30771,9,7,3,0,4,3
30771,8,20,4,0,16,4
30771,7,14,6,0,8,6
30771,6,8,3,0,5,3
30771,4,3,1,0,2,1
2128,10,4,1,0,3,1
2128,6,6,1,0,5,1
2128,5,10,4,0,6,4
2128,4,12,3,0,9,3
2128,3,7,4,0,3,4
2128,2,8,5,0,3,5
2128,1,2,1,0,1,1
84776,10,4,1,0,3,1
84776,8,8,3,0,5,3
84776,7,14,7,0,7,7
84776,6,19,9,0,10,9
84776,5,7,3,0,4,3
160488,8,7,2,0,5,2
160488,7,12,4,0,8,4
160488,6,15,5,0,10,5
160488,4,8,1,0,7,1
10557,10,1,1,0,0,1
10557,9,2,1,0,1,1
10557,8,3,2,0,1,2
10557,7,17,6,0,11,6
10557,6,17,5,0,12,5
10557,5,12,2,0,10,2
10557,3,1,1,0,0,1
243599,9,8,2,0,6,2
243599,8,9,1,0,8,1
243599,7,14,4,2,10,2
243599,4,4,2,0,2,2
243599,3,2,1,0,1,1
256915,9,3,2,0,1,2
256915,8,7,2,0,5,2
256915,7,12,2,0,10,2
256915,6,18,4,0,14,4
256915,5,8,2,0,6,2
256915,4,2,1,0,1,1
256915,3,1,1,0,0,1
256915,1,2,1,0,1,1
30583,8,4,1,0,3,1
30583,7,9,3,0,6,3
30583,6,23,7,0,16,7
30583,5,9,2,0,7,2
30583,4,5,2,0,3,2
30583,3,3,3,0,0,3
30583,2,1,1,0,0,1
27730,8,5,1,0,4,1
27730,7,8,4,0,4,4
27730,6,11,2,0,9,2
27730,5,10,4,0,6,4
27730,4,4,1,0,3,1
27730,2,6,1,0,5,1
11129,9,1,1,0,0,1
11129,8,7,4,0,3,4
11129,7,12,2,0,10,2
11129,6,18,7,0,11,7
11129,5,8,3,0,5,3
11129,4,7,2,0,5,2
1637,8,3,3,0,0,3
1637,7,13,7,0,6,7
1637,6,21,8,0,13,8
1637,5,5,2,0,3,2
1637,4,9,2,0,7,2
7862,7,5,1,0,4,1
7862,6,24,13,0,11,13
7862,5,15,7,0,8,7
7862,4,5,2,0,3,2
220541,8,10,5,0,5,5
220541,7,11,4,0,7,4
220541,6,21,3,0,18,3
220541,5,7,2,0,5,2
209642,10,4,1,0,3,1
209642,9,3,2,0,1,2
209642,8,11,2,0,9,2
209642,7,8,2,0,6,2
209642,6,14,4,0,10,4
209642,5,7,1,0,6,1
209642,4,1,1,1,0,0
209642,3,2,2,0,0,2
209642,2,3,1,0,2,1
73363,10,4,3,0,1,3
73363,8,17,9,0,8,9
73363,7,13,3,0,10,3
73363,6,12,2,0,10,2
233969,10,15,4,0,11,4
233969,9,10,5,0,5,5
233969,8,12,1,0,11,1
233969,6,7,2,0,5,2
174431,10,1,1,0,0,1
174431,8,20,10,0,10,10
174431,7,19,9,0,10,9
174431,6,6,3,0,3,3
174431,5,4,2,0,2,2
174431,3,1,1,0,0,1
2400,10,1,1,0,0,1
2400,9,1,1,0,0,1
2400,8,8,5,0,3,5
2400,7,12,5,0,7,5
2400,6,14,6,0,8,6
2400,5,13,4,0,9,4
11863,10,4,3,0,1,3
11863,8,2,1,0,1,1
11863,7,1,1,0,0,1
11863,5,11,2,0,9,2
11863,4,13,1,0,12,1
11863,3,6,4,0,2,4
11863,2,10,5,0,5,5
11863,1,6,1,0,5,1
198456,10,3,1,0,2,1
198456,8,10,3,0,7,3
198456,7,17,2,0,15,2
198456,6,13,2,0,11,2
198456,3,2,2,0,0,2
198456,2,1,1,0,0,1
153479,10,2,1,0,1,1
153479,8,13,2,0,11,2
153479,7,17,4,0,13,4
153479,6,14,2,0,12,2
153479,5,6,1,0,5,1
46925,9,5,1,0,4,1
46925,8,9,2,0,7,2
46925,7,7,1,0,6,1
46925,6,15,2,0,13,2
46925,5,9,3,0,6,3
46925,4,8,2,0,6,2
251854,8,9,4,0,5,4
251854,7,11,3,0,8,3
251854,6,18,1,0,17,1
251854,5,7,1,0,6,1
251854,4,4,2,0,2,2
4788,7,9,2,0,7,2
4788,6,14,7,0,7,7
4788,5,17,4,0,13,4
4788,4,7,1,0,6,1
4788,3,6,3,0,3,3
4788,2,1,1,0,0,1
171543,8,11,2,0,9,2
171543,7,11,2,0,9,2
171543,6,18,1,0,17,1
171543,5,7,1,0,6,1
171543,4,4,1,0,3,1
5988,10,3,3,0,0,3
5988,9,10,2,0,8,2
5988,8,15,4,0,11,4
5988,7,13,3,0,10,3
5988,6,7,4,0,3,4
5988,5,5,3,0,2,3
5988,4,1,1,0,0,1
5961,7,4,3,0,1,3
5961,6,13,5,0,8,5
5961,5,18,7,0,11,7
5961,4,8,3,0,5,3
5961,3,4,2,0,2,2
5961,2,3,2,0,1,2
109936,8,3,1,0,2,1
109936,7,15,4,0,11,4
109936,6,17,3,0,14,3
109936,5,13,5,0,8,5
109936,4,3,1,0,2,1
109936,3,1,1,0,0,1
38679,8,10,3,0,7,3
38679,7,11,4,0,7,4
38679,6,17,1,0,16,1
38679,5,9,3,0,6,3
38679,4,5,3,0,2,3
235653,9,15,8,0,7,8
235653,8,13,4,0,9,4
235653,7,5,1,0,4,1
235653,6,6,2,0,4,2
235653,5,4,1,0,3,1
235653,4,4,1,0,3,1
69632,8,7,2,0,5,2
69632,7,16,3,0,13,3
69632,6,15,4,0,11,4
69632,5,8,1,0,7,1
69632,4,2,1,0,1,1
69632,2,2,1,0,1,1
36412,8,6,3,0,3,3
36412,7,10,4,0,6,4
36412,6,21,11,0,10,11
36412,5,9,5,0,4,5
36412,4,3,2,0,1,2
257378,9,3,1,0,2,1
257378,8,11,3,0,8,3
257378,7,22,7,0,15,7
257378,6,11,1,0,10,1
257378,5,9,3,0,6,3
5890,8,3,1,0,2,1
5890,7,9,5,0,4,5
5890,6,18,6,0,12,6
5890,5,9,4,0,5,4
5890,4,6,2,0,4,2
5890,3,4,1,0,3,1
5890,2,2,2,0,0,2
5890,1,2,1,0,1,1
33950,7,7,3,0,4,3
33950,6,24,10,0,14,10
33950,5,8,8,0,0,8
33950,4,6,2,0,4,2
33950,3,2,1,0,1,1
33950,2,3,2,0,1,2
182198,6,14,1,0,13,1
137969,9,1,1,0,0,1
137969,7,4,1,1,3,0
137969,6,12,1,0,11,1
137969,5,14,4,0,10,4
137969,3,9,3,1,6,2
137969,2,7,3,0,4,3
6708,8,1,1,0,0,1
6708,7,6,2,0,4,2
6708,6,24,11,0,13,11
6708,5,10,4,0,6,4
6708,4,8,4,0,4,4
6708,3,3,2,0,1,2
6708,1,1,1,0,0,1
38197,8,3,3,0,0,3
38197,7,3,1,0,2,1
38197,6,9,3,0,6,3
38197,5,10,5,0,5,5
38197,4,16,4,0,12,4
38197,3,10,4,0,6,4
38197,2,2,1,0,1,1
215065,6,17,1,0,16,1
215065,4,4,1,0,3,1
215065,3,4,3,0,1,3
215065,2,3,2,0,1,2
215065,1,2,1,0,1,1
208543,9,1,1,0,0,1
208543,8,6,2,0,4,2
208543,7,12,2,0,10,2
208543,6,22,3,1,19,2
208543,2,1,1,0,0,1
40964,8,7,1,0,6,1
40964,7,12,3,0,9,3
40964,6,15,2,0,13,2
40964,5,9,1,0,8,1
40964,4,6,1,0,5,1
3543,10,1,1,0,0,1
3543,9,3,2,0,1,2
3543,8,6,3,0,3,3
3543,7,8,1,0,7,1
3543,6,21,7,0,14,7
3543,5,8,1,0,7,1
3543,4,5,2,0,3,2
3543,2,1,1,0,0,1
2159,9,2,1,0,1,1
2159,8,4,2,0,2,2
2159,7,14,7,0,7,7
2159,6,17,4,0,13,4
2159,5,9,2,0,7,2
2159,4,6,2,0,4,2
140100,8,12,6,2,6,4
140100,7,9,4,1,5,3
140100,6,16,4,2,12,2
140100,5,7,1,0,6,1
140100,4,8,3,0,5,3
140100,3,2,1,0,1,1
3617,8,13,5,0,8,5
3617,7,8,2,0,6,2
3617,6,18,6,0,12,6
3617,5,7,3,0,4,3
3617,2,1,1,0,0,1
3617,1,2,1,0,1,1
11974,7,12,4,0,8,4
11974,6,22,4,0,18,4
11974,5,11,3,0,8,3
11974,4,6,2,0,4,2
26795,9,3,2,0,1,2
26795,8,6,3,0,3,3
26795,7,16,5,0,11,5
26795,6,12,1,0,11,1
26795,5,5,2,0,3,2
26795,4,5,4,0,1,4
26795,3,4,3,0,1,3
26795,2,1,1,0,0,1
16727,8,5,1,0,4,1
16727,6,18,3,0,15,3
16727,5,13,4,0,9,4
16727,3,4,2,0,2,2
170867,9,4,1,0,3,1
170867,8,11,2,1,9,1
170867,7,16,2,1,14,1
170867,6,15,5,1,10,4
170867,5,5,2,0,3,2
170867,2,1,1,0,0,1
21479,10,2,1,0,1,1
21479,8,8,4,0,4,4
21479,7,18,12,0,6,12
21479,6,13,5,0,8,5
21479,5,5,2,0,3,2
21479,4,6,1,0,5,1
2515,6,14,2,0,12,2
2515,5,10,2,0,8,2
2515,4,15,5,0,10,5
2515,3,10,4,0,6,4
19246,9,2,1,0,1,1
19246,8,10,6,0,4,6
19246,7,16,7,0,9,7
19246,6,14,5,0,9,5
19246,5,7,3,0,4,3
19246,4,3,2,0,1,2
19246,3,2,1,0,1,1
158343,8,6,1,0,5,1
158343,7,4,1,0,3,1
158343,6,16,2,0,14,2
158343,3,6,1,0,5,1
11648,8,10,5,0,5,5
11648,7,11,3,0,8,3
11648,6,8,3,0,5,3
11648,5,6,2,0,4,2
11648,4,3,2,0,1,2
186990,9,6,3,0,3,3
186990,8,15,8,0,7,8
186990,7,16,6,0,10,6
186990,6,15,4,0,11,4
186990,4,2,2,0,0,2
85474,8,5,1,0,4,1
85474,7,14,3,0,11,3
85474,6,14,2,0,12,2
85474,4,12,1,0,11,1
85474,3,1,1,0,0,1
86768,9,7,4,0,3,4
86768,8,2,1,0,1,1
86768,7,4,1,0,3,1
86768,6,11,2,0,9,2
86768,5,8,1,0,7,1
86768,3,7,1,0,6,1
86768,2,6,2,0,4,2
86768,1,2,1,0,1,1
13356,6,7,1,0,6,1
13356,5,16,4,0,12,4
13356,4,14,6,0,8,6
13356,3,6,1,0,5,1
13356,1,3,2,0,1,2
126941,10,2,1,0,1,1
126941,9,3,1,0,2,1
126941,8,11,1,0,10,1
126941,7,11,3,0,8,3
126941,6,14,2,0,12,2
126941,4,6,2,1,4,1
88190,9,12,4,0,8,4
88190,8,17,4,0,13,4
88190,7,13,8,0,5,8
88190,3,1,1,0,0,1
25642,8,8,1,0,7,1
25642,7,10,4,0,6,4
25642,6,10,4,0,6,4
25642,5,9,6,0,3,6
25642,4,4,1,0,3,1
25642,3,7,3,0,4,3
25642,2,3,1,0,2,1
12130,10,2,1,0,1,1
12130,8,5,3,0,2,3
12130,7,9,1,0,8,1
12130,6,12,4,0,8,4
12130,5,9,4,0,5,4
12130,4,7,4,0,3,4
12130,3,4,2,0,2,2
12130,2,6,6,0,0,6
2868,9,1,1,0,0,1
2868,8,2,1,0,1,1
2868,7,3,2,0,1,2
2868,6,5,2,0,3,2
2868,5,8,1,0,7,1
2868,4,14,4,0,10,4
2868,3,12,2,0,10,2
2868,2,7,2,0,5,2
2868,1,2,2,0,0,2
142517,8,4,2,0,2,2
142517,7,4,1,0,3,1
142517,6,25,5,0,20,5
142517,5,14,2,0,12,2
142517,3,2,1,0,1,1
75674,8,18,6,0,12,6
75674,7,21,7,0,14,7
75674,6,7,3,0,4,3
75674,4,2,2,0,0,2
235247,7,9,3,0,6,3
235247,6,11,2,0,9,2
235247,5,8,2,0,6,2
235247,4,9,2,0,7,2
235247,3,5,1,0,4,1
235247,2,4,3,0,1,3
2681,7,8,2,0,6,2
2681,6,14,5,0,9,5
2681,5,11,5,0,6,5
2681,4,8,2,0,6,2
2681,3,4,1,0,3,1
2681,2,4,2,0,2,2
160664,10,3,1,0,2,1
160664,9,5,1,0,4,1
160664,8,12,3,0,9,3
160664,7,13,2,0,11,2
160664,6,16,3,0,13,3
9908,9,6,2,0,4,2
9908,8,10,3,0,7,3
9908,7,15,6,0,9,6
9908,6,13,5,0,8,5
9908,5,4,4,0,0,4
9908,4,2,1,0,1,1
236205,10,11,6,0,5,6
236205,9,11,5,0,6,5
236205,8,14,3,0,11,3
236205,7,6,1,0,5,1
236205,6,5,1,0,4,1
236205,5,3,1,0,2,1
236205,4,3,1,0,2,1
236205,3,1,1,0,0,1
15278,3,9,3,0,6,3
15278,2,13,4,0,9,4
15278,1,20,8,0,12,8
3566,10,1,1,0,0,1
3566,7,3,1,0,2,1
3566,6,16,3,0,13,3
3566,5,18,3,0,15,3
3566,4,6,1,0,5,1
3566,3,3,1,0,2,1
3566,2,3,2,0,1,2
160524,10,10,3,0,7,3
160524,9,14,6,0,8,6
160524,8,15,4,0,11,4
160524,7,7,3,0,4,3
160524,5,2,1,0,1,1
160524,3,1,1,0,0,1
144066,8,6,2,0,4,2
144066,7,7,3,0,4,3
144066,6,16,3,0,13,3
144066,5,8,4,0,4,4
144066,4,11,3,0,8,3
144066,3,5,1,0,4,1
182284,6,17,2,0,15,2
182284,5,14,4,0,10,4
182284,4,12,3,0,9,3
39192,6,14,3,0,11,3
39192,5,14,3,0,11,3
39192,3,8,3,0,5,3
12057,8,2,1,0,1,1
12057,7,7,2,0,5,2
12057,6,17,4,0,13,4
12057,5,16,4,0,12,4
12057,4,10,2,0,8,2
12057,3,1,1,0,0,1
6768,10,3,1,0,2,1
6768,9,4,3,0,1,3
6768,8,10,6,0,4,6
6768,7,6,3,0,3,3
6768,6,12,7,0,5,7
13126,6,18,6,0,12,6
13126,5,11,3,0,8,3
13126,4,7,2,0,5,2
13126,3,7,2,0,5,2
13126,1,1,1,0,0,1
3883,10,1,1,0,0,1
3883,7,6,2,0,4,2
3883,6,13,5,0,8,5
3883,5,11,6,0,5,6
3883,4,7,2,0,5,2
3883,3,5,2,0,3,2
3883,2,6,2,0,4,2
3883,1,3,1,0,2,1
2271,9,4,2,0,2,2
2271,8,10,4,0,6,4
2271,7,17,10,0,7,10
2271,6,16,7,0,9,7
2271,5,6,3,0,3,3
169368,10,2,1,0,1,1
169368,8,16,3,0,13,3
169368,7,22,3,0,19,3
169368,6,9,3,0,6,3
169368,5,3,1,0,2,1
34009,9,2,1,0,1,1
34009,8,5,2,0,3,2
34009,7,8,1,0,7,1
34009,6,12,3,0,9,3
34009,5,16,6,0,10,6
34009,4,7,1,0,6,1
6398,8,3,2,0,1,2
6398,7,3,1,0,2,1
6398,6,10,4,0,6,4
6398,5,13,3,0,10,3
6398,4,13,2,0,11,2
6398,3,9,4,0,5,4
6398,2,2,1,0,1,1
6398,1,1,1,0,0,1
8624,8,6,3,0,3,3
8624,7,5,2,0,3,2
8624,6,19,6,0,13,6
8624,5,9,2,0,7,2
8624,4,5,1,0,4,1
248224,7,15,4,0,11,4
248224,6,11,4,0,7,4
248224,5,7,2,0,5,2
186980,10,2,1,0,1,1
186980,9,4,2,0,2,2
186980,8,11,7,1,4,6
186980,7,14,6,1,8,5
186980,6,9,4,1,5,3
186980,5,4,1,0,3,1
186980,4,6,2,0,4,2
186980,3,2,1,0,1,1
186980,2,2,2,1,0,1
12676,10,4,2,0,2,2
12676,9,1,1,0,0,1
12676,7,10,2,0,8,2
12676,6,23,6,0,17,6
12676,4,3,2,0,1,2
39245,8,2,1,0,1,1
39245,7,18,1,0,17,1
39245,6,18,4,0,14,4
39245,2,1,1,0,0,1
13208,7,5,2,0,3,2
13208,6,15,4,0,11,4
13208,5,15,2,0,13,2
13208,4,5,1,0,4,1
13208,3,11,3,0,8,3
13208,2,3,1,0,2,1
237828,10,25,8,1,17,7
237828,9,15,2,0,13,2
237828,8,9,2,0,7,2
124387,8,6,1,0,5,1
124387,7,8,4,0,4,4
124387,6,24,4,0,20,4
124387,5,6,2,0,4,2
124387,4,6,2,0,4,2
124387,2,2,1,0,1,1
22209,7,5,2,0,3,2
22209,6,7,2,0,5,2
22209,5,10,5,0,5,5
22209,4,11,3,0,8,3
22209,3,8,3,0,5,3
22209,2,12,3,0,9,3
147931,8,8,2,0,6,2
147931,7,15,2,0,13,2
147931,6,15,1,0,14,1
147931,5,7,2,0,5,2
147931,4,5,1,0,4,1
26869,9,1,1,0,0,1
26869,8,8,2,0,6,2
26869,7,9,3,0,6,3
26869,6,23,5,0,18,5
26869,5,9,3,0,6,3
26869,4,2,1,0,1,1
22758,9,6,3,0,3,3
22758,8,11,6,0,5,6
22758,7,20,6,0,14,6
22758,6,12,3,0,9,3
22758,4,1,1,0,0,1
22758,1,1,1,0,0,1
198608,10,5,2,0,3,2
198608,9,6,5,0,1,5
198608,8,20,8,0,12,8
198608,7,12,4,0,8,4
198608,6,4,1,0,3,1
198608,5,4,1,0,3,1
198608,4,1,1,0,0,1
25455,8,4,1,0,3,1
25455,7,5,2,0,3,2
25455,6,20,2,0,18,2
25455,5,9,1,0,8,1
25455,4,6,1,0,5,1
25455,3,4,3,0,1,3
25455,2,3,2,0,1,2
25455,1,3,1,0,2,1
6803,10,3,3,0,0,3
6803,9,2,1,0,1,1
6803,8,11,3,0,8,3
6803,7,13,8,0,5,8
6803,6,14,6,0,8,6
6803,5,4,2,0,2,2
6803,4,4,1,0,3,1
6803,3,2,1,0,1,1
191681,8,5,1,0,4,1
191681,7,14,4,0,10,4
191681,6,21,1,0,20,1
2196,8,2,1,0,1,1
2196,7,9,2,0,7,2
2196,6,11,2,0,9,2
2196,5,14,1,0,13,1
2196,4,14,4,0,10,4
2196,3,3,2,0,1,2
2463,7,6,1,0,5,1
2463,6,15,6,0,9,6
2463,5,17,3,0,14,3
2463,4,5,2,0,3,2
2463,3,6,2,0,4,2
7829,9,6,3,0,3,3
7829,8,4,1,0,3,1
7829,7,18,9,0,9,9
7829,6,12,3,0,9,3
7829,4,3,1,0,2,1
7829,3,2,2,0,0,2
249730,10,2,2,0,0,2
249730,9,4,3,0,1,3
249730,8,15,5,0,10,5
249730,7,7,2,0,5,2
249730,6,13,3,0,10,3
249730,5,8,3,0,5,3
249730,3,2,1,0,1,1
4554,9,2,2,0,0,2
4554,8,5,3,0,2,3
4554,7,9,4,0,5,4
4554,6,25,7,0,18,7
4554,5,7,3,0,4,3
4554,4,2,1,0,1,1
4554,3,1,1,0,0,1
36415,10,21,1,0,20,1
36415,9,13,1,0,12,1
36415,8,4,1,0,3,1
36415,5,2,1,0,1,1
36415,4,1,1,0,0,1
36415,3,2,2,0,0,2
36415,1,8,3,0,5,3
20630,10,1,1,0,0,1
20630,9,4,1,0,3,1
20630,8,3,1,0,2,1
20630,7,11,3,0,8,3
20630,6,17,4,0,13,4
20630,5,9,3,0,6,3
20630,4,6,1,0,5,1
4069,9,1,1,0,0,1
4069,6,18,6,0,12,6
4069,5,17,4,0,13,4
4069,4,5,2,0,3,2
4069,2,1,1,0,0,1
8252,9,2,1,0,1,1
8252,8,3,1,0,2,1
8252,7,10,3,0,7,3
8252,6,16,3,0,13,3
8252,5,11,4,0,7,4
8252,4,9,1,0,8,1
233848,10,4,1,0,3,1
233848,6,13,3,0,10,3
233848,2,3,1,0,2,1
103783,8,15,3,0,12,3
103783,7,19,4,0,15,4
103783,6,9,2,0,7,2
103783,2,1,1,0,0,1
61383,9,3,1,0,2,1
61383,7,15,2,0,13,2
61383,6,17,1,0,16,1
61383,5,7,1,0,6,1
148204,10,5,3,0,2,3
148204,9,22,12,0,10,12
148204,8,16,2,0,14,2
148204,7,7,2,0,5,2
148204,5,1,1,0,0,1
148204,2,1,1,0,0,1
89610,9,2,1,0,1,1
89610,8,6,1,0,5,1
89610,6,20,2,0,18,2
89610,5,9,1,0,8,1
89610,4,5,1,0,4,1
89610,1,1,1,0,0,1
253635,9,8,2,1,6,1
253635,8,21,2,0,19,2
253635,7,9,2,0,7,2
253635,6,7,2,0,5,2
253635,5,1,1,0,0,1
253635,4,2,1,0,1,1
253635,3,2,2,0,0,2
105123,6,18,3,0,15,3
105123,5,9,1,0,8,1
105123,4,7,1,0,6,1
105123,3,6,2,0,4,2
225908,9,8,3,0,5,3
225908,8,14,2,0,12,2
225908,7,12,1,0,11,1
225908,6,9,1,0,8,1
225908,4,3,1,0,2,1
216740,10,20,11,0,9,11
216740,9,5,1,0,4,1
216740,8,7,1,0,6,1
216740,5,6,2,0,4,2
216740,3,2,1,0,1,1
216740,1,4,2,0,2,2
264282,9,4,1,0,3,1
264282,8,7,3,0,4,3
264282,7,8,1,0,7,1
264282,3,3,1,0,2,1
264282,2,2,1,0,1,1
264282,1,6,1,0,5,1
10261,8,8,2,0,6,2
10261,7,15,8,0,7,8
10261,6,22,6,0,16,6
10261,5,5,1,0,4,1
10261,4,1,1,0,0,1
173408,9,5,1,0,4,1
173408,7,13,1,0,12,1
173408,4,8,2,0,6,2
173408,2,1,1,0,0,1
8352,9,4,1,0,3,1
8352,8,16,7,0,9,7
8352,7,12,3,0,9,3
8352,6,11,1,0,10,1
8352,5,3,1,0,2,1
8352,4,4,3,0,1,3
8352,2,1,1,0,0,1
6689,10,4,1,0,3,1
6689,8,2,1,0,1,1
6689,7,8,4,0,4,4
6689,6,9,2,0,7,2
6689,5,16,4,0,12,4
6689,4,6,2,0,4,2
6689,3,6,5,0,1,5
32639,9,3,2,0,1,2
32639,8,9,7,0,2,7
32639,7,14,9,0,5,9
32639,6,15,7,0,8,7
32639,5,6,2,0,4,2
32639,4,2,2,0,0,2
32639,2,1,1,0,0,1
101206,9,3,2,0,1,2
101206,8,21,9,0,12,9
101206,7,20,8,0,12,8
101206,6,8,4,0,4,4
101206,5,1,1,0,0,1
1725,7,6,1,0,5,1
1725,5,6,1,0,5,1
1725,4,12,4,0,8,4
1725,3,10,2,0,8,2
1725,2,6,4,0,2,4
1725,1,5,3,0,2,3
192288,8,22,13,0,9,13
192288,7,18,2,0,16,2
192288,6,4,2,0,2,2
192288,5,4,3,0,1,3
7243,9,2,1,0,1,1
7243,8,11,3,0,8,3
7243,7,18,6,0,12,6
7243,6,16,3,0,13,3
126213,10,2,1,0,1,1
126213,9,1,1,0,0,1
126213,8,9,2,0,7,2
126213,7,15,3,0,12,3
126213,5,6,1,0,5,1
126213,4,4,1,0,3,1
126213,3,3,2,0,1,2
8220,10,3,2,0,1,2
8220,8,3,1,0,2,1
8220,7,9,4,0,5,4
8220,6,15,7,0,8,7
8220,5,11,6,0,5,6
8220,4,8,3,0,5,3
8220,2,1,1,0,0,1
2943,10,1,1,0,0,1
2943,7,10,2,0,8,2
2943,6,27,7,0,20,7
2943,5,5,2,0,3,2
2943,4,6,2,0,4,2
2943,2,1,1,0,0,1
10450,6,10,1,0,9,1
10450,5,9,4,0,5,4
10450,4,14,3,0,11,3
10450,3,8,1,0,7,1
10450,2,3,1,0,2,1
10450,1,2,2,0,0,2
3203,9,1,1,0,0,1
3203,8,4,3,0,1,3
3203,7,8,4,0,4,4
3203,6,11,4,0,7,4
3203,5,14,7,0,7,7
3203,4,7,4,0,3,4
3203,3,7,3,0,4,3
1091,8,6,4,0,2,4
1091,7,11,3,0,8,3
1091,6,16,4,0,12,4
1091,5,11,4,0,7,4
1091,4,7,1,0,6,1
1091,2,1,1,0,0,1
23030,8,8,3,0,5,3
23030,7,7,2,0,5,2
23030,6,20,9,0,11,9
23030,5,13,2,0,11,2
23030,4,3,2,0,1,2
6436,9,1,1,0,0,1
6436,8,2,2,0,0,2
6436,7,1,1,0,0,1
6436,6,12,2,0,10,2
6436,5,11,4,0,7,4
6436,4,12,7,0,5,7
6436,3,8,5,0,3,5
6436,2,6,2,0,4,2
220624,7,8,1,0,7,1
220624,6,17,2,0,15,2
220624,5,10,1,0,9,1
220624,2,3,1,0,2,1
26539,9,6,1,0,5,1
26539,8,10,4,0,6,4
26539,7,11,5,0,6,5
26539,6,19,3,0,16,3
26539,2,2,2,0,0,2
22616,8,6,1,0,5,1
22616,7,6,4,0,2,4
22616,6,20,10,0,10,10
22616,5,8,4,0,4,4
22616,3,6,4,0,2,4
22616,2,1,1,0,0,1
13792,6,11,4,0,7,4
13792,5,11,4,0,7,4
13792,4,11,1,0,10,1
13792,3,10,3,0,7,3
13792,2,8,3,0,5,3
33569,8,6,1,0,5,1
33569,7,3,1,0,2,1
33569,6,18,5,0,13,5
33569,5,8,2,0,6,2
33569,4,11,4,0,7,4
33569,3,3,2,0,1,2
147136,9,2,2,0,0,2
147136,8,5,3,2,2,1
147136,7,13,2,0,11,2
147136,6,20,3,1,17,2
147136,5,6,1,0,5,1
147136,4,2,1,1,1,0
147136,2,3,1,0,2,1
4620,9,1,1,0,0,1
4620,8,4,3,0,1,3
4620,7,10,3,0,7,3
4620,6,23,5,0,18,5
4620,5,9,3,0,6,3
4620,4,5,1,0,4,1
9426,6,18,5,0,13,5
9426,4,10,2,0,8,2
9426,3,9,2,0,7,2
262818,9,3,1,0,2,1
262818,8,20,3,0,17,3
262818,7,18,3,0,15,3
262818,6,7,3,0,4,3
262818,4,2,1,0,1,1
255651,8,10,1,0,9,1
255651,7,13,2,0,11,2
255651,6,16,2,1,14,1
255651,5,9,2,0,7,2
255651,2,1,1,1,0,0
255651,1,1,1,0,0,1
42470,10,2,1,0,1,1
42470,7,12,2,0,10,2
42470,6,15,3,0,12,3
42470,5,5,2,0,3,2
42470,3,5,3,0,2,3
42470,2,1,1,0,0,1
175464,10,4,1,0,3,1
175464,9,17,5,0,12,5
175464,8,20,9,0,11,9
175464,7,7,3,0,4,3
175464,6,4,3,0,1,3
40247,10,2,1,0,1,1
40247,7,9,1,0,8,1
40247,6,13,1,0,12,1
40247,5,13,3,0,10,3
40247,4,9,3,0,6,3
40247,3,4,1,0,3,1
11547,7,8,3,0,5,3
11547,6,23,4,0,19,4
11547,5,8,2,0,6,2
11547,4,5,1,0,4,1
11547,3,1,1,0,0,1
11547,2,2,1,0,1,1
207290,10,2,1,0,1,1
207290,9,4,1,0,3,1
207290,8,14,3,0,11,3
207290,7,13,4,0,9,4
207290,6,13,2,0,11,2
207290,5,5,1,0,4,1
18564,8,4,2,0,2,2
18564,7,11,5,0,6,5
18564,6,16,5,0,11,5
18564,5,7,5,0,2,5
18564,4,6,4,0,2,4
18564,3,6,4,0,2,4
18564,1,1,1,0,0,1
232300,8,4,2,0,2,2
232300,7,11,2,0,9,2
232300,6,19,3,0,16,3
232300,4,3,1,0,2,1
179813,9,2,1,0,1,1
179813,8,7,3,0,4,3
179813,6,15,3,0,12,3
179813,5,11,2,0,9,2
179813,4,5,1,0,4,1
179813,3,2,1,0,1,1
177751,10,1,1,0,0,1
177751,8,4,2,0,2,2
177751,7,3,1,0,2,1
177751,6,14,1,0,13,1
177751,5,8,1,0,7,1
177751,4,15,3,0,12,3
177751,3,2,1,0,1,1
101644,10,18,6,0,12,6
101644,8,10,1,0,9,1
101644,7,8,1,0,7,1
172325,10,2,1,0,1,1
172325,8,11,5,1,6,4
172325,7,15,6,0,9,6
172325,6,9,2,0,7,2
172325,5,7,2,0,5,2
172325,4,5,2,0,3,2
172325,3,3,1,0,2,1
2384,9,3,3,0,0,3
2384,8,4,2,0,2,2
2384,7,8,1,0,7,1
2384,6,23,9,0,14,9
2384,5,7,3,0,4,3
2384,4,3,2,0,1,2
2384,3,3,2,0,1,2
2384,2,2,1,0,1,1
740,7,5,1,0,4,1
740,6,21,9,0,12,9
740,5,13,5,0,8,5
740,4,7,3,0,4,3
740,3,2,1,0,1,1
740,1,3,1,0,2,1
164369,9,5,1,0,4,1
164369,8,11,1,0,10,1
164369,7,10,3,0,7,3
164369,6,21,5,0,16,5
164369,5,6,3,0,3,3
8177,9,2,1,0,1,1
8177,8,1,1,0,0,1
8177,7,6,2,0,4,2
8177,6,16,1,0,15,1
8177,5,13,4,0,9,4
8177,4,9,2,0,7,2
8177,3,3,1,0,2,1
8177,2,3,2,0,1,2
18164,8,2,1,0,1,1
18164,7,11,2,0,9,2
18164,6,11,3,0,8,3
18164,5,11,4,0,7,4
18164,4,13,2,0,11,2
18164,3,1,1,0,0,1
72957,8,2,1,0,1,1
72957,7,6,1,0,5,1
72957,6,13,6,0,7,6
72957,5,14,2,0,12,2
72957,4,10,1,0,9,1
7992,10,5,3,0,2,3
7992,9,2,2,0,0,2
7992,8,11,3,0,8,3
7992,7,15,5,0,10,5
7992,6,14,6,0,8,6
266964,10,14,1,0,13,1
266964,9,7,1,0,6,1
266964,7,11,1,0,10,1
266964,4,2,1,0,1,1
26474,9,7,1,0,6,1
26474,8,19,4,0,15,4
26474,5,5,2,0,3,2
26474,3,1,1,0,0,1
26474,2,1,1,0,0,1
180570,8,6,1,0,5,1
180570,6,15,3,0,12,3
180570,5,9,1,0,8,1
180570,4,5,2,0,3,2
2380,8,6,4,0,2,4
2380,7,12,5,0,7,5
2380,6,13,8,0,5,8
2380,5,9,2,0,7,2
2380,4,7,3,0,4,3
2380,2,1,1,0,0,1
181031,10,6,3,1,3,2
181031,9,6,2,0,4,2
181031,8,18,5,2,13,3
181031,7,8,3,0,5,3
181031,6,10,4,0,6,4
181031,2,1,1,1,0,0
154085,8,3,1,0,2,1
154085,7,4,1,0,3,1
154085,6,22,8,1,14,7
154085,4,10,3,0,7,3
154085,3,4,2,1,2,1
154085,2,5,2,0,3,2
245384,8,12,5,0,7,5
245384,7,11,2,0,9,2
245384,6,13,3,0,10,3
245384,5,9,3,0,6,3
245384,4,5,2,0,3,2
253861,8,6,3,0,3,3
253861,6,17,2,0,15,2
253861,4,5,1,0,4,1
10906,9,3,2,0,1,2
10906,8,5,1,0,4,1
10906,7,12,2,0,10,2
10906,6,16,5,0,11,5
10906,5,10,2,0,8,2
10906,4,5,1,0,4,1
10906,2,1,1,0,0,1
58192,8,6,2,0,4,2
58192,7,10,5,0,5,5
58192,6,17,3,0,14,3
58192,5,8,4,0,4,4
58192,3,3,3,0,0,3
58192,2,4,1,0,3,1
2435,6,12,6,0,6,6
2435,5,15,5,0,10,5
2435,4,10,1,0,9,1
2435,3,5,3,0,2,3
2435,2,8,5,0,3,5
4970,10,2,1,0,1,1
4970,9,2,1,0,1,1
4970,8,17,4,0,13,4
4970,7,16,5,0,11,5
4970,6,8,2,0,6,2
4970,5,4,2,0,2,2
4970,4,2,1,0,1,1
4970,1,2,1,0,1,1
254617,8,1,1,0,0,1
254617,7,5,1,0,4,1
254617,4,9,1,0,8,1
254617,2,3,1,0,2,1
186695,10,1,1,0,0,1
186695,9,2,1,0,1,1
186695,8,12,4,0,8,4
186695,7,16,3,0,13,3
186695,6,14,2,0,12,2
186695,5,4,2,0,2,2
186695,4,3,1,0,2,1
186695,3,2,1,0,1,1
218610,9,1,1,0,0,1
218610,8,15,5,0,10,5
218610,7,20,3,0,17,3
218610,5,5,1,0,4,1
6230,8,4,3,0,1,3
6230,7,6,1,0,5,1
6230,6,17,3,0,14,3
6230,5,11,1,0,10,1
6230,4,11,2,0,9,2
6230,3,3,1,0,2,1
130286,10,2,2,0,0,2
130286,9,1,1,0,0,1
130286,8,6,3,0,3,3
130286,7,11,5,0,6,5
130286,6,19,5,0,14,5
130286,5,8,4,0,4,4
130286,3,1,1,0,0,1
174925,10,7,5,0,2,5
174925,9,5,1,0,4,1
174925,8,4,3,0,1,3
174925,7,4,1,0,3,1
174925,6,5,1,1,4,0
174925,3,2,1,0,1,1
174925,2,4,2,0,2,2
174925,1,20,4,0,16,4
18422,9,2,2,0,0,2
18422,7,19,1,0,18,1
18422,5,6,2,0,4,2
192344,9,4,2,0,2,2
192344,8,10,2,0,8,2
192344,7,9,3,0,6,3
192344,6,20,1,0,19,1
192344,5,7,1,0,6,1
192344,4,2,1,0,1,1
12819,7,7,7,0,0,7
12819,6,16,5,0,11,5
12819,5,11,5,0,6,5
12819,4,9,3,0,6,3
12819,3,4,1,0,3,1
12819,2,4,1,0,3,1
12819,1,1,1,0,0,1
117910,7,6,2,0,4,2
117910,6,13,2,0,11,2
117910,5,12,2,0,10,2
117910,4,7,1,0,6,1
117910,3,11,3,0,8,3
117910,2,3,2,0,1,2
117910,1,1,1,0,0,1
151936,8,24,9,0,15,9
151936,7,18,4,0,14,4
151936,6,5,3,0,2,3
151936,5,2,2,0,0,2
151936,3,1,1,0,0,1
30335,9,3,2,0,1,2
30335,8,6,3,0,3,3
30335,7,10,4,0,6,4
30335,6,12,3,0,9,3
30335,5,9,2,0,7,2
30335,4,5,4,0,1,4
30335,3,4,3,0,1,3
30335,2,4,2,0,2,2
20525,7,4,2,0,2,2
20525,6,20,5,0,15,5
20525,5,18,8,0,10,8
20525,4,6,2,0,4,2
20525,3,1,1,0,0,1
107181,10,4,1,0,3,1
107181,8,7,3,0,4,3
107181,7,7,2,0,5,2
107181,6,21,3,0,18,3
107181,5,7,2,0,5,2
11889,9,4,1,0,3,1
11889,8,12,7,0,5,7
11889,7,11,3,0,8,3
11889,6,15,5,0,10,5
11889,5,8,4,0,4,4
66044,8,10,1,0,9,1
66044,7,6,1,0,5,1
66044,6,16,3,0,13,3
66044,5,12,2,0,10,2
66044,3,5,3,0,2,3
150018,6,11,1,0,10,1
150018,5,9,2,0,7,2
150018,3,10,1,0,9,1
10683,10,14,7,0,7,7
10683,9,16,3,0,13,3
10683,8,10,2,0,8,2
10683,7,4,1,0,3,1
22048,8,3,2,0,1,2
22048,7,8,2,0,6,2
22048,5,7,2,0,5,2
22048,4,6,1,0,5,1
22048,3,2,1,0,1,1
22048,1,1,1,0,0,1
235451,10,11,2,0,9,2
235451,9,7,4,1,3,3
235451,8,9,5,0,4,5
235451,7,13,3,0,10,3
235451,5,4,2,1,2,1
235451,3,1,1,0,0,1
235451,2,2,1,0,1,1
153432,7,10,1,0,9,1
153432,6,23,2,0,21,2
153432,5,9,2,0,7,2
31527,8,5,1,0,4,1
31527,7,15,2,0,13,2
31527,5,6,2,0,4,2
31527,3,3,2,0,1,2
31527,2,3,1,0,2,1
187834,8,9,1,0,8,1
187834,7,8,1,0,7,1
187834,6,23,9,0,14,9
187834,5,7,1,0,6,1
187834,4,3,1,0,2,1
187834,3,2,1,0,1,1
35618,10,3,1,0,2,1
35618,9,3,1,0,2,1
35618,8,6,3,0,3,3
35618,7,7,2,0,5,2
35618,6,16,2,0,14,2
35618,5,10,3,0,7,3
35618,4,5,1,0,4,1
35618,3,3,1,0,2,1
232974,10,1,1,0,0,1
232974,9,15,7,1,8,6
232974,8,25,8,0,17,8
232974,7,8,3,0,5,3
232974,6,4,2,0,2,2
145649,8,9,1,0,8,1
145649,6,22,3,0,19,3
145649,5,5,1,0,4,1
145649,4,2,2,0,0,2
1819,8,1,1,0,0,1
1819,7,4,1,0,3,1
1819,6,14,8,0,6,8
1819,5,17,7,0,10,7
1819,4,7,3,0,4,3
1819,3,6,2,0,4,2
1819,2,1,1,0,0,1
20824,10,1,1,0,0,1
20824,7,2,1,0,1,1
20824,6,7,1,0,6,1
20824,4,7,1,0,6,1
20824,3,12,2,0,10,2
20824,2,8,1,0,7,1
20824,1,7,2,0,5,2
116972,8,4,1,0,3,1
116972,7,6,1,0,5,1
116972,6,23,2,0,21,2
116972,5,11,3,0,8,3
116972,4,6,1,0,5,1
15599,8,1,1,0,0,1
15599,7,4,1,0,3,1
15599,6,4,1,0,3,1
15599,5,13,4,0,9,4
15599,4,12,5,0,7,5
15599,3,7,3,0,4,3
15599,2,8,3,0,5,3
15599,1,4,1,0,3,1
6954,9,2,2,0,0,2
6954,8,4,3,0,1,3
6954,7,10,4,0,6,4
6954,6,20,5,0,15,5
6954,5,9,4,0,5,4
6954,4,3,1,0,2,1
6954,1,1,1,0,0,1
8620,7,9,2,0,7,2
8620,6,16,6,0,10,6
8620,5,12,3,0,9,3
8620,4,9,2,0,7,2
8620,3,2,1,0,1,1
8620,1,3,1,0,2,1
37351,7,7,1,0,6,1
37351,5,6,1,0,5,1
37351,3,2,2,0,0,2
35548,10,1,1,0,0,1
35548,8,10,4,0,6,4
35548,7,10,7,0,3,7
35548,6,13,5,0,8,5
35548,5,8,3,0,5,3
35548,4,8,3,0,5,3
113780,10,6,1,0,5,1
113780,8,3,1,0,2,1
113780,7,7,1,0,6,1
113780,6,9,4,0,5,4
113780,5,11,2,0,9,2
113780,4,6,2,0,4,2
113780,3,2,1,0,1,1
113780,2,2,1,0,1,1
113780,1,5,2,0,3,2
207764,8,15,1,0,14,1
207764,6,14,2,0,12,2
207764,5,4,1,0,3,1
207764,4,5,1,0,4,1
207764,3,2,1,0,1,1
90467,7,4,1,0,3,1
90467,6,15,2,0,13,2
90467,5,15,1,0,14,1
90467,4,10,1,0,9,1
90467,3,4,2,0,2,2
89880,10,7,2,0,5,2
89880,9,4,2,0,2,2
89880,8,14,6,0,8,6
89880,7,14,3,0,11,3
89880,6,5,2,0,3,2
89880,5,6,4,0,2,4
89880,1,2,1,0,1,1
140861,10,3,1,0,2,1
140861,8,5,1,0,4,1
140861,7,9,5,0,4,5
140861,6,14,9,0,5,9
140861,5,2,1,0,1,1
140861,4,2,1,0,1,1
140861,2,2,1,0,1,1
123514,7,11,2,0,9,2
123514,6,19,2,0,17,2
123514,5,14,3,0,11,3
123514,4,5,2,0,3,2
158752,7,6,1,0,5,1
257839,7,16,1,0,15,1
257839,6,12,2,0,10,2
14151,10,3,2,0,1,2
14151,9,3,1,0,2,1
14151,8,9,2,0,7,2
14151,7,8,2,0,6,2
14151,6,13,5,0,8,5
14151,5,8,5,0,3,5
14151,3,5,1,0,4,1
14151,2,2,2,0,0,2
85332,9,3,1,0,2,1
85332,8,19,4,0,15,4
85332,7,12,1,0,11,1
85332,6,15,1,0,14,1
188997,8,10,4,0,6,4
188997,7,12,3,0,9,3
188997,6,16,2,0,14,2
1623,9,5,2,0,3,2
1623,8,7,3,0,4,3
1623,7,15,7,0,8,7
1623,6,11,5,0,6,5
1623,5,8,3,0,5,3
1623,4,3,1,0,2,1
1623,3,2,1,0,1,1
149927,10,4,1,0,3,1
149927,9,6,3,0,3,3
149927,8,11,2,0,9,2
149927,7,20,1,0,19,1
149927,6,10,1,0,9,1
147681,9,3,1,0,2,1
147681,8,8,1,0,7,1
147681,7,16,2,0,14,2
147681,6,18,3,0,15,3
147681,5,4,1,0,3,1
147681,1,2,1,0,1,1
117986,6,21,4,0,17,4
117986,4,3,1,0,2,1
8093,10,2,1,0,1,1
8093,9,4,2,0,2,2
8093,8,10,6,0,4,6
8093,7,12,8,0,4,8
8093,6,16,8,0,8,8
8093,5,3,1,0,2,1
8093,4,3,1,0,2,1
8093,1,1,1,0,0,1
150827,8,10,1,0,9,1
150827,7,14,4,0,10,4
150827,6,16,4,0,12,4
150827,5,6,2,0,4,2
150827,1,1,1,0,0,1
19379,8,4,1,0,3,1
19379,7,8,1,0,7,1
19379,6,18,1,0,17,1
19379,4,4,1,0,3,1
19379,3,6,1,0,5,1
19379,2,2,1,0,1,1
11113,8,10,4,0,6,4
11113,7,16,2,0,14,2
11113,6,13,5,0,8,5
11113,4,2,1,0,1,1
25841,10,3,2,0,1,2
25841,9,5,2,0,3,2
25841,8,17,5,0,12,5
25841,7,14,3,0,11,3
25841,6,3,1,0,2,1
25841,2,1,1,0,0,1
19634,9,4,3,0,1,3
19634,8,6,1,0,5,1
19634,7,14,3,0,11,3
19634,6,15,4,0,11,4
19634,5,8,2,0,6,2
19634,1,1,1,0,0,1
6404,8,2,1,0,1,1
6404,7,10,2,0,8,2
6404,6,17,5,0,12,5
6404,5,12,4,0,8,4
6404,4,3,1,0,2,1
6404,3,4,3,0,1,3
86165,8,8,2,0,6,2
86165,7,13,6,0,7,6
86165,6,20,5,0,15,5
86165,5,6,2,0,4,2
86165,4,3,1,0,2,1
38830,9,2,1,0,1,1
38830,8,8,2,0,6,2
38830,7,25,7,0,18,7
38830,6,12,4,0,8,4
38830,3,1,1,0,0,1
29447,9,1,1,0,0,1
29447,8,14,4,0,10,4
29447,7,8,3,0,5,3
29447,6,15,3,0,12,3
29447,5,8,3,0,5,3
29447,4,3,1,0,2,1
29447,3,1,1,0,0,1
29447,1,1,1,0,0,1
17464,9,1,1,0,0,1
17464,8,10,4,0,6,4
17464,7,17,7,0,10,7
17464,6,16,10,0,6,10
17464,5,5,1,0,4,1
17464,3,2,2,0,0,2
11188,10,10,4,0,6,4
11188,9,4,1,0,3,1
11188,8,8,2,0,6,2
11188,7,12,4,0,8,4
11188,6,12,5,0,7,5
11188,5,2,2,0,0,2
11188,4,2,2,0,0,2
11188,1,1,1,0,0,1
192275,8,6,1,0,5,1
192275,7,11,1,0,10,1
192275,6,15,2,0,13,2
192275,5,8,1,0,7,1
192275,4,4,1,0,3,1
4271,10,2,1,0,1,1
4271,7,10,2,0,8,2
4271,6,14,5,0,9,5
4271,5,15,4,0,11,4
4271,4,4,2,0,2,2
4271,3,4,1,0,3,1
218503,9,7,3,0,4,3
218503,8,13,2,0,11,2
218503,7,10,3,0,7,3
218503,6,9,1,0,8,1
218503,5,4,3,0,1,3
218503,4,2,1,0,1,1
256397,8,7,1,0,6,1
256397,7,8,1,0,7,1
256397,6,15,1,0,14,1
5828,8,8,2,0,6,2
5828,7,14,5,0,9,5
5828,6,17,4,0,13,4
5828,4,3,1,0,2,1
186624,8,11,2,0,9,2
186624,7,12,2,0,10,2
186624,6,23,3,0,20,3
11499,9,1,1,0,0,1
11499,8,7,3,0,4,3
11499,7,18,8,0,10,8
11499,6,11,2,0,9,2
11499,5,10,2,0,8,2
11499,4,4,1,0,3,1
11499,2,1,1,0,0,1
220331,10,9,2,0,7,2
220331,9,14,4,0,10,4
220331,8,17,5,0,12,5
220331,5,1,1,0,0,1
73240,8,11,5,0,6,5
73240,7,11,3,0,8,3
73240,6,13,6,0,7,6
73240,5,8,3,0,5,3
73240,4,3,1,0,2,1
11435,10,3,2,0,1,2
11435,9,3,1,0,2,1
11435,7,18,7,0,11,7
11435,6,12,4,0,8,4
11435,5,4,2,0,2,2
11435,3,2,2,0,0,2
20851,9,4,4,0,0,4
20851,8,11,8,0,3,8
20851,7,11,7,0,4,7
20851,6,9,3,0,6,3
20851,5,12,3,0,9,3
20851,3,1,1,0,0,1
200957,10,8,6,0,2,6
200957,9,8,3,1,5,2
200957,8,6,1,0,5,1
200957,7,10,1,0,9,1
200957,6,9,2,0,7,2
200957,4,2,1,0,1,1
200957,2,2,1,0,1,1
200957,1,2,1,0,1,1
73288,8,3,1,0,2,1
73288,7,6,1,0,5,1
73288,6,14,1,0,13,1
73288,4,12,4,0,8,4
73288,1,1,1,0,0,1
120033,10,7,4,0,3,4
120033,9,4,1,0,3,1
120033,8,21,4,0,17,4
120033,6,7,1,0,6,1
120033,5,1,1,0,0,1
120033,4,1,1,0,0,1
120033,1,1,1,0,0,1
9379,8,7,3,0,4,3
9379,7,14,6,0,8,6
9379,6,14,4,0,10,4
9379,5,8,3,0,5,3
9379,4,3,2,0,1,2
9379,2,1,1,0,0,1
9379,1,2,1,0,1,1
7623,10,17,8,0,9,8
7623,9,9,5,0,4,5
7623,8,10,3,0,7,3
7623,7,4,2,0,2,2
7623,6,7,5,0,2,5
7623,5,2,1,0,1,1
7623,4,1,1,0,0,1
7623,3,1,1,0,0,1
35354,8,7,2,0,5,2
35354,7,11,4,0,7,4
35354,6,24,9,0,15,9
35354,5,4,1,0,3,1
35354,4,5,2,0,3,2
767,9,3,1,0,2,1
767,8,8,2,0,6,2
767,7,16,4,0,12,4
767,6,15,4,0,11,4
767,5,6,1,0,5,1
159502,10,9,5,0,4,5
159502,9,6,3,0,3,3
159502,8,5,3,0,2,3
159502,7,8,1,0,7,1
159502,6,8,4,1,4,3
159502,4,5,3,1,2,2
159502,1,2,1,0,1,1
169755,6,19,3,0,16,3
169755,5,10,3,0,7,3
169755,4,8,2,0,6,2
169755,2,3,1,0,2,1
8351,9,4,3,0,1,3
8351,8,13,9,0,4,9
8351,7,19,6,0,13,6
8351,6,10,4,0,6,4
8351,4,2,1,0,1,1
12267,9,1,1,0,0,1
12267,8,4,3,0,1,3
12267,7,12,5,0,7,5
12267,6,16,2,0,14,2
12267,5,15,5,0,10,5
12267,4,2,1,0,1,1
260238,8,3,1,0,2,1
260238,7,15,4,0,11,4
260238,6,18,5,0,13,5
260238,4,5,2,0,3,2
260238,3,3,3,0,0,3
190758,10,10,3,0,7,3
190758,9,11,4,0,7,4
190758,8,14,8,0,6,8
190758,7,7,1,0,6,1
190758,3,1,1,0,0,1
190758,2,2,1,0,1,1
17869,9,2,2,0,0,2
17869,7,5,1,0,4,1
17869,6,13,4,0,9,4
17869,5,11,1,0,10,1
17869,4,7,2,0,5,2
17869,3,3,2,0,1,2
17869,2,5,1,0,4,1
17869,1,2,1,0,1,1
4797,8,2,1,0,1,1
4797,7,4,2,0,2,2
4797,6,17,8,0,9,8
4797,5,16,6,0,10,6
4797,4,5,2,0,3,2
4797,3,6,1,0,5,1
10688,9,1,1,0,0,1
10688,7,1,1,0,0,1
10688,6,16,4,0,12,4
10688,5,17,6,0,11,6
10688,4,7,4,0,3,4
10688,2,2,1,0,1,1
20000,8,14,1,0,13,1
20000,7,20,2,0,18,2
20000,6,13,1,0,12,1
14355,9,3,1,0,2,1
14355,8,13,4,0,9,4
14355,7,16,5,0,11,5
14355,6,10,5,0,5,5
14355,5,6,2,0,4,2
14355,4,1,1,0,0,1
14355,1,2,1,0,1,1
2131,10,4,2,0,2,2
2131,9,3,2,0,1,2
2131,8,7,2,0,5,2
2131,7,9,1,0,8,1
2131,6,10,6,0,4,6
2131,5,11,3,0,8,3
2131,4,3,1,0,2,1
2131,3,4,1,0,3,1
5955,9,2,1,0,1,1
5955,8,7,3,0,4,3
5955,7,15,5,0,10,5
5955,6,18,6,0,12,6
5955,4,3,2,0,1,2
5955,2,1,1,0,0,1
217322,7,10,2,0,8,2
217322,6,16,1,0,15,1
217322,5,4,1,0,3,1
217322,4,7,1,0,6,1
217322,3,7,1,0,6,1
161773,9,2,1,0,1,1
161773,8,7,2,0,5,2
161773,7,9,2,0,7,2
161773,6,14,1,0,13,1
161773,5,11,1,0,10,1
161773,4,4,1,0,3,1
161773,3,3,1,0,2,1
136910,9,3,1,0,2,1
136910,8,8,4,0,4,4
136910,7,8,2,0,6,2
136910,6,18,7,0,11,7
136910,5,6,1,0,5,1
136910,4,7,3,0,4,3
319,8,3,1,0,2,1
319,7,10,4,0,6,4
319,6,21,5,0,16,5
319,5,10,3,0,7,3
319,4,5,3,0,2,3
319,3,1,1,0,0,1
72340,8,17,6,0,11,6
72340,7,14,6,0,8,6
72340,6,12,4,0,8,4
72340,5,3,1,0,2,1
8741,8,4,1,0,3,1
8741,7,9,5,0,4,5
8741,6,21,9,0,12,9
8741,5,9,3,0,6,3
8741,4,6,3,0,3,3
9969,8,5,1,0,4,1
9969,7,8,2,0,6,2
9969,6,14,1,0,13,1
9969,5,11,1,0,10,1
9969,4,4,1,0,3,1
9969,3,5,3,0,2,3
9969,2,2,2,0,0,2
69703,9,5,3,0,2,3
69703,8,12,2,0,10,2
69703,6,12,5,0,7,5
69703,5,7,1,0,6,1
69703,4,3,2,0,1,2
69703,3,3,1,0,2,1
69703,2,1,1,0,0,1
205419,10,7,5,0,2,5
205419,9,4,3,0,1,3
205419,8,20,3,0,17,3
205419,7,10,2,1,8,1
205419,6,5,1,0,4,1
234972,9,5,1,0,4,1
234972,8,10,3,0,7,3
234972,7,13,5,0,8,5
234972,6,17,2,0,15,2
234972,5,2,1,0,1,1
234972,4,2,1,0,1,1
234972,3,2,1,0,1,1
121429,10,1,1,0,0,1
121429,9,5,2,0,3,2
121429,8,21,7,0,14,7
121429,7,16,5,0,11,5
121429,6,7,3,0,4,3
121429,5,2,2,0,0,2
25001,9,1,1,0,0,1
25001,8,2,1,0,1,1
25001,7,9,4,0,5,4
25001,6,23,9,0,14,9
25001,5,10,3,0,7,3
21040,10,3,3,0,0,3
21040,8,7,2,0,5,2
21040,7,15,7,0,8,7
21040,6,13,4,0,9,4
21040,4,6,5,0,1,5
21040,3,1,1,0,0,1
21040,1,3,2,0,1,2
5026,9,3,2,0,1,2
5026,8,1,1,0,0,1
5026,7,9,4,0,5,4
5026,6,13,4,0,9,4
5026,5,12,3,0,9,3
5026,4,9,4,0,5,4
5026,3,4,3,0,1,3
223971,8,6,2,0,4,2
223971,7,11,3,0,8,3
223971,6,13,5,0,8,5
223971,5,10,2,0,8,2
39662,10,1,1,0,0,1
39662,6,9,4,0,5,4
39662,5,10,4,0,6,4
39662,4,12,6,0,6,6
39662,3,6,1,0,5,1
39662,2,10,1,0,9,1
39662,1,2,2,0,0,2
178098,10,7,5,1,2,4
178098,9,7,4,1,3,3
178098,8,5,1,0,4,1
178098,7,13,1,0,12,1
178098,6,11,1,0,10,1
178098,5,4,1,0,3,1
178098,4,1,1,1,0,0
178098,1,3,1,1,2,0
5841,7,7,1,0,6,1
5841,6,17,3,0,14,3
5841,5,10,1,0,9,1
5841,4,8,3,0,5,3
5841,3,4,1,0,3,1
5841,1,1,1,0,0,1
211364,10,10,2,1,8,1
211364,9,11,3,0,8,3
211364,8,15,8,0,7,8
211364,7,10,4,0,6,4
211364,6,3,1,1,2,0
171721,10,1,1,0,0,1
171721,9,2,1,0,1,1
171721,8,17,8,0,9,8
171721,7,20,8,0,12,8
171721,5,4,2,0,2,2
180133,8,6,2,0,4,2
180133,7,10,4,0,6,4
180133,6,25,4,0,21,4
180133,5,7,1,0,6,1
180133,4,1,1,0,0,1
208700,10,9,5,0,4,5
208700,9,7,2,2,5,0
208700,8,23,6,1,17,5
208700,7,9,1,0,8,1
208700,6,3,1,0,2,1
3620,7,16,2,0,14,2
3620,6,20,7,0,13,7
3620,5,3,1,0,2,1
3620,4,5,4,0,1,4
3620,2,1,1,0,0,1
9197,10,2,1,0,1,1
9197,8,12,4,0,8,4
9197,7,14,2,0,12,2
9197,6,19,7,0,12,7
9197,5,2,1,0,1,1
9197,4,2,2,0,0,2
9197,3,1,1,0,0,1
136494,7,7,2,0,5,2
136494,6,15,4,0,11,4
136494,5,9,3,0,6,3
136494,4,12,5,0,7,5
136494,3,3,1,0,2,1
4964,10,3,2,0,1,2
4964,9,7,5,0,2,5
4964,8,15,7,0,8,7
4964,7,15,3,0,12,3
4964,6,6,2,0,4,2
4964,5,3,2,0,1,2
4964,3,1,1,0,0,1
4964,2,1,1,0,0,1
203029,10,3,2,0,1,2
203029,9,4,2,0,2,2
203029,8,9,2,0,7,2
203029,7,12,1,0,11,1
203029,6,13,4,0,9,4
203029,4,3,1,0,2,1
203029,3,2,1,0,1,1
203029,2,1,1,0,0,1
142205,8,20,5,0,15,5
142205,7,14,1,0,13,1
142205,6,7,1,0,6,1
142205,4,2,1,0,1,1
2941,10,1,1,0,0,1
2941,8,2,1,0,1,1
2941,6,13,4,0,9,4
2941,5,13,7,0,6,7
2941,4,5,2,0,3,2
2941,3,6,5,0,1,5
2941,2,4,2,0,2,2
2941,1,4,2,0,2,2
4070,7,5,1,0,4,1
4070,6,12,2,0,10,2
4070,5,14,2,0,12,2
4070,4,11,9,0,2,9
4070,3,6,2,0,4,2
4070,2,2,2,0,0,2
4070,1,1,1,0,0,1
8334,8,5,2,0,3,2
8334,7,19,5,0,14,5
8334,6,12,6,0,6,6
8334,5,9,2,0,7,2
8334,4,2,1,0,1,1
8334,2,1,1,0,0,1
210937,8,11,2,0,9,2
210937,7,8,2,0,6,2
210937,6,18,1,0,17,1
210937,4,5,1,0,4,1
210937,3,2,2,0,0,2
36478,10,2,1,0,1,1
36478,9,2,1,0,1,1
36478,8,11,6,0,5,6
36478,7,9,1,0,8,1
36478,6,18,6,0,12,6
36478,5,9,4,0,5,4
36478,1,1,1,0,0,1
7249,8,4,1,0,3,1
7249,7,2,1,0,1,1
7249,6,13,4,0,9,4
7249,5,11,5,0,6,5
7249,4,7,3,0,4,3
7249,3,8,4,0,4,4
7249,2,4,3,0,1,3
144383,10,6,5,1,1,4
144383,9,5,3,0,2,3
144383,8,5,1,0,4,1
144383,7,7,1,0,6,1
144383,6,14,4,0,10,4
144383,5,4,3,0,1,3
144383,4,8,2,0,6,2
144383,2,2,1,1,1,0
1096,8,4,1,0,3,1
1096,7,6,2,0,4,2
1096,6,9,4,0,5,4
1096,5,10,1,0,9,1
1096,4,11,2,0,9,2
1096,3,7,3,0,4,3
1096,2,4,3,0,1,3
1096,1,1,1,0,0,1
31111,7,4,3,0,1,3
31111,6,16,6,0,10,6
31111,5,10,1,0,9,1
31111,4,15,6,0,9,6
31111,3,5,2,0,3,2
1156,8,3,2,0,1,2
1156,7,4,4,0,0,4
1156,6,14,4,0,10,4
1156,4,5,1,0,4,1
1156,3,9,2,0,7,2
82577,10,1,1,0,0,1
82577,9,1,1,0,0,1
82577,8,10,3,0,7,3
82577,7,8,2,0,6,2
82577,6,19,5,0,14,5
82577,4,5,4,0,1,4
21635,7,11,2,0,9,2
21635,6,25,12,0,13,12
21635,5,7,4,0,3,4
21635,4,2,1,0,1,1
21635,3,2,2,0,0,2
21635,2,1,1,0,0,1
32150,9,10,3,0,7,3
32150,8,19,4,0,15,4
32150,7,14,1,0,13,1
167975,10,3,1,0,2,1
167975,9,6,4,0,2,4
167975,8,23,2,0,21,2
167975,7,14,3,0,11,3
173253,8,4,1,0,3,1
173253,7,15,3,0,12,3
173253,6,13,2,0,11,2
173253,5,10,2,0,8,2
173253,1,2,1,0,1,1
10236,8,7,1,0,6,1
10236,7,9,3,0,6,3
10236,6,18,4,0,14,4
10236,4,1,1,0,0,1
10236,3,1,1,0,0,1
191351,10,10,2,0,8,2
191351,9,13,5,0,8,5
191351,8,11,3,0,8,3
191351,7,13,5,0,8,5
191351,6,2,2,0,0,2
191351,3,1,1,0,0,1
4843,9,2,1,0,1,1
4843,7,5,2,0,3,2
4843,6,21,5,0,16,5
4843,5,11,7,0,4,7
4843,4,3,2,0,1,2
4843,2,2,2,0,0,2
1167,8,4,1,0,3,1
1167,7,12,3,0,9,3
1167,6,24,5,0,19,5
1167,5,10,1,0,9,1
1167,4,2,1,0,1,1
21622,10,6,1,0,5,1
21622,9,2,1,0,1,1
21622,5,7,2,0,5,2
21622,4,5,1,0,4,1
21622,3,3,2,0,1,2
21622,2,5,1,0,4,1
72050,10,7,1,0,6,1
72050,9,15,5,0,10,5
72050,8,14,2,0,12,2
72050,7,14,2,0,12,2
47158,10,3,1,0,2,1
47158,9,2,1,0,1,1
47158,8,12,7,0,5,7
47158,7,7,1,0,6,1
47158,6,15,5,0,10,5
47158,5,5,3,0,2,3
47158,3,5,1,0,4,1
47158,1,2,1,0,1,1
9293,8,4,3,0,1,3
9293,7,3,1,0,2,1
9293,6,20,3,0,17,3
9293,5,6,1,0,5,1
9293,4,10,2,0,8,2
9293,3,6,1,0,5,1
36789,7,15,2,0,13,2
36789,6,15,1,0,14,1
36789,4,4,1,0,3,1
5840,10,3,2,0,1,2
5840,9,3,3,0,0,3
5840,8,16,7,0,9,7
5840,7,11,2,0,9,2
5840,6,13,4,0,9,4
5840,5,6,2,0,4,2
2554,8,11,2,0,9,2
2554,7,20,8,0,12,8
2554,6,13,4,0,9,4
2554,5,3,1,0,2,1
2554,4,1,1,0,0,1
3008,8,6,2,0,4,2
3008,7,18,6,0,12,6
3008,6,9,3,0,6,3
3008,5,6,3,0,3,3
3008,4,3,2,0,1,2
3008,3,3,2,0,1,2
3008,2,3,2,0,1,2
32922,9,1,1,0,0,1
32922,7,5,1,0,4,1
32922,6,12,1,0,11,1
32922,5,16,3,0,13,3
32922,4,6,3,0,3,3
32922,2,4,1,0,3,1
32922,1,1,1,0,0,1
35468,8,1,1,0,0,1
35468,7,4,1,0,3,1
35468,5,16,2,0,14,2
35468,4,14,5,0,9,5
41624,10,4,1,0,3,1
41624,9,10,3,0,7,3
41624,8,19,7,0,12,7
41624,7,9,2,0,7,2
41624,6,8,1,0,7,1
8122,9,2,1,0,1,1
8122,8,8,2,0,6,2
8122,7,12,5,0,7,5
8122,6,17,8,0,9,8
8122,5,4,3,0,1,3
8122,4,9,6,0,3,6
159525,10,1,1,0,0,1
159525,9,9,6,0,3,6
159525,8,9,4,0,5,4
159525,7,8,4,0,4,4
159525,6,7,4,0,3,4
159525,5,10,2,0,8,2
52827,10,4,2,0,2,2
52827,9,5,4,0,1,4
52827,8,9,3,0,6,3
52827,7,8,4,0,4,4
52827,6,16,8,0,8,8
52827,5,4,2,0,2,2
52827,4,5,2,0,3,2
215455,8,8,1,0,7,1
215455,7,23,3,0,20,3
215455,6,14,1,0,13,1
215455,5,3,1,0,2,1
199907,8,18,6,0,12,6
199907,7,17,4,0,13,4
199907,6,12,1,0,11,1
56889,7,13,2,0,11,2
56889,6,15,2,0,13,2
56889,5,12,3,0,9,3
29080,10,3,1,0,2,1
29080,8,5,1,0,4,1
29080,7,7,1,0,6,1
29080,6,18,5,0,13,5
29080,5,10,4,0,6,4
29080,4,3,1,0,2,1
29080,3,2,2,0,0,2
29080,2,3,1,0,2,1
1700,10,1,1,0,0,1
1700,8,9,4,0,5,4
1700,7,7,3,0,4,3
1700,6,14,8,0,6,8
1700,5,8,2,0,6,2
1700,4,10,6,0,4,6
1700,3,3,2,0,1,2
119165,8,4,1,0,3,1
119165,7,8,1,0,7,1
119165,6,15,3,0,12,3
119165,5,7,2,1,5,1
119165,4,7,3,0,4,3
119165,3,4,2,0,2,2
11703,9,2,2,0,0,2
11703,8,4,1,0,3,1
11703,7,10,3,0,7,3
11703,6,14,4,0,10,4
11703,5,7,2,0,5,2
11703,4,8,4,0,4,4
11703,3,5,4,0,1,4
11703,1,2,2,0,0,2
7399,7,3,3,0,0,3
7399,6,6,3,0,3,3
7399,5,8,6,0,2,6
7399,4,10,4,0,6,4
7399,3,8,2,0,6,2
7399,2,12,3,0,9,3
258302,10,10,4,0,6,4
258302,7,2,2,0,0,2
258302,3,2,1,0,1,1
258302,2,3,2,0,1,2
258302,1,26,7,0,19,7
25593,8,10,8,0,2,8
25593,7,15,8,0,7,8
25593,6,18,6,0,12,6
25593,5,2,1,0,1,1
25593,4,5,3,0,2,3
65333,6,18,3,0,15,3
35414,8,7,3,0,4,3
35414,7,5,1,0,4,1
35414,6,10,2,0,8,2
35414,5,17,7,0,10,7
35414,4,7,4,0,3,4
35414,3,5,1,0,4,1
113700,8,8,2,0,6,2
113700,7,16,5,0,11,5
113700,6,12,2,0,10,2
113700,5,7,1,0,6,1
113700,4,3,1,0,2,1
113700,3,4,1,0,3,1
71889,9,5,3,0,2,3
71889,8,11,9,0,2,9
71889,7,8,3,0,5,3
71889,6,19,8,0,11,8
71889,5,5,2,0,3,2
71889,4,4,2,0,2,2
149156,6,10,2,0,8,2
149156,5,4,1,0,3,1
149156,4,5,1,0,4,1
149156,3,16,5,1,11,4
149156,2,12,3,1,9,2
149156,1,5,1,0,4,1
176193,8,15,3,0,12,3
176193,7,18,7,0,11,7
176193,5,6,1,0,5,1
198778,8,11,4,0,7,4
198778,7,19,6,0,13,6
198778,6,11,1,0,10,1
198778,5,9,2,0,7,2
198778,4,2,1,0,1,1
13921,8,5,2,0,3,2
13921,7,6,2,0,4,2
13921,6,18,7,0,11,7
13921,5,8,1,0,7,1
13921,4,8,5,0,3,5
13921,3,3,1,0,2,1
13921,2,2,2,0,0,2
13921,1,1,1,0,0,1
133689,10,6,2,0,4,2
133689,9,15,5,0,10,5
133689,8,14,6,0,8,6
133689,7,10,3,0,7,3
133689,6,5,4,0,1,4
133689,3,1,1,0,0,1
3701,10,2,1,0,1,1
3701,8,1,1,0,0,1
3701,7,5,3,0,2,3
3701,6,18,12,0,6,12
3701,5,13,4,0,9,4
3701,4,7,1,0,6,1
3701,3,3,2,0,1,2
3701,1,2,1,0,1,1
17748,8,4,1,0,3,1
17748,7,6,1,0,5,1
17748,6,24,13,0,11,13
17748,5,10,5,0,5,5
17748,4,6,3,0,3,3
17748,3,2,1,0,1,1
220199,9,4,2,0,2,2
220199,8,7,1,0,6,1
220199,7,12,4,0,8,4
220199,6,17,1,0,16,1
220199,5,7,1,0,6,1
220199,4,3,1,0,2,1
24525,9,6,2,0,4,2
24525,8,12,4,0,8,4
24525,7,16,4,0,12,4
24525,6,12,5,0,7,5
24525,5,5,3,0,2,3
208170,10,1,1,1,0,0
208170,7,9,3,2,6,1
208170,6,15,4,0,11,4
208170,5,11,3,1,8,2
208170,4,5,1,0,4,1
208170,3,4,1,0,3,1
208170,2,3,2,0,1,2
104353,10,1,1,0,0,1
104353,8,6,5,0,1,5
104353,7,12,8,0,4,8
104353,6,20,13,0,7,13
104353,5,11,5,0,6,5
104353,4,1,1,0,0,1
104353,2,1,1,0,0,1
177641,10,2,1,0,1,1
177641,9,3,1,0,2,1
177641,8,11,4,0,7,4
177641,7,14,5,0,9,5
177641,6,11,3,0,8,3
177641,1,1,1,0,0,1
8979,10,1,1,0,0,1
8979,8,8,4,0,4,4
8979,7,12,4,0,8,4
8979,6,11,3,0,8,3
8979,5,11,3,0,8,3
8979,4,5,4,0,1,4
4245,8,9,6,0,3,6
4245,7,8,5,0,3,5
4245,6,15,4,0,11,4
4245,5,11,1,0,10,1
4245,4,4,2,0,2,2
25168,10,2,1,0,1,1
25168,8,4,1,0,3,1
25168,7,9,2,0,7,2
25168,6,14,4,0,10,4
25168,5,10,1,0,9,1
25168,4,7,1,0,6,1
25168,1,1,1,0,0,1
207899,8,6,1,0,5,1
207899,6,19,3,0,16,3
207899,4,1,1,0,0,1
3483,7,4,1,0,3,1
3483,6,19,6,0,13,6
3483,5,13,5,0,8,5
237009,10,7,2,0,5,2
237009,9,15,6,0,9,6
237009,8,15,5,0,10,5
237009,7,9,2,0,7,2
237009,6,3,1,0,2,1
123828,8,5,1,0,4,1
123828,7,8,4,0,4,4
123828,6,18,6,0,12,6
123828,5,11,2,0,9,2
123828,3,3,1,0,2,1
123828,2,1,1,0,0,1
12715,8,12,4,0,8,4
12715,7,17,5,0,12,5
12715,6,9,1,0,8,1
12715,3,2,1,0,1,1
12715,2,1,1,0,0,1
29489,8,5,1,0,4,1
29489,7,17,3,0,14,3
29489,6,14,1,0,13,1
29489,4,4,1,0,3,1
29489,3,2,1,0,1,1
1603,6,12,4,0,8,4
1603,4,11,2,0,9,2
1603,3,10,1,0,9,1
1603,1,1,1,0,0,1
784,8,11,3,0,8,3
784,7,15,5,0,10,5
784,6,11,2,0,9,2
784,5,5,3,0,2,3
784,2,1,1,0,0,1
202581,9,1,1,0,0,1
202581,8,9,4,0,5,4
202581,7,17,1,0,16,1
202581,6,9,2,0,7,2
202581,4,4,2,0,2,2
202581,3,4,2,0,2,2
149078,9,1,1,0,0,1
149078,7,9,3,0,6,3
149078,6,16,2,0,14,2
149078,5,14,2,0,12,2
149078,4,7,1,0,6,1
198005,10,15,10,0,5,10
198005,9,14,12,0,2,12
198005,8,15,6,0,9,6
198005,7,3,1,0,2,1
8911,10,2,1,0,1,1
8911,8,8,5,0,3,5
8911,7,13,2,0,11,2
8911,6,20,9,0,11,9
8911,4,2,1,0,1,1
8911,3,2,1,0,1,1
488,9,3,1,0,2,1
488,8,8,4,0,4,4
488,7,11,3,0,8,3
488,6,9,4,0,5,4
488,5,13,2,0,11,2
488,4,5,1,0,4,1
488,2,1,1,0,0,1
5875,7,10,2,0,8,2
5875,6,21,4,0,17,4
5875,5,9,2,0,7,2
5875,4,4,3,0,1,3
5875,3,2,2,0,0,2
5875,1,1,1,0,0,1
252265,9,4,1,0,3,1
252265,8,16,3,0,13,3
252265,7,16,2,0,14,2
252265,6,8,2,0,6,2
252265,5,5,2,0,3,2
252265,3,1,1,0,0,1
6087,8,2,2,0,0,2
6087,7,9,2,0,7,2
6087,6,13,2,0,11,2
6087,5,17,2,0,15,2
6087,4,7,5,0,2,5
6087,1,1,1,0,0,1
14012,9,4,1,0,3,1
14012,8,8,3,0,5,3
14012,7,16,4,0,12,4
14012,6,14,3,0,11,3
22305,10,1,1,0,0,1
22305,8,6,3,0,3,3
22305,7,11,3,0,8,3
22305,6,20,7,0,13,7
22305,5,3,1,0,2,1
22305,4,5,1,0,4,1
22305,3,4,2,0,2,2
2643,8,3,3,0,0,3
2643,7,5,1,0,4,1
2643,6,12,2,0,10,2
2643,5,15,3,0,12,3
2643,4,6,4,0,2,4
2643,3,7,2,0,5,2
36911,10,3,2,0,1,2
36911,9,3,1,0,2,1
36911,8,14,5,0,9,5
36911,7,16,7,0,9,7
36911,6,6,2,0,4,2
36911,5,7,2,0,5,2
36911,4,1,1,0,0,1
36911,3,1,1,0,0,1
220478,10,3,2,0,1,2
220478,9,6,5,1,1,4
220478,7,12,2,0,10,2
220478,6,15,2,0,13,2
220478,4,5,2,0,3,2
4450,8,4,2,0,2,2
4450,7,5,3,0,2,3
4450,6,19,8,0,11,8
4450,5,13,7,0,6,7
4450,4,6,3,0,3,3
4450,3,2,1,0,1,1
4450,2,1,1,0,0,1
194388,8,19,1,0,18,1
194388,6,10,2,0,8,2
194388,5,4,2,0,2,2
22724,8,6,1,0,5,1
22724,7,7,1,0,6,1
22724,6,14,5,0,9,5
22724,5,11,6,0,5,6
22724,4,4,1,0,3,1
22724,3,4,2,0,2,2
22724,2,2,2,0,0,2
15990,9,7,2,0,5,2
15990,8,13,6,0,7,6
15990,7,15,4,0,11,4
15990,4,1,1,0,0,1
17693,9,1,1,0,0,1
17693,8,2,2,0,0,2
17693,7,12,9,0,3,9
17693,6,16,6,0,10,6
17693,5,11,7,0,4,7
17693,4,7,3,0,4,3
24151,9,1,1,0,0,1
24151,8,2,1,0,1,1
24151,5,8,3,0,5,3
24151,4,6,1,0,5,1
24151,3,6,4,0,2,4
24151,1,3,1,0,2,1
28511,7,10,3,0,7,3
28511,6,19,5,0,14,5
28511,5,11,2,0,9,2
28511,4,4,1,0,3,1
28511,3,3,1,0,2,1
7607,8,5,4,0,1,4
7607,7,16,3,0,13,3
7607,6,22,7,0,15,7
6885,8,7,2,0,5,2
6885,7,17,7,0,10,7
6885,6,13,4,0,9,4
6885,5,7,4,0,3,4
6885,4,5,2,0,3,2
7241,9,2,2,0,0,2
7241,8,6,3,0,3,3
7241,7,11,4,0,7,4
7241,6,18,2,0,16,2
7241,4,3,1,0,2,1
7241,3,3,2,0,1,2
203087,10,3,1,0,2,1
203087,9,10,3,0,7,3
203087,8,23,4,0,19,4
203087,7,7,1,0,6,1
203087,6,4,1,0,3,1
203087,5,2,2,0,0,2
203087,3,1,1,0,0,1
135077,8,5,1,1,4,0
135077,6,13,4,0,9,4
135077,5,17,3,0,14,3
135077,4,5,1,0,4,1
135077,3,3,2,0,1,2
135077,2,2,1,0,1,1
19378,6,13,4,0,9,4
19378,5,11,4,0,7,4
19378,4,10,7,0,3,7
19378,3,3,1,0,2,1
19378,2,5,1,0,4,1
19378,1,4,1,0,3,1
171889,8,5,1,0,4,1
171889,7,17,3,0,14,3
171889,6,15,1,0,14,1
171889,5,8,1,0,7,1
171889,4,6,2,0,4,2
223167,10,19,10,2,9,8
223167,9,19,5,1,14,4
223167,8,6,2,0,4,2
223167,4,1,1,0,0,1
223167,3,1,1,0,0,1
226454,8,8,2,0,6,2
226454,7,16,2,0,14,2
226454,6,19,4,0,15,4
226454,5,4,1,0,3,1
237153,9,3,1,0,2,1
237153,8,7,3,0,4,3
237153,7,8,1,0,7,1
237153,6,17,1,0,16,1
237153,5,9,1,0,8,1
125634,10,2,1,0,1,1
125634,9,4,1,0,3,1
125634,8,18,13,0,5,13
125634,7,18,6,0,12,6
125634,6,7,3,0,4,3
125634,5,1,1,0,0,1
24779,8,5,1,0,4,1
24779,6,15,5,0,10,5
24779,5,11,2,0,9,2
24779,4,6,1,0,5,1
24779,3,5,1,0,4,1
42255,10,2,2,0,0,2
42255,9,4,2,0,2,2
42255,8,20,4,0,16,4
42255,7,13,2,0,11,2
42255,6,9,2,0,7,2
42255,5,2,1,0,1,1
6507,10,1,1,0,0,1
6507,9,1,1,0,0,1
6507,8,4,2,0,2,2
6507,7,6,2,0,4,2
6507,6,27,18,0,9,18
6507,5,8,3,0,5,3
6507,3,2,1,0,1,1
6507,1,1,1,0,0,1
233070,8,10,2,0,8,2
233070,7,18,2,0,16,2
233070,6,15,3,0,12,3
233070,4,2,2,0,0,2
269595,10,2,1,0,1,1
269595,8,22,4,0,18,4
269595,7,15,2,0,13,2
97582,10,6,5,0,1,5
97582,8,5,1,0,4,1
97582,7,11,2,0,9,2
97582,6,19,4,0,15,4
97582,5,4,2,0,2,2
265249,10,2,1,0,1,1
265249,9,6,2,0,4,2
265249,8,21,3,0,18,3
265249,6,9,2,0,7,2
39789,7,4,1,0,3,1
39789,6,7,2,0,5,2
39789,5,11,3,0,8,3
39789,4,7,2,0,5,2
39789,3,9,3,0,6,3
39789,2,4,3,0,1,3
39789,1,5,1,0,4,1
89550,6,5,1,0,4,1
89550,5,8,1,0,7,1
89550,4,12,1,0,11,1
89550,3,9,2,0,7,2
89550,2,11,4,0,7,4
89550,1,6,2,0,4,2
88079,10,6,3,0,3,3
88079,9,7,4,0,3,4
88079,8,24,6,0,18,6
88079,7,6,1,0,5,1
88079,6,5,1,0,4,1
88079,5,3,1,0,2,1
7754,10,2,1,0,1,1
7754,8,9,3,0,6,3
7754,7,15,7,0,8,7
7754,6,13,4,0,9,4
7754,3,1,1,0,0,1
7754,2,2,2,0,0,2
7754,1,1,1,0,0,1
121322,10,3,2,0,1,2
121322,9,7,5,0,2,5
121322,8,15,7,1,8,6
121322,7,10,2,0,8,2
121322,6,7,3,0,4,3
121322,5,6,1,0,5,1
121322,4,2,1,0,1,1
53373,7,7,1,0,6,1
53373,6,12,2,0,10,2
53373,5,12,2,0,10,2
53373,4,7,2,0,5,2
53373,3,7,1,0,6,1
139690,10,6,3,1,3,2
139690,9,3,1,0,2,1
139690,8,4,1,0,3,1
139690,7,9,3,0,6,3
139690,5,11,1,1,10,0
139690,4,6,2,0,4,2
139690,3,3,1,0,2,1
139690,2,2,2,0,0,2
219988,10,7,6,1,1,5
219988,9,6,3,0,3,3
219988,8,8,2,1,6,1
219988,7,14,4,0,10,4
219988,5,4,2,0,2,2
219988,4,2,1,1,1,0
219988,3,1,1,0,0,1
219988,2,1,1,0,0,1
3229,9,1,1,0,0,1
3229,8,12,5,0,7,5
3229,7,16,2,0,14,2
3229,6,16,1,0,15,1
3229,1,1,1,0,0,1
5254,9,1,1,0,0,1
5254,5,8,5,0,3,5
5254,4,16,9,0,7,9
5254,3,6,3,0,3,3
5254,2,6,4,0,2,4
5254,1,5,4,0,1,4
5019,8,3,2,0,1,2
5019,7,10,7,0,3,7
5019,6,21,10,0,11,10
5019,5,7,3,0,4,3
5019,4,8,2,0,6,2
17537,10,7,3,0,4,3
17537,9,8,3,0,5,3
17537,8,15,7,0,8,7
17537,7,14,8,0,6,8
17537,6,7,1,0,6,1
254546,10,8,1,0,7,1
254546,9,7,1,0,6,1
254546,6,10,1,0,9,1
254546,5,2,1,0,1,1
254546,3,4,3,0,1,3
229408,10,5,1,0,4,1
229408,9,3,1,0,2,1
229408,8,12,2,0,10,2
229408,7,9,1,0,8,1
229408,6,13,3,0,10,3
229408,5,5,1,0,4,1
229408,3,1,1,0,0,1
192409,8,1,1,0,0,1
192409,7,6,1,0,5,1
192409,6,11,2,0,9,2
192409,5,12,1,0,11,1
192409,2,5,1,0,4,1
11011,8,12,6,0,6,6
11011,7,15,5,0,10,5
11011,6,13,4,0,9,4
11011,5,7,2,0,5,2
11011,4,3,2,0,1,2
147919,10,6,2,0,4,2
147919,9,9,3,0,6,3
147919,8,17,6,0,11,6
147919,7,13,2,0,11,2
147919,5,2,1,0,1,1
147919,4,1,1,0,0,1
96342,7,11,3,0,8,3
96342,6,10,1,0,9,1
96342,3,3,1,0,2,1
96342,1,3,1,0,2,1
36777,6,21,12,0,9,12
36777,5,15,4,0,11,4
36777,4,8,6,0,2,6
36777,3,2,1,0,1,1
15269,10,4,3,0,1,3
15269,8,12,3,0,9,3
15269,7,13,6,0,7,6
15269,6,13,3,0,10,3
15269,5,4,2,0,2,2
15269,4,2,1,0,1,1
176936,9,9,3,0,6,3
176936,8,16,2,0,14,2
176936,7,12,1,0,11,1
176936,6,8,1,0,7,1
176936,5,2,1,0,1,1
176936,2,1,1,0,0,1
179718,8,6,1,0,5,1
179718,6,10,1,0,9,1
179718,4,9,3,0,6,3
179718,3,10,5,0,5,5
179718,2,2,1,0,1,1
179718,1,1,1,0,0,1
33701,7,8,4,0,4,4
33701,6,10,6,0,4,6
33701,5,8,5,0,3,5
33701,4,12,6,0,6,6
33701,3,4,2,0,2,2
33701,2,3,2,0,1,2
5463,8,4,1,0,3,1
5463,6,16,7,0,9,7
5463,5,17,5,0,12,5
5463,4,6,5,0,1,5
5463,3,3,1,0,2,1
106523,8,14,6,0,8,6
106523,7,11,1,0,10,1
106523,6,9,3,0,6,3
106523,5,7,2,0,5,2
106523,2,1,1,0,0,1
231315,8,8,1,0,7,1
231315,7,15,1,0,14,1
231315,6,11,4,0,7,4
231315,5,9,3,0,6,3
231315,4,3,1,0,2,1
5231,7,10,1,0,9,1
5231,6,23,8,0,15,8
5231,5,8,3,0,5,3
5231,4,6,3,0,3,3
5231,3,1,1,0,0,1
148522,7,5,1,0,4,1
148522,6,21,4,0,17,4
148522,5,11,1,0,10,1
148522,4,3,1,0,2,1
148522,2,1,1,0,0,1
2532,8,4,3,0,1,3
2532,7,8,2,0,6,2
2532,6,25,4,0,21,4
2532,4,6,1,0,5,1
2532,3,2,2,0,0,2
131304,7,9,1,0,8,1
131304,6,22,7,0,15,7
131304,4,3,2,0,1,2
131304,2,1,1,0,0,1
44125,9,4,3,0,1,3
44125,8,15,11,0,4,11
44125,7,10,3,0,7,3
44125,6,12,5,0,7,5
44125,5,8,3,0,5,3
44125,3,1,1,0,0,1
165283,7,4,1,0,3,1
165283,6,16,3,0,13,3
165283,5,6,2,0,4,2
165283,2,3,2,0,1,2
165283,1,1,1,0,0,1
4834,8,1,1,0,0,1
4834,7,2,1,0,1,1
4834,6,5,4,0,1,4
4834,5,16,4,0,12,4
4834,4,10,2,0,8,2
4834,3,7,3,0,4,3
4834,2,5,2,0,3,2
4834,1,4,1,0,3,1
126119,8,17,6,0,11,6
126119,7,10,3,0,7,3
126119,6,5,1,0,4,1
117975,8,12,3,0,9,3
117975,7,12,4,1,8,3
117975,6,13,5,0,8,5
117975,5,6,2,0,4,2
117975,4,3,2,0,1,2
117975,2,2,1,0,1,1
1045,9,4,1,0,3,1
1045,8,10,1,0,9,1
1045,7,5,1,0,4,1
1045,6,19,7,0,12,7
1045,5,8,3,0,5,3
1045,1,1,1,0,0,1
175497,9,3,1,0,2,1
175497,8,5,1,0,4,1
175497,7,13,2,0,11,2
175497,6,14,4,0,10,4
175497,5,6,1,0,5,1
175497,4,6,1,0,5,1
175497,3,2,1,0,1,1
5412,8,2,1,0,1,1
5412,7,6,4,0,2,4
5412,6,7,1,0,6,1
5412,5,12,7,0,5,7
5412,4,8,2,0,6,2
5412,3,5,4,0,1,4
5412,2,7,2,0,5,2
5412,1,4,4,0,0,4
140988,7,9,4,0,5,4
140988,6,20,5,1,15,4
140988,4,3,3,0,0,3
140988,3,7,3,0,4,3
140988,2,3,2,0,1,2
144417,9,2,1,0,1,1
144417,7,9,3,0,6,3
144417,6,18,3,0,15,3
144417,5,5,1,0,4,1
144417,3,4,2,0,2,2
208321,10,3,1,0,2,1
208321,9,3,1,0,2,1
208321,8,15,3,0,12,3
208321,7,20,6,0,14,6
208321,6,6,2,0,4,2
208321,5,4,3,0,1,3
88556,8,2,1,0,1,1
88556,7,4,2,0,2,2
88556,6,11,4,0,7,4
88556,5,7,2,0,5,2
88556,4,10,2,0,8,2
88556,3,4,2,0,2,2
88556,2,2,1,0,1,1
88556,1,9,6,0,3,6
15195,8,3,1,0,2,1
15195,6,12,1,0,11,1
15195,5,12,5,0,7,5
15195,4,10,3,0,7,3
15195,3,3,1,0,2,1
15195,2,5,1,0,4,1
4015,10,3,1,0,2,1
4015,9,2,1,0,1,1
4015,8,4,2,0,2,2
4015,7,18,5,0,13,5
4015,6,14,5,0,9,5
4015,5,6,3,0,3,3
4015,4,4,3,0,1,3
180205,8,16,7,0,9,7
180205,7,13,2,0,11,2
180205,6,13,5,0,8,5
180205,5,5,3,0,2,3
180205,3,1,1,0,0,1
36339,10,8,5,0,3,5
36339,9,11,3,0,8,3
36339,8,17,6,0,11,6
36339,6,3,1,0,2,1
36339,5,2,1,0,1,1
14253,9,1,1,0,0,1
14253,7,5,1,0,4,1
14253,6,15,4,0,11,4
14253,5,6,3,0,3,3
14253,4,4,2,0,2,2
14253,1,2,2,0,0,2
149286,10,5,3,0,2,3
149286,9,13,3,0,10,3
149286,8,20,5,0,15,5
149286,6,1,1,0,0,1
101239,8,2,1,0,1,1
101239,7,6,1,0,5,1
101239,6,24,5,0,19,5
101239,5,11,2,0,9,2
101239,4,4,2,0,2,2
101239,3,3,1,0,2,1
101239,2,1,1,0,0,1
40654,8,4,1,0,3,1
40654,7,9,2,0,7,2
40654,6,13,6,0,7,6
40654,5,10,2,0,8,2
40654,4,12,4,0,8,4
40654,3,2,1,0,1,1
138206,6,19,5,0,14,5
138206,5,9,1,0,8,1
138206,4,7,3,0,4,3
138206,3,1,1,0,0,1
152345,9,15,4,0,11,4
152345,8,19,5,0,14,5
152345,7,8,4,0,4,4
152345,4,1,1,0,0,1
152345,3,1,1,0,0,1
19127,9,3,1,0,2,1
19127,8,5,3,0,2,3
19127,7,6,6,0,0,6
19127,6,17,4,0,13,4
19127,5,6,1,0,5,1
19127,4,8,2,0,6,2
19127,3,2,2,0,0,2
19127,2,1,1,0,0,1
32907,9,8,5,0,3,5
32907,8,13,2,0,11,2
32907,7,18,2,0,16,2
32907,6,5,1,0,4,1
32907,5,4,3,0,1,3
189520,7,6,1,0,5,1
189520,6,15,1,0,14,1
189520,5,10,2,0,8,2
189520,4,7,1,0,6,1
182214,10,4,2,0,2,2
182214,9,4,2,1,2,1
182214,7,9,2,0,7,2
182214,6,10,1,0,9,1
182214,4,4,1,0,3,1
182214,3,5,2,0,3,2
163798,10,6,1,0,5,1
163798,9,9,2,0,7,2
163798,8,9,3,0,6,3
163798,7,11,1,0,10,1
163798,6,10,2,0,8,2
1401,8,11,6,0,5,6
1401,7,16,7,0,9,7
1401,6,14,3,0,11,3
1401,5,3,2,0,1,2
1401,4,6,2,0,4,2
8577,10,2,1,0,1,1
8577,9,7,2,0,5,2
8577,8,12,1,0,11,1
8577,7,10,3,0,7,3
8577,6,4,2,0,2,2
8577,5,8,4,0,4,4
8577,4,5,1,0,4,1
8577,3,1,1,0,0,1
8577,1,1,1,0,0,1
15527,9,2,2,0,0,2
15527,8,3,1,0,2,1
15527,6,11,1,0,10,1
15527,5,19,3,0,16,3
90972,8,4,2,0,2,2
90972,7,13,6,0,7,6
90972,6,10,1,0,9,1
90972,5,9,2,0,7,2
90972,4,7,3,0,4,3
90972,3,4,1,0,3,1
14705,6,8,3,0,5,3
14705,5,11,4,0,7,4
14705,4,16,5,0,11,5
14705,3,4,1,0,3,1
14705,1,2,2,0,0,2
226170,8,15,1,0,14,1
226170,7,20,2,0,18,2
11954,8,1,1,0,0,1
11954,7,1,1,0,0,1
11954,6,17,3,0,14,3
11954,5,13,2,0,11,2
11954,4,7,4,0,3,4
11954,3,6,2,0,4,2
11954,2,4,3,0,1,3
11954,1,1,1,0,0,1
34377,7,5,1,0,4,1
34377,5,15,4,0,11,4
34377,4,12,6,0,6,6
34377,3,4,2,0,2,2
34377,2,3,1,0,2,1
194234,9,4,2,0,2,2
194234,8,11,3,0,8,3
194234,7,11,1,0,10,1
194234,6,13,1,0,12,1
194234,5,5,1,0,4,1
178028,7,8,2,0,6,2
178028,6,17,2,0,15,2
178028,5,14,3,0,11,3
178028,4,7,2,0,5,2
155943,10,4,1,0,3,1
155943,9,9,3,0,6,3
155943,8,12,4,1,8,3
155943,6,8,3,0,5,3
155943,5,6,2,0,4,2
155943,4,3,2,0,1,2
155943,3,3,3,0,0,3
109827,10,1,1,0,0,1
109827,8,16,4,0,12,4
109827,7,13,4,0,9,4
109827,6,13,3,0,10,3
109827,5,4,1,0,3,1
109827,2,1,1,0,0,1
2178,8,4,1,0,3,1
2178,6,17,4,0,13,4
2178,3,2,1,0,1,1
177861,10,11,3,0,8,3
177861,9,16,5,0,11,5
177861,8,12,5,0,7,5
177861,7,5,1,0,4,1
177861,5,1,1,0,0,1
18531,10,3,2,0,1,2
18531,9,3,1,0,2,1
18531,8,11,5,0,6,5
18531,7,15,7,0,8,7
18531,6,9,5,0,4,5
18531,4,2,1,0,1,1
18531,1,1,1,0,0,1
16793,10,4,1,0,3,1
16793,9,7,1,0,6,1
16793,8,11,2,0,9,2
16793,7,14,3,0,11,3
16793,4,4,2,0,2,2
16793,3,2,1,0,1,1
16793,2,1,1,0,0,1
158604,9,2,1,0,1,1
158604,8,8,1,0,7,1
158604,7,9,2,0,7,2
158604,6,22,6,0,16,6
158604,4,3,2,0,1,2
150162,6,16,3,0,13,3
150162,5,13,3,0,10,3
150162,3,7,2,0,5,2
150162,2,2,1,0,1,1
1648,8,1,1,0,0,1
1648,7,3,2,0,1,2
1648,6,9,2,0,7,2
1648,5,16,4,0,12,4
1648,4,13,4,0,9,4
1648,3,4,2,0,2,2
1648,2,4,2,0,2,2
3693,8,3,1,0,2,1
3693,7,10,5,0,5,5
3693,6,15,5,0,10,5
3693,4,3,1,0,2,1
3693,3,5,2,0,3,2
3693,2,3,2,0,1,2
233932,10,10,2,0,8,2
233932,9,7,2,0,5,2
233932,8,15,5,1,10,4
233932,7,8,1,0,7,1
233932,6,7,3,0,4,3
233932,2,3,1,0,2,1
21788,7,7,1,0,6,1
21788,6,17,5,0,12,5
21788,5,14,2,0,12,2
136085,9,2,1,0,1,1
136085,8,10,3,0,7,3
136085,7,17,2,0,15,2
136085,6,16,4,0,12,4
136085,5,1,1,0,0,1
3514,8,2,1,0,1,1
3514,7,5,2,0,3,2
3514,6,14,3,0,11,3
3514,5,14,2,0,12,2
3514,4,8,3,0,5,3
3514,3,3,1,0,2,1
8033,9,4,3,0,1,3
8033,8,11,3,0,8,3
8033,7,16,7,0,9,7
8033,6,10,3,0,7,3
8033,5,7,4,0,3,4
8033,3,1,1,0,0,1
225313,7,8,2,0,6,2
225313,5,9,2,0,7,2
225313,4,8,2,0,6,2
137912,8,10,2,0,8,2
137912,7,19,5,0,14,5
137912,6,15,4,0,11,4
131956,8,3,1,0,2,1
131956,6,9,2,0,7,2
131956,5,5,2,2,3,0
131956,3,6,1,1,5,0
131956,2,7,6,1,1,5
131956,1,9,4,1,5,3
5211,9,1,1,0,0,1
5211,8,2,2,0,0,2
5211,7,4,1,0,3,1
5211,6,9,4,0,5,4
5211,5,4,2,0,2,2
5211,4,11,3,0,8,3
5211,3,3,3,0,0,3
5211,2,11,8,0,3,8
5211,1,5,4,0,1,4
10612,8,1,1,0,0,1
10612,7,6,1,0,5,1
10612,6,22,7,0,15,7
10612,5,10,6,0,4,6
10612,4,4,3,0,1,3
10612,3,4,1,0,3,1
10612,2,2,1,0,1,1
10612,1,1,1,0,0,1
3759,9,1,1,0,0,1
3759,7,2,1,0,1,1
3759,6,11,3,0,8,3
3759,5,6,3,0,3,3
3759,4,6,3,0,3,3
3759,3,10,3,0,7,3
3759,2,10,5,0,5,5
3759,1,3,2,0,1,2
3753,10,2,1,0,1,1
3753,9,1,1,0,0,1
3753,8,4,1,0,3,1
3753,7,6,2,0,4,2
3753,6,15,5,0,10,5
3753,5,6,1,0,5,1
3753,3,5,2,0,3,2
3753,2,6,2,0,4,2
10104,10,1,1,0,0,1
10104,8,6,1,0,5,1
10104,7,6,1,0,5,1
10104,6,7,1,0,6,1
10104,5,11,4,0,7,4
10104,4,13,4,0,9,4
10104,3,5,2,0,3,2
1242,8,4,1,0,3,1
1242,7,5,2,0,3,2
1242,6,16,5,0,11,5
1242,5,8,3,0,5,3
1242,4,9,2,0,7,2
1242,3,5,3,0,2,3
1242,2,1,1,0,0,1
8024,10,2,1,0,1,1
8024,9,2,1,0,1,1
8024,7,6,1,0,5,1
8024,6,13,1,0,12,1
8024,5,10,3,0,7,3
8024,4,7,3,0,4,3
8024,3,6,2,0,4,2
8024,2,2,2,0,0,2
8024,1,1,1,0,0,1
1781,10,3,2,0,1,2
1781,9,2,1,0,1,1
1781,8,10,4,0,6,4
1781,7,12,6,0,6,6
1781,6,13,4,0,9,4
1781,5,7,4,0,3,4
1781,4,3,1,0,2,1
147352,7,15,4,0,11,4
147352,6,14,1,0,13,1
147352,5,7,1,0,6,1
5876,10,2,1,0,1,1
5876,9,2,2,0,0,2
5876,8,5,2,0,3,2
5876,7,6,1,0,5,1
5876,6,13,5,0,8,5
5876,5,10,3,0,7,3
5876,4,8,1,0,7,1
5876,3,2,1,0,1,1
5876,2,1,1,0,0,1
5876,1,1,1,0,0,1
261145,9,11,1,0,10,1
261145,8,23,2,0,21,2
39663,10,3,1,0,2,1
39663,9,9,3,0,6,3
39663,8,15,4,0,11,4
39663,7,13,3,0,10,3
39663,6,8,1,0,7,1
143048,9,2,1,0,1,1
143048,8,13,7,0,6,7
143048,7,15,3,0,12,3
143048,6,14,8,0,6,8
143048,5,2,1,0,1,1
143048,4,4,1,0,3,1
860,7,11,1,0,10,1
860,6,11,2,0,9,2
860,5,14,6,0,8,6
860,4,6,3,0,3,3
860,2,2,1,0,1,1
207378,9,3,1,0,2,1
207378,8,8,3,0,5,3
207378,7,14,2,0,12,2
207378,6,17,5,0,12,5
207378,5,7,1,0,6,1
80044,10,1,1,0,0,1
80044,9,5,1,0,4,1
80044,8,16,9,0,7,9
80044,7,12,5,0,7,5
80044,6,9,1,0,8,1
80044,5,3,2,0,1,2
80044,4,2,1,0,1,1
80044,3,2,2,0,0,2
19842,9,1,1,0,0,1
19842,6,11,2,0,9,2
19842,5,19,8,0,11,8
19842,4,10,2,0,8,2
19842,3,2,1,0,1,1
19842,2,3,1,0,2,1
154009,8,4,1,0,3,1
154009,7,5,1,0,4,1
154009,6,10,2,0,8,2
154009,5,15,4,0,11,4
154009,4,7,2,0,5,2
154009,3,5,3,0,2,3
154009,2,2,2,0,0,2
62633,7,3,1,0,2,1
62633,6,11,3,0,8,3
62633,5,9,3,0,6,3
62633,4,12,1,0,11,1
62633,3,3,1,0,2,1
62633,2,3,2,0,1,2
3745,9,1,1,0,0,1
3745,8,5,2,0,3,2
3745,7,5,1,0,4,1
3745,6,10,2,0,8,2
3745,5,12,3,0,9,3
3745,4,11,2,0,9,2
3745,2,2,2,0,0,2
21866,7,6,1,0,5,1
21866,6,8,4,0,4,4
21866,5,13,4,0,9,4
21866,4,9,5,0,4,5
21866,3,7,2,0,5,2
21866,2,6,3,0,3,3
128635,7,6,1,0,5,1
128635,6,12,1,0,11,1
128635,4,12,5,0,7,5
128635,3,6,1,0,5,1
128635,2,4,3,0,1,3
191178,9,6,2,0,4,2
191178,7,15,2,1,13,1
191178,6,12,3,1,9,2
10718,9,2,1,0,1,1
10718,8,2,2,0,0,2
10718,7,8,1,0,7,1
10718,6,13,1,0,12,1
10718,5,11,4,0,7,4
10718,4,8,4,0,4,4
10718,3,2,2,0,0,2
6869,8,5,1,0,4,1
6869,7,7,5,0,2,5
6869,6,13,1,0,12,1
6869,5,8,3,0,5,3
6869,4,11,5,0,6,5
6869,1,1,1,0,0,1
252997,10,6,4,0,2,4
252997,9,5,2,0,3,2
252997,8,17,3,1,14,2
252997,7,14,2,1,12,1
252997,6,8,2,1,6,1
13412,8,3,1,0,2,1
13412,7,5,3,0,2,3
13412,6,12,4,0,8,4
13412,5,15,6,0,9,6
13412,4,6,2,0,4,2
13412,3,8,1,0,7,1
13412,1,1,1,0,0,1
28565,8,10,4,0,6,4
28565,7,13,7,0,6,7
28565,6,17,1,0,16,1
254188,10,6,3,0,3,3
254188,8,12,2,0,10,2
254188,7,11,3,0,8,3
254188,6,13,2,0,11,2
3894,7,4,1,0,3,1
3894,6,17,1,0,16,1
3894,5,14,4,0,10,4
3894,4,6,3,0,3,3
3894,1,1,1,0,0,1
1909,8,4,1,0,3,1
1909,6,15,7,0,8,7
1909,4,9,2,0,7,2
1909,3,6,4,0,2,4
127650,9,4,3,0,1,3
127650,8,8,4,0,4,4
127650,7,14,4,0,10,4
127650,6,17,9,0,8,9
127650,5,3,1,0,2,1
127650,4,1,1,0,0,1
136813,4,2,2,0,0,2
6978,9,3,1,0,2,1
6978,8,7,5,0,2,5
6978,7,13,8,0,5,8
6978,6,16,4,0,12,4
6978,5,5,3,0,2,3
6978,4,4,1,0,3,1
6447,4,4,1,0,3,1
6447,3,8,4,0,4,4
6447,2,15,5,0,10,5
6447,1,19,13,0,6,13
124224,8,5,1,0,4,1
124224,7,9,2,0,7,2
124224,6,19,5,0,14,5
124224,5,6,3,0,3,3
124224,4,3,2,0,1,2
124224,3,5,2,0,3,2
124224,2,2,1,0,1,1
124224,1,1,1,0,0,1
1993,10,1,1,0,0,1
1993,9,2,1,0,1,1
1993,8,8,2,0,6,2
1993,7,9,4,0,5,4
1993,6,9,5,0,4,5
1993,5,11,3,0,8,3
1993,4,7,1,0,6,1
1993,3,2,1,0,1,1
1993,2,1,1,0,0,1
153470,8,7,2,1,5,1
153470,7,10,2,0,8,2
153470,6,15,2,0,13,2
153470,5,8,2,0,6,2
153470,4,8,2,0,6,2
153470,1,1,1,1,0,0
195163,9,5,1,0,4,1
195163,8,6,1,0,5,1
195163,7,15,2,0,13,2
195163,6,16,2,0,14,2
195163,5,5,3,0,2,3
2527,10,1,1,0,0,1
2527,9,2,1,0,1,1
2527,7,6,2,0,4,2
2527,6,15,3,0,12,3
2527,5,15,8,0,7,8
2527,4,6,4,0,2,4
2527,3,1,1,0,0,1
2527,2,1,1,0,0,1
3552,9,2,1,0,1,1
3552,7,12,7,0,5,7
3552,6,23,9,0,14,9
3552,4,2,1,0,1,1
3552,3,2,1,0,1,1
22901,10,1,1,0,0,1
22901,9,4,1,0,3,1
22901,8,18,10,0,8,10
22901,7,10,8,0,2,8
22901,6,11,3,0,8,3
22901,5,3,2,0,1,2
22901,4,1,1,0,0,1
22901,3,1,1,0,0,1
22901,2,1,1,0,0,1
11135,9,1,1,0,0,1
11135,8,8,1,0,7,1
11135,7,20,8,0,12,8
11135,6,14,4,0,10,4
11135,5,3,1,0,2,1
11135,3,2,2,0,0,2
11135,2,1,1,0,0,1
11407,9,2,1,0,1,1
11407,7,12,2,0,10,2
11407,6,14,4,0,10,4
11407,5,10,2,0,8,2
11407,4,6,1,0,5,1
173931,10,1,1,0,0,1
173931,8,9,4,2,5,2
173931,7,10,1,0,9,1
173931,6,12,4,0,8,4
173931,4,4,4,0,0,4
173931,3,2,2,0,0,2
173931,2,4,3,0,1,3
173931,1,3,1,0,2,1
223454,10,6,2,0,4,2
223454,9,7,1,0,6,1
223454,8,10,1,0,9,1
223454,7,18,4,0,14,4
223454,6,6,1,0,5,1
13614,9,1,1,0,0,1
13614,8,4,1,0,3,1
13614,7,6,1,0,5,1
13614,6,17,5,0,12,5
13614,5,11,4,0,7,4
13614,4,4,3,0,1,3
13614,3,3,2,0,1,2
13614,1,1,1,0,0,1
178038,6,21,2,0,19,2
178038,3,3,1,0,2,1
118325,7,10,1,0,9,1
118325,6,19,3,0,16,3
118325,5,6,1,0,5,1
118325,2,1,1,0,0,1
88521,7,9,2,0,7,2
88521,6,24,14,0,10,14
88521,5,8,2,0,6,2
88521,4,6,2,0,4,2
88521,3,1,1,0,0,1
88521,2,1,1,0,0,1
776,8,7,2,0,5,2
776,7,8,1,0,7,1
776,6,18,5,0,13,5
776,5,5,1,0,4,1
776,4,9,3,0,6,3
161885,8,17,10,0,7,10
161885,7,14,4,0,10,4
161885,6,17,6,0,11,6
161885,4,2,1,0,1,1
8788,7,7,2,0,5,2
8788,6,18,9,0,9,9
8788,5,12,6,0,6,6
8788,4,4,2,0,2,2
8788,3,2,1,0,1,1
8788,2,2,1,0,1,1
14387,10,3,1,0,2,1
14387,9,4,2,0,2,2
14387,8,15,6,0,9,6
14387,7,13,4,0,9,4
14387,6,9,4,0,5,4
14387,5,5,1,0,4,1
21036,8,4,1,0,3,1
21036,7,12,4,0,8,4
21036,6,21,6,0,15,6
21036,5,9,1,0,8,1
132261,10,5,3,0,2,3
132261,9,3,1,0,2,1
132261,8,10,2,0,8,2
132261,7,10,3,0,7,3
132261,6,12,4,0,8,4
132261,4,4,2,0,2,2
13495,9,1,1,0,0,1
13495,8,6,4,0,2,4
13495,7,12,2,0,10,2
13495,5,7,1,0,6,1
13495,4,6,1,0,5,1
13495,1,1,1,0,0,1
264647,10,6,1,1,5,0
264647,9,9,4,1,5,3
264647,8,16,3,0,13,3
264647,7,11,2,0,9,2
264647,6,3,2,0,1,2
264647,5,2,1,0,1,1
264647,4,3,2,0,1,2
10533,9,1,1,0,0,1
10533,8,4,1,0,3,1
10533,7,12,3,0,9,3
10533,6,15,6,0,9,6
10533,5,11,4,0,7,4
10533,4,4,1,0,3,1
10533,3,2,1,0,1,1
137047,8,3,2,0,1,2
137047,7,17,2,0,15,2
137047,6,17,2,0,15,2
137047,5,8,1,0,7,1
137047,3,3,1,0,2,1
230570,10,4,2,0,2,2
230570,8,15,2,0,13,2
230570,7,10,3,0,7,3
230570,6,9,2,0,7,2
230570,5,3,1,0,2,1
230570,4,4,2,0,2,2
230570,1,1,1,0,0,1
6476,10,5,2,0,3,2
6476,8,17,7,0,10,7
6476,7,8,6,0,2,6
6476,6,15,9,0,6,9
6476,4,1,1,0,0,1
244584,8,4,2,0,2,2
244584,7,12,4,0,8,4
244584,6,16,1,0,15,1
244584,5,9,3,0,6,3
244584,4,4,1,0,3,1
6939,8,3,2,0,1,2
6939,7,10,3,0,7,3
6939,6,27,10,0,17,10
6939,5,6,2,0,4,2
6939,1,1,1,0,0,1
120444,8,12,4,0,8,4
120444,7,10,1,0,9,1
120444,6,13,2,0,11,2
120444,5,6,2,0,4,2
120444,4,3,1,0,2,1
120444,3,2,1,0,1,1
120444,2,2,1,0,1,1
120444,1,1,1,0,0,1
39067,9,4,3,0,1,3
39067,8,19,4,0,15,4
39067,7,11,5,0,6,5
39067,6,10,4,0,6,4
39067,5,2,1,0,1,1
39067,4,1,1,0,0,1
39067,3,1,1,0,0,1
5515,10,2,1,0,1,1
5515,8,6,5,0,1,5
5515,7,8,1,0,7,1
5515,6,21,10,0,11,10
5515,5,6,1,0,5,1
5515,4,3,1,0,2,1
5515,2,3,1,0,2,1
16719,6,8,2,0,6,2
239621,9,4,2,1,2,1
239621,8,9,2,1,7,1
239621,6,13,4,0,9,4
239621,5,8,2,0,6,2
239621,3,6,5,0,1,5
146762,10,7,4,1,3,3
146762,9,13,6,2,7,4
146762,8,15,6,1,9,5
146762,7,7,2,0,5,2
146762,6,2,1,0,1,1
146762,5,5,1,0,4,1
192016,10,2,1,0,1,1
192016,9,3,1,0,2,1
192016,8,5,1,0,4,1
192016,7,12,2,1,10,1
192016,6,18,2,0,16,2
192016,5,4,2,0,2,2
192016,4,5,3,0,2,3
192016,1,1,1,0,0,1
11581,10,3,2,0,1,2
11581,8,16,4,0,12,4
11581,7,16,4,0,12,4
11581,6,11,4,0,7,4
11581,5,2,2,0,0,2
11581,4,2,1,0,1,1
36510,9,1,1,0,0,1
36510,8,2,2,0,0,2
36510,7,13,8,0,5,8
36510,6,20,9,0,11,9
36510,5,7,2,0,5,2
36510,4,2,1,0,1,1
36510,3,1,1,0,0,1
105550,7,10,3,0,7,3
105550,6,21,3,0,18,3
105550,3,5,1,0,4,1
234052,8,9,4,0,5,4
234052,7,11,2,0,9,2
234052,6,6,3,0,3,3
234052,5,6,3,0,3,3
234052,4,2,1,0,1,1
234052,2,1,1,0,0,1
234052,1,7,2,1,5,1
171665,8,12,4,0,8,4
171665,7,9,3,0,6,3
171665,6,14,4,0,10,4
171665,4,4,1,0,3,1
171665,2,2,1,0,1,1
110570,9,3,1,0,2,1
110570,7,9,1,0,8,1
110570,6,13,2,0,11,2
110570,4,5,2,0,3,2
110570,3,1,1,0,0,1
110570,2,2,1,0,1,1
110570,1,3,1,0,2,1
183716,8,8,1,0,7,1
183716,7,16,2,0,14,2
183716,6,18,2,0,16,2
183716,4,2,1,0,1,1
7795,8,3,1,0,2,1
7795,7,14,6,0,8,6
7795,6,19,5,0,14,5
7795,5,4,2,0,2,2
7795,4,3,2,0,1,2
7795,3,4,2,0,2,2
7795,2,1,1,0,0,1
6414,8,8,3,0,5,3
6414,7,7,2,0,5,2
6414,6,21,10,0,11,10
6414,5,10,3,0,7,3
6414,4,4,2,0,2,2
241731,10,2,1,0,1,1
241731,9,1,1,0,0,1
241731,8,9,1,0,8,1
241731,7,14,3,0,11,3
241731,6,14,4,0,10,4
241731,5,5,2,0,3,2
241731,4,2,1,0,1,1
218905,9,2,1,0,1,1
218905,8,8,2,0,6,2
218905,7,15,1,0,14,1
218905,6,19,5,0,14,5
42336,8,7,4,0,3,4
42336,7,12,4,1,8,3
42336,6,16,8,1,8,7
42336,5,5,2,0,3,2
42336,4,3,1,0,2,1
42336,3,3,1,0,2,1
42336,1,1,1,0,0,1
5343,9,3,2,0,1,2
5343,8,7,2,0,5,2
5343,7,12,6,0,6,6
5343,6,11,5,0,6,5
5343,5,11,6,0,5,6
17765,9,3,3,0,0,3
17765,8,7,2,0,5,2
17765,7,14,7,0,7,7
17765,6,15,7,0,8,7
17765,5,7,4,0,3,4
17765,4,3,2,0,1,2
17765,3,1,1,0,0,1
7230,7,18,8,0,10,8
7230,6,19,8,0,11,8
7230,5,5,1,0,4,1
7230,2,1,1,0,0,1
147251,9,4,1,0,3,1
147251,8,5,1,0,4,1
147251,7,17,3,0,14,3
147251,6,10,2,0,8,2
147251,5,6,3,0,3,3
147251,4,4,1,0,3,1
147251,1,1,1,0,0,1
167723,10,3,1,0,2,1
167723,9,3,3,0,0,3
167723,8,6,3,1,3,2
167723,7,6,2,0,4,2
167723,6,12,3,0,9,3
167723,5,10,2,0,8,2
167723,4,5,1,0,4,1
167723,1,1,1,0,0,1
125436,9,2,2,0,0,2
125436,7,9,3,0,6,3
125436,6,21,9,0,12,9
125436,5,7,1,0,6,1
129314,8,8,2,0,6,2
129314,7,12,2,0,10,2
129314,6,20,5,0,15,5
129314,5,7,1,0,6,1
9062,8,4,1,0,3,1
9062,7,19,7,0,12,7
9062,6,14,3,0,11,3
9062,4,3,1,0,2,1
9062,3,3,2,0,1,2
36612,9,4,3,0,1,3
36612,8,14,6,0,8,6
36612,7,20,5,0,15,5
36612,6,8,2,0,6,2
36612,5,3,1,0,2,1
100275,10,4,3,0,1,3
100275,9,5,3,0,2,3
100275,8,7,4,0,3,4
100275,7,11,1,0,10,1
100275,6,11,5,0,6,5
100275,4,4,1,0,3,1
100275,3,4,2,0,2,2
100275,1,2,1,0,1,1
10221,10,1,1,0,0,1
10221,9,2,1,0,1,1
10221,7,15,3,0,12,3
10221,6,20,7,0,13,7
10221,5,5,2,0,3,2
8990,8,8,3,0,5,3
8990,7,13,4,0,9,4
8990,6,11,5,0,6,5
8990,5,9,3,0,6,3
8990,4,2,1,0,1,1
8990,2,1,1,0,0,1
8754,9,5,1,0,4,1
8754,8,4,1,0,3,1
8754,7,14,9,0,5,9
8754,6,14,8,0,6,8
8754,5,8,2,0,6,2
8754,4,1,1,0,0,1
8754,2,1,1,0,0,1
8754,1,1,1,0,0,1
151191,9,1,1,0,0,1
151191,8,9,3,0,6,3
151191,7,11,4,0,7,4
151191,6,13,1,0,12,1
151191,5,7,1,0,6,1
151191,3,1,1,0,0,1
151191,2,1,1,0,0,1
155836,8,4,3,0,1,3
155836,7,10,4,0,6,4
155836,6,14,3,0,11,3
155836,4,7,1,0,6,1
210065,8,6,2,0,4,2
210065,7,8,3,0,5,3
210065,6,16,1,0,15,1
210065,5,13,2,0,11,2
5279,9,5,1,0,4,1
5279,8,19,3,0,16,3
5279,7,10,1,0,9,1
5279,6,9,2,0,7,2
5279,4,1,1,0,0,1
12319,9,2,1,0,1,1
12319,8,7,1,0,6,1
12319,7,14,5,0,9,5
12319,6,15,3,0,12,3
12319,5,6,3,0,3,3
12319,4,4,3,0,1,3
12319,2,1,1,0,0,1
164600,10,11,7,0,4,7
164600,9,4,2,0,2,2
164600,8,7,2,0,5,2
164600,6,10,2,1,8,1
164600,4,4,1,0,3,1
164600,2,4,3,0,1,3
164600,1,2,2,0,0,2
123930,8,8,5,2,3,3
123930,7,9,2,0,7,2
123930,6,14,2,0,12,2
123930,5,6,2,0,4,2
123930,3,5,2,0,3,2
246689,9,5,1,0,4,1
246689,8,13,2,0,11,2
246689,7,15,1,0,14,1
246689,6,10,3,1,7,2
172509,8,5,1,0,4,1
172509,7,10,2,0,8,2
172509,6,22,2,0,20,2
172509,3,4,1,0,3,1
172509,2,1,1,0,0,1
166341,10,12,6,0,6,6
166341,9,8,7,0,1,7
166341,8,8,3,0,5,3
166341,7,7,2,0,5,2
166341,6,7,1,0,6,1
166341,5,6,1,0,5,1
229736,7,11,3,0,8,3
229736,6,13,1,0,12,1
229736,4,7,2,0,5,2
170568,8,15,2,0,13,2
170568,6,7,2,0,5,2
170568,5,8,1,0,7,1
111327,9,3,2,0,1,2
111327,6,18,1,0,17,1
111327,5,7,1,0,6,1
111327,3,4,1,0,3,1
111327,2,2,1,0,1,1
111327,1,3,1,0,2,1
76444,6,8,1,0,7,1
76444,5,10,4,0,6,4
76444,4,9,3,0,6,3
76444,3,9,3,0,6,3
76444,2,8,1,0,7,1
205604,10,2,1,0,1,1
205604,9,2,1,0,1,1
205604,8,5,1,0,4,1
205604,6,15,4,1,11,3
205604,5,7,1,0,6,1
205604,4,5,4,1,1,3
205604,3,4,2,0,2,2
18590,10,29,6,0,23,6
18590,9,8,2,0,6,2
18590,8,3,1,0,2,1
18590,7,2,1,0,1,1
18590,6,2,1,0,1,1
18590,1,3,2,0,1,2
252576,9,9,2,0,7,2
252576,8,15,4,0,11,4
252576,7,13,3,0,10,3
252576,6,6,2,0,4,2
252576,5,3,2,0,1,2
7031,10,2,2,0,0,2
7031,9,2,1,0,1,1
7031,8,4,2,0,2,2
7031,7,8,5,0,3,5
7031,6,11,4,0,7,4
7031,5,11,7,0,4,7
7031,4,6,4,0,2,4
7031,3,4,1,0,3,1
7031,2,1,1,0,0,1
7488,9,1,1,0,0,1
7488,7,5,3,0,2,3
7488,6,19,8,0,11,8
7488,5,9,3,0,6,3
7488,4,11,2,0,9,2
187347,10,4,2,1,2,1
187347,9,6,2,1,4,1
187347,8,18,2,0,16,2
187347,7,7,1,0,6,1
187347,6,6,1,0,5,1
147581,7,4,1,0,3,1
147581,6,15,4,0,11,4
147581,5,12,1,0,11,1
147581,4,8,1,0,7,1
147581,3,6,1,0,5,1
101954,7,2,1,0,1,1
101954,6,15,5,0,10,5
101954,5,15,4,0,11,4
101954,4,5,1,0,4,1
101954,2,5,3,0,2,3
101954,1,2,1,0,1,1
91197,9,2,1,0,1,1
91197,7,9,3,0,6,3
91197,6,19,4,0,15,4
91197,5,8,1,0,7,1
91197,3,3,1,0,2,1
91197,2,2,1,0,1,1
247199,6,15,1,0,14,1
247199,4,4,1,0,3,1
232950,10,5,2,1,3,1
232950,9,1,1,0,0,1
232950,8,8,1,0,7,1
232950,7,8,1,0,7,1
232950,6,13,5,0,8,5
232950,5,5,2,1,3,1
232950,3,1,1,0,0,1
232950,1,4,1,0,3,1
9345,10,1,1,0,0,1
9345,8,9,2,0,7,2
9345,7,9,3,0,6,3
9345,6,14,5,0,9,5
9345,5,9,5,0,4,5
9345,3,2,1,0,1,1
13010,9,1,1,0,0,1
13010,7,9,1,0,8,1
13010,6,14,2,0,12,2
13010,5,8,4,0,4,4
13010,4,8,2,0,6,2
13010,3,5,1,0,4,1
113971,10,14,7,0,7,7
113971,9,13,4,0,9,4
113971,8,13,5,0,8,5
113971,7,7,1,0,6,1
113971,6,1,1,0,0,1
41152,8,2,1,0,1,1
41152,7,6,1,0,5,1
41152,6,15,3,0,12,3
41152,5,16,3,0,13,3
41152,4,5,2,0,3,2
41152,3,5,2,0,3,2
49399,9,5,1,0,4,1
49399,7,16,1,0,15,1
49399,6,11,3,0,8,3
111802,9,4,1,0,3,1
111802,8,9,5,0,4,5
111802,7,12,4,0,8,4
111802,6,11,6,0,5,6
111802,5,9,3,0,6,3
111802,4,2,1,0,1,1
173302,10,2,1,0,1,1
173302,8,12,4,0,8,4
173302,7,13,4,0,9,4
173302,6,8,1,0,7,1
173302,4,3,2,0,1,2
15613,10,3,2,0,1,2
15613,7,6,3,0,3,3
15613,6,12,1,0,11,1
15613,5,10,1,0,9,1
15613,4,6,3,0,3,3
15613,3,3,1,0,2,1
15613,2,4,1,0,3,1
198825,9,4,2,0,2,2
198825,8,10,2,0,8,2
198825,6,15,2,0,13,2
198825,5,6,1,0,5,1
198825,4,2,1,0,1,1
198825,3,1,1,0,0,1
178937,7,10,1,0,9,1
178937,6,17,1,0,16,1
178937,5,7,1,0,6,1
178937,4,6,2,0,4,2
65087,8,5,3,0,2,3
65087,7,6,4,0,2,4
65087,6,11,4,0,7,4
65087,5,6,2,0,4,2
65087,4,8,4,0,4,4
65087,3,5,1,0,4,1
65087,2,1,1,0,0,1
65087,1,1,1,0,0,1
98931,9,1,1,0,0,1
98931,8,11,7,0,4,7
98931,7,14,3,0,11,3
98931,6,10,4,0,6,4
98931,5,10,2,0,8,2
220674,9,3,1,0,2,1
220674,8,7,3,0,4,3
220674,7,15,3,0,12,3
220674,6,14,2,0,12,2
220674,5,6,2,0,4,2
220674,4,2,1,0,1,1
220674,3,2,1,0,1,1
2920,10,6,2,0,4,2
2920,9,6,2,0,4,2
2920,8,15,5,0,10,5
2920,7,12,2,0,10,2
2920,5,2,1,0,1,1
2920,4,2,2,0,0,2
2920,3,1,1,0,0,1
2474,9,3,2,0,1,2
2474,8,8,4,0,4,4
2474,7,11,1,0,10,1
2474,6,15,8,0,7,8
2474,5,6,2,0,4,2
2474,4,4,2,0,2,2
2474,3,1,1,0,0,1
2474,1,1,1,0,0,1
8852,8,1,1,0,0,1
8852,6,12,4,0,8,4
8852,5,12,5,0,7,5
8852,4,10,4,0,6,4
8852,3,3,1,0,2,1
8852,2,5,3,0,2,3
8852,1,2,1,0,1,1
30760,9,2,1,0,1,1
30760,7,12,4,0,8,4
30760,6,14,6,0,8,6
30760,5,6,3,0,3,3
30760,4,7,3,0,4,3
30760,3,3,1,0,2,1
30760,2,1,1,0,0,1
30760,1,2,1,0,1,1
257283,10,18,3,1,15,2
257283,9,5,2,0,3,2
257283,7,9,3,1,6,2
257283,5,2,1,0,1,1
257283,3,1,1,0,0,1
257283,2,1,1,1,0,0
257283,1,3,2,1,1,1
255680,9,7,3,0,4,3
255680,8,20,6,0,14,6
255680,7,10,1,0,9,1
255680,6,4,1,0,3,1
255680,5,4,1,0,3,1
24069,7,9,1,0,8,1
24069,6,17,2,0,15,2
24069,5,10,5,0,5,5
24069,4,2,1,0,1,1
24069,3,2,1,0,1,1
11413,9,3,1,0,2,1
11413,7,10,5,0,5,5
11413,6,23,4,0,19,4
11413,5,4,1,0,3,1
11413,4,6,3,0,3,3
147396,8,5,1,0,4,1
147396,7,10,2,0,8,2
147396,6,14,1,0,13,1
147396,5,10,2,0,8,2
147396,3,4,1,0,3,1
147396,1,1,1,0,0,1
113311,10,2,1,0,1,1
113311,9,2,1,0,1,1
113311,8,8,2,0,6,2
113311,6,12,3,0,9,3
113311,5,10,2,1,8,1
113311,4,5,2,0,3,2
113311,3,3,2,0,1,2
17482,10,4,2,0,2,2
17482,9,4,1,0,3,1
17482,8,9,2,0,7,2
17482,7,14,2,0,12,2
17482,6,9,4,0,5,4
17482,4,3,1,0,2,1
9589,10,1,1,0,0,1
9589,9,1,1,0,0,1
9589,8,2,2,0,0,2
9589,7,4,2,0,2,2
9589,6,12,6,0,6,6
9589,5,13,5,0,8,5
9589,4,12,6,0,6,6
9589,3,3,1,0,2,1
234920,9,2,1,0,1,1
234920,8,10,1,0,9,1
234920,7,14,3,0,11,3
234920,6,12,4,1,8,3
234920,5,7,2,0,5,2
234920,4,3,1,0,2,1
5517,7,6,2,0,4,2
5517,6,18,5,0,13,5
5517,5,10,4,0,6,4
5517,4,8,4,0,4,4
21095,9,1,1,0,0,1
21095,8,7,4,0,3,4
21095,6,9,3,0,6,3
21095,5,4,3,0,1,3
21095,4,9,7,0,2,7
21095,3,9,5,0,4,5
21095,2,7,2,0,5,2
10033,8,2,1,0,1,1
10033,7,8,1,0,7,1
10033,6,10,2,0,8,2
10033,5,10,3,0,7,3
10033,4,7,3,0,4,3
10033,3,6,2,0,4,2
2415,8,5,3,0,2,3
2415,7,15,2,0,13,2
2415,6,18,9,0,9,9
2415,5,8,1,0,7,1
2415,4,1,1,0,0,1
2415,3,1,1,0,0,1
173899,10,1,1,0,0,1
173899,8,2,1,0,1,1
173899,6,9,3,0,6,3
173899,5,6,2,0,4,2
173899,4,9,2,0,7,2
173899,3,10,5,0,5,5
173899,1,4,1,0,3,1
231573,10,1,1,0,0,1
231573,9,7,1,0,6,1
231573,8,20,8,0,12,8
231573,7,11,1,0,10,1
231573,6,8,2,0,6,2
231573,4,1,1,0,0,1
5433,9,1,1,0,0,1
5433,8,5,3,0,2,3
5433,6,14,5,0,9,5
5433,5,12,2,0,10,2
5433,4,12,5,0,7,5
5433,3,2,1,0,1,1
121715,8,9,3,2,6,1
121715,7,13,2,0,11,2
121715,6,13,2,0,11,2
121715,4,2,1,0,1,1
168278,9,2,2,0,0,2
168278,8,4,2,0,2,2
168278,7,8,3,0,5,3
168278,6,13,3,0,10,3
168278,5,12,3,0,9,3
168278,4,4,1,0,3,1
168278,3,2,2,0,0,2
168278,2,3,1,0,2,1
168278,1,1,1,0,0,1
135598,6,15,2,0,13,2
135598,5,7,1,0,6,1
135598,4,6,1,0,5,1
103405,7,4,1,0,3,1
103405,6,12,4,0,8,4
103405,5,13,4,0,9,4
103405,4,7,2,0,5,2
103405,3,6,1,0,5,1
103405,2,5,2,0,3,2
103405,1,2,1,0,1,1
4894,9,2,2,0,0,2
4894,8,7,2,0,5,2
4894,7,10,2,0,8,2
4894,6,19,3,0,16,3
4894,5,7,4,0,3,4
63868,10,2,1,0,1,1
63868,9,15,2,0,13,2
63868,8,14,6,0,8,6
63868,7,8,2,0,6,2
63868,6,6,2,0,4,2
63868,2,1,1,0,0,1
205039,9,4,2,0,2,2
205039,8,11,4,0,7,4
205039,7,10,1,0,9,1
205039,6,13,2,0,11,2
205039,2,2,1,0,1,1
166929,10,1,1,0,0,1
166929,8,5,2,0,3,2
166929,7,5,1,0,4,1
166929,6,14,4,0,10,4
166929,5,9,4,0,5,4
166929,4,7,2,0,5,2
166929,3,4,1,0,3,1
166929,2,4,1,0,3,1
206591,10,6,3,0,3,3
206591,9,10,5,1,5,4
206591,8,13,5,1,8,4
206591,7,10,2,1,8,1
206591,5,3,2,0,1,2
203265,9,2,2,0,0,2
203265,7,9,1,0,8,1
203265,6,20,2,0,18,2
203265,5,10,1,0,9,1
103327,8,2,2,0,0,2
103327,7,8,3,0,5,3
103327,6,10,4,0,6,4
103327,5,7,2,0,5,2
103327,4,7,1,0,6,1
103327,2,6,1,0,5,1
103327,1,7,4,0,3,4
99310,9,6,3,0,3,3
99310,8,10,6,0,4,6
99310,7,10,2,0,8,2
99310,6,13,1,0,12,1
99310,5,5,2,0,3,2
24024,9,3,1,0,2,1
24024,8,6,3,0,3,3
24024,7,10,3,0,7,3
24024,6,16,7,0,9,7
24024,5,8,1,0,7,1
24024,4,3,1,0,2,1
24024,2,1,1,0,0,1
243707,9,1,1,0,0,1
243707,7,9,1,0,8,1
243707,6,18,4,0,14,4
243707,5,10,3,0,7,3
243707,4,4,1,0,3,1
243707,3,2,1,0,1,1
207653,10,2,1,0,1,1
207653,9,2,1,0,1,1
207653,8,17,1,0,16,1
207653,5,2,1,0,1,1
172580,10,3,1,0,2,1
172580,8,13,5,1,8,4
172580,7,4,1,1,3,0
172580,4,5,2,0,3,2
172580,3,7,1,0,6,1
172580,2,1,1,0,0,1
172580,1,4,2,0,2,2
37103,9,4,1,0,3,1
37103,8,3,1,0,2,1
37103,7,15,6,0,9,6
37103,6,17,6,0,11,6
37103,5,6,2,0,4,2
37103,3,1,1,0,0,1
11862,10,9,6,0,3,6
11862,9,1,1,0,0,1
11862,8,3,2,0,1,2
11862,6,2,1,0,1,1
11862,4,3,1,0,2,1
11862,3,3,1,0,2,1
11862,2,8,2,0,6,2
11862,1,16,3,0,13,3
2753,10,2,1,0,1,1
2753,8,6,4,0,2,4
2753,7,6,2,0,4,2
2753,6,14,5,0,9,5
2753,5,9,3,0,6,3
2753,4,8,3,0,5,3
2753,3,3,1,0,2,1
2753,1,1,1,0,0,1
5566,6,13,5,0,8,5
5566,5,9,4,0,5,4
5566,4,8,1,0,7,1
5566,3,9,1,0,8,1
5566,2,5,1,0,4,1
5566,1,2,2,0,0,2
249289,8,2,1,0,1,1
249289,7,14,4,0,10,4
249289,6,15,1,0,14,1
249289,5,4,1,0,3,1
249289,4,9,3,0,6,3
32410,6,21,3,0,18,3
32410,5,7,1,0,6,1
32410,3,3,1,0,2,1
40198,8,9,4,0,5,4
40198,7,10,2,0,8,2
40198,6,15,2,0,13,2
40198,4,3,1,0,2,1
110643,10,7,3,0,4,3
110643,9,12,3,0,9,3
110643,8,12,5,0,7,5
110643,7,13,2,0,11,2
110643,5,1,1,0,0,1
110643,4,1,1,0,0,1
260799,8,15,2,0,13,2
260799,7,22,4,0,18,4
260799,6,3,1,0,2,1
38464,9,1,1,0,0,1
38464,7,11,3,0,8,3
38464,6,12,2,0,10,2
38464,5,6,1,0,5,1
38464,4,5,3,0,2,3
38464,3,9,2,0,7,2
38464,2,2,1,0,1,1
18613,10,1,1,0,0,1
18613,9,3,1,0,2,1
18613,8,2,1,0,1,1
18613,7,12,6,0,6,6
18613,6,10,3,0,7,3
18613,5,11,2,0,9,2
18613,3,4,3,0,1,3
18613,1,2,1,0,1,1
66809,10,2,1,0,1,1
66809,9,6,3,0,3,3
66809,8,18,3,0,15,3
66809,7,11,6,0,5,6
66809,6,9,2,0,7,2
3016,8,2,2,0,0,2
3016,7,4,1,0,3,1
3016,6,20,2,0,18,2
3016,5,5,1,0,4,1
3016,4,10,6,0,4,6
3016,3,3,3,0,0,3
3016,1,2,2,0,0,2
7069,9,2,2,0,0,2
7069,8,3,2,0,1,2
7069,7,7,3,0,4,3
7069,6,15,6,0,9,6
7069,5,9,2,0,7,2
7069,4,5,2,0,3,2
7069,3,2,1,0,1,1
7069,2,6,3,0,3,3
172506,7,7,1,0,6,1
172506,6,20,2,0,18,2
172506,5,9,4,0,5,4
172506,4,6,2,0,4,2
172506,3,2,1,0,1,1
30022,10,4,2,0,2,2
30022,9,6,1,0,5,1
30022,8,5,3,0,2,3
30022,7,20,10,0,10,10
30022,6,8,2,0,6,2
30022,5,5,2,0,3,2
10880,10,2,1,0,1,1
10880,9,2,2,0,0,2
10880,8,4,2,0,2,2
10880,7,17,5,0,12,5
10880,6,16,3,0,13,3
10880,5,3,1,0,2,1
138091,9,2,1,1,1,0
138091,8,6,3,0,3,3
138091,7,5,1,1,4,0
138091,6,20,1,0,19,1
138091,5,9,3,1,6,2
138091,3,1,1,0,0,1
246700,10,15,5,0,10,5
246700,9,11,4,0,7,4
246700,8,20,6,0,14,6
246700,7,2,1,0,1,1
246700,2,1,1,0,0,1
94746,10,1,1,0,0,1
94746,9,6,4,0,2,4
94746,8,13,6,0,7,6
94746,7,11,3,0,8,3
94746,6,11,6,0,5,6
94746,5,4,1,0,3,1
94746,4,3,2,0,1,2
180050,10,9,1,0,8,1
180050,9,4,1,0,3,1
180050,7,7,1,0,6,1
180050,6,10,1,0,9,1
1640,9,1,1,0,0,1
1640,7,6,2,0,4,2
1640,6,14,4,0,10,4
1640,5,12,5,0,7,5
1640,4,9,3,0,6,3
1640,3,4,3,0,1,3
20224,8,1,1,0,0,1
20224,6,6,1,0,5,1
20224,5,18,2,0,16,2
20224,4,11,1,0,10,1
20224,3,3,1,0,2,1
20224,2,3,2,0,1,2
142277,9,4,2,0,2,2
142277,8,8,1,0,7,1
142277,6,19,2,0,17,2
26372,9,4,1,0,3,1
26372,8,19,6,0,13,6
26372,7,11,2,0,9,2
26372,6,8,3,0,5,3
26372,4,3,2,0,1,2
11452,10,3,1,0,2,1
11452,8,9,4,0,5,4
11452,7,19,5,0,14,5
11452,6,12,4,0,8,4
11452,5,4,1,0,3,1
3302,6,11,5,0,6,5
3302,4,12,2,0,10,2
3302,3,5,3,0,2,3
3302,2,3,1,0,2,1
209095,8,4,1,0,3,1
209095,6,22,3,0,19,3
209095,5,12,3,0,9,3
373,8,9,4,0,5,4
373,7,11,3,0,8,3
373,6,18,7,0,11,7
373,5,8,5,0,3,5
373,4,1,1,0,0,1
140702,8,6,1,0,5,1
140702,6,17,4,0,13,4
140702,4,5,1,0,4,1
261393,10,29,8,0,21,8
261393,9,12,3,0,9,3
261393,1,3,2,0,1,2
10811,8,1,1,0,0,1
10811,7,6,2,0,4,2
10811,6,20,5,0,15,5
10811,5,14,4,0,10,4
10811,4,5,1,0,4,1
10811,3,2,1,0,1,1
177502,9,1,1,0,0,1
177502,8,4,1,0,3,1
177502,6,13,1,0,12,1
177502,5,10,2,0,8,2
177502,4,10,1,0,9,1
177502,1,2,2,0,0,2
192203,10,6,3,0,3,3
192203,8,7,2,0,5,2
192203,7,9,2,0,7,2
192203,6,15,2,0,13,2
192203,5,7,1,0,6,1
36751,7,14,4,0,10,4
36751,6,17,3,0,14,3
36751,5,7,1,0,6,1
184688,8,7,1,0,6,1
184688,7,19,3,0,16,3
184688,6,12,1,0,11,1
14897,8,2,1,0,1,1
14897,7,10,3,0,7,3
14897,6,13,1,0,12,1
14897,5,10,6,0,4,6
14897,4,8,3,0,5,3
14897,3,3,1,0,2,1
5818,10,3,1,0,2,1
5818,9,9,6,0,3,6
5818,8,13,4,0,9,4
5818,7,9,8,0,1,8
5818,6,11,7,0,4,7
5818,5,3,2,0,1,2
11673,7,6,4,0,2,4
11673,6,17,10,0,7,10
11673,5,9,2,0,7,2
11673,4,5,1,0,4,1
11673,3,3,2,0,1,2
11673,2,2,1,0,1,1
11673,1,6,4,0,2,4
129315,8,4,1,0,3,1
129315,7,7,4,0,3,4
129315,6,24,8,0,16,8
129315,5,4,2,0,2,2
129315,4,4,2,0,2,2
129315,2,2,2,0,0,2
5836,8,5,2,0,3,2
5836,7,7,2,0,5,2
5836,6,18,4,0,14,4
5836,5,10,5,0,5,5
5836,4,5,2,0,3,2
5836,3,4,2,0,2,2
217261,8,19,2,0,17,2
217261,6,4,2,0,2,2
192858,10,9,6,0,3,6
192858,9,8,5,0,3,5
192858,8,19,5,0,14,5
192858,7,7,4,0,3,4
192858,6,3,2,0,1,2
192858,5,1,1,0,0,1
11126,10,3,1,0,2,1
11126,8,3,1,0,2,1
11126,7,10,5,0,5,5
11126,6,17,5,0,12,5
11126,5,8,1,0,7,1
11126,3,3,1,0,2,1
11126,2,2,1,0,1,1
256536,10,4,3,0,1,3
256536,9,3,2,0,1,2
256536,8,6,2,0,4,2
256536,7,3,2,0,1,2
256536,6,18,2,0,16,2
256536,5,12,2,0,10,2
256536,4,2,1,0,1,1
3130,9,3,1,0,2,1
3130,8,8,1,0,7,1
3130,7,13,3,0,10,3
3130,6,13,4,0,9,4
3130,5,7,1,0,6,1
3130,4,1,1,0,0,1
3130,1,2,1,0,1,1
7143,8,2,2,0,0,2
7143,7,12,3,0,9,3
7143,6,14,3,0,11,3
7143,5,9,2,0,7,2
7143,4,7,2,0,5,2
7143,3,1,1,0,0,1
7143,2,1,1,0,0,1
7143,1,1,1,0,0,1
176070,10,2,1,0,1,1
176070,9,10,3,0,7,3
176070,8,14,4,0,10,4
176070,7,12,3,0,9,3
176070,6,8,1,0,7,1
176070,3,3,3,0,0,3
18780,10,3,1,0,2,1
18780,9,1,1,0,0,1
18780,7,7,2,0,5,2
18780,6,16,3,0,13,3
18780,5,5,3,0,2,3
18780,3,4,1,0,3,1
18780,2,3,1,0,2,1
8366,10,1,1,0,0,1
8366,8,3,1,0,2,1
8366,7,9,7,0,2,7
8366,6,18,6,0,12,6
8366,5,10,1,0,9,1
8366,4,5,1,0,4,1
8366,3,2,1,0,1,1
250309,10,9,4,0,5,4
250309,8,22,7,1,15,6
250309,7,6,1,0,5,1
250309,6,5,1,0,4,1
250309,5,3,2,0,1,2
250309,1,1,1,0,0,1
136086,7,14,3,0,11,3
136086,5,3,1,0,2,1
154098,10,12,4,0,8,4
154098,9,10,6,0,4,6
154098,8,19,6,0,13,6
154098,7,3,2,0,1,2
154098,6,3,1,0,2,1
217298,10,2,1,0,1,1
217298,9,5,3,0,2,3
217298,8,7,2,0,5,2
217298,7,13,2,0,11,2
217298,6,12,2,0,10,2
217298,5,3,1,0,2,1
217298,4,4,1,0,3,1
217298,3,2,2,0,0,2
217298,2,1,1,0,0,1
11616,8,3,1,0,2,1
11616,7,5,1,0,4,1
11616,6,11,3,0,8,3
11616,5,11,4,0,7,4
11616,4,6,3,0,3,3
11616,3,9,2,0,7,2
11873,9,1,1,0,0,1
11873,8,8,1,0,7,1
11873,7,8,3,0,5,3
11873,6,12,4,0,8,4
11873,5,8,4,0,4,4
11873,4,5,1,0,4,1
11873,3,4,3,0,1,3
11873,1,2,1,0,1,1
4171,9,3,1,0,2,1
4171,7,8,2,0,6,2
4171,6,9,7,0,2,7
4171,5,14,3,0,11,3
4171,4,2,1,0,1,1
4171,3,4,3,0,1,3
170984,8,11,1,0,10,1
170984,7,15,3,0,12,3
170984,6,14,2,0,12,2
10544,6,21,2,0,19,2
10544,5,8,2,0,6,2
10544,4,8,2,0,6,2
10544,3,3,1,0,2,1
10544,1,2,1,0,1,1
12352,10,2,1,0,1,1
12352,9,4,2,0,2,2
12352,8,10,6,0,4,6
12352,7,9,5,0,4,5
12352,6,15,8,0,7,8
12352,5,5,3,0,2,3
12352,4,4,3,0,1,3
31067,9,5,3,0,2,3
31067,8,8,1,0,7,1
31067,7,15,2,0,13,2
31067,6,13,5,0,8,5
31067,3,1,1,0,0,1
31067,2,1,1,0,0,1
179227,8,5,2,1,3,1
179227,7,9,4,1,5,3
179227,6,17,2,0,15,2
179227,5,6,1,0,5,1
179227,4,4,1,0,3,1
179227,2,1,1,0,0,1
2236,10,6,3,0,3,3
2236,9,9,2,0,7,2
2236,8,17,5,0,12,5
2236,7,7,2,0,5,2
2236,6,4,1,0,3,1
2236,5,5,2,0,3,2
2236,1,1,1,0,0,1
135213,7,18,3,0,15,3
135213,6,16,3,0,13,3
109635,9,9,3,0,6,3
109635,8,18,6,0,12,6
109635,7,13,4,0,9,4
109635,6,4,2,0,2,2
109635,4,1,1,0,0,1
98780,8,10,4,0,6,4
98780,7,19,7,0,12,7
98780,6,8,1,0,7,1
98780,5,6,4,0,2,4
98780,4,1,1,0,0,1
98780,3,2,1,0,1,1
23285,8,8,5,0,3,5
23285,7,13,6,0,7,6
23285,6,12,5,0,7,5
23285,5,9,5,0,4,5
23285,4,4,3,0,1,3
23285,3,1,1,0,0,1
27949,9,1,1,0,0,1
27949,8,6,2,0,4,2
27949,7,9,4,0,5,4
27949,6,16,6,0,10,6
27949,5,8,3,0,5,3
27949,4,6,1,0,5,1
27949,3,1,1,0,0,1
37444,9,5,3,0,2,3
37444,8,18,10,0,8,10
37444,7,8,1,0,7,1
37444,6,13,4,0,9,4
37444,3,1,1,0,0,1
16088,9,1,1,0,0,1
16088,8,2,1,0,1,1
16088,7,8,2,0,6,2
16088,6,13,8,0,5,8
16088,5,10,3,0,7,3
16088,4,7,3,0,4,3
16088,3,4,3,0,1,3
16088,2,1,1,0,0,1
16088,1,2,2,0,0,2
133687,9,1,1,0,0,1
133687,6,11,2,0,9,2
133687,5,9,2,0,7,2
133687,4,9,1,0,8,1
133687,3,7,1,0,6,1
195161,10,1,1,0,0,1
195161,8,3,3,1,0,2
195161,7,5,1,1,4,0
195161,6,10,2,0,8,2
195161,5,10,1,0,9,1
195161,4,10,2,0,8,2
22469,7,8,3,0,5,3
22469,6,20,10,0,10,10
22469,5,8,2,0,6,2
22469,4,8,1,0,7,1
22469,2,2,1,0,1,1
137332,10,1,1,0,0,1
137332,8,4,1,0,3,1
137332,7,11,1,0,10,1
137332,6,21,5,0,16,5
137332,5,6,1,0,5,1
20514,10,4,1,0,3,1
20514,9,3,2,0,1,2
20514,8,7,3,0,4,3
20514,7,9,5,0,4,5
20514,6,15,4,0,11,4
20514,5,6,3,0,3,3
20514,3,3,1,0,2,1
13165,10,2,2,0,0,2
13165,7,4,2,0,2,2
13165,6,9,6,0,3,6
13165,5,8,4,0,4,4
13165,4,10,5,0,5,5
13165,2,6,2,0,4,2
13165,1,1,1,0,0,1
227468,8,9,1,1,8,0
227468,6,16,6,1,10,5
227468,5,4,2,1,2,1
227468,4,4,2,0,2,2
227468,2,2,1,0,1,1
191714,10,1,1,0,0,1
191714,8,4,2,0,2,2
191714,7,6,2,1,4,1
191714,6,17,3,2,14,1
191714,5,8,3,0,5,3
191714,4,4,1,1,3,0
10246,10,3,3,0,0,3
10246,9,9,5,0,4,5
10246,8,14,6,0,8,6
10246,7,11,6,0,5,6
10246,6,8,4,0,4,4
10246,5,1,1,0,0,1
7808,10,3,3,0,0,3
7808,9,1,1,0,0,1
7808,8,2,2,0,0,2
7808,7,6,1,0,5,1
7808,6,21,7,0,14,7
7808,5,8,4,0,4,4
6233,8,4,1,0,3,1
6233,7,9,2,0,7,2
6233,6,11,3,0,8,3
6233,5,12,2,0,10,2
6233,4,7,1,0,6,1
6233,3,3,1,0,2,1
23308,8,1,1,0,0,1
23308,7,7,3,0,4,3
23308,6,12,5,0,7,5
23308,5,11,4,0,7,4
23308,4,8,4,0,4,4
23308,3,4,1,0,3,1
23308,2,5,1,0,4,1
11030,10,8,5,0,3,5
11030,9,4,1,0,3,1
11030,8,10,5,0,5,5
11030,7,8,4,0,4,4
11030,6,6,3,0,3,3
11030,5,7,2,0,5,2
11030,3,2,2,0,0,2
206753,10,10,5,0,5,5
206753,7,9,3,0,6,3
206753,6,9,1,0,8,1
206753,5,9,2,0,7,2
206753,2,2,1,0,1,1
126234,10,2,1,0,1,1
126234,9,3,2,1,1,1
126234,7,7,2,1,5,1
126234,6,10,1,0,9,1
126234,5,4,1,0,3,1
126234,4,5,1,0,4,1
126234,3,6,1,0,5,1
126234,2,5,2,0,3,2
126234,1,3,3,0,0,3
32031,10,7,1,0,6,1
32031,9,4,1,0,3,1
32031,8,11,3,0,8,3
32031,7,11,6,0,5,6
32031,6,9,5,0,4,5
32031,5,5,2,0,3,2
32031,3,1,1,0,0,1
16367,8,1,1,0,0,1
16367,7,4,3,0,1,3
16367,6,17,2,0,15,2
16367,5,13,2,0,11,2
16367,4,9,2,0,7,2
16367,3,4,1,0,3,1
144378,10,1,1,0,0,1
144378,9,7,2,0,5,2
144378,8,8,2,0,6,2
144378,7,8,2,0,6,2
144378,5,7,3,0,4,3
144378,4,4,1,0,3,1
144378,1,1,1,0,0,1
238182,10,8,4,2,4,2
238182,9,8,4,0,4,4
238182,8,18,3,0,15,3
238182,7,9,2,0,7,2
238182,4,1,1,0,0,1
3109,9,7,3,0,4,3
3109,8,13,5,0,8,5
3109,7,8,2,0,6,2
3109,6,12,5,0,7,5
3109,5,4,1,0,3,1
3109,4,1,1,0,0,1
5276,10,4,1,0,3,1
5276,8,8,4,0,4,4
5276,7,9,4,0,5,4
5276,6,18,10,0,8,10
5276,5,5,2,0,3,2
5276,3,2,1,0,1,1
22931,7,4,2,0,2,2
22931,6,8,2,0,6,2
22931,5,12,1,0,11,1
22931,4,9,1,0,8,1
22931,3,7,3,0,4,3
22931,2,3,1,0,2,1
196328,9,2,1,0,1,1
196328,8,11,5,0,6,5
196328,7,15,8,0,7,8
196328,6,11,5,0,6,5
196328,5,3,1,0,2,1
196328,4,4,3,0,1,3
57276,7,9,1,0,8,1
57276,6,16,2,0,14,2
57276,5,8,1,0,7,1
39320,6,10,3,0,7,3
39320,5,8,2,0,6,2
39320,4,12,4,0,8,4
39320,3,6,1,0,5,1
39320,2,7,4,0,3,4
220730,8,22,6,1,16,5
220730,7,12,5,1,7,4
220730,6,3,2,0,1,2
220730,5,4,2,0,2,2
220730,4,3,1,0,2,1
198886,10,14,7,1,7,6
198886,9,4,4,1,0,3
198886,8,13,2,0,11,2
198886,7,10,3,1,7,2
198886,6,6,3,0,3,3
195508,10,16,4,0,12,4
195508,8,11,5,0,6,5
195508,7,8,4,0,4,4
195508,5,2,1,0,1,1
195508,4,1,1,0,0,1
195508,1,3,1,0,2,1
5435,8,4,2,0,2,2
5435,7,7,1,0,6,1
5435,6,18,3,0,15,3
5435,5,8,1,0,7,1
5435,4,8,4,0,4,4
5435,2,2,1,0,1,1
229496,10,6,3,0,3,3
229496,9,8,4,0,4,4
229496,8,14,3,0,11,3
229496,6,9,3,0,6,3
229496,5,3,1,0,2,1
229496,3,1,1,0,0,1
2299,9,3,2,0,1,2
2299,8,10,4,0,6,4
2299,7,11,5,0,6,5
2299,6,14,2,0,12,2
2299,3,2,2,0,0,2
6949,10,2,2,0,0,2
6949,7,3,3,0,0,3
6949,6,12,5,0,7,5
6949,5,8,3,0,5,3
6949,4,17,7,0,10,7
6949,3,3,1,0,2,1
6949,2,1,1,0,0,1
33198,5,7,1,0,6,1
33198,3,10,1,0,9,1
200396,9,3,2,0,1,2
200396,7,12,5,0,7,5
200396,6,20,5,0,15,5
200396,5,4,1,0,3,1
200396,2,1,1,0,0,1
93463,7,10,3,0,7,3
93463,6,15,5,0,10,5
93463,5,10,4,0,6,4
93463,3,1,1,0,0,1
93463,1,1,1,0,0,1
61996,9,5,1,0,4,1
61996,8,5,2,0,3,2
61996,7,8,2,0,6,2
61996,6,12,2,0,10,2
61996,5,8,1,0,7,1
61996,4,6,2,0,4,2
61996,2,3,1,0,2,1
28596,10,3,1,0,2,1
28596,9,2,1,0,1,1
28596,8,16,10,0,6,10
28596,7,4,3,0,1,3
28596,6,9,4,0,5,4
28596,5,3,2,0,1,2
28596,4,7,5,0,2,5
28596,3,3,3,0,0,3
5389,9,4,1,0,3,1
5389,8,14,4,0,10,4
5389,7,15,1,0,14,1
5389,6,9,1,0,8,1
5389,4,1,1,0,0,1
9507,9,1,1,0,0,1
9507,8,4,3,0,1,3
9507,6,9,2,0,7,2
9507,5,7,1,0,6,1
9507,4,10,3,0,7,3
9507,3,5,2,0,3,2
9507,2,4,1,0,3,1
222798,9,3,1,0,2,1
222798,8,12,8,0,4,8
222798,7,18,5,0,13,5
222798,6,11,6,0,5,6
222798,5,2,1,0,1,1
222798,4,3,2,0,1,2
43233,8,4,1,0,3,1
43233,7,6,1,0,5,1
43233,6,17,7,0,10,7
43233,5,7,3,0,4,3
43233,4,5,1,0,4,1
183677,10,4,1,0,3,1
183677,9,4,1,0,3,1
183677,8,5,2,0,3,2
183677,7,14,1,0,13,1
183677,6,13,1,0,12,1
183677,4,4,1,0,3,1
183677,3,1,1,0,0,1
12624,7,9,1,0,8,1
12624,6,12,4,0,8,4
12624,5,10,3,0,7,3
12624,4,6,1,0,5,1
12624,3,4,2,0,2,2
12624,1,1,1,0,0,1
9356,9,11,5,0,6,5
9356,8,18,9,0,9,9
9356,7,6,2,0,4,2
9356,6,5,3,0,2,3
9356,5,2,2,0,0,2
9356,3,1,1,0,0,1
40617,7,8,5,0,3,5
40617,6,13,2,0,11,2
40617,4,9,3,0,6,3
40617,2,1,1,0,0,1
242616,8,6,2,0,4,2
242616,7,16,2,0,14,2
242616,6,16,2,0,14,2
242616,5,6,1,0,5,1
137014,8,2,1,0,1,1
137014,5,12,1,0,11,1
137014,4,6,1,0,5,1
137014,3,5,1,0,4,1
137014,1,2,1,0,1,1
158341,8,7,1,0,6,1
158341,7,13,1,0,12,1
158341,6,13,1,0,12,1
158341,3,3,1,0,2,1
18618,6,9,2,0,7,2
18618,5,16,3,0,13,3
18618,4,7,3,0,4,3
18618,1,3,1,0,2,1
56843,8,2,2,0,0,2
56843,7,12,4,0,8,4
56843,6,18,6,0,12,6
56843,5,7,2,0,5,2
56843,4,4,1,0,3,1
56843,3,4,1,0,3,1
56843,2,1,1,0,0,1
8834,9,4,2,0,2,2
8834,8,9,3,0,6,3
8834,7,23,12,0,11,12
8834,5,3,1,0,2,1
8834,3,1,1,0,0,1
63823,9,3,1,0,2,1
63823,8,18,6,0,12,6
63823,6,5,2,0,3,2
63823,5,4,1,0,3,1
63823,4,1,1,0,0,1
63823,3,2,2,0,0,2
17529,10,2,2,0,0,2
17529,9,2,1,0,1,1
17529,8,10,5,0,5,5
17529,7,12,7,0,5,7
17529,6,10,6,0,4,6
17529,5,10,5,0,5,5
17529,4,1,1,0,0,1
18908,9,1,1,0,0,1
18908,8,4,3,0,1,3
18908,6,16,4,0,12,4
18908,5,6,4,0,2,4
18908,4,7,4,0,3,4
18908,3,3,3,0,0,3
18908,2,1,1,0,0,1
137958,10,13,5,1,8,4
137958,8,13,1,0,12,1
137958,5,2,1,0,1,1
137958,2,1,1,0,0,1
137958,1,1,1,1,0,0
35425,9,5,2,0,3,2
35425,8,23,5,0,18,5
35425,7,7,1,0,6,1
35425,6,8,1,0,7,1
35425,5,3,1,0,2,1
7228,9,4,2,0,2,2
7228,8,8,4,0,4,4
7228,7,21,7,0,14,7
7228,6,10,2,0,8,2
7228,5,2,1,0,1,1
7228,4,3,1,0,2,1
88113,10,1,1,0,0,1
88113,9,4,1,0,3,1
88113,8,13,4,0,9,4
88113,6,12,1,0,11,1
88113,5,2,1,0,1,1
88113,4,3,1,0,2,1
88113,3,1,1,0,0,1
7657,10,4,2,0,2,2
7657,8,7,6,0,1,6
7657,7,10,2,0,8,2
7657,6,22,12,0,10,12
7657,5,2,1,0,1,1
7657,4,3,1,0,2,1
3425,10,3,2,0,1,2
3425,6,21,8,0,13,8
3425,5,6,2,0,4,2
3425,4,8,3,0,5,3
3425,3,3,1,0,2,1
127505,9,5,3,0,2,3
127505,7,4,1,0,3,1
127505,6,13,3,0,10,3
127505,5,12,1,0,11,1
127505,4,2,1,0,1,1
127505,3,4,1,0,3,1
42591,8,16,2,0,14,2
42591,7,14,6,0,8,6
42591,6,9,3,0,6,3
42591,5,4,1,0,3,1
42591,4,3,2,0,1,2
182982,10,5,2,0,3,2
182982,9,15,7,0,8,7
182982,8,18,6,0,12,6
182982,7,6,2,0,4,2
182982,6,3,1,0,2,1
182982,5,2,1,0,1,1
4885,10,2,1,0,1,1
4885,7,4,3,0,1,3
4885,6,14,8,0,6,8
4885,5,11,6,0,5,6
4885,4,12,2,0,10,2
4885,3,3,1,0,2,1
244327,9,1,1,0,0,1
244327,8,4,2,0,2,2
244327,7,15,2,0,13,2
244327,6,12,2,0,10,2
244327,5,8,4,0,4,4
244327,4,5,1,0,4,1
244327,2,1,1,0,0,1
125400,8,9,1,0,8,1
125400,7,21,4,0,17,4
125400,6,14,6,0,8,6
125400,5,2,2,0,0,2
159573,10,1,1,0,0,1
159573,8,2,1,0,1,1
159573,7,15,5,0,10,5
159573,6,16,3,0,13,3
159573,4,4,1,0,3,1
28050,9,1,1,0,0,1
28050,7,16,3,0,13,3
28050,6,22,6,0,16,6
28050,5,5,1,0,4,1
28050,4,3,2,0,1,2
179560,6,17,2,0,15,2
179560,3,4,1,0,3,1
9646,9,1,1,0,0,1
9646,7,7,4,0,3,4
9646,6,13,6,0,7,6
9646,5,13,4,0,9,4
9646,4,7,1,0,6,1
9646,3,5,1,0,4,1
9022,7,5,1,0,4,1
9022,6,16,5,0,11,5
9022,5,19,3,0,16,3
9022,4,5,2,0,3,2
9022,3,1,1,0,0,1
247578,9,3,1,0,2,1
247578,8,24,2,0,22,2
247578,6,6,1,0,5,1
9143,10,5,3,0,2,3
9143,9,5,1,0,4,1
9143,8,13,2,0,11,2
9143,7,12,3,0,9,3
9143,6,6,2,0,4,2
9143,5,2,1,0,1,1
9143,4,3,1,0,2,1
9143,3,1,1,0,0,1
9143,2,1,1,0,0,1
90004,8,5,1,0,4,1
90004,6,22,2,0,20,2
90004,4,2,1,0,1,1
9153,8,1,1,0,0,1
9153,6,7,2,0,5,2
9153,5,13,1,0,12,1
9153,4,14,7,0,7,7
9153,3,5,2,0,3,2
9153,1,2,1,0,1,1
19915,8,1,1,0,0,1
19915,7,3,1,0,2,1
19915,6,13,4,0,9,4
19915,5,4,2,0,2,2
19915,4,8,4,0,4,4
19915,3,12,4,0,8,4
19915,2,7,2,0,5,2
4654,10,1,1,0,0,1
4654,8,4,2,0,2,2
4654,7,8,2,0,6,2
4654,6,13,2,0,11,2
4654,5,6,3,0,3,3
4654,4,12,4,0,8,4
4654,3,2,1,0,1,1
4654,1,1,1,0,0,1
19272,5,11,2,0,9,2
19272,4,19,10,0,9,10
19272,3,9,2,0,7,2
19272,2,1,1,0,0,1
143238,8,13,3,1,10,2
143238,7,15,4,1,11,3
143238,6,12,1,0,11,1
143238,5,5,1,0,4,1
143238,4,1,1,0,0,1
24706,8,3,2,0,1,2
24706,7,5,1,0,4,1
24706,6,12,2,0,10,2
24706,5,11,4,0,7,4
24706,4,7,1,0,6,1
24706,3,7,2,0,5,2
24706,2,1,1,0,0,1
174404,6,18,1,0,17,1
174404,5,7,1,0,6,1
174404,4,9,1,0,8,1
174404,1,1,1,0,0,1
19253,9,4,4,0,0,4
19253,8,7,2,0,5,2
19253,7,9,5,0,4,5
19253,6,14,6,0,8,6
19253,5,9,6,0,3,6
19253,4,2,1,0,1,1
166443,8,9,3,0,6,3
166443,7,6,1,0,5,1
166443,6,16,1,0,15,1
166443,5,7,2,0,5,2
166443,4,3,1,0,2,1
166443,3,2,1,0,1,1
166443,2,1,1,0,0,1
37379,9,1,1,0,0,1
37379,8,5,4,0,1,4
37379,7,10,3,0,7,3
37379,6,15,4,0,11,4
37379,5,7,3,0,4,3
37379,3,2,2,0,0,2
195489,8,4,1,1,3,0
195489,7,17,3,0,14,3
195489,6,13,2,0,11,2
195489,5,10,4,0,6,4
195489,4,2,1,0,1,1
195489,3,2,1,0,1,1
254145,7,5,1,0,4,1
254145,6,14,1,0,13,1
254145,4,6,2,0,4,2
156015,8,5,1,0,4,1
156015,7,10,1,1,9,0
156015,6,12,1,0,11,1
156015,4,6,1,1,5,0
186510,9,4,1,0,3,1
186510,8,12,5,0,7,5
186510,7,6,3,0,3,3
186510,6,12,2,0,10,2
186510,5,3,1,0,2,1
88996,9,3,2,0,1,2
88996,8,4,2,0,2,2
88996,7,7,2,0,5,2
88996,6,20,7,0,13,7
88996,5,3,1,0,2,1
88996,4,6,2,0,4,2
88996,2,2,1,0,1,1
17538,9,9,3,0,6,3
17538,8,10,5,0,5,5
17538,7,17,5,0,12,5
17538,6,3,1,0,2,1
17538,5,2,2,0,0,2
238700,9,6,3,0,3,3
238700,7,15,1,0,14,1
238700,3,1,1,0,0,1
3018,7,1,1,0,0,1
3018,6,7,2,0,5,2
3018,5,10,4,0,6,4
3018,4,11,3,0,8,3
3018,3,8,3,0,5,3
3018,2,6,2,0,4,2
3018,1,3,1,0,2,1
11476,8,3,1,0,2,1
11476,7,6,1,0,5,1
11476,6,20,9,0,11,9
11476,5,11,4,0,7,4
11476,4,3,1,0,2,1
11476,3,1,1,0,0,1
11476,2,2,2,0,0,2
24189,7,7,2,0,5,2
24189,6,20,4,0,16,4
24189,5,10,4,0,6,4
24189,4,8,1,0,7,1
64769,9,3,1,0,2,1
64769,8,9,3,0,6,3
64769,7,19,5,0,14,5
64769,6,7,4,0,3,4
64769,5,4,2,0,2,2
64769,3,2,1,0,1,1
54501,9,6,2,0,4,2
54501,7,12,1,0,11,1
54501,6,10,1,0,9,1
54501,5,5,1,0,4,1
22042,6,8,3,0,5,3
22042,5,11,2,0,9,2
22042,4,16,5,0,11,5
22042,3,6,2,0,4,2
22042,2,3,1,0,2,1
22042,1,3,2,0,1,2
13771,8,9,6,0,3,6
13771,7,15,4,0,11,4
13771,6,10,4,0,6,4
13771,5,7,3,0,4,3
13771,3,1,1,0,0,1
150659,7,10,1,0,9,1
150659,6,13,3,0,10,3
150659,5,8,2,0,6,2
150659,4,4,1,0,3,1
150659,3,4,3,0,1,3
15275,9,3,1,0,2,1
15275,8,8,5,0,3,5
15275,7,18,3,0,15,3
15275,6,9,2,0,7,2
15275,5,6,1,0,5,1
15275,4,2,2,0,0,2
10836,9,2,1,0,1,1
10836,8,4,3,0,1,3
10836,7,15,3,0,12,3
10836,6,10,1,0,9,1
10836,5,10,4,0,6,4
10836,4,4,1,0,3,1
10836,3,1,1,0,0,1
36737,8,6,4,0,2,4
36737,7,14,3,0,11,3
36737,6,22,10,0,12,10
36737,5,6,3,0,3,3
271869,9,10,2,0,8,2
271869,8,17,6,0,11,6
271869,7,13,3,0,10,3
271869,6,8,1,0,7,1
271869,5,1,1,0,0,1
5204,7,4,2,0,2,2
5204,6,12,4,0,8,4
5204,5,14,4,0,10,4
5204,4,8,3,0,5,3
5204,3,7,1,0,6,1
5204,2,2,1,0,1,1
1500,7,8,4,0,4,4
1500,6,15,2,0,13,2
1500,5,9,3,0,6,3
1500,4,6,2,0,4,2
1500,3,3,1,0,2,1
1500,2,2,2,0,0,2
148050,10,1,1,0,0,1
148050,9,5,3,0,2,3
148050,8,15,5,0,10,5
148050,7,12,3,0,9,3
148050,6,13,5,0,8,5
148050,5,1,1,0,0,1
148050,4,1,1,0,0,1
168662,10,2,1,0,1,1
168662,9,4,3,0,1,3
168662,8,23,11,0,12,11
168662,7,13,4,0,9,4
168662,6,5,3,0,2,3
8363,9,3,2,0,1,2
8363,8,6,2,0,4,2
8363,7,12,7,0,5,7
8363,6,14,6,0,8,6
8363,5,7,3,0,4,3
8363,4,3,1,0,2,1
8363,2,1,1,0,0,1
4022,10,2,1,0,1,1
4022,9,1,1,0,0,1
4022,8,5,3,0,2,3
4022,7,6,2,0,4,2
4022,6,15,1,0,14,1
4022,5,6,1,0,5,1
4022,4,7,4,0,3,4
4022,2,2,1,0,1,1
4022,1,1,1,0,0,1
139374,8,4,1,0,3,1
139374,6,17,3,0,14,3
139374,5,6,1,0,5,1
26540,8,2,1,0,1,1
26540,7,8,4,0,4,4
26540,6,14,5,0,9,5
26540,5,8,2,0,6,2
26540,4,5,1,0,4,1
26540,2,3,1,0,2,1
26540,1,5,5,0,0,5
175730,10,5,5,3,0,2
175730,8,2,1,0,1,1
175730,7,5,2,0,3,2
175730,6,10,2,0,8,2
175730,5,9,2,0,7,2
175730,4,4,2,1,2,1
175730,3,5,2,1,3,1
175730,2,4,1,1,3,0
175730,1,4,3,1,1,2
134419,8,16,3,0,13,3
134419,7,7,1,0,6,1
134419,6,12,3,0,9,3
134419,4,1,1,0,0,1
134419,3,1,1,0,0,1
134419,2,3,1,0,2,1
154645,8,14,3,0,11,3
154645,7,17,1,0,16,1
154645,6,8,4,0,4,4
154645,5,5,2,0,3,2
154645,1,1,1,0,0,1
30020,10,3,2,0,1,2
30020,8,4,1,0,3,1
30020,7,15,4,0,11,4
30020,6,13,6,0,7,6
30020,5,6,5,0,1,5
30020,4,2,2,0,0,2
30020,2,1,1,0,0,1
171124,9,7,3,0,4,3
171124,8,18,4,0,14,4
171124,7,11,1,0,10,1
171124,6,8,1,0,7,1
171124,4,1,1,0,0,1
2232,9,5,2,0,3,2
2232,8,8,4,0,4,4
2232,7,14,2,0,12,2
2232,6,13,5,0,8,5
2232,5,7,2,0,5,2
143663,10,4,3,0,1,3
143663,9,5,1,0,4,1
143663,8,14,7,1,7,6
143663,7,8,3,0,5,3
143663,6,10,1,0,9,1
143663,5,6,2,1,4,1
203266,8,4,1,0,3,1
203266,6,21,1,0,20,1
203266,5,6,2,0,4,2
41305,10,1,1,0,0,1
41305,8,8,2,0,6,2
41305,7,11,4,0,7,4
41305,6,15,7,0,8,7
41305,5,5,2,0,3,2
41305,3,3,1,0,2,1
262899,9,5,1,0,4,1
262899,8,11,2,0,9,2
262899,7,9,1,0,8,1
262899,6,14,2,0,12,2
1226,8,1,1,0,0,1
1226,7,9,3,0,6,3
1226,6,15,5,0,10,5
1226,5,8,1,0,7,1
1226,4,9,3,0,6,3
1226,3,4,1,0,3,1
10890,10,4,2,0,2,2
10890,9,4,2,0,2,2
10890,8,7,1,0,6,1
10890,6,9,3,0,6,3
10890,4,3,1,0,2,1
33125,10,5,3,0,2,3
33125,8,8,3,0,5,3
33125,6,7,1,0,6,1
33125,4,7,1,0,6,1
33125,3,4,3,0,1,3
33125,2,4,2,0,2,2
33125,1,3,2,0,1,2
25866,9,2,1,0,1,1
25866,8,6,1,0,5,1
25866,7,14,2,0,12,2
25866,6,18,2,0,16,2
25866,5,5,2,0,3,2
4579,7,13,1,0,12,1
4579,6,13,1,0,12,1
4579,5,6,1,0,5,1
4579,4,7,2,0,5,2
4579,3,3,1,0,2,1
33421,10,5,1,0,4,1
33421,7,2,1,0,1,1
33421,6,14,2,0,12,2
33421,4,7,2,0,5,2
33421,3,3,1,0,2,1
33421,2,4,2,0,2,2
194231,6,11,2,0,9,2
194231,5,8,3,0,5,3
194231,4,3,1,0,2,1
11258,7,7,4,0,3,4
11258,6,19,7,0,12,7
11258,5,7,3,0,4,3
11258,4,9,6,0,3,6
11258,3,2,2,0,0,2
10084,10,1,1,0,0,1
10084,9,3,1,0,2,1
10084,8,4,3,0,1,3
10084,7,9,5,0,4,5
10084,6,18,6,0,12,6
10084,5,8,5,0,3,5
10084,4,4,1,0,3,1
22123,8,7,2,0,5,2
22123,7,8,2,0,6,2
22123,6,13,3,0,10,3
22123,5,10,1,0,9,1
22123,3,5,1,0,4,1
231620,8,5,1,0,4,1
231620,6,13,2,0,11,2
231620,5,11,2,0,9,2
66969,8,11,2,0,9,2
66969,7,8,2,0,6,2
66969,6,15,2,0,13,2
66969,5,7,1,0,6,1
1368,10,1,1,0,0,1
1368,8,1,1,0,0,1
1368,7,7,1,0,6,1
1368,6,16,5,0,11,5
1368,5,10,4,0,6,4
1368,4,6,2,0,4,2
1368,2,3,1,0,2,1
11200,9,1,1,0,0,1
11200,7,4,1,0,3,1
11200,6,8,2,0,6,2
11200,5,12,5,0,7,5
11200,4,8,3,0,5,3
11200,3,2,1,0,1,1
11200,1,9,4,0,5,4
152245,9,3,1,0,2,1
152245,8,5,2,0,3,2
152245,7,5,1,0,4,1
152245,6,12,4,0,8,4
152245,5,12,2,0,10,2
152245,4,4,1,0,3,1
152245,3,3,2,0,1,2
246,8,2,2,0,0,2
246,7,3,1,0,2,1
246,6,12,2,0,10,2
246,5,5,2,0,3,2
246,4,12,1,0,11,1
246,3,5,1,0,4,1
246,2,6,1,0,5,1
9082,8,4,2,0,2,2
9082,7,4,2,0,2,2
9082,6,7,3,0,4,3
9082,5,7,2,0,5,2
9082,4,7,3,0,4,3
9082,3,6,2,0,4,2
9082,2,5,4,0,1,4
9082,1,5,4,0,1,4
29694,8,3,2,0,1,2
29694,7,6,2,0,4,2
29694,6,19,3,0,16,3
29694,5,6,3,0,3,3
29694,4,6,2,0,4,2
29694,3,4,1,0,3,1
29694,2,2,1,0,1,1
210097,10,1,1,0,0,1
210097,9,2,2,0,0,2
210097,8,13,4,0,9,4
210097,7,14,3,0,11,3
210097,6,9,3,0,6,3
210097,5,5,2,0,3,2
210097,4,2,1,0,1,1
210097,3,1,1,0,0,1
173269,8,23,2,0,21,2
173269,7,15,3,0,12,3
98978,9,2,2,0,0,2
98978,7,11,2,0,9,2
98978,6,14,2,0,12,2
98978,5,6,2,0,4,2
98978,4,7,2,0,5,2
98978,2,1,1,0,0,1
125013,7,4,1,0,3,1
125013,6,19,2,0,17,2
125013,5,11,1,0,10,1
125013,4,6,1,0,5,1
90274,10,4,4,0,0,4
90274,9,8,2,0,6,2
90274,8,14,6,1,8,5
90274,7,8,2,0,6,2
90274,6,8,3,0,5,3
90274,5,3,1,0,2,1
90274,4,2,1,0,1,1
158967,8,3,1,0,2,1
158967,7,16,5,0,11,5
158967,6,20,1,0,19,1
158967,5,5,2,0,3,2
158967,4,3,2,0,1,2
13553,10,3,1,0,2,1
13553,9,13,6,0,7,6
13553,8,9,4,0,5,4
13553,7,12,3,0,9,3
13553,6,7,1,0,6,1
13553,5,2,1,0,1,1
13553,2,1,1,0,0,1
184490,8,8,3,0,5,3
184490,7,15,3,0,12,3
184490,5,8,1,0,7,1
184490,3,2,1,0,1,1
35635,10,2,2,0,0,2
35635,9,3,1,0,2,1
35635,8,4,2,0,2,2
35635,7,12,8,0,4,8
35635,6,18,13,0,5,13
35635,5,6,3,0,3,3
35635,4,1,1,0,0,1
35635,3,1,1,0,0,1
110245,8,10,2,0,8,2
110245,7,15,4,0,11,4
110245,6,12,1,0,11,1
110245,4,2,1,0,1,1
103752,9,5,2,0,3,2
103752,8,13,6,0,7,6
103752,7,16,1,0,15,1
103752,6,4,1,0,3,1
103752,4,1,1,0,0,1
10889,10,3,2,0,1,2
10889,9,7,3,0,4,3
10889,8,11,5,0,6,5
10889,7,7,2,0,5,2
10889,6,10,5,0,5,5
10889,5,8,5,0,3,5
34395,5,14,3,0,11,3
34395,4,7,1,0,6,1
34395,3,8,5,0,3,5
34395,2,5,1,0,4,1
173514,10,37,10,0,27,10
173514,1,2,1,0,1,1
6759,10,1,1,0,0,1
6759,9,1,1,0,0,1
6759,8,3,1,0,2,1
6759,7,10,4,0,6,4
6759,6,13,2,0,11,2
6759,5,9,3,0,6,3
6759,4,8,4,0,4,4
6759,3,1,1,0,0,1
601,9,2,2,0,0,2
601,8,2,2,0,0,2
601,7,8,4,0,4,4
601,6,18,3,0,15,3
601,5,8,1,0,7,1
601,3,3,1,0,2,1
6842,8,6,3,0,3,3
6842,7,9,2,0,7,2
6842,6,13,5,0,8,5
6842,5,9,2,0,7,2
6842,4,3,2,0,1,2
6842,3,4,2,0,2,2
247526,9,7,2,0,5,2
247526,8,9,3,0,6,3
247526,7,9,1,0,8,1
247526,6,12,3,0,9,3
247526,5,5,1,0,4,1
247526,4,2,1,0,1,1
31360,8,5,3,0,2,3
31360,7,6,2,0,4,2
31360,6,13,2,0,11,2
31360,5,8,1,0,7,1
31360,4,3,1,0,2,1
31360,3,6,1,0,5,1
31360,2,3,2,0,1,2
5798,9,1,1,0,0,1
5798,7,7,1,0,6,1
5798,6,14,5,0,9,5
5798,5,9,4,0,5,4
5798,4,11,5,0,6,5
5798,3,3,1,0,2,1
54707,9,3,1,0,2,1
54707,8,8,2,0,6,2
54707,7,7,1,0,6,1
54707,5,6,3,0,3,3
54707,4,4,1,0,3,1
10341,10,1,1,0,0,1
10341,8,6,2,0,4,2
10341,7,4,4,0,0,4
10341,6,14,4,0,10,4
10341,5,10,1,0,9,1
10341,4,9,2,0,7,2
10341,3,2,2,0,0,2
10341,1,1,1,0,0,1
9249,6,16,4,0,12,4
9249,5,10,3,0,7,3
9249,3,5,1,0,4,1
13979,8,7,2,0,5,2
13979,7,16,7,0,9,7
13979,6,12,1,0,11,1
13979,5,6,2,0,4,2
13979,2,1,1,0,0,1
34692,8,3,1,0,2,1
34692,7,14,7,0,7,7
34692,6,21,6,0,15,6
34692,5,7,2,0,5,2
262621,10,1,1,0,0,1
262621,9,3,1,0,2,1
262621,8,15,7,0,8,7
262621,7,19,4,0,15,4
262621,5,3,1,0,2,1
262621,4,1,1,0,0,1
135577,10,3,1,0,2,1
135577,9,7,3,0,4,3
135577,8,15,6,0,9,6
135577,7,11,3,0,8,3
135577,6,10,3,0,7,3
135577,5,1,1,0,0,1
61475,10,1,1,0,0,1
61475,9,1,1,0,0,1
61475,8,3,1,0,2,1
61475,7,7,2,0,5,2
61475,6,11,3,0,8,3
61475,4,7,2,0,5,2
61475,3,3,1,0,2,1
165414,6,14,3,0,11,3
165414,4,6,2,0,4,2
165414,3,4,2,0,2,2
165414,1,2,1,0,1,1
123417,7,4,1,0,3,1
123417,6,3,1,0,2,1
123417,4,15,5,0,10,5
123417,3,7,2,0,5,2
123417,1,3,2,0,1,2
52276,8,2,1,0,1,1
52276,7,6,3,0,3,3
52276,6,22,5,0,17,5
52276,5,7,3,0,4,3
52276,2,2,1,0,1,1
175864,9,1,1,0,0,1
175864,8,9,6,0,3,6
175864,7,12,2,0,10,2
175864,6,18,5,0,13,5
175864,5,2,1,0,1,1
175864,4,3,1,0,2,1
236905,10,2,1,0,1,1
236905,9,3,1,0,2,1
236905,8,7,3,0,4,3
236905,7,11,4,0,7,4
236905,6,16,4,1,12,3
236905,5,3,1,0,2,1
236905,4,4,1,0,3,1
39515,9,1,1,0,0,1
39515,7,18,9,0,9,9
39515,6,12,4,0,8,4
39515,4,1,1,0,0,1
4693,6,9,1,0,8,1
4693,4,10,3,0,7,3
4693,3,9,3,0,6,3
4693,2,10,4,0,6,4
217609,10,3,2,0,1,2
217609,9,7,3,0,4,3
217609,8,22,5,0,17,5
217609,7,9,4,0,5,4
217609,6,4,1,0,3,1
217609,4,2,1,0,1,1
27751,9,3,3,0,0,3
27751,8,10,4,0,6,4
27751,7,8,5,0,3,5
27751,6,9,3,0,6,3
27751,5,12,6,0,6,6
27751,3,1,1,0,0,1
35262,6,14,2,0,12,2
35262,5,11,1,0,10,1
35262,3,5,2,0,3,2
129031,10,4,2,1,2,1
129031,7,11,2,1,9,1
129031,6,10,3,2,7,1
129031,1,3,2,0,1,2
226997,9,5,1,0,4,1
226997,8,15,4,0,11,4
226997,7,11,3,0,8,3
226997,6,8,3,0,5,3
226997,5,2,1,0,1,1
226997,4,2,2,0,0,2
226997,3,1,1,0,0,1
177566,9,6,1,0,5,1
177566,8,13,3,1,10,2
177566,7,16,2,0,14,2
177566,6,9,3,0,6,3
8249,7,7,3,0,4,3
8249,6,13,3,0,10,3
8249,5,14,4,0,10,4
8249,4,8,1,0,7,1
8249,3,1,1,0,0,1
8249,1,2,1,0,1,1
4456,7,4,1,0,3,1
4456,6,5,1,0,4,1
4456,5,14,4,0,10,4
4456,4,9,4,0,5,4
4456,3,6,2,0,4,2
4456,2,5,2,0,3,2
4456,1,3,2,0,1,2
167185,7,18,3,0,15,3
167185,6,16,3,0,13,3
12280,10,2,1,0,1,1
12280,9,2,2,0,0,2
12280,8,8,4,0,4,4
12280,7,7,2,0,5,2
12280,6,13,3,0,10,3
5804,8,1,1,0,0,1
5804,7,5,1,0,4,1
5804,6,10,1,0,9,1
5804,5,8,2,0,6,2
5804,4,14,4,0,10,4
5804,3,4,2,0,2,2
5804,2,1,1,0,0,1
5804,1,3,2,0,1,2
11477,9,1,1,0,0,1
11477,8,11,3,0,8,3
11477,7,15,4,0,11,4
11477,6,11,2,0,9,2
11477,5,5,1,0,4,1
11477,4,1,1,0,0,1
11477,3,1,1,0,0,1
33875,10,1,1,0,0,1
33875,9,4,1,0,3,1
33875,8,17,4,0,13,4
33875,6,6,1,0,5,1
230542,8,4,1,0,3,1
230542,6,10,3,0,7,3
230542,4,7,4,0,3,4
230542,3,9,1,0,8,1
157451,10,1,1,0,0,1
157451,9,4,1,0,3,1
157451,8,16,3,0,13,3
157451,7,8,1,0,7,1
157451,6,15,3,0,12,3
215806,10,12,7,0,5,7
215806,9,6,2,0,4,2
215806,8,6,2,0,4,2
215806,6,11,2,0,9,2
215806,5,5,2,0,3,2
5464,10,1,1,0,0,1
5464,8,13,9,0,4,9
5464,7,15,6,0,9,6
5464,6,12,5,0,7,5
5464,5,2,1,0,1,1
4093,8,4,1,0,3,1
4093,7,4,2,0,2,2
4093,6,17,8,0,9,8
4093,5,15,4,0,11,4
20643,9,1,1,0,0,1
20643,8,10,4,0,6,4
20643,7,9,2,0,7,2
20643,6,18,7,0,11,7
20643,5,6,2,0,4,2
20643,4,2,2,0,0,2
7713,6,14,4,0,10,4
7713,5,7,2,0,5,2
7713,4,13,1,0,12,1
7713,2,3,1,0,2,1
73242,10,2,1,0,1,1
73242,8,8,3,0,5,3
73242,7,7,1,0,6,1
73242,6,14,4,0,10,4
73242,5,10,4,0,6,4
73242,4,3,2,0,1,2
73242,2,1,1,0,0,1
188885,10,10,2,0,8,2
188885,9,9,1,0,8,1
188885,8,17,1,0,16,1
188885,3,1,1,0,0,1
11707,9,5,2,0,3,2
11707,8,17,10,0,7,10
11707,7,8,4,0,4,4
11707,6,7,2,0,5,2
11707,4,2,2,0,0,2
11707,3,1,1,0,0,1
6712,8,5,1,0,4,1
6712,7,6,3,0,3,3
6712,6,3,2,0,1,2
6712,5,6,2,0,4,2
6712,4,7,3,0,4,3
6712,3,7,2,0,5,2
6712,2,5,1,0,4,1
6712,1,5,2,0,3,2
103745,10,1,1,0,0,1
103745,8,6,3,0,3,3
103745,7,13,4,0,9,4
103745,6,11,2,0,9,2
103745,5,8,1,0,7,1
103745,4,6,4,0,2,4
103745,2,2,2,0,0,2
22342,9,1,1,0,0,1
22342,7,4,2,0,2,2
22342,6,16,5,0,11,5
22342,5,12,4,0,8,4
22342,4,6,2,0,4,2
22342,3,5,2,0,3,2
22342,2,2,1,0,1,1
74678,8,7,2,0,5,2
74678,7,18,5,0,13,5
74678,6,11,4,0,7,4
74678,5,5,1,0,4,1
74678,4,3,1,0,2,1
193272,9,2,1,0,1,1
193272,7,8,1,0,7,1
193272,6,14,2,0,12,2
193272,5,13,1,0,12,1
193272,4,6,1,0,5,1
193272,3,2,1,0,1,1
84778,8,5,2,0,3,2
84778,7,13,3,0,10,3
84778,6,17,6,0,11,6
84778,5,9,4,0,5,4
84778,4,3,1,0,2,1
5349,8,2,1,0,1,1
5349,7,10,2,0,8,2
5349,6,16,1,0,15,1
5349,5,4,1,0,3,1
5349,4,4,1,0,3,1
5349,3,4,2,0,2,2
5349,2,1,1,0,0,1
5349,1,3,3,0,0,3
173673,7,10,2,1,8,1
173673,6,17,3,0,14,3
173673,4,3,2,0,1,2
81100,8,9,3,0,6,3
81100,7,11,3,0,8,3
81100,6,15,5,0,10,5
12541,9,4,1,0,3,1
12541,8,14,8,0,6,8
12541,7,8,2,0,6,2
12541,6,13,7,0,6,7
12541,5,6,3,0,3,3
12541,4,2,1,0,1,1
727,7,11,3,0,8,3
727,6,9,4,0,5,4
727,5,8,5,0,3,5
727,4,10,2,0,8,2
727,3,2,1,0,1,1
192355,10,4,1,0,3,1
192355,9,4,2,0,2,2
192355,7,16,1,0,15,1
192355,6,11,3,0,8,3
192355,3,1,1,0,0,1
13182,10,8,4,0,4,4
13182,9,6,4,0,2,4
13182,8,19,7,0,12,7
13182,7,4,1,0,3,1
13182,5,1,1,0,0,1
218854,7,18,2,0,16,2
218854,6,15,2,0,13,2
218854,5,7,1,0,6,1
167463,8,3,1,0,2,1
167463,7,14,1,0,13,1
167463,6,20,4,0,16,4
7980,10,3,1,0,2,1
7980,8,3,2,0,1,2
7980,7,13,2,0,11,2
7980,6,16,3,0,13,3
7980,5,7,2,0,5,2
7980,4,1,1,0,0,1
1127,10,1,1,0,0,1
1127,9,2,1,0,1,1
1127,7,6,4,0,2,4
1127,6,13,5,0,8,5
1127,5,14,2,0,12,2
1127,4,3,1,0,2,1
1127,3,4,1,0,3,1
183340,8,7,1,0,6,1
183340,7,15,1,0,14,1
183340,6,16,1,0,15,1
183340,5,5,3,0,2,3
36238,8,4,2,0,2,2
36238,6,10,2,0,8,2
36238,4,4,2,0,2,2
36238,3,4,2,0,2,2
194040,7,6,1,0,5,1
194040,5,13,1,0,12,1
254419,10,1,1,0,0,1
254419,9,3,1,0,2,1
254419,7,10,1,0,9,1
254419,6,15,3,0,12,3
254419,5,8,1,0,7,1
254419,3,3,1,0,2,1
162141,9,3,2,0,1,2
162141,8,20,4,0,16,4
162141,7,8,2,0,6,2
162141,6,10,5,0,5,5
162141,5,3,1,0,2,1
162141,4,1,1,0,0,1
162141,2,1,1,0,0,1
165208,9,1,1,0,0,1
165208,8,2,1,0,1,1
165208,6,15,4,0,11,4
165208,4,5,1,0,4,1
197433,10,4,2,0,2,2
197433,8,5,1,1,4,0
197433,7,7,1,0,6,1
197433,6,16,2,0,14,2
197433,5,6,2,0,4,2
197433,4,5,1,0,4,1
197433,3,3,1,0,2,1
39145,9,1,1,0,0,1
39145,7,6,3,0,3,3
39145,6,16,8,0,8,8
39145,5,3,1,0,2,1
39145,4,10,5,0,5,5
39145,3,5,2,0,3,2
39145,2,6,5,0,1,5
181928,10,2,1,0,1,1
181928,8,8,2,1,6,1
181928,7,10,5,0,5,5
181928,6,15,1,0,14,1
181928,5,7,1,0,6,1
181928,3,1,1,0,0,1
238012,10,12,3,0,9,3
238012,9,13,1,0,12,1
238012,8,9,2,0,7,2
238012,6,4,1,0,3,1
238012,5,3,1,0,2,1
4082,9,3,2,0,1,2
4082,8,6,4,0,2,4
4082,6,20,8,0,12,8
4082,5,5,2,0,3,2
4082,4,4,2,0,2,2
4082,2,3,3,0,0,3
192226,8,10,2,0,8,2
192226,7,16,6,0,10,6
192226,5,3,1,0,2,1
6054,8,8,2,0,6,2
6054,7,9,1,0,8,1
6054,6,15,4,0,11,4
6054,5,3,1,0,2,1
6054,4,7,2,0,5,2
6054,3,3,2,0,1,2
63443,8,2,1,0,1,1
63443,7,3,1,0,2,1
63443,6,10,3,0,7,3
63443,5,18,5,0,13,5
63443,4,9,5,0,4,5
63443,2,2,1,0,1,1
17430,8,9,5,0,4,5
17430,7,19,9,0,10,9
17430,6,14,7,0,7,7
128794,10,3,1,0,2,1
128794,9,7,2,0,5,2
128794,8,13,8,0,5,8
128794,7,11,3,0,8,3
128794,6,9,2,0,7,2
128794,5,3,1,0,2,1
128794,4,1,1,0,0,1
11970,8,4,1,0,3,1
11970,7,11,5,0,6,5
11970,6,15,9,0,6,9
11970,5,7,4,0,3,4
11970,4,5,3,0,2,3
11970,3,4,2,0,2,2
176678,9,5,2,0,3,2
176678,8,13,3,0,10,3
176678,7,12,3,0,9,3
176678,6,9,5,0,4,5
176678,5,4,2,0,2,2
20136,8,8,2,0,6,2
20136,6,13,1,0,12,1
20136,5,6,1,0,5,1
20136,4,1,1,0,0,1
187959,8,6,2,0,4,2
187959,7,16,1,0,15,1
187959,6,15,3,0,12,3
187959,4,3,1,0,2,1
9959,8,6,3,0,3,3
9959,7,2,2,0,0,2
9959,6,10,4,0,6,4
9959,5,13,6,0,7,6
9959,4,7,2,0,5,2
9959,3,6,2,0,4,2
9959,2,2,1,0,1,1
5609,8,5,1,0,4,1
5609,6,6,1,0,5,1
5609,5,12,5,0,7,5
5609,4,6,4,0,2,4
5609,3,5,2,0,3,2
5609,2,7,4,0,3,4
5609,1,1,1,0,0,1
12568,10,2,1,0,1,1
12568,8,5,1,0,4,1
12568,7,3,2,0,1,2
12568,6,17,6,0,11,6
12568,5,6,2,0,4,2
12568,4,8,2,0,6,2
12568,3,3,1,0,2,1
12568,1,1,1,0,0,1
237329,8,1,1,0,0,1
237329,7,6,1,0,5,1
237329,6,13,2,0,11,2
237329,5,17,3,0,14,3
237329,4,8,2,0,6,2
237329,2,1,1,0,0,1
12252,10,6,5,0,1,5
12252,9,9,2,0,7,2
12252,8,20,9,0,11,9
12252,7,9,6,0,3,6
12252,6,2,1,0,1,1
255712,9,4,2,0,2,2
255712,8,7,4,0,3,4
255712,7,15,6,0,9,6
255712,6,15,3,0,12,3
255712,5,4,1,0,3,1
255712,1,1,1,0,0,1
88088,6,21,1,0,20,1
88088,5,15,1,0,14,1
88088,4,5,1,0,4,1
74203,9,2,1,0,1,1
74203,8,10,2,0,8,2
74203,7,7,1,0,6,1
74203,4,1,1,0,0,1
74203,3,5,1,0,4,1
40908,7,9,3,0,6,3
40908,4,9,1,0,8,1
40908,3,5,1,0,4,1
40908,2,3,1,0,2,1
172465,10,6,1,0,5,1
172465,9,4,2,0,2,2
172465,7,9,3,0,6,3
172465,4,4,1,0,3,1
16268,8,6,1,0,5,1
16268,7,13,2,0,11,2
16268,6,22,8,0,14,8
16268,4,1,1,0,0,1
133940,10,6,5,0,1,5
133940,9,7,5,0,2,5
133940,8,16,5,0,11,5
133940,7,8,1,0,7,1
133940,6,7,6,0,1,6
210152,10,4,3,0,1,3
210152,9,8,5,0,3,5
210152,8,18,7,0,11,7
210152,7,11,2,0,9,2
210152,6,2,1,0,1,1
15236,8,4,1,0,3,1
15236,7,5,2,0,3,2
15236,6,11,3,0,8,3
15236,5,14,3,0,11,3
15236,4,9,1,0,8,1
15236,1,1,1,0,0,1
227794,10,8,4,0,4,4
227794,9,9,2,0,7,2
227794,8,14,3,1,11,2
227794,6,5,1,0,4,1
227794,5,2,1,0,1,1
227794,4,2,1,0,1,1
227794,3,1,1,0,0,1
248567,8,16,4,0,12,4
248567,7,12,2,0,10,2
97469,9,1,1,0,0,1
97469,8,7,3,0,4,3
97469,7,13,4,0,9,4
97469,6,17,3,0,14,3
97469,4,3,2,0,1,2
260561,10,14,6,1,8,5
260561,9,11,6,0,5,6
260561,8,10,4,0,6,4
260561,6,5,1,0,4,1
185987,8,15,6,0,9,6
185987,7,13,2,0,11,2
185987,6,12,3,0,9,3
185987,1,1,1,0,0,1
26861,6,8,2,0,6,2
26861,5,11,3,0,8,3
26861,4,10,2,0,8,2
26861,3,6,3,0,3,3
26861,2,6,2,0,4,2
24323,7,4,1,0,3,1
24323,6,15,6,0,9,6
24323,5,9,3,0,6,3
24323,4,5,3,0,2,3
24323,3,3,2,0,1,2
24323,2,2,1,0,1,1
24323,1,5,2,0,3,2
211146,7,17,3,0,14,3
211146,6,17,3,0,14,3
205876,8,3,1,0,2,1
205876,7,8,2,0,6,2
205876,6,12,2,0,10,2
205876,4,7,3,0,4,3
205876,3,4,2,0,2,2
5927,9,1,1,0,0,1
5927,8,8,6,0,2,6
5927,7,14,3,0,11,3
5927,6,9,4,0,5,4
5927,5,8,3,0,5,3
5927,4,2,1,0,1,1
5927,2,1,1,0,0,1
51624,8,8,1,0,7,1
51624,7,9,2,0,7,2
51624,6,12,1,0,11,1
51624,5,5,1,0,4,1
51624,4,4,1,0,3,1
51624,3,5,3,0,2,3
51624,2,2,2,0,0,2
1351,8,9,2,0,7,2
1351,7,6,2,0,4,2
1351,6,13,3,0,10,3
1351,5,8,1,0,7,1
1351,4,6,1,0,5,1
1351,3,5,1,0,4,1
145549,10,3,2,0,1,2
145549,9,3,1,0,2,1
145549,8,18,8,0,10,8
145549,7,12,6,0,6,6
145549,6,8,5,0,3,5
145549,5,1,1,0,0,1
145549,2,1,1,0,0,1
191880,7,8,1,0,7,1
191880,5,13,4,0,9,4
191880,4,5,2,0,3,2
191880,3,6,3,0,3,3
213421,8,12,1,0,11,1
93578,9,1,1,0,0,1
93578,8,7,1,0,6,1
93578,7,7,1,0,6,1
93578,6,14,4,0,10,4
93578,5,5,1,0,4,1
93578,3,5,2,0,3,2
93578,2,3,1,0,2,1
93578,1,1,1,0,0,1
203312,10,6,1,0,5,1
203312,9,15,2,0,13,2
203312,8,12,2,0,10,2
203312,7,10,1,0,9,1
203312,6,2,2,0,0,2
203312,1,1,1,0,0,1
66457,9,4,3,0,1,3
66457,8,5,2,0,3,2
66457,7,6,2,0,4,2
66457,6,18,4,0,14,4
66457,5,4,1,0,3,1
66457,4,3,1,0,2,1
12629,10,2,1,0,1,1
12629,9,2,1,0,1,1
12629,8,7,2,0,5,2
12629,7,14,5,0,9,5
12629,6,10,3,0,7,3
12629,5,5,1,0,4,1
12629,4,2,1,0,1,1
12629,3,1,1,0,0,1
12629,2,3,2,0,1,2
200672,8,13,3,0,10,3
200672,7,11,1,0,10,1
200672,6,9,2,0,7,2
18061,8,14,7,0,7,7
18061,7,13,3,0,10,3
18061,6,10,2,0,8,2
18061,5,4,1,0,3,1
18061,4,2,1,0,1,1
18061,3,2,2,0,0,2
88006,10,2,2,0,0,2
88006,9,5,5,0,0,5
88006,8,10,6,0,4,6
88006,7,18,8,0,10,8
88006,6,6,3,0,3,3
88006,3,1,1,0,0,1
4320,10,1,1,0,0,1
4320,9,2,1,0,1,1
4320,8,9,3,0,6,3
4320,7,14,2,0,12,2
4320,6,10,2,0,8,2
4320,4,2,1,0,1,1
7586,10,2,2,0,0,2
7586,9,1,1,0,0,1
7586,8,4,2,0,2,2
7586,7,8,3,0,5,3
7586,6,9,5,0,4,5
7586,5,6,3,0,3,3
7586,4,7,2,0,5,2
7586,3,5,4,0,1,4
7586,2,2,2,0,0,2
7586,1,2,1,0,1,1
257395,9,8,5,1,3,4
257395,8,18,5,0,13,5
257395,1,3,2,0,1,2
391,7,2,1,0,1,1
391,6,11,1,0,10,1
391,5,15,2,0,13,2
391,2,4,2,0,2,2
2958,8,6,2,0,4,2
2958,7,6,1,0,5,1
2958,6,16,4,0,12,4
2958,5,8,1,0,7,1
2958,4,5,2,0,3,2
22336,8,3,1,0,2,1
22336,7,8,1,0,7,1
22336,6,14,1,0,13,1
22336,5,11,1,0,10,1
22336,4,4,1,0,3,1
20836,7,1,1,0,0,1
20836,6,18,9,0,9,9
20836,5,10,4,0,6,4
20836,4,11,6,0,5,6
20836,3,4,1,0,3,1
20836,2,2,1,0,1,1
1175,4,11,2,0,9,2
1175,3,9,1,0,8,1
1175,1,9,4,0,5,4
11527,8,3,2,0,1,2
11527,7,12,5,0,7,5
11527,6,21,4,0,17,4
11527,5,6,3,0,3,3
11527,2,1,1,0,0,1
4097,8,5,2,0,3,2
4097,7,9,2,0,7,2
4097,6,12,5,0,7,5
4097,5,5,2,0,3,2
4097,4,12,1,0,11,1
4097,3,2,2,0,0,2
4097,2,1,1,0,0,1
119474,5,13,4,0,9,4
119474,2,2,1,0,1,1
7578,10,1,1,0,0,1
7578,9,1,1,0,0,1
7578,8,9,5,0,4,5
7578,7,16,5,0,11,5
7578,6,11,5,0,6,5
7578,5,5,1,0,4,1
7578,4,2,1,0,1,1
2440,7,5,1,0,4,1
2440,6,15,7,0,8,7
2440,5,12,6,0,6,6
2440,4,10,7,0,3,7
2440,2,2,2,0,0,2
158098,10,8,2,0,6,2
158098,9,6,1,0,5,1
158098,8,12,5,0,7,5
158098,7,8,1,0,7,1
158098,6,8,1,0,7,1
192904,9,3,1,0,2,1
192904,6,11,3,0,8,3
192904,3,5,1,0,4,1
192904,2,5,3,0,2,3
23614,9,2,1,0,1,1
23614,7,15,4,0,11,4
23614,6,15,4,0,11,4
23614,5,3,1,0,2,1
23614,4,2,2,0,0,2
23614,3,3,1,0,2,1
248157,8,3,1,0,2,1
248157,7,10,3,0,7,3
248157,6,13,6,0,7,6
248157,5,12,6,0,6,6
38702,8,5,1,0,4,1
38702,7,4,4,0,0,4
38702,6,22,10,0,12,10
38702,5,8,3,0,5,3
38702,4,2,2,0,0,2
38702,3,3,3,0,0,3
38702,2,2,1,0,1,1
41149,10,1,1,0,0,1
41149,9,7,3,0,4,3
41149,8,15,3,0,12,3
41149,7,11,3,0,8,3
41149,6,11,4,0,7,4
41149,4,1,1,0,0,1
133992,8,9,4,0,5,4
133992,7,6,1,0,5,1
133992,6,16,5,0,11,5
133992,5,6,1,0,5,1
133992,4,3,1,0,2,1
56886,10,10,1,0,9,1
56886,9,10,1,0,9,1
56886,8,13,4,0,9,4
56886,4,1,1,0,0,1
23404,8,11,4,0,7,4
23404,7,11,3,0,8,3
23404,6,15,2,0,13,2
10094,6,10,1,0,9,1
10094,5,16,4,0,12,4
10094,4,4,1,0,3,1
10094,3,6,2,0,4,2
10094,2,3,1,0,2,1
193105,10,4,1,0,3,1
193105,9,5,2,0,3,2
193105,8,12,4,0,8,4
193105,7,7,1,0,6,1
193105,6,12,4,0,8,4
193105,4,4,1,0,3,1
28860,7,6,1,0,5,1
28860,6,6,2,0,4,2
28860,5,14,1,0,13,1
28860,4,9,4,0,5,4
28860,3,5,3,0,2,3
28860,2,1,1,0,0,1
28860,1,2,2,0,0,2
197788,10,7,1,0,6,1
197788,9,2,1,0,1,1
197788,8,6,1,1,5,0
197788,7,9,1,0,8,1
197788,6,8,2,1,6,1
197788,4,3,1,0,2,1
197788,3,2,1,0,1,1
197788,2,1,1,0,0,1
197788,1,2,1,0,1,1
113513,6,15,5,0,10,5
113513,5,10,3,0,7,3
113513,4,4,1,0,3,1
113513,3,2,1,0,1,1
166246,8,7,3,0,4,3
166246,7,12,1,0,11,1
166246,6,12,5,0,7,5
166246,4,5,2,0,3,2
20036,8,7,5,0,2,5
20036,7,14,5,0,9,5
20036,6,20,10,0,10,10
181376,8,5,2,0,3,2
181376,7,9,2,0,7,2
181376,6,13,2,0,11,2
181376,5,10,3,0,7,3
181376,3,3,1,0,2,1
166509,9,2,2,0,0,2
166509,7,7,2,0,5,2
166509,6,10,2,0,8,2
166509,5,12,3,0,9,3
166509,4,6,3,0,3,3
166509,3,3,1,0,2,1
198898,7,16,2,0,14,2
198898,6,8,1,0,7,1
198898,5,8,3,0,5,3
172088,10,4,2,0,2,2
172088,9,3,1,0,2,1
172088,8,13,4,0,9,4
172088,7,9,5,0,4,5
172088,6,13,3,0,10,3
172088,5,3,1,0,2,1
118627,8,6,1,0,5,1
118627,7,11,2,0,9,2
118627,6,15,1,0,14,1
118627,5,9,1,0,8,1
118627,1,1,1,0,0,1
6125,8,4,1,0,3,1
6125,7,12,3,0,9,3
6125,6,16,1,0,15,1
6125,5,5,1,0,4,1
6125,2,2,1,0,1,1
88246,10,1,1,0,0,1
88246,8,14,3,0,11,3
88246,7,11,7,0,4,7
88246,6,7,3,0,4,3
88246,5,2,1,0,1,1
88246,4,2,2,0,0,2
183305,9,3,2,0,1,2
183305,8,5,1,0,4,1
183305,7,12,4,0,8,4
183305,6,15,3,0,12,3
183305,5,7,2,0,5,2
183305,4,3,1,0,2,1
153624,7,5,1,0,4,1
153624,6,13,1,0,12,1
153624,5,16,3,0,13,3
153624,4,9,1,0,8,1
123511,10,1,1,0,0,1
123511,9,5,1,0,4,1
123511,8,8,1,0,7,1
123511,7,15,1,0,14,1
123511,6,7,4,0,3,4
123511,5,6,3,0,3,3
123511,4,3,2,0,1,2
123511,3,1,1,0,0,1
176898,8,5,1,0,4,1
176898,7,16,5,0,11,5
176898,6,11,3,0,8,3
176898,5,9,2,0,7,2
176898,2,2,1,0,1,1
252684,8,6,1,0,5,1
252684,7,11,2,0,9,2
252684,6,14,3,1,11,2
252684,5,10,3,0,7,3
252684,4,3,2,1,1,1
7003,10,2,1,0,1,1
7003,9,3,3,0,0,3
7003,8,4,3,0,1,3
7003,7,13,6,0,7,6
7003,6,13,6,0,7,6
7003,5,5,3,0,2,3
7003,4,4,2,0,2,2
7003,3,1,1,0,0,1
7003,2,1,1,0,0,1
162120,7,8,1,0,7,1
162120,6,15,4,0,11,4
162120,4,4,1,0,3,1
162120,3,2,1,0,1,1
91313,10,2,2,0,0,2
91313,9,4,2,0,2,2
91313,8,4,1,0,3,1
91313,7,5,2,0,3,2
91313,6,19,6,0,13,6
91313,5,5,2,0,3,2
91313,4,4,4,0,0,4
91313,2,2,1,0,1,1
3746,10,3,2,0,1,2
3746,8,7,1,0,6,1
3746,7,6,2,0,4,2
3746,6,14,4,0,10,4
3746,5,8,3,0,5,3
3746,4,5,1,0,4,1
3746,3,2,1,0,1,1
3746,2,1,1,0,0,1
151981,8,3,1,1,2,0
151981,5,10,2,1,8,1
151981,4,6,2,0,4,2
151981,3,4,2,1,2,1
13447,10,1,1,0,0,1
13447,6,5,3,0,2,3
13447,5,4,1,0,3,1
13447,4,14,3,0,11,3
13447,3,7,3,0,4,3
13447,2,9,4,0,5,4
13447,1,5,4,0,1,4
1567,9,1,1,0,0,1
1567,7,9,2,0,7,2
1567,6,13,5,0,8,5
1567,5,14,3,0,11,3
1567,4,3,1,0,2,1
1567,2,1,1,0,0,1
1567,1,2,1,0,1,1
238912,9,3,1,0,2,1
238912,8,7,2,0,5,2
238912,7,10,2,0,8,2
238912,6,10,3,0,7,3
238912,5,6,1,0,5,1
238912,4,6,3,0,3,3
238912,3,2,1,0,1,1
2349,9,1,1,0,0,1
2349,8,2,1,0,1,1
2349,7,6,3,0,3,3
2349,6,20,5,0,15,5
2349,5,9,4,0,5,4
2349,3,3,2,0,1,2
18704,9,5,2,0,3,2
18704,8,11,2,0,9,2
18704,7,8,2,0,6,2
18704,6,11,3,0,8,3
18704,4,2,1,0,1,1
18704,2,3,1,0,2,1
5275,9,4,2,0,2,2
5275,8,7,3,0,4,3
5275,7,17,7,0,10,7
5275,6,11,2,0,9,2
6963,8,2,1,0,1,1
6963,7,2,1,0,1,1
6963,6,8,1,0,7,1
6963,5,7,1,0,6,1
6963,4,9,5,0,4,5
6963,3,8,2,0,6,2
64706,7,6,1,0,5,1
64706,6,13,5,0,8,5
64706,5,12,3,0,9,3
64706,4,8,3,0,5,3
64706,3,2,1,0,1,1
64706,1,2,1,0,1,1
7185,10,1,1,0,0,1
7185,7,7,1,0,6,1
7185,6,13,1,0,12,1
7185,5,14,6,0,8,6
7185,4,7,1,0,6,1
5678,10,4,2,0,2,2
5678,9,3,3,0,0,3
5678,8,1,1,0,0,1
5678,7,7,4,0,3,4
5678,6,16,7,0,9,7
5678,5,6,1,0,5,1
5678,4,4,2,0,2,2
5678,3,2,2,0,0,2
5678,1,3,2,0,1,2
38795,7,4,3,0,1,3
38795,6,11,4,0,7,4
38795,5,10,5,0,5,5
38795,4,10,2,0,8,2
38795,2,3,1,0,2,1
66537,9,1,1,0,0,1
66537,8,5,1,0,4,1
66537,7,7,1,0,6,1
66537,6,15,3,0,12,3
66537,4,4,2,0,2,2
66537,3,1,1,0,0,1
66537,2,2,1,0,1,1
136177,8,6,1,0,5,1
136177,7,9,1,0,8,1
136177,6,16,2,0,14,2
136177,4,2,1,0,1,1
136177,2,1,1,0,0,1
203421,7,11,2,0,9,2
203421,6,21,3,0,18,3
203421,5,8,1,0,7,1
182978,10,1,1,1,0,0
182978,9,3,2,0,1,2
182978,8,9,2,1,7,1
182978,7,15,2,0,13,2
182978,6,16,3,0,13,3
182978,5,1,1,1,0,0
182978,4,1,1,0,0,1
4849,8,8,4,0,4,4
4849,5,7,1,0,6,1
4849,4,9,3,0,6,3
4849,3,4,2,0,2,2
4849,2,1,1,0,0,1
18247,8,11,5,0,6,5
18247,7,11,3,0,8,3
18247,6,14,4,0,10,4
18247,5,6,3,0,3,3
18247,4,2,1,0,1,1
222401,10,3,1,0,2,1
222401,8,16,6,0,10,6
222401,4,1,1,0,0,1
222401,1,2,1,0,1,1
17691,10,5,2,0,3,2
17691,9,7,2,0,5,2
17691,8,8,1,0,7,1
17691,7,10,1,0,9,1
17691,6,8,1,0,7,1
17691,5,5,2,0,3,2
17691,3,2,2,0,0,2
41329,8,7,1,0,6,1
41329,7,5,1,0,4,1
41329,6,20,6,0,14,6
41329,5,12,2,0,10,2
177437,6,16,4,0,12,4
177437,5,11,1,0,10,1
177437,4,7,2,0,5,2
1084,7,8,3,0,5,3
1084,6,9,2,0,7,2
1084,5,9,2,0,7,2
1084,4,13,6,0,7,6
1084,3,6,1,0,5,1
160541,10,1,1,0,0,1
160541,6,5,1,0,4,1
160541,5,13,4,0,9,4
160541,4,10,4,0,6,4
160541,3,9,4,0,5,4
160541,2,6,2,0,4,2
16987,10,2,1,0,1,1
16987,7,2,1,0,1,1
16987,6,16,5,0,11,5
16987,5,11,3,0,8,3
16987,4,6,2,0,4,2
16987,3,6,1,0,5,1
16987,2,2,1,0,1,1
32821,10,2,1,0,1,1
32821,9,5,3,0,2,3
32821,8,8,5,0,3,5
32821,7,9,5,0,4,5
32821,6,9,3,0,6,3
32821,5,9,3,0,6,3
32821,4,2,1,0,1,1
32821,3,1,1,0,0,1
32821,2,1,1,0,0,1
47125,6,12,1,0,11,1
47125,5,6,1,0,5,1
47125,2,2,2,0,0,2
125585,8,9,2,0,7,2
125585,7,10,2,0,8,2
125585,6,11,2,0,9,2
125585,5,5,1,0,4,1
125585,4,3,1,0,2,1
132357,9,1,1,0,0,1
132357,8,1,1,0,0,1
132357,7,9,1,0,8,1
132357,6,11,2,0,9,2
132357,5,7,1,0,6,1
132357,4,10,2,0,8,2
132357,3,3,1,0,2,1
132357,2,3,2,0,1,2
93402,7,8,2,0,6,2
93402,6,17,2,0,15,2
93402,3,1,1,0,0,1
56641,10,4,1,0,3,1
56641,9,10,4,0,6,4
56641,8,12,1,0,11,1
56641,7,6,1,0,5,1
56641,6,10,1,0,9,1
56641,5,2,1,0,1,1
56641,4,1,1,0,0,1
18311,10,3,2,0,1,2
18311,9,8,5,0,3,5
18311,8,15,5,0,10,5
18311,7,9,3,0,6,3
18311,6,6,1,0,5,1
18311,5,3,3,0,0,3
18311,4,2,1,0,1,1
175086,9,3,1,0,2,1
175086,8,7,1,1,6,0
175086,6,10,2,0,8,2
175086,5,7,1,0,6,1
175086,3,1,1,0,0,1
1934,5,15,1,0,14,1
1934,2,1,1,0,0,1
257204,10,1,1,0,0,1
257204,9,5,3,0,2,3
257204,8,16,4,0,12,4
257204,7,10,3,0,7,3
257204,6,6,2,0,4,2
257204,4,2,1,0,1,1
128154,10,5,1,0,4,1
128154,9,13,4,0,9,4
128154,8,12,2,0,10,2
128154,6,6,2,0,4,2
128154,4,2,1,0,1,1
72751,8,3,2,0,1,2
72751,7,5,3,0,2,3
72751,6,23,4,0,19,4
72751,4,5,1,0,4,1
72751,1,1,1,0,0,1
13912,8,5,3,0,2,3
13912,7,8,1,0,7,1
13912,6,14,3,0,11,3
13912,5,10,3,0,7,3
13912,4,3,2,0,1,2
13912,3,1,1,0,0,1
13912,2,2,2,0,0,2
13912,1,1,1,0,0,1
20414,10,31,3,0,28,3
20414,9,3,1,0,2,1
20414,3,2,1,0,1,1
20414,1,2,1,0,1,1
225062,10,2,2,0,0,2
225062,9,4,1,0,3,1
225062,8,12,2,0,10,2
225062,7,16,5,0,11,5
225062,6,7,1,0,6,1
18574,7,4,1,0,3,1
18574,6,7,1,0,6,1
18574,5,10,3,0,7,3
18574,4,9,3,0,6,3
18574,3,6,2,0,4,2
18574,2,4,2,0,2,2
18574,1,5,3,0,2,3
7232,9,3,1,0,2,1
7232,8,3,1,0,2,1
7232,7,9,3,0,6,3
7232,6,16,6,0,10,6
7232,5,6,2,0,4,2
7232,4,3,1,0,2,1
7232,3,6,2,0,4,2
175627,9,4,3,0,1,3
175627,8,15,4,0,11,4
175627,7,13,3,0,10,3
175627,6,7,3,0,4,3
175627,5,2,1,0,1,1
175627,3,2,1,0,1,1
73253,9,2,2,0,0,2
73253,8,10,6,0,4,6
73253,7,15,8,0,7,8
73253,6,13,4,0,9,4
73253,5,3,1,0,2,1
73253,4,2,1,0,1,1
8863,9,3,3,0,0,3
8863,8,3,2,0,1,2
8863,7,10,1,0,9,1
8863,6,16,3,0,13,3
8863,5,6,4,0,2,4
8863,4,2,1,0,1,1
8863,3,2,1,0,1,1
231392,10,4,1,0,3,1
231392,8,9,1,0,8,1
231392,7,12,2,0,10,2
231392,6,11,1,0,10,1
231392,5,3,1,0,2,1
231392,4,2,1,0,1,1
193854,9,1,1,0,0,1
193854,8,7,3,2,4,1
193854,7,14,3,0,11,3
193854,6,18,7,2,11,5
193854,5,3,1,0,2,1
175778,10,3,1,0,2,1
175778,8,6,2,0,4,2
175778,7,7,2,0,5,2
175778,5,8,2,0,6,2
175778,4,4,1,0,3,1
17433,10,5,3,0,2,3
17433,9,8,5,0,3,5
17433,8,9,1,0,8,1
17433,7,10,3,0,7,3
17433,6,7,4,0,3,4
17433,5,3,1,0,2,1
17433,4,2,1,0,1,1
17433,3,2,1,0,1,1
107435,7,8,5,0,3,5
107435,6,10,3,0,7,3
107435,5,11,3,0,8,3
107435,4,7,1,0,6,1
107435,3,3,1,0,2,1
107435,1,1,1,0,0,1
237217,10,5,2,0,3,2
237217,8,7,1,0,6,1
237217,7,20,2,0,18,2
237217,6,8,1,0,7,1
237217,5,2,1,0,1,1
145621,9,2,2,0,0,2
145621,8,4,1,0,3,1
145621,7,5,2,0,3,2
145621,6,15,2,0,13,2
145621,5,5,2,0,3,2
6346,10,9,4,0,5,4
6346,8,6,4,0,2,4
6346,6,13,4,0,9,4
6346,5,8,4,0,4,4
6346,1,1,1,0,0,1
129311,8,10,6,0,4,6
129311,7,18,6,0,12,6
129311,6,11,2,0,9,2
129311,5,6,3,0,3,3
129311,4,1,1,0,0,1
132601,9,3,1,0,2,1
132601,8,17,4,0,13,4
132601,7,11,2,0,9,2
132601,6,6,4,0,2,4
132601,5,4,2,0,2,2
132601,4,1,1,0,0,1
132601,3,1,1,0,0,1
222502,10,5,3,0,2,3
222502,9,12,5,0,7,5
222502,8,25,8,0,17,8
222502,7,4,2,0,2,2
206410,10,2,1,0,1,1
206410,8,2,1,1,1,0
206410,7,8,2,0,6,2
206410,6,12,1,0,11,1
206410,5,6,3,0,3,3
206410,4,4,1,0,3,1
206410,3,6,3,0,3,3
206410,2,3,2,0,1,2
206410,1,1,1,0,0,1
4199,9,4,2,0,2,2
4199,8,14,6,0,8,6
4199,7,10,6,0,4,6
4199,6,10,2,0,8,2
4199,5,5,1,0,4,1
4199,4,3,2,0,1,2
167468,6,27,5,0,22,5
96626,9,6,3,0,3,3
96626,8,15,3,0,12,3
96626,7,11,2,0,9,2
96626,6,9,3,0,6,3
8530,8,1,1,0,0,1
8530,7,2,1,0,1,1
8530,6,10,3,0,7,3
8530,5,6,3,0,3,3
8530,4,17,7,0,10,7
8530,3,8,3,0,5,3
8530,2,2,2,0,0,2
36373,8,2,1,0,1,1
36373,7,11,6,0,5,6
36373,6,19,6,0,13,6
36373,5,8,4,0,4,4
36373,3,3,1,0,2,1
173752,10,5,1,0,4,1
173752,9,3,1,0,2,1
173752,8,5,2,0,3,2
173752,6,12,3,0,9,3
173752,3,3,1,0,2,1
161063,10,2,1,0,1,1
161063,9,6,1,0,5,1
161063,8,7,5,1,2,4
161063,7,14,1,0,13,1
161063,6,9,2,0,7,2
161063,5,5,2,1,3,1
161063,4,1,1,0,0,1
161063,3,1,1,0,0,1
161063,2,1,1,0,0,1
260704,10,3,1,0,2,1
260704,9,3,1,0,2,1
260704,8,6,1,0,5,1
260704,7,9,1,0,8,1
260704,6,18,2,0,16,2
260704,5,3,1,0,2,1
260704,2,1,1,0,0,1
32863,8,3,2,0,1,2
32863,7,7,4,0,3,4
32863,6,18,7,0,11,7
32863,5,4,1,0,3,1
32863,4,3,1,0,2,1
32863,3,5,1,0,4,1
32863,2,4,1,0,3,1
32863,1,2,1,0,1,1
8067,8,3,3,0,0,3
8067,7,18,4,0,14,4
8067,6,14,6,0,8,6
8067,4,5,3,0,2,3
247785,10,6,6,0,0,6
247785,9,8,4,0,4,4
247785,8,18,5,0,13,5
247785,7,11,4,0,7,4
247785,6,3,2,0,1,2
49392,9,9,3,0,6,3
49392,8,8,1,0,7,1
49392,7,15,1,0,14,1
49392,6,9,2,0,7,2
138470,8,4,2,0,2,2
138470,7,10,2,0,8,2
138470,6,18,10,0,8,10
138470,5,7,1,0,6,1
138470,4,4,1,0,3,1
138470,3,3,2,0,1,2
223455,10,16,2,0,14,2
223455,9,1,1,0,0,1
223455,8,9,4,0,5,4
223455,3,1,1,0,0,1
223455,1,2,1,0,1,1
31477,2,2,2,0,0,2
7749,10,5,2,0,3,2
7749,9,4,2,0,2,2
7749,8,17,7,0,10,7
7749,7,13,1,0,12,1
7749,6,5,1,0,4,1
148215,8,5,2,0,3,2
148215,7,8,2,0,6,2
148215,6,18,4,0,14,4
148215,5,8,1,0,7,1
148215,3,3,1,0,2,1
148215,2,1,1,0,0,1
205776,8,8,2,0,6,2
205776,7,3,1,0,2,1
205776,5,4,1,0,3,1
205776,4,2,1,0,1,1
205776,3,3,1,0,2,1
205776,2,2,1,0,1,1
8748,8,4,2,0,2,2
8748,7,10,3,0,7,3
8748,6,18,11,0,7,11
8748,5,4,3,0,1,3
8748,4,4,2,0,2,2
8748,1,1,1,0,0,1
4948,8,6,1,0,5,1
4948,7,9,3,0,6,3
4948,6,13,4,0,9,4
4948,5,7,5,0,2,5
4948,4,6,3,0,3,3
4948,3,3,1,0,2,1
4948,2,1,1,0,0,1
179433,8,5,1,0,4,1
179433,7,7,1,0,6,1
179433,6,16,3,0,13,3
179433,5,5,1,0,4,1
179433,4,9,2,0,7,2
3814,8,2,1,0,1,1
3814,7,4,3,0,1,3
3814,6,18,3,0,15,3
3814,5,11,5,0,6,5
3814,4,4,2,0,2,2
3814,1,1,1,0,0,1
175879,7,7,3,1,4,2
175879,6,9,3,1,6,2
175879,5,8,1,1,7,0
175879,4,9,2,0,7,2
175879,3,6,1,0,5,1
175879,1,1,1,0,0,1
25992,10,3,1,0,2,1
25992,7,5,1,0,4,1
25992,6,22,9,0,13,9
25992,5,5,1,0,4,1
25992,4,5,3,0,2,3
25992,3,2,1,0,1,1
25992,2,2,2,0,0,2
25992,1,1,1,0,0,1
60872,7,8,2,0,6,2
60872,6,22,5,0,17,5
60872,5,4,1,0,3,1
60872,3,3,1,0,2,1
60872,1,2,1,0,1,1
5935,10,2,1,0,1,1
5935,8,9,7,0,2,7
5935,7,14,5,0,9,5
5935,6,15,4,0,11,4
238972,9,3,1,0,2,1
238972,7,10,1,0,9,1
238972,6,15,2,0,13,2
238972,4,1,1,0,0,1
31378,9,3,2,0,1,2
31378,8,21,3,0,18,3
31378,7,11,2,0,9,2
31378,6,6,2,0,4,2
31378,3,1,1,0,0,1
210966,8,5,2,1,3,1
210966,7,9,2,1,7,1
210966,6,18,1,0,17,1
210966,5,8,2,1,6,1
19908,10,3,1,0,2,1
19908,9,1,1,0,0,1
19908,8,9,2,0,7,2
19908,7,11,3,0,8,3
19908,6,14,3,0,11,3
14991,8,2,2,0,0,2
14991,7,6,3,0,3,3
14991,6,11,3,0,8,3
14991,5,10,1,0,9,1
14991,4,5,3,0,2,3
14991,3,3,2,0,1,2
14991,2,3,1,0,2,1
14991,1,6,5,0,1,5
12505,10,2,1,0,1,1
12505,9,2,1,0,1,1
12505,8,6,4,0,2,4
12505,7,14,6,0,8,6
12505,6,15,7,0,8,7
12505,3,1,1,0,0,1
183665,7,9,2,0,7,2
183665,6,16,3,0,13,3
158774,10,3,2,0,1,2
158774,9,3,2,0,1,2
158774,8,4,2,0,2,2
158774,7,9,2,0,7,2
158774,6,14,3,0,11,3
158774,5,7,2,0,5,2
158774,2,2,1,0,1,1
7870,10,2,1,0,1,1
7870,9,2,1,0,1,1
7870,8,8,4,0,4,4
7870,7,17,10,0,7,10
7870,6,8,3,0,5,3
7870,5,8,5,0,3,5
218453,8,12,3,0,9,3
218453,7,13,2,0,11,2
218453,6,12,3,0,9,3
218453,4,5,1,0,4,1
42498,9,1,1,0,0,1
42498,8,10,3,0,7,3
42498,7,10,7,0,3,7
42498,6,16,10,0,6,10
42498,5,4,3,0,1,3
42498,4,2,1,0,1,1
97339,9,3,2,0,1,2
97339,7,11,3,0,8,3
97339,6,10,2,0,8,2
97339,5,11,2,0,9,2
97339,4,9,1,0,8,1
97339,3,1,1,0,0,1
16972,9,8,1,0,7,1
16972,8,12,2,0,10,2
16972,7,12,1,0,11,1
16972,6,6,3,0,3,3
16972,4,2,2,0,0,2
6364,8,1,1,0,0,1
6364,6,9,3,0,6,3
6364,5,10,2,0,8,2
6364,4,7,4,0,3,4
6364,3,4,2,0,2,2
6364,2,8,3,0,5,3
27336,8,2,2,0,0,2
27336,7,11,4,0,7,4
27336,6,19,6,0,13,6
27336,5,3,2,0,1,2
27336,4,7,1,0,6,1
250467,10,8,2,1,6,1
250467,9,12,4,0,8,4
250467,8,15,5,0,10,5
250467,7,9,2,0,7,2
250467,5,1,1,0,0,1
215058,9,4,1,0,3,1
215058,8,18,2,0,16,2
215058,6,7,1,0,6,1
8133,6,7,1,0,6,1
8133,5,7,5,0,2,5
8133,4,9,1,0,8,1
8133,3,9,1,0,8,1
8133,2,9,8,0,1,8
8133,1,1,1,0,0,1
1290,6,13,2,0,11,2
1290,5,12,3,0,9,3
1290,4,6,2,0,4,2
1290,3,6,2,0,4,2
1290,2,4,3,0,1,3
1290,1,2,2,0,0,2
228526,9,4,2,0,2,2
228526,8,14,5,0,9,5
228526,7,9,1,0,8,1
228526,6,11,2,0,9,2
4016,9,7,4,0,3,4
4016,8,12,5,0,7,5
4016,7,10,6,0,4,6
4016,6,12,4,0,8,4
4016,3,1,1,0,0,1
223034,10,1,1,0,0,1
223034,8,6,2,0,4,2
223034,6,9,3,0,6,3
223034,5,8,2,0,6,2
223034,4,4,1,0,3,1
223034,2,4,2,0,2,2
133063,9,2,1,0,1,1
133063,6,4,2,0,2,2
133063,5,2,1,0,1,1
133063,4,12,4,0,8,4
133063,3,8,3,0,5,3
133063,2,11,3,0,8,3
133063,1,5,1,0,4,1
2676,10,1,1,0,0,1
2676,9,2,1,0,1,1
2676,8,3,1,0,2,1
2676,7,11,5,0,6,5
2676,6,12,4,0,8,4
2676,5,12,2,0,10,2
11136,7,8,3,0,5,3
11136,6,15,6,0,9,6
11136,5,5,1,0,4,1
11136,4,7,3,0,4,3
1996,7,8,1,0,7,1
1996,6,12,2,0,10,2
1996,5,13,3,0,10,3
1996,3,1,1,0,0,1
35877,7,4,1,0,3,1
35877,6,13,5,0,8,5
35877,5,13,3,0,10,3
35877,4,11,1,0,10,1
35877,3,3,1,0,2,1
101463,8,5,3,0,2,3
101463,7,19,3,0,16,3
101463,6,10,4,0,6,4
101463,5,4,2,0,2,2
101463,4,1,1,0,0,1
101463,3,1,1,0,0,1
108156,6,16,2,0,14,2
108156,5,10,2,0,8,2
108156,4,10,1,0,9,1
108156,3,2,1,0,1,1
4117,8,2,2,0,0,2
4117,7,3,2,0,1,2
4117,6,6,2,0,4,2
4117,5,13,3,0,10,3
4117,4,8,4,0,4,4
4117,3,6,3,0,3,3
4117,2,6,2,0,4,2
10805,7,9,3,0,6,3
10805,6,13,3,0,10,3
10805,5,7,4,0,3,4
10805,4,6,3,0,3,3
10805,3,6,2,0,4,2
200096,8,9,2,0,7,2
200096,6,13,3,0,10,3
200096,5,5,3,0,2,3
4404,9,1,1,0,0,1
4404,8,1,1,0,0,1
4404,7,1,1,0,0,1
4404,6,9,3,0,6,3
4404,5,15,4,0,11,4
4404,3,9,5,0,4,5
11373,10,4,3,0,1,3
11373,9,2,1,0,1,1
11373,8,9,3,0,6,3
11373,7,12,5,0,7,5
11373,6,12,2,0,10,2
11373,3,2,1,0,1,1
22062,9,3,1,0,2,1
22062,8,3,2,0,1,2
22062,7,11,6,0,5,6
22062,6,18,8,0,10,8
22062,5,4,1,0,3,1
22062,4,4,3,0,1,3
13212,10,4,1,0,3,1
13212,8,12,1,0,11,1
13212,7,12,4,1,8,3
13212,6,7,1,0,6,1
13212,5,4,3,0,1,3
251987,10,1,1,0,0,1
251987,7,12,4,0,8,4
251987,6,11,3,0,8,3
251987,5,9,4,0,5,4
19417,9,4,1,0,3,1
19417,8,5,3,0,2,3
19417,7,9,3,0,6,3
19417,6,13,9,0,4,9
19417,5,5,1,0,4,1
19417,4,3,1,0,2,1
19417,2,3,2,0,1,2
184712,8,9,3,0,6,3
184712,7,19,2,0,17,2
15372,7,6,1,0,5,1
15372,6,10,1,0,9,1
15372,5,15,3,0,12,3
187033,8,4,2,2,2,0
187033,6,15,2,0,13,2
187033,5,4,1,0,3,1
187033,4,6,1,0,5,1
187033,3,6,2,0,4,2
187033,2,2,1,0,1,1
187033,1,4,2,0,2,2
26349,9,2,1,0,1,1
26349,6,9,3,0,6,3
26349,5,14,1,0,13,1
26349,4,6,2,0,4,2
26349,3,3,1,0,2,1
29375,9,4,3,0,1,3
29375,8,23,11,0,12,11
29375,7,8,3,0,5,3
29375,6,5,2,0,3,2
197435,9,1,1,0,0,1
197435,8,4,2,0,2,2
197435,7,5,4,0,1,4
197435,6,14,4,0,10,4
197435,5,4,2,0,2,2
197435,3,5,1,0,4,1
197435,2,3,1,0,2,1
19349,7,3,1,0,2,1
19349,6,11,1,0,10,1
19349,5,10,2,0,8,2
19349,4,13,4,0,9,4
131735,6,10,1,0,9,1
131735,5,8,2,0,6,2
131735,3,9,3,0,6,3
131735,2,4,1,0,3,1
131735,1,2,1,0,1,1
27443,9,1,1,0,0,1
27443,7,4,1,0,3,1
27443,6,4,2,0,2,2
27443,5,7,3,0,4,3
27443,4,11,1,0,10,1
27443,3,6,2,0,4,2
27443,2,6,3,0,3,3
27443,1,6,4,0,2,4
9866,9,3,2,0,1,2
9866,8,10,4,0,6,4
9866,7,17,5,0,12,5
9866,6,7,1,0,6,1
9866,5,6,3,0,3,3
174927,8,3,1,0,2,1
174927,7,4,2,0,2,2
174927,6,14,3,0,11,3
174927,4,11,4,0,7,4
174927,3,4,1,0,3,1
36698,9,2,1,0,1,1
36698,8,5,2,0,3,2
36698,7,6,2,0,4,2
36698,6,13,1,0,12,1
36698,2,2,2,0,0,2
171862,8,6,1,0,5,1
171862,7,15,4,0,11,4
171862,6,8,1,0,7,1
171862,3,2,1,0,1,1
171862,2,3,1,0,2,1
3700,9,5,1,0,4,1
3700,8,14,5,0,9,5
3700,7,11,4,0,7,4
3700,6,7,2,0,5,2
3700,5,5,1,0,4,1
170190,8,5,2,1,3,1
170190,7,6,2,0,4,2
170190,6,7,1,0,6,1
170190,5,10,1,0,9,1
170190,4,8,1,0,7,1
170190,3,4,1,0,3,1
170190,2,3,3,0,0,3
170190,1,2,2,0,0,2
29939,8,1,1,0,0,1
29939,7,7,2,0,5,2
29939,6,13,5,0,8,5
29939,5,16,6,0,10,6
29939,4,5,2,0,3,2
7250,10,1,1,0,0,1
7250,9,1,1,0,0,1
7250,7,2,1,0,1,1
7250,6,3,1,0,2,1
7250,5,11,3,0,8,3
7250,4,11,2,0,9,2
7250,2,9,3,0,6,3
7250,1,2,1,0,1,1
88011,9,4,3,0,1,3
88011,8,9,6,0,3,6
88011,7,12,8,0,4,8
88011,6,10,4,0,6,4
88011,5,4,1,0,3,1
88011,4,3,1,0,2,1
88011,2,2,1,0,1,1
8693,7,13,6,0,7,6
8693,6,18,4,0,14,4
8693,5,5,2,0,3,2
8693,2,1,1,0,0,1
124757,8,5,1,0,4,1
124757,7,11,4,0,7,4
124757,6,21,3,0,18,3
124757,4,4,1,0,3,1
17597,6,8,1,0,7,1
17597,4,14,1,0,13,1
17597,3,8,3,0,5,3
17597,2,7,3,0,4,3
17597,1,1,1,0,0,1
171579,10,5,1,0,4,1
171579,9,3,2,0,1,2
171579,8,11,3,0,8,3
171579,7,7,2,0,5,2
171579,6,11,3,0,8,3
171579,5,3,1,0,2,1
171579,3,1,1,0,0,1
171579,2,1,1,0,0,1
129313,9,1,1,0,0,1
129313,8,3,1,0,2,1
129313,7,13,6,0,7,6
129313,6,17,8,0,9,8
129313,4,6,5,0,1,5
721,7,2,1,0,1,1
721,6,19,8,0,11,8
721,5,12,4,0,8,4
721,4,4,2,0,2,2
721,3,4,2,0,2,2
256620,8,10,3,0,7,3
256620,7,11,2,0,9,2
256620,6,16,4,0,12,4
256620,5,5,1,0,4,1
23920,7,17,8,0,9,8
23920,6,17,13,0,4,13
23920,5,2,1,0,1,1
23920,4,3,2,0,1,2
244428,10,4,1,0,3,1
244428,9,3,1,0,2,1
244428,8,5,2,1,3,1
244428,7,11,3,0,8,3
244428,6,10,3,0,7,3
244428,4,3,1,0,2,1
244428,3,3,1,0,2,1
244428,2,2,2,0,0,2
10414,7,4,2,0,2,2
10414,6,8,4,0,4,4
10414,5,11,3,0,8,3
10414,4,10,4,0,6,4
10414,3,5,3,0,2,3
10414,2,3,1,0,2,1
10414,1,2,1,0,1,1
129944,8,3,2,0,1,2
129944,7,6,2,0,4,2
129944,6,13,3,0,10,3
129944,5,11,4,0,7,4
5347,8,3,1,0,2,1
5347,7,5,2,0,3,2
5347,6,10,2,0,8,2
5347,5,13,5,0,8,5
5347,4,6,2,0,4,2
5347,3,4,2,0,2,2
5347,2,4,1,0,3,1
2925,6,10,2,0,8,2
2925,5,10,5,0,5,5
2925,4,11,3,0,8,3
2925,3,4,1,0,3,1
2925,2,4,2,0,2,2
6944,8,3,2,0,1,2
6944,7,12,6,0,6,6
6944,6,16,9,0,7,9
6944,5,10,6,0,4,6
6944,4,2,1,0,1,1
256730,10,8,1,0,7,1
256730,9,10,2,0,8,2
256730,8,15,3,0,12,3
256730,7,5,1,0,4,1
256730,4,1,1,0,0,1
256730,2,1,1,0,0,1
256730,1,2,2,0,0,2
122524,6,7,1,0,6,1
122524,5,9,2,0,7,2
122524,4,11,2,0,9,2
122524,3,7,2,0,5,2
122524,2,5,1,0,4,1
122524,1,3,2,0,1,2
85389,6,8,2,0,6,2
85389,5,11,2,0,9,2
85389,4,8,3,1,5,2
39898,7,3,3,0,0,3
39898,6,14,3,0,11,3
39898,5,14,4,0,10,4
39898,4,5,1,0,4,1
39898,3,2,1,0,1,1
39898,2,4,3,0,1,3
10470,10,5,2,0,3,2
10470,9,3,1,0,2,1
10470,8,11,1,0,10,1
10470,7,16,2,0,14,2
10470,6,5,1,0,4,1
10470,2,2,1,0,1,1
231368,8,6,1,0,5,1
231368,6,15,3,0,12,3
231368,5,6,1,0,5,1
5387,8,1,1,0,0,1
5387,7,3,1,0,2,1
5387,6,8,4,0,4,4
5387,5,9,3,0,6,3
5387,3,5,3,0,2,3
5387,2,7,5,0,2,5
5387,1,3,3,0,0,3
19475,9,2,1,0,1,1
19475,7,6,1,0,5,1
19475,6,14,5,0,9,5
19475,5,6,1,0,5,1
19475,4,8,3,0,5,3
19475,2,2,1,0,1,1
255272,7,12,3,0,9,3
255272,6,15,2,0,13,2
255272,5,2,1,0,1,1
255272,4,1,1,0,0,1
204578,8,15,3,0,12,3
204578,7,9,3,0,6,3
204578,6,14,3,0,11,3
204578,5,2,1,0,1,1
204578,4,1,1,0,0,1
204578,3,2,1,0,1,1
13269,10,3,2,0,1,2
13269,9,3,1,0,2,1
13269,8,8,6,0,2,6
13269,7,16,7,0,9,7
13269,6,12,5,0,7,5
13269,5,1,1,0,0,1
13827,6,14,1,0,13,1
13827,5,10,1,0,9,1
13827,4,7,2,0,5,2
169574,8,2,1,0,1,1
169574,7,9,2,0,7,2
169574,6,16,3,0,13,3
169574,4,4,1,0,3,1
169574,3,2,1,0,1,1
147457,6,7,2,0,5,2
147457,4,5,1,0,4,1
147457,3,4,1,0,3,1
139401,8,5,2,0,3,2
139401,6,7,2,0,5,2
139401,5,13,3,1,10,2
139401,4,5,2,0,3,2
139401,2,6,2,0,4,2
97888,6,9,2,0,7,2
97888,5,16,2,0,14,2
128388,9,3,1,0,2,1
128388,8,7,2,0,5,2
128388,7,14,5,0,9,5
128388,6,11,1,0,10,1
128388,5,5,2,0,3,2
128388,4,2,1,0,1,1
136029,8,11,1,0,10,1
136029,6,6,1,0,5,1
136029,5,13,1,0,12,1
136029,3,2,1,0,1,1
107604,9,2,1,0,1,1
107604,8,5,1,0,4,1
107604,7,8,1,0,7,1
107604,6,19,1,0,18,1
107604,5,5,1,0,4,1
107604,4,3,1,0,2,1
169462,8,5,3,0,2,3
169462,5,6,2,0,4,2
169462,4,6,3,0,3,3
2733,8,10,3,0,7,3
2733,7,10,2,0,8,2
2733,6,16,4,0,12,4
2733,1,1,1,0,0,1
4878,9,4,2,0,2,2
4878,8,8,2,0,6,2
4878,7,8,2,0,6,2
4878,6,14,6,0,8,6
4878,5,8,4,0,4,4
4878,4,2,1,0,1,1
125059,6,9,1,0,8,1
125059,5,15,6,0,9,6
125059,4,9,2,0,7,2
125059,3,2,1,0,1,1
125059,2,3,1,0,2,1
8097,8,1,1,0,0,1
8097,7,5,3,0,2,3
8097,6,8,4,0,4,4
8097,5,11,5,0,6,5
8097,4,8,4,0,4,4
8097,3,9,6,0,3,6
9192,8,8,3,0,5,3
9192,7,14,5,0,9,5
9192,6,12,2,0,10,2
9192,4,4,2,0,2,2
186489,10,2,1,0,1,1
186489,9,5,3,0,2,3
186489,8,7,1,0,6,1
186489,7,14,6,0,8,6
186489,6,12,2,0,10,2
186489,5,4,1,0,3,1
186489,3,1,1,0,0,1
238221,10,7,3,0,4,3
238221,8,8,1,0,7,1
238221,7,14,1,0,13,1
238221,5,3,1,0,2,1
1065,8,2,1,0,1,1
1065,7,6,2,0,4,2
1065,6,24,7,0,17,7
1065,5,9,2,0,7,2
1065,3,1,1,0,0,1
3024,10,2,1,0,1,1
3024,9,4,2,0,2,2
3024,8,7,2,0,5,2
3024,7,13,4,0,9,4
3024,6,13,5,0,8,5
3024,5,5,1,0,4,1
12976,10,1,1,0,0,1
12976,8,3,1,0,2,1
12976,7,4,2,0,2,2
12976,6,13,2,0,11,2
12976,5,11,4,0,7,4
12976,4,5,5,0,0,5
12976,3,3,3,0,0,3
12976,2,4,3,0,1,3
12976,1,1,1,0,0,1
146247,8,5,1,0,4,1
146247,6,15,2,0,13,2
146247,4,2,1,0,1,1
146247,3,1,1,0,0,1
146247,1,1,1,0,0,1
4434,10,1,1,0,0,1
4434,9,5,3,0,2,3
4434,8,6,3,0,3,3
4434,7,6,4,0,2,4
4434,6,15,6,0,9,6
4434,5,5,2,0,3,2
4434,4,3,1,0,2,1
4434,3,4,3,0,1,3
5043,8,5,1,0,4,1
5043,6,8,2,0,6,2
5043,5,13,4,0,9,4
5043,4,12,2,0,10,2
5043,2,2,2,0,0,2
4176,10,11,6,0,5,6
4176,9,5,3,0,2,3
4176,8,15,3,0,12,3
4176,7,6,2,0,4,2
4176,6,3,2,0,1,2
4176,5,3,2,0,1,2
4176,3,2,2,0,0,2
4649,10,1,1,0,0,1
4649,9,2,2,0,0,2
4649,8,2,2,0,0,2
4649,7,6,5,0,1,5
4649,6,15,6,0,9,6
4649,5,5,2,0,3,2
4649,4,6,2,0,4,2
4649,1,3,2,0,1,2
115944,8,3,1,0,2,1
115944,7,14,2,0,12,2
115944,6,14,7,0,7,7
115944,5,8,2,0,6,2
115944,4,4,1,0,3,1
115944,3,2,1,0,1,1
41065,9,2,2,0,0,2
41065,8,7,5,0,2,5
41065,7,9,2,0,7,2
41065,6,12,1,0,11,1
41065,5,4,2,0,2,2
41065,3,1,1,0,0,1
41065,2,2,2,0,0,2
42686,7,3,1,0,2,1
42686,6,9,2,0,7,2
42686,5,14,4,0,10,4
42686,4,10,4,0,6,4
42686,3,6,2,0,4,2
42686,2,3,1,0,2,1
22594,8,5,1,0,4,1
22594,7,11,4,0,7,4
22594,6,16,5,0,11,5
22594,5,8,3,0,5,3
22594,3,1,1,0,0,1
256569,8,2,1,0,1,1
256569,7,16,2,0,14,2
256569,6,16,5,0,11,5
97521,9,2,1,0,1,1
97521,8,11,6,0,5,6
97521,7,16,7,0,9,7
97521,6,12,3,0,9,3
97521,5,3,1,0,2,1
97521,4,1,1,0,0,1
208323,9,1,1,0,0,1
208323,8,15,3,0,12,3
208323,7,14,5,0,9,5
208323,6,4,1,0,3,1
208323,5,2,1,0,1,1
208323,4,2,1,0,1,1
208323,3,5,4,0,1,4
18330,9,2,1,0,1,1
18330,7,17,1,0,16,1
18330,5,3,1,0,2,1
38829,9,2,1,0,1,1
38829,8,13,5,0,8,5
38829,7,16,5,0,11,5
38829,6,6,2,0,4,2
38829,4,2,1,0,1,1
38829,3,1,1,0,0,1
38829,1,2,2,0,0,2
5723,10,2,1,0,1,1
5723,9,1,1,0,0,1
5723,8,9,5,0,4,5
5723,7,10,5,0,5,5
5723,6,12,4,0,8,4
5723,5,7,3,0,4,3
4503,10,2,1,0,1,1
4503,8,9,2,0,7,2
4503,7,13,5,0,8,5
4503,6,12,4,0,8,4
4503,4,4,1,0,3,1
179912,9,4,1,0,3,1
179912,8,14,7,2,7,5
179912,7,7,2,0,5,2
179912,6,7,1,0,6,1
179912,5,5,3,0,2,3
179912,3,2,1,0,1,1
179912,1,1,1,0,0,1
34118,9,2,1,0,1,1
34118,8,13,9,0,4,9
34118,7,11,5,0,6,5
34118,6,11,6,0,5,6
34118,5,3,1,0,2,1
34118,2,1,1,0,0,1
12539,7,10,2,0,8,2
12539,6,13,1,0,12,1
12539,3,4,2,0,2,2
159774,8,2,1,0,1,1
159774,7,5,2,0,3,2
159774,6,16,1,0,15,1
159774,5,10,1,0,9,1
159774,4,11,1,0,10,1
162038,10,1,1,0,0,1
162038,9,2,1,0,1,1
162038,8,6,1,1,5,0
162038,7,16,4,1,12,3
162038,6,12,2,0,10,2
162038,5,4,3,1,1,2
162038,3,2,1,0,1,1
90471,7,9,3,0,6,3
90471,6,18,3,0,15,3
104858,10,3,2,0,1,2
104858,8,6,1,0,5,1
104858,4,5,3,0,2,3
243636,10,6,3,0,3,3
243636,9,8,3,0,5,3
243636,8,11,1,0,10,1
243636,6,6,1,0,5,1
243636,2,1,1,0,0,1
9565,10,2,1,0,1,1
9565,8,4,3,0,1,3
9565,7,6,2,0,4,2
9565,6,12,1,0,11,1
9565,5,12,4,0,8,4
9565,4,7,3,0,4,3
23643,10,1,1,0,0,1
23643,8,10,4,0,6,4
23643,7,14,5,0,9,5
23643,6,12,6,0,6,6
23643,5,4,1,0,3,1
23643,4,1,1,0,0,1
23643,3,2,2,0,0,2
4332,10,1,1,0,0,1
4332,9,5,2,0,3,2
4332,8,13,6,0,7,6
4332,7,16,7,0,9,7
4332,6,7,2,0,5,2
31412,8,14,7,0,7,7
31412,7,10,4,0,6,4
31412,6,7,3,0,4,3
31412,5,6,1,0,5,1
31412,4,2,1,0,1,1
4925,7,2,1,0,1,1
4925,6,4,2,0,2,2
4925,5,7,1,0,6,1
4925,2,10,6,0,4,6
4925,1,8,5,0,3,5
3564,9,1,1,0,0,1
3564,7,10,4,0,6,4
3564,6,14,6,0,8,6
3564,5,4,1,0,3,1
3564,4,5,2,0,3,2
3564,3,4,2,0,2,2
3564,2,3,1,0,2,1
190700,10,2,1,0,1,1
190700,9,9,1,0,8,1
190700,8,13,1,0,12,1
190700,6,5,1,0,4,1
190700,2,1,1,0,0,1
169550,10,4,3,0,1,3
169550,9,2,1,1,1,0
169550,8,9,4,0,5,4
169550,7,7,3,1,4,2
169550,6,14,2,0,12,2
169550,5,4,1,0,3,1
13378,8,3,1,0,2,1
13378,7,9,3,0,6,3
13378,6,16,6,0,10,6
13378,5,9,2,0,7,2
13378,4,4,1,0,3,1
13378,3,2,1,0,1,1
22406,9,2,2,0,0,2
22406,8,17,5,0,12,5
22406,7,7,1,0,6,1
22406,6,11,3,0,8,3
22406,5,4,4,0,0,4
153802,10,4,1,0,3,1
153802,9,9,3,1,6,2
153802,5,5,1,0,4,1
23733,9,3,2,0,1,2
23733,8,16,6,0,10,6
23733,7,13,5,0,8,5
23733,6,8,1,0,7,1
23733,3,1,1,0,0,1
12900,9,6,3,0,3,3
12900,8,10,5,0,5,5
12900,7,9,1,0,8,1
12900,6,12,3,0,9,3
12900,5,2,1,0,1,1
12900,4,2,1,0,1,1
12900,2,1,1,0,0,1
5201,9,3,2,0,1,2
5201,8,6,2,0,4,2
5201,7,3,1,0,2,1
5201,6,12,7,0,5,7
5201,5,10,3,0,7,3
5201,4,8,3,0,5,3
5201,3,3,1,0,2,1
243752,8,14,2,0,12,2
243752,5,3,1,0,2,1
243752,4,3,1,0,2,1
30023,10,2,1,0,1,1
30023,9,4,1,0,3,1
30023,8,6,3,0,3,3
30023,7,21,6,0,15,6
30023,6,5,1,0,4,1
30023,5,5,3,0,2,3
30023,3,1,1,0,0,1
145915,10,13,8,0,5,8
145915,9,8,5,0,3,5
145915,8,9,7,1,2,6
145915,7,4,1,0,3,1
145915,6,9,1,0,8,1
4969,6,23,6,0,17,6
4969,5,10,4,0,6,4
4969,4,2,1,0,1,1
4969,3,4,1,0,3,1
13919,8,3,1,0,2,1
13919,7,20,7,0,13,7
13919,6,9,2,0,7,2
13919,5,9,3,0,6,3
13919,4,2,1,0,1,1
7579,8,18,6,0,12,6
7579,7,14,7,0,7,7
7579,6,7,2,0,5,2
7579,5,2,2,0,0,2
7579,4,2,1,0,1,1
7579,2,1,1,0,0,1
104553,9,6,2,0,4,2
104553,8,10,2,0,8,2
104553,7,13,4,0,9,4
104553,6,9,2,0,7,2
104553,5,3,2,0,1,2
104553,4,1,1,0,0,1
11149,8,6,4,0,2,4
11149,7,10,3,0,7,3
11149,6,14,9,0,5,9
11149,5,5,2,0,3,2
11149,4,4,2,0,2,2
11149,3,4,2,0,2,2
7183,10,2,2,0,0,2
7183,8,4,1,0,3,1
7183,6,9,3,0,6,3
7183,5,11,3,0,8,3
7183,4,7,1,0,6,1
99286,10,6,3,0,3,3
99286,9,5,2,0,3,2
99286,8,9,4,1,5,3
99286,7,4,1,0,3,1
99286,6,6,1,0,5,1
99286,4,6,2,0,4,2
99286,3,4,2,0,2,2
99286,2,2,1,0,1,1
66256,9,2,2,0,0,2
66256,8,5,2,0,3,2
66256,7,9,2,0,7,2
66256,6,8,4,0,4,4
66256,5,8,3,0,5,3
66256,4,6,1,0,5,1
66256,2,1,1,0,0,1
66256,1,3,2,0,1,2
192729,7,6,3,0,3,3
192729,6,18,5,0,13,5
192729,5,15,3,0,12,3
76416,8,5,2,0,3,2
76416,7,7,4,0,3,4
76416,6,15,6,0,9,6
76416,4,4,1,0,3,1
24969,10,1,1,0,0,1
24969,8,1,1,0,0,1
24969,7,9,5,0,4,5
24969,6,17,5,0,12,5
24969,5,7,5,0,2,5
24969,4,8,2,0,6,2
24969,1,1,1,0,0,1
209863,10,3,1,0,2,1
209863,9,9,2,0,7,2
209863,8,14,6,0,8,6
209863,7,13,5,0,8,5
209863,6,4,1,0,3,1
209863,4,1,1,0,0,1
54743,8,6,3,0,3,3
54743,6,15,2,0,13,2
54743,5,8,1,0,7,1
54743,4,3,2,0,1,2
129272,9,2,1,0,1,1
129272,8,3,1,0,2,1
129272,7,9,4,0,5,4
129272,6,14,3,0,11,3
129272,5,7,2,0,5,2
129272,3,3,1,0,2,1
129272,2,4,2,0,2,2
123923,10,1,1,0,0,1
123923,8,6,3,0,3,3
123923,7,17,5,0,12,5
123923,6,12,5,0,7,5
123923,5,6,2,0,4,2
123923,4,2,1,0,1,1
11393,9,1,1,0,0,1
11393,8,2,1,0,1,1
11393,7,3,2,0,1,2
11393,6,8,4,0,4,4
11393,5,10,1,0,9,1
11393,4,8,4,0,4,4
11393,3,9,4,0,5,4
9571,9,2,1,0,1,1
9571,7,6,3,0,3,3
9571,6,15,6,0,9,6
9571,5,10,1,0,9,1
9571,4,7,5,0,2,5
9571,3,2,2,0,0,2
14088,10,3,2,0,1,2
14088,9,4,2,0,2,2
14088,8,9,3,0,6,3
14088,7,13,5,0,8,5
14088,6,9,2,0,7,2
14088,5,3,2,0,1,2
14088,4,1,1,0,0,1
14088,3,2,1,0,1,1
134884,10,2,1,0,1,1
134884,9,2,1,0,1,1
134884,8,8,2,0,6,2
134884,7,12,2,0,10,2
134884,6,8,3,0,5,3
134884,4,3,1,0,2,1
134884,2,1,1,0,0,1
134884,1,1,1,0,0,1
113324,8,6,2,0,4,2
113324,7,14,6,0,8,6
113324,6,10,5,0,5,5
113324,5,7,2,0,5,2
113324,4,5,3,0,2,3
113324,2,1,1,0,0,1
169463,6,20,2,0,18,2
169463,5,10,1,0,9,1
169463,3,2,1,0,1,1
169463,2,5,4,0,1,4
86006,9,4,2,0,2,2
86006,8,14,5,0,9,5
86006,7,7,1,0,6,1
86006,6,7,3,0,4,3
86006,5,7,1,0,6,1
86006,1,1,1,0,0,1
232661,9,1,1,0,0,1
232661,8,10,6,0,4,6
232661,7,16,4,0,12,4
232661,5,3,2,0,1,2
232661,4,3,2,0,1,2
34381,8,10,5,0,5,5
34381,7,13,6,0,7,6
34381,6,12,8,0,4,8
34381,5,7,3,0,4,3
57834,10,1,1,0,0,1
57834,8,4,4,0,0,4
57834,7,10,3,0,7,3
57834,6,11,4,0,7,4
57834,5,9,1,0,8,1
57834,4,3,2,0,1,2
57834,2,1,1,0,0,1
57834,1,4,1,0,3,1
10605,7,9,3,0,6,3
10605,6,18,3,0,15,3
1453,8,4,1,0,3,1
1453,7,8,3,0,5,3
1453,6,17,7,0,10,7
1453,5,6,1,0,5,1
1453,4,3,1,0,2,1
1453,3,3,2,0,1,2
1453,2,1,1,0,0,1
140973,10,1,1,0,0,1
140973,9,6,2,0,4,2
140973,8,14,3,0,11,3
140973,7,12,3,0,9,3
140973,3,1,1,0,0,1
140973,2,1,1,0,0,1
157675,6,16,1,0,15,1
162777,10,4,1,0,3,1
162777,9,4,1,0,3,1
162777,8,12,1,0,11,1
162777,7,9,2,0,7,2
162777,6,6,3,0,3,3
162777,5,8,1,0,7,1
165559,10,1,1,0,0,1
165559,7,8,3,0,5,3
165559,6,12,2,0,10,2
165559,4,4,1,0,3,1
165559,3,5,2,0,3,2
165559,2,3,1,0,2,1
211810,9,2,1,0,1,1
211810,8,8,3,0,5,3
211810,7,15,3,0,12,3
211810,6,14,6,0,8,6
211810,4,1,1,0,0,1
211810,3,1,1,0,0,1
116806,10,6,1,0,5,1
116806,9,9,1,0,8,1
116806,8,18,5,0,13,5
116806,7,7,2,0,5,2
116806,6,2,1,0,1,1
116806,4,1,1,0,0,1
229540,10,5,2,0,3,2
229540,8,17,2,0,15,2
229540,6,7,1,1,6,0
229957,9,1,1,0,0,1
229957,8,10,3,0,7,3
229957,7,11,1,0,10,1
229957,6,16,1,0,15,1
229957,4,3,1,0,2,1
229957,3,1,1,0,0,1
88005,8,3,1,0,2,1
88005,6,12,2,0,10,2
88005,3,2,1,0,1,1
88005,2,2,1,0,1,1
25475,9,1,1,0,0,1
25475,8,1,1,0,0,1
25475,6,13,2,0,11,2
25475,5,5,2,0,3,2
25475,4,9,2,0,7,2
25475,3,6,1,0,5,1
25475,2,5,3,0,2,3
25475,1,4,1,0,3,1
12189,10,1,1,0,0,1
12189,9,2,1,0,1,1
12189,8,10,5,0,5,5
12189,7,15,6,0,9,6
12189,6,8,2,0,6,2
12189,4,4,4,0,0,4
5930,9,1,1,0,0,1
5930,8,11,5,0,6,5
5930,7,8,3,0,5,3
5930,6,13,4,0,9,4
5930,5,6,2,0,4,2
5930,4,1,1,0,0,1
11756,9,6,3,0,3,3
11756,8,14,3,0,11,3
11756,7,8,3,0,5,3
11756,6,9,3,0,6,3
68187,10,5,1,0,4,1
68187,8,10,4,0,6,4
68187,7,9,4,0,5,4
68187,6,11,2,0,9,2
68187,3,1,1,0,0,1
68187,2,1,1,0,0,1
16018,9,2,1,0,1,1
16018,8,5,3,0,2,3
16018,7,10,3,0,7,3
16018,6,17,5,0,12,5
16018,5,4,1,0,3,1
16018,4,2,1,0,1,1
16018,3,2,1,0,1,1
16018,2,1,1,0,0,1
31558,10,1,1,0,0,1
31558,9,3,1,0,2,1
31558,8,6,5,0,1,5
31558,7,6,2,0,4,2
31558,6,15,7,0,8,7
31558,5,7,3,0,4,3
31558,4,4,1,0,3,1
31558,3,1,1,0,0,1
9860,9,3,1,0,2,1
9860,8,10,1,0,9,1
9860,7,13,3,0,10,3
9860,6,10,2,0,8,2
9860,5,4,2,0,2,2
9860,4,1,1,0,0,1
4152,7,5,3,0,2,3
4152,6,16,6,0,10,6
4152,5,7,3,0,4,3
4152,4,7,3,0,4,3
4152,3,5,2,0,3,2
4152,1,1,1,0,0,1
31770,10,2,1,0,1,1
31770,9,2,1,0,1,1
31770,8,9,6,0,3,6
31770,7,8,4,0,4,4
31770,6,13,6,0,7,6
31770,5,4,2,0,2,2
31770,3,2,1,0,1,1
23402,8,7,3,0,4,3
23402,7,7,2,0,5,2
23402,6,12,2,0,10,2
23402,5,3,1,0,2,1
23402,4,7,1,0,6,1
23402,3,4,2,0,2,2
23402,1,1,1,0,0,1
21412,8,5,3,0,2,3
21412,7,14,9,0,5,9
21412,6,12,5,0,7,5
21412,5,4,2,0,2,2
21412,4,4,1,0,3,1
21412,1,1,1,0,0,1
193696,10,3,1,0,2,1
193696,8,16,4,0,12,4
193696,7,8,2,0,6,2
193696,5,3,1,0,2,1
193696,4,3,1,0,2,1
193696,3,2,1,0,1,1
15153,10,2,1,0,1,1
15153,9,8,3,0,5,3
15153,8,16,9,0,7,9
15153,7,7,3,0,4,3
15153,6,7,3,0,4,3
15153,5,4,2,0,2,2
1076,9,1,1,0,0,1
1076,8,5,1,0,4,1
1076,7,7,2,0,5,2
1076,6,17,6,0,11,6
1076,5,9,2,0,7,2
1076,4,3,1,0,2,1
1812,9,1,1,0,0,1
1812,7,5,4,0,1,4
1812,6,14,4,0,10,4
1812,5,11,5,0,6,5
1812,4,6,2,0,4,2
1812,3,3,1,0,2,1
1812,1,3,2,0,1,2
17071,7,8,3,0,5,3
17071,6,10,2,0,8,2
17071,5,6,1,0,5,1
17071,4,8,5,0,3,5
17071,3,9,6,0,3,6
17071,1,1,1,0,0,1
182796,10,7,5,1,2,4
182796,9,4,4,0,0,4
182796,8,3,2,1,1,1
182796,7,7,1,0,6,1
182796,6,5,3,1,2,2
182796,5,7,3,0,4,3
182796,4,5,1,0,4,1
182796,3,5,2,0,3,2
106836,7,7,2,0,5,2
106836,6,14,1,0,13,1
106836,5,11,1,0,10,1
106836,4,6,1,0,5,1
106836,3,3,1,0,2,1
244274,9,7,1,0,6,1
244274,8,9,2,0,7,2
244274,7,16,4,0,12,4
244274,6,8,1,0,7,1
244274,5,1,1,0,0,1
244274,1,1,1,0,0,1
13333,8,6,3,0,3,3
13333,7,6,1,0,5,1
13333,6,12,1,0,11,1
13333,5,8,4,0,4,4
13333,4,6,1,0,5,1
13333,3,3,1,0,2,1
13333,1,2,1,0,1,1
41995,7,8,4,0,4,4
41995,6,15,4,0,11,4
41995,5,13,2,0,11,2
41995,4,3,2,0,1,2
262733,10,29,7,0,22,7
262733,6,3,1,0,2,1
197705,10,6,3,0,3,3
197705,9,12,7,3,5,4
197705,8,14,9,2,5,7
197705,7,4,2,0,2,2
197705,6,2,2,0,0,2
197705,5,1,1,0,0,1
197705,3,2,1,0,1,1
197705,2,2,1,0,1,1
232446,9,5,1,0,4,1
232446,8,10,1,0,9,1
232446,7,12,3,0,9,3
232446,4,2,1,0,1,1
229297,8,11,4,0,7,4
229297,7,12,4,0,8,4
229297,6,11,3,0,8,3
229297,5,3,1,0,2,1
229297,4,5,2,0,3,2
229297,2,1,1,0,0,1
223767,10,8,6,1,2,5
223767,8,12,1,0,11,1
223767,7,11,1,0,10,1
223767,1,2,2,1,0,1
9968,9,1,1,0,0,1
9968,8,5,2,0,3,2
9968,7,4,1,0,3,1
9968,6,12,1,0,11,1
9968,5,12,4,0,8,4
9968,3,1,1,0,0,1
9968,2,2,1,0,1,1
9968,1,4,3,0,1,3
10264,10,2,1,0,1,1
10264,9,3,3,0,0,3
10264,8,5,2,0,3,2
10264,7,8,2,0,6,2
10264,6,17,10,0,7,10
10264,4,1,1,0,0,1
11370,5,3,1,0,2,1
11370,4,2,1,0,1,1
11370,2,3,1,0,2,1
11370,1,7,4,0,3,4
194032,7,5,1,0,4,1
194032,6,15,2,0,13,2
194032,5,10,3,0,7,3
194032,4,5,2,0,3,2
194032,2,2,1,0,1,1
1952,8,5,2,0,3,2
1952,6,14,2,0,12,2
1952,5,3,1,0,2,1
1952,4,5,2,0,3,2
1952,3,2,1,0,1,1
7354,10,3,2,0,1,2
7354,7,14,5,0,9,5
7354,6,18,6,0,12,6
224794,8,12,1,0,11,1
224794,7,10,1,0,9,1
224794,6,12,6,0,6,6
224794,5,3,2,0,1,2
161600,8,11,3,0,8,3
161600,7,13,2,0,11,2
161600,6,10,3,0,7,3
3512,7,9,3,0,6,3
3512,6,16,6,0,10,6
3512,5,4,3,0,1,3
3512,4,6,2,0,4,2
3512,3,5,3,0,2,3
10780,9,1,1,0,0,1
10780,8,7,6,0,1,6
10780,7,8,5,0,3,5
10780,6,20,8,0,12,8
10780,5,5,2,0,3,2
10780,4,1,1,0,0,1
10780,3,1,1,0,0,1
10780,2,1,1,0,0,1
4655,8,3,1,0,2,1
4655,7,6,4,0,2,4
4655,6,11,4,0,7,4
4655,5,11,4,0,7,4
4655,4,6,3,0,3,3
4655,3,3,3,0,0,3
4655,2,3,2,0,1,2
3238,7,14,3,0,11,3
3238,6,20,2,0,18,2
3238,4,1,1,0,0,1
204541,10,7,4,0,3,4
204541,9,15,6,0,9,6
204541,8,12,3,0,9,3
204541,6,1,1,1,0,0
204541,4,1,1,0,0,1
204541,2,2,2,0,0,2
7715,10,2,1,0,1,1
7715,7,6,5,0,1,5
7715,6,10,3,0,7,3
7715,4,7,1,0,6,1
7715,3,6,3,0,3,3
7715,2,5,2,0,3,2
7715,1,1,1,0,0,1
19571,8,2,1,0,1,1
19571,5,16,3,0,13,3
19571,4,9,6,0,3,6
19571,3,5,3,0,2,3
19571,1,5,2,0,3,2
22227,8,9,5,0,4,5
22227,7,16,7,0,9,7
22227,6,11,5,0,6,5
22227,5,4,2,0,2,2
12059,10,3,2,0,1,2
12059,9,2,1,0,1,1
12059,8,4,2,0,2,2
12059,7,10,4,0,6,4
12059,6,10,3,0,7,3
12059,5,7,3,0,4,3
12059,4,3,1,0,2,1
12059,3,2,1,0,1,1
12059,2,3,1,0,2,1
3989,10,1,1,0,0,1
3989,7,8,4,0,4,4
3989,6,12,4,0,8,4
3989,5,8,1,0,7,1
3989,4,4,3,0,1,3
3989,3,2,1,0,1,1
30947,5,11,1,0,10,1
30947,4,8,2,0,6,2
30947,3,5,5,0,0,5
30947,2,7,4,0,3,4
30947,1,3,2,0,1,2
3524,7,2,1,0,1,1
3524,6,12,4,0,8,4
3524,5,13,1,0,12,1
3524,4,9,3,0,6,3
3524,3,4,1,0,3,1
3524,1,2,2,0,0,2
8753,9,1,1,0,0,1
8753,8,2,2,0,0,2
8753,7,13,8,0,5,8
8753,6,5,2,0,3,2
8753,5,14,6,0,8,6
8753,4,5,2,0,3,2
30286,10,1,1,0,0,1
30286,8,8,3,0,5,3
30286,7,10,3,0,7,3
30286,6,15,4,0,11,4
30286,5,6,4,0,2,4
30286,4,2,1,0,1,1
30286,3,2,1,0,1,1
211962,9,2,1,0,1,1
211962,8,13,5,0,8,5
211962,7,11,4,0,7,4
211962,6,11,2,0,9,2
211962,5,6,1,0,5,1
120579,8,2,2,0,0,2
120579,7,1,1,0,0,1
120579,6,15,2,0,13,2
120579,5,12,1,0,11,1
120579,4,5,1,0,4,1
120579,2,4,2,0,2,2
235534,9,2,1,0,1,1
235534,6,14,2,0,12,2
235534,5,8,1,0,7,1
235534,4,12,1,0,11,1
235534,3,4,1,0,3,1
235534,2,1,1,0,0,1
47484,10,8,3,1,5,2
47484,9,7,2,0,5,2
47484,8,18,6,0,12,6
47484,7,8,4,0,4,4
184159,7,2,1,0,1,1
184159,5,13,5,0,8,5
184159,4,15,4,0,11,4
184159,3,5,1,0,4,1
184159,2,6,4,0,2,4
184159,1,1,1,0,0,1
184266,9,3,1,0,2,1
184266,8,9,1,1,8,0
184266,7,5,2,0,3,2
184266,6,15,2,0,13,2
184266,5,10,3,0,7,3
232823,8,14,3,0,11,3
232823,7,13,2,0,11,2
232823,6,14,1,0,13,1
67628,6,10,4,0,6,4
67628,5,9,3,0,6,3
67628,4,11,3,0,8,3
67628,3,5,1,0,4,1
67628,2,5,2,0,3,2
67628,1,2,2,0,0,2
7779,10,4,2,0,2,2
7779,9,5,5,0,0,5
7779,8,9,2,0,7,2
7779,7,13,4,0,9,4
7779,6,7,1,0,6,1
7779,5,6,3,0,3,3
27374,7,6,1,0,5,1
27374,6,13,2,0,11,2
27374,5,7,1,0,6,1
27374,4,7,2,0,5,2
27374,3,3,1,0,2,1
27374,2,5,1,0,4,1
85165,10,8,3,0,5,3
85165,9,6,3,0,3,3
85165,8,8,1,0,7,1
85165,7,10,3,0,7,3
85165,6,4,2,0,2,2
85165,4,2,1,0,1,1
85165,3,1,1,0,0,1
85165,1,2,1,0,1,1
227254,10,4,1,0,3,1
227254,9,1,1,0,0,1
227254,8,9,4,0,5,4
227254,7,17,4,0,13,4
227254,6,8,2,0,6,2
255255,9,2,1,0,1,1
255255,8,9,3,0,6,3
255255,7,11,3,0,8,3
255255,6,8,2,1,6,1
255255,4,2,1,1,1,0
255255,2,3,2,0,1,2
29491,9,1,1,0,0,1
29491,8,5,2,0,3,2
29491,7,8,4,0,4,4
29491,6,10,5,0,5,5
29491,5,9,4,0,5,4
29491,4,3,1,0,2,1
29491,3,3,2,0,1,2
29491,2,3,2,0,1,2
205495,7,12,3,0,9,3
205495,6,16,1,0,15,1
194496,8,3,1,0,2,1
194496,7,6,2,0,4,2
194496,6,15,2,0,13,2
194496,4,5,2,0,3,2
4345,8,1,1,0,0,1
4345,7,4,1,0,3,1
4345,5,8,2,0,6,2
4345,4,13,4,0,9,4
4345,3,8,4,0,4,4
4345,2,3,2,0,1,2
4345,1,3,2,0,1,2
5561,7,7,2,0,5,2
5561,6,14,9,0,5,9
5561,5,12,2,0,10,2
5561,4,7,3,0,4,3
5561,2,2,1,0,1,1
166537,10,3,1,0,2,1
166537,8,1,1,0,0,1
166537,6,13,3,0,10,3
166537,5,9,3,0,6,3
166537,4,5,2,0,3,2
166537,3,7,4,1,3,3
166537,1,2,1,0,1,1
39276,7,4,2,0,2,2
39276,6,13,4,0,9,4
39276,5,8,2,0,6,2
39276,4,11,4,0,7,4
39276,3,2,1,0,1,1
4298,8,6,3,0,3,3
4298,7,7,1,0,6,1
4298,6,9,3,0,6,3
4298,5,10,2,0,8,2
4298,4,10,1,0,9,1
162727,8,8,2,0,6,2
162727,7,10,2,0,8,2
162727,6,10,4,0,6,4
162727,5,5,1,0,4,1
162727,4,4,1,0,3,1
162727,3,2,1,0,1,1
162727,1,2,1,0,1,1
12040,10,2,2,0,0,2
12040,9,9,4,0,5,4
12040,8,14,3,0,11,3
12040,7,9,7,0,2,7
12040,6,9,4,0,5,4
12040,3,1,1,0,0,1
238919,9,4,1,0,3,1
238919,8,12,6,0,6,6
238919,7,18,3,0,15,3
238919,6,8,3,0,5,3
238919,5,2,1,0,1,1
4290,9,3,1,0,2,1
4290,8,16,7,0,9,7
4290,7,13,3,0,10,3
4290,4,2,1,0,1,1
31421,9,4,3,0,1,3
31421,8,7,4,0,3,4
31421,7,5,2,0,3,2
31421,6,8,1,0,7,1
31421,5,10,4,0,6,4
31421,3,5,3,0,2,3
31421,2,3,1,0,2,1
101660,8,5,1,0,4,1
101660,7,8,2,0,6,2
101660,6,15,3,0,12,3
101660,5,6,2,0,4,2
101660,4,2,1,0,1,1
3538,8,1,1,0,0,1
3538,6,12,3,0,9,3
3538,5,9,6,0,3,6
3538,4,5,1,0,4,1
3538,3,6,2,0,4,2
3538,2,3,1,0,2,1
3538,1,7,2,0,5,2
189663,9,11,6,0,5,6
189663,8,11,2,0,9,2
189663,7,10,3,0,7,3
189663,6,9,3,0,6,3
13299,10,2,1,0,1,1
13299,9,1,1,0,0,1
13299,7,10,3,0,7,3
13299,6,14,3,0,11,3
13299,5,7,3,0,4,3
13299,4,3,1,0,2,1
66852,8,2,2,0,0,2
66852,7,3,1,0,2,1
66852,6,19,4,0,15,4
66852,5,7,1,0,6,1
66852,4,6,3,0,3,3
66852,3,4,2,0,2,2
117885,7,12,3,0,9,3
117885,6,16,5,0,11,5
117885,5,8,2,0,6,2
117885,4,3,1,0,2,1
117885,2,1,1,0,0,1
175468,10,4,4,1,0,3
175468,9,7,4,0,3,4
175468,8,7,4,0,3,4
175468,7,9,1,0,8,1
175468,6,6,1,0,5,1
175468,5,5,2,0,3,2
175468,4,4,2,0,2,2
175468,3,1,1,0,0,1
175468,1,1,1,0,0,1
10361,8,16,6,0,10,6
10361,7,12,2,0,10,2
10361,6,7,4,0,3,4
10361,4,3,2,0,1,2
14233,7,6,2,0,4,2
14233,6,16,4,0,12,4
14233,5,13,2,0,11,2
14233,4,6,1,0,5,1
171912,10,1,1,0,0,1
171912,8,4,1,0,3,1
171912,7,10,1,0,9,1
171912,6,13,2,0,11,2
171912,5,8,2,0,6,2
171912,4,1,1,0,0,1
171912,2,1,1,0,0,1
9776,9,2,2,0,0,2
9776,8,4,2,0,2,2
9776,7,6,4,0,2,4
9776,6,12,4,0,8,4
9776,5,9,6,0,3,6
9776,4,7,2,0,5,2
9776,3,4,3,0,1,3
160353,10,3,2,0,1,2
160353,9,5,1,0,4,1
160353,8,5,1,0,4,1
160353,6,7,2,0,5,2
160353,5,2,1,0,1,1
160353,4,9,2,0,7,2
160353,2,1,1,0,0,1
11241,10,4,1,0,3,1
11241,8,6,1,0,5,1
11241,7,17,7,0,10,7
11241,6,8,1,0,7,1
11241,5,4,1,0,3,1
204429,4,2,1,0,1,1
204429,3,2,1,0,1,1
8409,8,2,1,0,1,1
8409,7,5,1,0,4,1
8409,6,19,5,0,14,5
8409,5,12,5,0,7,5
8409,3,1,1,0,0,1
412,7,12,2,0,10,2
412,6,11,3,0,8,3
412,5,5,1,0,4,1
412,4,5,3,0,2,3
412,2,1,1,0,0,1
4875,8,7,4,0,3,4
4875,7,12,5,0,7,5
4875,6,15,6,0,9,6
4875,5,5,2,0,3,2
138682,10,3,2,0,1,2
138682,9,4,2,0,2,2
138682,8,11,5,0,6,5
138682,7,9,2,0,7,2
138682,6,9,2,0,7,2
138682,2,2,2,0,0,2
113517,8,3,1,0,2,1
113517,7,7,2,0,5,2
113517,6,15,2,0,13,2
113517,5,9,2,0,7,2
113517,4,4,1,0,3,1
35661,8,3,1,0,2,1
35661,7,6,1,0,5,1
35661,6,24,12,0,12,12
35661,5,5,1,0,4,1
35661,4,3,2,0,1,2
80972,6,14,4,0,10,4
80972,5,13,4,0,9,4
80972,4,4,1,0,3,1
17830,7,8,3,0,5,3
17830,6,11,6,0,5,6
17830,5,12,3,0,9,3
17830,4,5,2,0,3,2
17830,3,1,1,0,0,1
17830,1,1,1,0,0,1
40886,6,7,3,0,4,3
40886,5,15,2,0,13,2
40886,4,12,1,0,11,1
40886,3,5,4,0,1,4
130400,10,3,2,0,1,2
130400,9,2,2,0,0,2
130400,8,9,4,0,5,4
130400,7,13,1,0,12,1
130400,6,13,1,0,12,1
130400,4,2,1,0,1,1
154244,9,2,1,0,1,1
154244,8,5,1,0,4,1
154244,7,10,5,0,5,5
154244,6,19,5,0,14,5
154244,5,4,2,0,2,2
154244,4,2,1,0,1,1
821,10,1,1,0,0,1
821,8,4,1,0,3,1
821,7,4,2,0,2,2
821,6,10,1,0,9,1
821,5,13,3,0,10,3
821,4,6,1,0,5,1
821,2,1,1,0,0,1
16456,9,5,2,0,3,2
16456,8,16,4,0,12,4
16456,7,16,7,0,9,7
16456,6,7,2,0,5,2
7088,10,3,3,0,0,3
7088,9,2,2,0,0,2
7088,8,3,2,0,1,2
7088,7,7,2,0,5,2
7088,6,14,1,0,13,1
7088,4,3,1,0,2,1
7088,3,2,1,0,1,1
7088,2,2,1,0,1,1
150615,9,4,1,0,3,1
150615,8,5,1,0,4,1
150615,7,6,1,0,5,1
150615,6,12,1,0,11,1
150615,5,5,1,0,4,1
150615,4,5,1,0,4,1
150615,3,4,1,0,3,1
150615,2,1,1,0,0,1
150615,1,2,2,0,0,2
141467,8,13,7,0,6,7
141467,7,9,3,0,6,3
141467,6,11,3,0,8,3
141467,5,4,2,0,2,2
141467,4,2,1,0,1,1
10898,8,5,1,0,4,1
10898,7,13,5,0,8,5
10898,6,11,5,0,6,5
10898,5,3,1,0,2,1
10898,4,8,3,0,5,3
792,10,1,1,0,0,1
792,8,4,3,0,1,3
792,6,16,7,0,9,7
792,5,11,6,0,5,6
792,4,2,1,0,1,1
792,3,2,2,0,0,2
39426,9,7,4,0,3,4
39426,8,21,6,0,15,6
39426,7,8,4,0,4,4
39426,6,4,2,0,2,2
6400,9,5,2,0,3,2
6400,8,13,7,0,6,7
6400,7,12,3,0,9,3
6400,6,9,4,0,5,4
6400,5,2,2,0,0,2
6400,4,3,1,0,2,1
206938,8,9,2,0,7,2
206938,7,9,3,0,6,3
206938,6,14,1,0,13,1
206938,5,8,1,0,7,1
206938,4,2,1,0,1,1
217177,10,1,1,0,0,1
217177,8,3,3,0,0,3
217177,7,10,1,0,9,1
217177,6,12,1,0,11,1
217177,5,7,1,0,6,1
217177,4,5,1,0,4,1
7141,8,3,2,0,1,2
7141,7,17,3,0,14,3
7141,6,15,5,0,10,5
7141,2,1,1,0,0,1
224830,10,3,2,0,1,2
224830,9,10,3,0,7,3
224830,8,15,4,0,11,4
224830,7,10,3,0,7,3
224830,6,2,1,0,1,1
224830,5,3,2,1,1,1
217671,8,8,1,0,7,1
217671,7,7,1,0,6,1
217671,6,9,3,0,6,3
217671,5,9,2,0,7,2
217671,4,6,1,0,5,1
217671,2,2,1,0,1,1
7254,8,5,3,0,2,3
7254,7,15,2,0,13,2
7254,6,14,4,0,10,4
7254,5,5,2,0,3,2
10785,10,2,1,0,1,1
10785,9,3,1,0,2,1
10785,8,7,2,0,5,2
10785,7,12,4,0,8,4
10785,6,12,2,0,10,2
10785,5,3,1,0,2,1
10785,4,3,2,0,1,2
23333,6,4,1,0,3,1
23333,5,8,4,0,4,4
23333,4,13,6,0,7,6
23333,3,10,5,0,5,5
23333,2,8,4,0,4,4
23333,1,1,1,0,0,1
17323,8,1,1,0,0,1
17323,6,6,4,0,2,4
17323,5,10,2,0,8,2
17323,4,14,5,0,9,5
17323,3,7,3,0,4,3
17323,2,2,1,0,1,1
227316,10,3,2,0,1,2
227316,9,4,3,0,1,3
227316,8,11,3,0,8,3
227316,6,7,1,0,6,1
227316,5,5,2,0,3,2
227316,3,2,1,0,1,1
8923,9,3,2,0,1,2
8923,8,10,3,0,7,3
8923,7,14,4,0,10,4
8923,6,13,5,0,8,5
11085,8,5,1,0,4,1
11085,7,10,1,0,9,1
11085,6,11,4,0,7,4
11085,5,11,4,0,7,4
17787,9,4,1,0,3,1
17787,8,8,1,0,7,1
17787,6,6,2,0,4,2
17787,5,6,3,0,3,3
17787,4,7,4,0,3,4
17787,3,2,1,0,1,1
17787,1,1,1,0,0,1
70922,9,3,1,0,2,1
70922,8,6,2,0,4,2
70922,7,5,2,0,3,2
70922,6,15,5,0,10,5
70922,5,8,3,0,5,3
70922,4,3,1,0,2,1
70922,1,3,2,0,1,2
29146,8,4,3,0,1,3
29146,7,13,5,0,8,5
29146,5,8,1,0,7,1
29146,4,5,1,0,4,1
29146,1,1,1,0,0,1
156113,8,3,2,0,1,2
156113,7,13,4,1,9,3
156113,6,14,1,0,13,1
156113,3,3,2,0,1,2
176916,9,3,2,1,1,1
176916,8,11,3,1,8,2
176916,7,12,5,1,7,4
176916,6,15,1,0,14,1
176916,4,1,1,0,0,1
5364,9,7,2,0,5,2
5364,8,9,5,0,4,5
5364,7,7,1,0,6,1
5364,6,14,5,0,9,5
5364,4,1,1,0,0,1
5364,2,1,1,0,0,1
40974,6,12,2,0,10,2
40974,4,6,2,0,4,2
40974,1,4,3,0,1,3
216647,10,3,1,0,2,1
216647,8,4,1,0,3,1
216647,6,11,1,0,10,1
216647,5,8,2,0,6,2
216647,4,9,2,0,7,2
216647,2,1,1,0,0,1
216647,1,1,1,0,0,1
241266,9,1,1,0,0,1
241266,8,15,4,0,11,4
241266,7,12,5,0,7,5
241266,6,9,3,0,6,3
241266,5,4,1,0,3,1
6665,8,3,2,0,1,2
6665,7,7,2,0,5,2
6665,6,14,4,0,10,4
6665,5,11,6,0,5,6
6665,4,7,2,0,5,2
242753,10,5,2,0,3,2
242753,9,7,1,0,6,1
242753,8,16,1,0,15,1
242753,7,10,1,0,9,1
242753,3,1,1,0,0,1
242753,1,2,2,0,0,2
11293,8,10,8,0,2,8
11293,7,10,3,0,7,3
11293,6,8,4,0,4,4
11293,5,3,3,0,0,3
11293,4,5,1,0,4,1
132456,9,13,3,0,10,3
132456,8,18,2,0,16,2
132456,6,2,1,0,1,1
132456,5,2,2,0,0,2
218489,10,23,14,0,9,14
218489,9,8,4,0,4,4
218489,8,5,1,0,4,1
218489,2,1,1,0,0,1
227813,10,7,1,0,6,1
227813,9,11,6,0,5,6
227813,7,8,1,0,7,1
227813,6,4,2,0,2,2
227813,5,3,1,0,2,1
227813,1,3,1,0,2,1
5690,6,9,5,0,4,5
5690,4,10,4,0,6,4
5690,3,6,3,0,3,3
5690,2,3,1,0,2,1
3472,9,3,1,0,2,1
3472,8,12,3,0,9,3
3472,7,12,1,0,11,1
3472,5,5,2,0,3,2
5692,9,4,1,0,3,1
5692,8,13,3,0,10,3
5692,7,10,3,0,7,3
5692,5,6,3,0,3,3
5692,4,3,2,0,1,2
5692,2,1,1,0,0,1
148213,10,22,11,0,11,11
148213,9,11,4,0,7,4
148213,7,4,2,0,2,2
64608,5,7,1,0,6,1
64608,4,8,1,0,7,1
64608,3,9,2,0,7,2
64608,2,4,1,0,3,1
64608,1,7,2,0,5,2
253215,10,2,1,0,1,1
253215,9,4,2,0,2,2
253215,8,16,6,1,10,5
253215,7,12,2,0,10,2
246685,9,5,1,0,4,1
246685,7,12,3,0,9,3
246685,6,8,2,0,6,2
246685,4,3,1,0,2,1
116821,7,6,1,0,5,1
116821,6,8,2,0,6,2
116821,4,10,1,0,9,1
116821,1,3,1,0,2,1
21188,9,3,3,0,0,3
21188,8,3,2,0,1,2
21188,7,15,8,0,7,8
21188,6,15,5,0,10,5
21188,5,5,4,0,1,4
21188,4,2,2,0,0,2
15559,10,1,1,0,0,1
15559,8,1,1,0,0,1
15559,7,8,2,0,6,2
15559,6,18,4,0,14,4
15559,5,9,5,0,4,5
15559,4,4,2,0,2,2
15559,1,1,1,0,0,1
1871,6,12,6,0,6,6
1871,5,11,2,0,9,2
1871,3,5,3,0,2,3
1871,2,3,1,0,2,1
1871,1,2,1,0,1,1
3502,7,4,1,0,3,1
3502,6,8,2,0,6,2
3502,5,9,2,0,7,2
3502,4,6,4,0,2,4
3502,3,10,3,0,7,3
3502,1,2,1,0,1,1
5460,10,1,1,0,0,1
5460,9,3,3,0,0,3
5460,8,6,2,0,4,2
5460,7,7,6,0,1,6
5460,6,16,10,0,6,10
5460,5,6,4,0,2,4
5460,4,3,1,0,2,1
5460,2,1,1,0,0,1
5460,1,1,1,0,0,1
3610,6,12,5,0,7,5
3610,5,9,2,0,7,2
3610,4,7,1,0,6,1
3610,3,9,3,0,6,3
9248,8,2,1,0,1,1
9248,7,8,2,0,6,2
9248,6,15,2,0,13,2
9248,5,12,8,0,4,8
9248,4,4,3,0,1,3
13944,6,12,7,0,5,7
13944,5,12,2,0,10,2
13944,4,10,7,0,3,7
13944,3,6,4,0,2,4
9705,7,6,1,0,5,1
9705,5,8,1,0,7,1
9705,4,7,1,0,6,1
9705,3,8,4,0,4,4
9705,2,4,1,0,3,1
20028,6,8,2,0,6,2
20028,5,12,6,0,6,6
20028,4,9,3,0,6,3
20028,3,10,6,0,4,6
20028,1,2,1,0,1,1
6333,9,2,1,0,1,1
6333,8,1,1,0,0,1
6333,7,8,4,0,4,4
6333,6,12,4,0,8,4
6333,4,5,1,0,4,1
6333,3,4,2,0,2,2
6333,1,2,1,0,1,1
262635,7,15,1,0,14,1
262635,6,14,1,0,13,1
262635,5,6,2,0,4,2
262635,3,1,1,0,0,1
179975,6,13,1,0,12,1
179975,5,7,1,0,6,1
179975,3,8,1,0,7,1
95503,10,5,1,0,4,1
95503,8,6,4,0,2,4
95503,7,10,3,0,7,3
95503,6,11,5,0,6,5
95503,5,7,1,0,6,1
3239,10,3,2,0,1,2
3239,9,1,1,0,0,1
3239,8,4,4,0,0,4
3239,6,12,3,0,9,3
3239,5,13,2,0,11,2
3239,3,4,2,0,2,2
231042,10,1,1,0,0,1
231042,9,1,1,0,0,1
231042,7,7,1,0,6,1
231042,6,18,3,0,15,3
231042,5,8,2,0,6,2
231042,4,4,2,0,2,2
231042,3,1,1,0,0,1
6735,10,2,1,0,1,1
6735,8,11,7,0,4,7
6735,7,9,3,0,6,3
6735,6,8,3,0,5,3
6735,5,6,3,0,3,3
6735,4,1,1,0,0,1
195476,10,3,2,0,1,2
195476,9,2,2,1,0,1
195476,8,7,2,0,5,2
195476,7,9,2,0,7,2
195476,4,6,3,0,3,3
195476,3,2,1,0,1,1
29278,9,8,1,0,7,1
29278,8,15,5,0,10,5
29278,7,10,2,0,8,2
29278,6,5,2,0,3,2
29278,5,2,1,0,1,1
155745,8,14,3,0,11,3
8258,10,5,4,0,1,4
8258,9,3,2,0,1,2
8258,8,19,10,0,9,10
8258,6,8,2,0,6,2
19030,7,9,4,0,5,4
19030,6,13,3,0,10,3
19030,5,9,5,0,4,5
19030,4,6,2,0,4,2
128672,8,3,2,1,1,1
128672,5,9,3,0,6,3
128672,3,10,2,0,8,2
128672,2,5,3,0,2,3
172517,7,14,1,0,13,1
172517,6,9,1,0,8,1
50560,9,3,2,0,1,2
50560,8,11,4,0,7,4
50560,7,14,3,0,11,3
50560,6,11,1,0,10,1
50560,5,2,1,0,1,1
50560,4,2,1,0,1,1
9858,10,6,1,0,5,1
9858,9,7,1,0,6,1
9858,8,17,3,0,14,3
9858,7,5,1,0,4,1
9858,6,5,1,0,4,1
9858,5,3,1,0,2,1
24079,8,12,2,0,10,2
24079,7,12,2,0,10,2
24079,6,9,1,0,8,1
24079,5,5,2,0,3,2
183528,8,9,3,0,6,3
183528,7,12,1,0,11,1
183528,6,12,2,0,10,2
183528,4,3,1,0,2,1
6605,7,1,1,0,0,1
6605,6,9,2,0,7,2
6605,5,10,3,0,7,3
6605,4,9,2,0,7,2
6605,3,5,3,0,2,3
6605,2,6,2,0,4,2
6605,1,1,1,0,0,1
171090,6,8,3,0,5,3
171090,5,10,1,0,9,1
171090,3,12,3,0,9,3
171090,2,5,1,0,4,1
171090,1,1,1,0,0,1
162012,9,5,1,0,4,1
162012,7,13,2,0,11,2
162012,6,12,2,0,10,2
139963,8,7,3,0,4,3
139963,7,12,3,0,9,3
139963,6,8,2,0,6,2
139963,5,7,1,1,6,0
139963,4,5,3,0,2,3
139963,3,2,1,0,1,1
10822,10,2,1,0,1,1
10822,8,9,2,0,7,2
10822,7,17,5,0,12,5
10822,6,9,4,0,5,4
10822,3,1,1,0,0,1
10822,2,1,1,0,0,1
97433,9,1,1,0,0,1
97433,8,13,3,0,10,3
97433,7,15,5,0,10,5
97433,6,9,2,0,7,2
97433,5,5,2,0,3,2
124918,9,7,5,0,2,5
124918,7,13,5,0,8,5
124918,6,11,1,0,10,1
153107,10,2,1,0,1,1
153107,9,2,1,0,1,1
153107,8,15,10,2,5,8
153107,7,8,1,0,7,1
153107,6,5,1,0,4,1
153107,5,3,2,0,1,2
153107,4,4,3,0,1,3
153107,1,1,1,1,0,0
192731,7,19,1,0,18,1
192731,6,12,5,0,7,5
34195,9,2,1,0,1,1
34195,8,12,3,0,9,3
34195,7,14,6,0,8,6
34195,6,9,4,0,5,4
34195,3,3,1,0,2,1
34195,2,1,1,0,0,1
3047,8,2,1,0,1,1
3047,7,6,1,0,5,1
3047,6,15,3,0,12,3
3047,5,4,3,0,1,3
3047,3,4,1,0,3,1
3047,2,2,2,0,0,2
3047,1,1,1,0,0,1
6219,9,1,1,0,0,1
6219,7,9,5,0,4,5
6219,6,13,7,0,6,7
6219,5,10,1,0,9,1
6219,4,6,1,0,5,1
6219,3,2,1,0,1,1
6219,2,2,2,0,0,2
74310,6,14,3,0,11,3
74310,5,9,2,0,7,2
74310,4,3,1,0,2,1
74310,3,1,1,0,0,1
74310,2,4,2,0,2,2
74310,1,3,2,0,1,2
206087,10,12,3,0,9,3
206087,9,9,3,0,6,3
206087,8,10,3,0,7,3
206087,7,3,1,0,2,1
206087,6,3,1,0,2,1
206087,5,3,2,0,1,2
30438,8,7,3,0,4,3
30438,7,15,3,0,12,3
30438,6,8,1,0,7,1
30438,5,7,1,0,6,1
202742,10,3,1,0,2,1
202742,7,10,3,0,7,3
202742,6,4,2,0,2,2
202742,2,1,1,0,0,1
233994,9,3,1,0,2,1
233994,8,7,2,0,5,2
233994,6,10,1,0,9,1
233994,5,7,2,0,5,2
233994,3,4,4,0,0,4
233994,1,2,1,0,1,1
229235,10,3,1,0,2,1
229235,9,3,1,0,2,1
229235,8,10,3,0,7,3
229235,7,16,3,0,13,3
229235,6,4,1,0,3,1
229235,5,5,1,0,4,1
229235,4,3,2,0,1,2
140743,9,5,1,0,4,1
140743,8,11,6,0,5,6
140743,6,12,2,0,10,2
159501,10,4,3,0,1,3
159501,9,5,2,0,3,2
159501,8,9,2,1,7,1
159501,7,6,2,1,4,1
159501,5,7,2,0,5,2
159501,3,4,2,0,2,2
251350,9,8,2,0,6,2
251350,8,10,5,2,5,3
251350,7,10,1,1,9,0
251350,6,11,1,0,10,1
251350,5,4,1,0,3,1
164838,9,3,1,0,2,1
164838,8,1,1,0,0,1
164838,7,10,4,0,6,4
164838,6,16,2,0,14,2
164838,5,5,1,0,4,1
164838,4,5,3,0,2,3
164838,3,3,1,0,2,1
37849,7,1,1,0,0,1
37849,6,3,3,0,0,3
37849,5,16,10,0,6,10
37849,4,11,5,0,6,5
37849,3,5,1,0,4,1
37849,2,4,1,0,3,1
8675,8,1,1,0,0,1
8675,7,8,3,0,5,3
8675,6,16,7,0,9,7
8675,5,6,2,0,4,2
8675,4,6,2,0,4,2
8675,3,5,1,0,4,1
8253,9,1,1,0,0,1
8253,7,9,4,0,5,4
8253,6,12,6,0,6,6
8253,5,11,2,0,9,2
8253,3,3,2,0,1,2
159333,10,4,1,0,3,1
159333,9,8,3,0,5,3
159333,8,14,4,0,10,4
159333,7,10,3,0,7,3
159333,6,3,1,0,2,1
159333,2,1,1,0,0,1
33799,9,1,1,0,0,1
33799,7,5,4,0,1,4
33799,6,10,6,0,4,6
33799,5,9,1,0,8,1
33799,4,4,2,0,2,2
33799,3,6,1,0,5,1
33799,2,7,5,0,2,5
33799,1,1,1,0,0,1
7421,10,2,2,0,0,2
7421,6,12,3,0,9,3
7421,5,12,3,0,9,3
7421,4,7,1,0,6,1
7421,3,2,2,0,0,2
127258,9,2,2,0,0,2
127258,7,10,2,0,8,2
127258,6,19,5,0,14,5
127258,5,6,1,0,5,1
127258,2,1,1,0,0,1
148007,10,2,2,0,0,2
148007,9,5,3,0,2,3
148007,8,19,7,0,12,7
148007,7,10,3,0,7,3
148007,6,7,4,0,3,4
113066,8,2,2,0,0,2
113066,7,12,3,0,9,3
113066,6,20,4,0,16,4
113066,5,5,3,0,2,3
113066,4,2,1,0,1,1
113066,3,1,1,0,0,1
29286,10,2,1,0,1,1
29286,8,3,2,0,1,2
29286,7,13,3,0,10,3
29286,6,16,7,0,9,7
29286,5,7,2,0,5,2
165190,9,2,1,0,1,1
165190,7,11,2,0,9,2
165190,6,13,1,0,12,1
165190,5,5,1,0,4,1
165190,4,5,1,0,4,1
14698,8,7,2,0,5,2
14698,7,16,5,0,11,5
14698,6,7,2,0,5,2
14698,4,3,1,0,2,1
14698,3,4,1,0,3,1
26890,8,11,4,0,7,4
26890,7,14,4,0,10,4
26890,6,13,3,0,10,3
26890,5,4,1,0,3,1
1715,10,2,1,0,1,1
1715,7,4,4,0,0,4
1715,6,11,3,0,8,3
1715,5,11,1,0,10,1
1715,4,10,1,0,9,1
1715,3,2,1,0,1,1
1715,2,1,1,0,0,1
14814,9,3,2,0,1,2
14814,8,12,4,0,8,4
14814,7,10,2,0,8,2
14814,6,12,4,0,8,4
14814,5,3,1,0,2,1
14814,4,2,1,0,1,1
6890,9,1,1,0,0,1
6890,8,12,4,0,8,4
6890,7,11,4,0,7,4
6890,6,8,2,0,6,2
6890,4,1,1,0,0,1
6890,3,2,1,0,1,1
187806,7,12,2,0,10,2
187806,6,12,3,0,9,3
187806,3,2,2,0,0,2
187806,2,1,1,0,0,1
99918,10,1,1,0,0,1
99918,6,1,1,0,0,1
99918,5,1,1,0,0,1
99918,2,1,1,0,0,1
99918,1,39,12,0,27,12
12369,10,1,1,0,0,1
12369,9,4,1,0,3,1
12369,8,10,5,0,5,5
12369,7,8,2,0,6,2
12369,6,14,6,0,8,6
12369,5,3,1,0,2,1
12369,2,1,1,0,0,1
12369,1,1,1,0,0,1
12139,9,2,1,0,1,1
12139,8,13,4,0,9,4
12139,7,11,1,0,10,1
12139,6,9,1,0,8,1
12139,5,3,1,0,2,1
12139,4,1,1,0,0,1
12139,2,1,1,0,0,1
41532,8,6,1,0,5,1
41532,7,6,3,0,3,3
41532,6,14,1,0,13,1
41532,5,8,1,0,7,1
41532,1,2,1,0,1,1
128290,10,1,1,0,0,1
128290,9,2,1,0,1,1
128290,7,8,1,0,7,1
128290,6,12,3,0,9,3
128290,5,8,3,0,5,3
128290,4,7,4,0,3,4
128290,2,1,1,0,0,1
5669,8,7,2,0,5,2
5669,7,6,2,0,4,2
5669,6,20,6,0,14,6
5669,4,4,1,0,3,1
5669,3,1,1,0,0,1
224999,8,3,1,0,2,1
224999,7,10,2,0,8,2
224999,6,19,3,0,16,3
224999,5,6,1,0,5,1
224999,4,3,1,0,2,1
6350,7,13,4,0,9,4
6350,6,11,3,0,8,3
6350,5,8,4,0,4,4
6350,3,3,2,0,1,2
52332,8,4,2,0,2,2
52332,7,11,8,0,3,8
52332,6,23,7,0,16,7
52332,4,1,1,0,0,1
8676,10,2,2,0,0,2
8676,6,9,5,0,4,5
8676,5,4,1,0,3,1
8676,4,11,4,0,7,4
8676,3,9,2,0,7,2
8676,2,3,2,0,1,2
8676,1,3,1,0,2,1
36228,6,6,2,0,4,2
36228,5,10,2,0,8,2
36228,4,7,5,0,2,5
36228,3,6,2,0,4,2
36228,2,4,2,0,2,2
4064,8,1,1,0,0,1
4064,7,4,1,0,3,1
4064,6,7,1,0,6,1
4064,5,11,1,0,10,1
4064,4,11,4,0,7,4
4064,3,3,2,0,1,2
4064,2,3,1,0,2,1
4064,1,3,1,0,2,1
7640,10,4,1,0,3,1
7640,9,2,2,0,0,2
7640,8,13,8,0,5,8
7640,7,16,7,0,9,7
7640,5,4,1,0,3,1
29291,8,8,5,0,3,5
29291,7,6,1,0,5,1
29291,6,13,4,0,9,4
29291,5,7,5,0,2,5
29291,4,6,5,0,1,5
176634,10,3,1,0,2,1
176634,8,7,1,0,6,1
176634,7,7,1,0,6,1
176634,6,12,3,0,9,3
18044,6,1,1,0,0,1
18044,3,4,2,0,2,2
18044,2,7,3,0,4,3
18044,1,30,24,0,6,24
40385,10,1,1,0,0,1
40385,9,3,1,0,2,1
40385,8,13,7,0,6,7
40385,7,16,5,0,11,5
40385,6,6,3,0,3,3
40385,5,4,1,0,3,1
197076,10,4,1,0,3,1
197076,9,10,4,0,6,4
197076,8,16,6,0,10,6
197076,7,9,2,0,7,2
197076,6,4,1,0,3,1
7519,8,1,1,0,0,1
7519,7,3,1,0,2,1
7519,6,10,2,0,8,2
7519,4,8,2,0,6,2
7519,3,4,1,0,3,1
7519,1,4,2,0,2,2
203715,10,1,1,0,0,1
203715,9,5,1,0,4,1
203715,8,8,3,0,5,3
203715,7,12,4,0,8,4
203715,6,9,3,0,6,3
203715,5,5,2,0,3,2
29517,10,2,1,0,1,1
29517,8,10,2,0,8,2
29517,6,4,1,0,3,1
29517,4,3,1,0,2,1
29517,3,6,1,0,5,1
29517,2,2,1,0,1,1
163963,8,5,1,0,4,1
163963,7,11,1,0,10,1
163963,6,14,4,0,10,4
163963,5,5,1,0,4,1
163963,4,6,3,0,3,3
118539,10,3,1,0,2,1
118539,8,8,4,0,4,4
118539,7,11,4,0,7,4
118539,6,10,2,0,8,2
118539,5,4,2,0,2,2
118539,3,2,1,0,1,1
118539,2,1,1,0,0,1
94363,8,5,3,0,2,3
94363,7,9,2,0,7,2
94363,6,19,3,0,16,3
94363,5,6,1,0,5,1
94363,4,2,1,0,1,1
16325,9,5,4,0,1,4
16325,8,17,6,0,11,6
16325,7,11,2,0,9,2
16325,5,2,1,0,1,1
16325,4,1,1,0,0,1
177977,10,5,2,0,3,2
177977,9,8,1,0,7,1
177977,7,13,3,0,10,3
177977,4,2,1,0,1,1
249817,9,2,1,0,1,1
249817,8,4,1,0,3,1
249817,7,16,4,0,12,4
249817,6,16,6,0,10,6
249817,4,1,1,0,0,1
104798,10,1,1,0,0,1
104798,8,7,1,0,6,1
104798,7,9,2,0,7,2
104798,6,12,2,0,10,2
104798,5,5,2,0,3,2
104798,4,4,2,0,2,2
23243,6,8,4,0,4,4
23243,5,12,4,0,8,4
23243,4,5,1,0,4,1
23243,3,8,2,0,6,2
23243,2,7,6,0,1,6
179,8,8,4,0,4,4
179,7,7,2,0,5,2
179,6,16,3,0,13,3
179,5,9,3,0,6,3
179,4,2,1,0,1,1
97512,10,1,1,0,0,1
97512,9,3,2,0,1,2
97512,8,13,3,0,10,3
97512,7,15,3,0,12,3
97512,6,6,3,0,3,3
97512,4,2,1,0,1,1
15391,10,4,2,0,2,2
15391,9,8,4,0,4,4
15391,8,7,4,0,3,4
15391,7,6,3,0,3,3
15391,6,12,3,0,9,3
15391,4,2,1,0,1,1
5512,8,3,1,0,2,1
5512,7,6,2,0,4,2
5512,6,4,3,0,1,3
5512,5,9,3,0,6,3
5512,4,7,2,0,5,2
5512,3,6,4,0,2,4
5512,2,5,2,0,3,2
5512,1,2,1,0,1,1
145963,10,4,1,0,3,1
145963,6,9,2,0,7,2
145963,5,10,2,0,8,2
145963,4,7,1,0,6,1
9246,7,8,2,0,6,2
9246,6,20,6,0,14,6
9246,5,5,2,0,3,2
26353,10,2,1,0,1,1
26353,8,5,1,0,4,1
26353,6,13,5,0,8,5
26353,5,5,3,0,2,3
26353,4,6,1,0,5,1
26353,2,1,1,0,0,1
36985,9,1,1,0,0,1
36985,8,8,3,0,5,3
36985,7,11,5,0,6,5
36985,6,13,2,0,11,2
36985,5,5,1,0,4,1
36985,4,4,2,0,2,2
218722,2,1,1,0,0,1
345,9,3,2,0,1,2
345,8,11,4,0,7,4
345,7,13,6,0,7,6
345,6,12,3,0,9,3
345,5,2,2,0,0,2
86754,9,5,1,0,4,1
86754,8,10,3,0,7,3
86754,7,8,1,0,7,1
86754,5,4,1,0,3,1
17352,10,3,2,0,1,2
17352,9,2,1,0,1,1
17352,7,11,2,0,9,2
17352,6,5,2,0,3,2
17352,5,7,4,0,3,4
17352,3,5,1,0,4,1
22338,9,1,1,0,0,1
22338,7,4,1,0,3,1
22338,6,17,3,0,14,3
22338,5,12,3,0,9,3
22338,4,2,1,0,1,1
22338,3,2,1,0,1,1
76540,7,6,1,0,5,1
76540,6,12,1,0,11,1
76540,5,10,1,0,9,1
76540,4,6,2,0,4,2
76540,3,5,4,0,1,4
76540,1,1,1,0,0,1
10310,10,3,2,0,1,2
10310,9,11,3,0,8,3
10310,8,6,1,0,5,1
10310,7,11,2,0,9,2
10310,6,10,6,0,4,6
93679,8,6,1,0,5,1
93679,7,10,6,0,4,6
93679,6,14,6,0,8,6
93679,5,5,2,0,3,2
93679,3,2,2,0,0,2
8618,7,2,1,0,1,1
8618,6,17,5,0,12,5
8618,5,13,4,0,9,4
8618,4,5,2,0,3,2
8618,3,3,2,0,1,2
8618,2,2,1,0,1,1
6721,10,5,3,0,2,3
6721,9,6,3,0,3,3
6721,8,11,7,0,4,7
6721,7,13,4,0,9,4
6721,6,4,2,0,2,2
6721,5,3,1,0,2,1
18913,8,2,1,0,1,1
18913,7,7,1,0,6,1
18913,6,14,2,0,12,2
18913,5,4,1,0,3,1
18913,4,8,1,0,7,1
18913,3,3,3,0,0,3
18913,2,2,1,0,1,1
47414,8,10,3,0,7,3
47414,7,13,8,0,5,8
47414,6,15,5,0,10,5
47414,5,5,3,0,2,3
167465,8,4,2,2,2,0
167465,7,6,1,1,5,0
167465,5,5,3,0,2,3
167465,4,8,2,1,6,1
167465,3,2,1,1,1,0
167465,2,9,3,1,6,2
12062,10,1,1,0,0,1
12062,8,6,3,0,3,3
12062,7,5,1,0,4,1
12062,6,15,6,0,9,6
12062,5,11,7,0,4,7
12062,4,4,1,0,3,1
604,7,6,4,0,2,4
604,6,12,2,0,10,2
604,5,11,2,0,9,2
604,3,3,1,0,2,1
604,1,1,1,0,0,1
25081,6,2,2,0,0,2
25081,5,6,1,0,5,1
25081,3,10,3,0,7,3
25081,2,6,1,0,5,1
25081,1,7,1,0,6,1
188198,7,11,1,0,10,1
188198,5,6,1,0,5,1
209809,10,12,2,0,10,2
209809,9,8,1,0,7,1
209809,8,9,1,0,8,1
209809,6,2,1,0,1,1
209809,4,1,1,0,0,1
10419,8,4,1,0,3,1
10419,7,6,1,0,5,1
10419,6,8,2,0,6,2
10419,5,6,1,0,5,1
10419,4,8,1,0,7,1
10419,3,6,3,0,3,3
10419,2,2,1,0,1,1
10419,1,2,1,0,1,1
187000,7,8,1,0,7,1
187000,6,21,1,0,20,1
187000,4,2,1,0,1,1
11177,10,1,1,0,0,1
11177,9,1,1,0,0,1
11177,8,6,2,0,4,2
11177,7,7,1,0,6,1
11177,6,13,4,0,9,4
11177,5,7,4,0,3,4
11177,4,3,2,0,1,2
2210,9,3,1,0,2,1
2210,8,5,3,0,2,3
2210,7,10,4,0,6,4
2210,5,8,4,0,4,4
2210,3,2,2,0,0,2
2210,1,1,1,0,0,1
2756,10,2,1,0,1,1
2756,8,3,1,0,2,1
2756,7,10,3,0,7,3
2756,6,13,4,0,9,4
2756,5,9,5,0,4,5
2756,3,3,1,0,2,1
11635,7,2,1,0,1,1
11635,6,10,3,0,7,3
11635,5,16,3,0,13,3
11635,4,8,2,0,6,2
11635,2,5,3,0,2,3
150276,9,1,1,0,0,1
150276,8,3,1,0,2,1
150276,7,4,1,0,3,1
150276,6,12,1,0,11,1
150276,5,4,1,0,3,1
150276,4,9,1,0,8,1
40446,8,12,5,0,7,5
40446,7,13,4,0,9,4
40446,6,13,4,0,9,4
40446,5,1,1,0,0,1
137173,9,6,1,0,5,1
137173,8,10,4,0,6,4
137173,7,19,6,0,13,6
137173,6,7,1,0,6,1
137173,5,1,1,0,0,1
147112,8,4,1,0,3,1
147112,6,10,1,0,9,1
147112,5,8,2,0,6,2
147112,4,7,2,0,5,2
147112,3,4,2,0,2,2
183401,9,2,1,0,1,1
183401,7,17,3,0,14,3
183401,6,8,1,0,7,1
183401,5,8,1,0,7,1
183401,4,1,1,0,0,1
237551,10,2,2,0,0,2
237551,9,5,2,0,3,2
237551,8,11,4,1,7,3
237551,7,16,5,0,11,5
237551,5,2,1,0,1,1
237551,4,1,1,0,0,1
8354,9,5,2,0,3,2
8354,8,15,6,0,9,6
8354,7,12,3,0,9,3
8354,6,8,2,0,6,2
7187,8,3,2,0,1,2
7187,7,4,3,0,1,3
7187,6,14,6,0,8,6
7187,5,12,5,0,7,5
7187,4,7,3,0,4,3
7187,3,2,2,0,0,2
957,10,2,1,0,1,1
957,9,3,3,0,0,3
957,8,4,3,0,1,3
957,6,12,8,0,4,8
957,5,6,1,0,5,1
957,4,3,2,0,1,2
957,3,1,1,0,0,1
957,2,3,1,0,2,1
35499,8,4,1,0,3,1
35499,7,3,1,0,2,1
35499,6,10,2,0,8,2
35499,5,7,3,0,4,3
35499,4,5,1,0,4,1
35499,3,4,3,0,1,3
35499,2,3,2,0,1,2
35499,1,4,3,0,1,3
27667,9,2,1,0,1,1
27667,7,7,1,0,6,1
27667,6,13,4,0,9,4
27667,5,8,1,0,7,1
27667,4,4,2,0,2,2
27667,3,7,3,0,4,3
229527,8,12,1,0,11,1
229527,7,15,1,0,14,1
116975,7,12,1,0,11,1
116975,6,11,1,0,10,1
116975,5,7,1,0,6,1
116975,4,4,1,0,3,1
203818,8,7,2,1,5,1
203818,7,7,3,1,4,2
203818,6,14,4,0,10,4
203818,5,3,2,0,1,2
203818,4,5,1,0,4,1
203818,3,3,1,0,2,1
10214,10,2,1,0,1,1
10214,8,2,1,0,1,1
10214,7,9,4,0,5,4
10214,6,13,5,0,8,5
10214,5,11,5,0,6,5
10214,4,2,1,0,1,1
10214,3,4,2,0,2,2
21685,10,6,2,0,4,2
21685,9,11,2,0,9,2
21685,8,10,1,0,9,1
21685,7,6,1,0,5,1
21685,6,7,1,0,6,1
36234,8,5,3,0,2,3
36234,7,3,1,0,2,1
36234,6,13,6,0,7,6
36234,5,11,5,0,6,5
36234,4,6,2,0,4,2
36234,3,4,2,0,2,2
56195,8,10,3,0,7,3
56195,7,14,4,0,10,4
56195,6,9,2,0,7,2
56195,5,1,1,0,0,1
56195,4,5,3,0,2,3
56195,1,1,1,0,0,1
930,7,4,1,0,3,1
930,6,13,6,0,7,6
930,5,15,1,0,14,1
930,4,7,2,0,5,2
243437,7,9,2,0,7,2
243437,6,19,2,0,17,2
243437,5,9,1,0,8,1
243437,4,4,2,0,2,2
148330,9,4,2,0,2,2
148330,8,14,7,1,7,6
148330,7,8,1,0,7,1
148330,6,9,2,0,7,2
148330,3,1,1,0,0,1
47475,10,5,1,0,4,1
47475,8,6,1,0,5,1
47475,7,6,1,0,5,1
47475,6,1,1,0,0,1
47475,5,10,2,0,8,2
47475,4,3,2,0,1,2
47475,3,2,1,0,1,1
47475,2,1,1,0,0,1
47475,1,2,1,0,1,1
14708,5,6,1,0,5,1
14708,3,13,2,0,11,2
14708,2,5,3,0,2,3
14708,1,7,3,0,4,3
108079,8,11,4,0,7,4
108079,7,7,4,0,3,4
108079,6,16,7,0,9,7
108079,5,6,3,0,3,3
108079,4,1,1,0,0,1
108079,3,1,1,0,0,1
6563,10,4,1,0,3,1
6563,8,5,2,0,3,2
6563,7,4,2,0,2,2
6563,6,6,1,0,5,1
6563,5,2,1,0,1,1
6563,4,9,3,0,6,3
6563,2,7,4,0,3,4
6563,1,3,1,0,2,1
40559,6,20,2,0,18,2
40559,5,12,3,0,9,3
40559,3,2,1,0,1,1
11972,8,6,1,0,5,1
11972,7,9,3,0,6,3
11972,6,10,5,0,5,5
11972,5,11,4,0,7,4
11972,4,4,2,0,2,2
245090,9,2,1,0,1,1
245090,7,20,1,0,19,1
245090,6,18,4,0,14,4
8537,10,3,2,0,1,2
8537,9,3,2,0,1,2
8537,8,18,9,0,9,9
8537,7,11,4,0,7,4
8537,6,6,1,0,5,1
66611,7,9,1,0,8,1
66611,6,18,1,0,17,1
66611,5,9,2,0,7,2
66611,3,1,1,0,0,1
156461,9,2,1,0,1,1
156461,7,7,1,0,6,1
156461,5,12,1,0,11,1
156461,4,4,1,0,3,1
156461,2,1,1,0,0,1
728,10,2,1,0,1,1
728,9,3,1,0,2,1
728,8,12,4,0,8,4
728,7,10,3,0,7,3
728,6,13,3,0,10,3
728,5,3,1,0,2,1
728,1,1,1,0,0,1
49050,6,6,1,0,5,1
7026,10,3,2,0,1,2
7026,8,5,2,0,3,2
7026,7,9,4,0,5,4
7026,6,16,11,0,5,11
7026,4,2,1,0,1,1
7026,3,2,1,0,1,1
7026,2,3,1,0,2,1
227599,10,3,2,0,1,2
227599,8,7,4,0,3,4
227599,7,12,1,0,11,1
7129,8,4,2,0,2,2
7129,7,12,2,0,10,2
7129,6,13,2,0,11,2
7129,5,8,2,0,6,2
223947,10,2,2,0,0,2
223947,9,3,1,0,2,1
223947,8,12,5,0,7,5
223947,7,13,4,1,9,3
223947,6,6,1,0,5,1
223947,5,3,2,0,1,2
223947,4,2,1,0,1,1
223947,2,1,1,0,0,1
200836,10,1,1,0,0,1
200836,8,4,1,0,3,1
200836,7,10,1,0,9,1
200836,6,15,4,0,11,4
200836,5,8,2,0,6,2
200836,4,1,1,0,0,1
32280,9,5,1,0,4,1
32280,8,3,1,0,2,1
32280,7,7,2,0,5,2
32280,5,10,4,0,6,4
32280,2,2,1,0,1,1
2361,7,7,2,0,5,2
2361,6,13,2,0,11,2
2361,4,7,3,0,4,3
270633,10,19,10,1,9,9
270633,9,15,5,0,10,5
270633,6,2,1,0,1,1
270633,1,1,1,0,0,1
24125,6,19,3,0,16,3
24125,5,8,1,0,7,1
24125,4,4,1,0,3,1
24125,3,7,2,0,5,2
24125,1,2,1,0,1,1
22126,10,3,2,0,1,2
22126,9,5,1,0,4,1
22126,8,17,5,0,12,5
22126,7,9,2,0,7,2
22126,4,2,2,0,0,2
22126,2,2,2,0,0,2
16112,6,5,1,0,4,1
16112,5,11,2,0,9,2
16112,4,7,2,0,5,2
16112,3,10,2,0,8,2
16112,2,4,2,0,2,2
16112,1,2,1,0,1,1
1989,7,1,1,0,0,1
1989,6,6,1,0,5,1
1989,5,3,1,0,2,1
1989,4,12,5,0,7,5
1989,3,10,5,0,5,5
1989,2,4,1,0,3,1
25754,6,13,2,0,11,2
25754,5,11,1,0,10,1
25754,4,10,5,0,5,5
25754,3,2,1,0,1,1
25754,2,3,1,0,2,1
39530,8,7,2,0,5,2
39530,7,14,6,0,8,6
39530,6,8,2,0,6,2
39530,5,6,2,0,4,2
260268,10,3,1,0,2,1
260268,8,2,1,0,1,1
260268,7,8,1,0,7,1
260268,5,9,1,0,8,1
260268,4,4,2,0,2,2
260268,3,3,1,0,2,1
260268,2,2,1,0,1,1
8410,8,11,5,0,6,5
8410,7,14,5,0,9,5
8410,6,5,2,0,3,2
8410,5,2,1,0,1,1
138945,9,3,1,0,2,1
138945,8,19,12,0,7,12
138945,7,11,4,0,7,4
145068,10,5,1,0,4,1
145068,8,5,1,0,4,1
145068,7,9,2,0,7,2
145068,6,8,1,0,7,1
145068,2,3,1,0,2,1
8700,8,3,2,0,1,2
8700,7,12,2,0,10,2
8700,5,6,3,0,3,3
8700,4,5,2,0,3,2
8700,3,1,1,0,0,1
18529,10,10,3,0,7,3
18529,9,11,6,0,5,6
18529,8,14,11,0,3,11
18529,7,4,2,0,2,2
2014,7,11,2,0,9,2
2014,6,19,4,0,15,4
2014,2,3,1,0,2,1
43169,8,9,2,0,7,2
43169,7,12,1,0,11,1
116231,4,3,1,0,2,1
127572,8,12,5,0,7,5
127572,7,10,2,0,8,2
127572,6,11,2,0,9,2
127572,5,4,2,0,2,2
127572,4,3,1,0,2,1
147427,10,3,1,0,2,1
147427,9,3,2,0,1,2
147427,8,6,3,0,3,3
147427,7,16,2,0,14,2
147427,6,12,2,0,10,2
147427,5,1,1,0,0,1
5728,10,3,1,0,2,1
5728,9,5,1,0,4,1
5728,8,9,2,0,7,2
5728,7,7,1,0,6,1
5728,6,13,5,0,8,5
5728,4,1,1,0,0,1
11284,8,10,1,0,9,1
11284,7,10,3,0,7,3
11284,5,3,1,0,2,1
6486,10,1,1,0,0,1
6486,9,1,1,0,0,1
6486,8,1,1,0,0,1
6486,5,9,3,0,6,3
6486,4,10,5,0,5,5
6486,3,4,2,0,2,2
6486,2,3,1,0,2,1
6486,1,2,1,0,1,1
19834,9,1,1,0,0,1
19834,7,2,1,0,1,1
19834,6,4,1,0,3,1
19834,5,14,7,0,7,7
19834,4,10,4,0,6,4
19834,3,7,4,0,3,4
19834,2,2,1,0,1,1
19834,1,2,1,0,1,1
7610,7,1,1,0,0,1
7610,6,9,4,0,5,4
7610,5,21,8,0,13,8
7610,4,6,3,0,3,3
7610,3,3,1,0,2,1
7610,2,2,2,0,0,2
192696,8,7,2,0,5,2
192696,7,6,2,0,4,2
192696,5,8,3,0,5,3
192696,4,3,2,0,1,2
192696,1,2,1,0,1,1
83228,9,4,2,0,2,2
83228,8,9,6,0,3,6
83228,7,11,6,0,5,6
83228,6,10,5,0,5,5
83228,5,4,2,0,2,2
83228,3,2,2,0,0,2
244738,7,15,4,0,11,4
244738,6,16,2,0,14,2
244738,5,5,1,0,4,1
244738,3,1,1,0,0,1
10326,10,1,1,0,0,1
10326,9,3,1,0,2,1
10326,8,7,2,0,5,2
10326,7,6,2,0,4,2
10326,6,14,2,0,12,2
10326,5,6,2,0,4,2
10326,4,4,2,0,2,2
10326,3,1,1,0,0,1
4812,6,7,3,0,4,3
4812,5,4,1,0,3,1
4812,4,13,8,0,5,8
4812,3,11,5,0,6,5
4812,1,3,2,0,1,2
3298,7,3,2,0,1,2
3298,6,16,5,0,11,5
3298,5,10,1,0,9,1
3298,3,6,4,0,2,4
3298,2,2,1,0,1,1
264638,8,14,4,0,10,4
264638,7,14,3,0,11,3
264638,6,10,3,0,7,3
131496,8,8,1,0,7,1
131496,6,8,1,0,7,1
131496,5,6,2,1,4,1
131496,3,3,2,0,1,2
131496,1,2,1,0,1,1
210414,7,19,2,0,17,2
210414,4,2,1,0,1,1
230966,10,4,3,0,1,3
230966,9,8,4,0,4,4
230966,8,16,4,0,12,4
230966,7,5,2,0,3,2
230966,6,6,1,0,5,1
10245,10,9,7,0,2,7
10245,9,8,4,0,4,4
10245,8,14,5,0,9,5
10245,6,3,1,0,2,1
195158,9,9,6,0,3,6
195158,8,13,2,0,11,2
195158,7,5,2,0,3,2
195158,6,3,1,0,2,1
7366,8,8,4,0,4,4
7366,7,6,1,0,5,1
7366,6,14,4,0,10,4
7366,5,7,6,0,1,6
7366,4,4,1,0,3,1
3682,7,7,3,0,4,3
3682,6,15,8,0,7,8
3682,5,8,3,0,5,3
3682,4,4,1,0,3,1
3682,3,6,5,0,1,5
12683,9,1,1,0,0,1
12683,8,3,1,0,2,1
12683,7,4,2,0,2,2
12683,6,9,5,0,4,5
12683,5,12,3,0,9,3
12683,4,9,3,0,6,3
12683,2,1,1,0,0,1
145400,8,4,2,0,2,2
145400,7,13,1,0,12,1
145400,5,7,1,0,6,1
145400,4,4,1,0,3,1
145400,3,2,1,0,1,1
145400,2,2,1,0,1,1
148273,10,5,2,0,3,2
148273,4,6,1,0,5,1
148273,3,6,1,0,5,1
148273,2,6,2,0,4,2
148273,1,2,1,0,1,1
3634,9,2,1,0,1,1
3634,8,4,2,0,2,2
3634,7,11,3,0,8,3
3634,6,11,3,0,8,3
3634,5,7,1,0,6,1
3634,4,3,1,0,2,1
3634,1,3,1,0,2,1
41068,7,1,1,0,0,1
41068,5,5,2,0,3,2
41068,4,5,2,0,3,2
41068,2,13,2,0,11,2
41068,1,14,5,0,9,5
13361,10,2,1,0,1,1
13361,8,5,1,0,4,1
13361,7,16,2,0,14,2
13361,6,7,1,0,6,1
13361,5,5,4,0,1,4
13361,3,2,1,0,1,1
260218,9,6,1,0,5,1
260218,8,11,2,0,9,2
260218,7,20,4,0,16,4
260218,1,1,1,0,0,1
36650,7,3,1,0,2,1
36650,6,17,3,0,14,3
36650,5,8,2,0,6,2
36650,3,4,2,0,2,2
36650,2,1,1,0,0,1
94684,6,10,2,0,8,2
94684,5,8,4,0,4,4
94684,4,8,1,0,7,1
94684,3,3,1,0,2,1
11800,7,5,1,0,4,1
11800,6,11,6,0,5,6
11800,5,15,2,0,13,2
11800,4,7,4,0,3,4
11800,3,2,1,0,1,1
129955,7,5,2,0,3,2
129955,6,13,2,0,11,2
129955,5,12,3,0,9,3
129955,4,6,1,0,5,1
129955,2,1,1,0,0,1
7558,9,1,1,0,0,1
7558,8,7,1,0,6,1
7558,7,12,4,0,8,4
7558,6,13,4,0,9,4
7558,5,5,4,0,1,4
194575,9,3,1,0,2,1
18885,8,2,1,0,1,1
18885,6,16,3,0,13,3
18885,5,12,1,0,11,1
18885,4,3,1,0,2,1
18885,2,1,1,0,0,1
25789,5,9,2,0,7,2
25789,4,10,4,0,6,4
25789,3,8,3,0,5,3
25789,2,5,3,0,2,3
25789,1,4,2,0,2,2
223222,7,9,1,0,8,1
223222,6,16,2,0,14,2
223222,2,2,1,0,1,1
39587,8,3,1,0,2,1
39587,6,18,2,0,16,2
39587,5,7,2,0,5,2
39587,3,1,1,0,0,1
11167,9,1,1,0,0,1
11167,6,9,5,0,4,5
11167,5,10,3,0,7,3
11167,4,13,3,0,10,3
11167,3,2,1,0,1,1
11167,2,5,3,0,2,3
18084,7,8,2,0,6,2
18084,5,6,1,0,5,1
6124,9,1,1,0,0,1
6124,8,2,1,0,1,1
6124,7,5,1,0,4,1
6124,6,12,1,0,11,1
6124,5,5,2,0,3,2
11131,8,4,1,0,3,1
11131,7,12,4,0,8,4
11131,6,14,5,0,9,5
11131,5,6,3,0,3,3
11131,4,2,1,0,1,1
11131,3,1,1,0,0,1
11131,1,1,1,0,0,1
249047,10,6,2,1,4,1
249047,9,5,2,0,3,2
249047,8,6,1,0,5,1
249047,7,10,4,1,6,3
249047,6,11,3,0,8,3
249047,5,3,1,0,2,1
249047,3,1,1,0,0,1
40609,10,3,1,0,2,1
40609,8,9,2,0,7,2
40609,7,5,1,0,4,1
40609,6,10,1,0,9,1
40609,5,8,2,0,6,2
244196,8,15,1,0,14,1
244196,1,2,2,0,0,2
31615,9,1,1,0,0,1
31615,7,4,2,0,2,2
31615,6,5,2,0,3,2
31615,5,8,2,0,6,2
31615,4,3,1,0,2,1
31615,3,6,2,0,4,2
31615,2,8,3,0,5,3
31615,1,6,1,0,5,1
69638,8,11,6,0,5,6
69638,7,13,6,0,7,6
69638,6,11,2,0,9,2
69638,5,2,2,0,0,2
69638,4,2,1,0,1,1
69638,3,1,1,0,0,1
4296,10,1,1,0,0,1
4296,9,1,1,0,0,1
4296,8,9,3,0,6,3
4296,7,10,4,0,6,4
4296,6,12,7,0,5,7
4296,5,5,1,0,4,1
4296,4,4,1,0,3,1
30021,9,4,1,0,3,1
30021,8,3,1,0,2,1
30021,7,13,5,0,8,5
30021,6,13,6,0,7,6
30021,5,5,3,0,2,3
30021,4,1,1,0,0,1
30021,2,1,1,0,0,1
265524,8,10,5,0,5,5
265524,7,16,2,0,14,2
265524,5,3,2,0,1,2
14881,9,3,1,0,2,1
14881,8,9,5,0,4,5
14881,7,16,3,0,13,3
14881,6,5,1,0,4,1
14881,5,3,1,0,2,1
264242,8,6,1,0,5,1
264242,7,11,2,0,9,2
143023,9,3,3,0,0,3
143023,8,18,4,0,14,4
143023,7,8,3,0,5,3
143023,6,5,2,0,3,2
5790,9,1,1,0,0,1
5790,7,7,3,0,4,3
5790,6,14,9,0,5,9
5790,5,4,1,0,3,1
5790,4,5,4,0,1,4
5790,3,4,3,0,1,3
5790,2,1,1,0,0,1
5790,1,2,1,0,1,1
5427,8,4,2,0,2,2
5427,6,9,3,0,6,3
5427,5,9,3,0,6,3
5427,4,9,2,0,7,2
5427,3,5,2,0,3,2
5427,2,4,3,0,1,3
4486,10,1,1,0,0,1
4486,8,1,1,0,0,1
4486,7,6,3,0,3,3
4486,5,18,4,0,14,4
4486,4,7,2,0,5,2
4486,2,2,1,0,1,1
20954,8,9,6,0,3,6
20954,7,12,8,0,4,8
20954,6,14,9,0,5,9
20954,5,4,3,0,1,3
20954,3,2,1,0,1,1
7063,8,5,1,0,4,1
7063,6,10,2,0,8,2
7063,5,9,3,0,6,3
7063,4,5,1,0,4,1
7063,3,2,1,0,1,1
130470,8,2,1,0,1,1
130470,7,6,2,0,4,2
130470,6,15,3,2,12,1
130470,5,5,1,0,4,1
130470,4,7,2,1,5,1
130470,3,6,1,0,5,1
130470,1,1,1,1,0,0
150220,9,2,1,0,1,1
150220,8,15,4,0,11,4
150220,7,11,1,0,10,1
150220,6,11,2,0,9,2
150220,5,2,1,0,1,1
267378,9,4,2,0,2,2
267378,8,15,1,0,14,1
267378,7,14,1,0,13,1
8159,9,3,2,0,1,2
8159,8,9,5,0,4,5
8159,7,8,1,0,7,1
8159,6,11,5,0,6,5
8159,5,5,2,0,3,2
8159,3,3,2,0,1,2
129013,10,1,1,0,0,1
129013,9,6,3,0,3,3
129013,8,14,6,0,8,6
129013,7,10,1,0,9,1
129013,6,8,3,0,5,3
129013,5,3,1,0,2,1
196342,8,8,2,0,6,2
196342,7,9,2,0,7,2
196342,6,15,4,0,11,4
196342,5,8,2,0,6,2
209741,8,12,3,0,9,3
209741,7,12,2,1,10,1
209741,6,12,2,0,10,2
209741,5,2,1,0,1,1
3500,8,7,3,0,4,3
3500,7,6,1,0,5,1
3500,6,17,3,0,14,3
3500,5,7,2,0,5,2
3500,2,1,1,0,0,1
25045,10,5,3,0,2,3
25045,8,9,3,0,6,3
25045,7,9,3,0,6,3
25045,6,10,6,1,4,5
25045,5,1,1,0,0,1
25045,4,5,2,0,3,2
25045,2,1,1,0,0,1
86033,8,4,1,0,3,1
86033,7,13,1,0,12,1
86033,6,11,2,0,9,2
86033,5,8,1,0,7,1
25665,8,9,4,0,5,4
25665,7,12,5,0,7,5
25665,6,9,3,0,6,3
25665,5,6,2,0,4,2
25665,3,4,2,0,2,2
25665,2,1,1,0,0,1
188753,10,1,1,0,0,1
188753,9,8,5,2,3,3
188753,8,9,5,1,4,4
188753,7,7,1,0,6,1
188753,6,7,2,0,5,2
6620,9,2,1,0,1,1
6620,7,7,1,0,6,1
6620,6,10,5,0,5,5
6620,5,8,2,0,6,2
6620,4,7,2,0,5,2
6620,3,3,2,0,1,2
6620,2,4,2,0,2,2
209378,8,1,1,0,0,1
209378,7,3,1,0,2,1
209378,6,14,3,0,11,3
209378,5,8,3,0,5,3
209378,4,11,3,0,8,3
209378,3,5,2,0,3,2
130357,10,16,7,0,9,7
130357,9,7,2,0,5,2
130357,8,11,6,0,5,6
130357,7,3,1,0,2,1
49096,8,8,3,0,5,3
49096,7,13,2,0,11,2
49096,6,7,2,0,5,2
49096,5,5,3,0,2,3
49096,2,2,1,0,1,1
212668,10,5,3,0,2,3
212668,9,2,1,1,1,0
212668,7,6,2,0,4,2
212668,6,11,3,1,8,2
212668,5,4,1,0,3,1
212668,4,3,2,0,1,2
212668,1,4,1,1,3,0
3214,8,3,2,0,1,2
3214,7,6,3,0,3,3
3214,6,7,3,0,4,3
3214,5,7,4,0,3,4
3214,4,11,2,0,9,2
3214,3,5,3,0,2,3
3214,2,2,2,0,0,2
3214,1,1,1,0,0,1
122069,8,6,1,0,5,1
122069,7,13,4,0,9,4
122069,6,14,7,0,7,7
122069,5,5,2,0,3,2
122069,4,1,1,0,0,1
122069,3,1,1,0,0,1
122069,1,2,1,0,1,1
3398,6,16,5,0,11,5
3398,5,8,2,0,6,2
3398,4,8,4,0,4,4
3398,3,2,1,0,1,1
9932,8,6,1,0,5,1
9932,7,14,5,0,9,5
9932,6,16,3,0,13,3
9932,5,4,1,0,3,1
9932,4,1,1,0,0,1
15109,4,8,1,0,7,1
15109,2,1,1,0,0,1
10561,10,3,1,0,2,1
10561,8,6,5,0,1,5
10561,7,14,6,0,8,6
10561,6,11,4,0,7,4
10561,5,5,1,0,4,1
32327,10,2,1,0,1,1
32327,9,6,2,0,4,2
32327,8,11,2,0,9,2
32327,7,12,3,0,9,3
32327,6,5,2,0,3,2
32327,5,2,1,0,1,1
32327,2,2,2,0,0,2
47170,10,2,1,0,1,1
47170,9,3,1,0,2,1
47170,8,1,1,0,0,1
47170,7,4,2,0,2,2
47170,4,7,2,0,5,2
47170,3,3,2,0,1,2
47170,2,5,2,0,3,2
32415,6,8,1,0,7,1
32415,5,9,1,0,8,1
32415,3,4,2,0,2,2
14471,9,1,1,0,0,1
14471,8,7,4,0,3,4
14471,6,9,4,0,5,4
14471,5,8,2,0,6,2
14471,4,3,1,0,2,1
14471,3,2,2,0,0,2
63901,7,3,1,0,2,1
63901,6,8,4,0,4,4
63901,4,12,1,0,11,1
63901,3,7,2,0,5,2
63901,1,3,1,0,2,1
13623,7,10,2,0,8,2
13623,6,15,2,0,13,2
13623,5,8,3,0,5,3
13623,4,5,2,0,3,2
253372,10,5,1,0,4,1
253372,9,10,4,0,6,4
253372,8,17,1,0,16,1
22344,8,5,2,0,3,2
22344,6,16,4,0,12,4
22344,4,2,1,0,1,1
22344,3,4,1,0,3,1
5864,10,5,4,0,1,4
5864,9,4,1,0,3,1
5864,8,12,6,0,6,6
5864,7,12,3,0,9,3
5864,6,3,1,0,2,1
5864,5,4,1,0,3,1
2404,7,6,6,0,0,6
2404,6,12,2,0,10,2
2404,5,11,1,0,10,1
2404,4,6,2,0,4,2
2404,3,5,3,0,2,3
2404,1,1,1,0,0,1
10230,10,5,3,0,2,3
10230,8,16,5,0,11,5
10230,7,10,4,0,6,4
10230,6,5,2,0,3,2
1200,9,1,1,0,0,1
1200,8,2,1,0,1,1
1200,6,12,4,0,8,4
1200,5,9,3,0,6,3
1200,4,6,2,0,4,2
1200,2,2,1,0,1,1
1200,1,3,2,0,1,2
176859,9,1,1,0,0,1
176859,6,19,3,0,16,3
1424,7,2,1,0,1,1
1424,5,5,2,0,3,2
1424,4,9,3,0,6,3
1424,3,10,3,0,7,3
1424,2,5,1,0,4,1
1424,1,5,3,0,2,3
11530,9,2,2,0,0,2
11530,7,5,1,0,4,1
11530,5,4,2,0,2,2
11530,4,9,4,0,5,4
11530,2,8,5,0,3,5
11530,1,2,1,0,1,1
61319,10,1,1,0,0,1
61319,8,4,1,0,3,1
61319,7,16,4,0,12,4
61319,6,18,1,0,17,1
5194,10,2,2,0,0,2
5194,9,1,1,0,0,1
5194,8,3,2,0,1,2
5194,7,14,7,0,7,7
5194,6,12,7,0,5,7
5194,5,5,1,0,4,1
238329,10,3,1,0,2,1
238329,8,8,2,0,6,2
238329,6,15,1,0,14,1
238329,5,3,2,0,1,2
246015,8,4,1,0,3,1
246015,7,4,1,0,3,1
246015,6,14,2,0,12,2
246015,5,6,1,0,5,1
246015,4,6,2,0,4,2
246015,3,5,3,0,2,3
246015,1,2,2,0,0,2
184560,10,4,2,0,2,2
184560,9,8,1,0,7,1
184560,8,19,6,0,13,6
184560,7,6,1,0,5,1
184560,6,3,2,0,1,2
11824,8,2,1,0,1,1
11824,6,3,1,0,2,1
11824,5,6,1,0,5,1
11824,3,8,2,0,6,2
11824,2,4,2,0,2,2
11824,1,4,1,0,3,1
65575,8,5,2,0,3,2
65575,7,11,3,0,8,3
65575,6,13,6,0,7,6
65575,5,9,2,0,7,2
65575,4,2,1,0,1,1
65575,2,1,1,0,0,1
87428,8,20,10,0,10,10
87428,7,11,3,0,8,3
87428,6,5,2,0,3,2
87428,5,3,1,0,2,1
87428,4,1,1,0,0,1
39007,9,2,1,0,1,1
39007,8,7,1,0,6,1
39007,7,12,3,0,9,3
39007,6,18,7,0,11,7
195842,10,8,2,0,6,2
195842,9,5,2,0,3,2
195842,8,10,1,0,9,1
195842,7,8,2,0,6,2
195842,6,4,1,0,3,1
195842,3,1,1,0,0,1
195842,1,4,2,0,2,2
35481,8,7,1,0,6,1
35481,7,12,4,0,8,4
35481,6,16,4,0,12,4
35481,4,1,1,0,0,1
26918,8,8,6,0,2,6
26918,7,8,3,0,5,3
26918,6,9,4,0,5,4
26918,5,5,2,0,3,2
26918,4,3,3,0,0,3
26918,3,5,4,0,1,4
26918,1,1,1,0,0,1
262566,10,1,1,0,0,1
262566,8,12,3,0,9,3
262566,7,11,3,0,8,3
262566,6,10,4,0,6,4
262566,5,4,1,0,3,1
262566,4,3,2,0,1,2
234314,8,10,1,0,9,1
234314,7,10,2,0,8,2
234314,6,7,1,0,6,1
234314,5,2,1,0,1,1
234314,4,1,1,0,0,1
9973,8,8,4,0,4,4
9973,7,7,2,0,5,2
9973,6,19,10,0,9,10
9973,5,1,1,0,0,1
9973,1,1,1,0,0,1
26560,10,2,2,0,0,2
26560,9,2,1,0,1,1
26560,7,5,1,0,4,1
26560,6,17,4,0,13,4
26560,5,5,2,0,3,2
26560,4,6,2,0,4,2
26560,2,1,1,0,0,1
21366,10,24,5,0,19,5
21366,1,5,3,0,2,3
87929,7,5,1,0,4,1
87929,6,10,4,0,6,4
87929,5,11,6,0,5,6
87929,4,7,3,0,4,3
87929,3,7,3,0,4,3
87929,2,1,1,0,0,1
64331,9,7,3,0,4,3
64331,8,10,2,0,8,2
64331,7,16,4,0,12,4
64331,6,4,1,0,3,1
40943,9,1,1,0,0,1
40943,8,3,1,0,2,1
40943,7,8,1,0,7,1
40943,6,15,2,0,13,2
40943,5,7,1,0,6,1
40943,3,5,2,0,3,2
40943,2,1,1,0,0,1
107938,6,12,1,0,11,1
107938,5,10,1,0,9,1
107938,4,7,2,0,5,2
8365,8,2,2,0,0,2
8365,7,6,2,0,4,2
8365,6,21,8,0,13,8
8365,5,8,2,0,6,2
8365,3,1,1,0,0,1
152115,10,2,1,0,1,1
152115,9,12,7,0,5,7
152115,8,12,4,0,8,4
152115,7,10,2,0,8,2
1090,6,8,1,0,7,1
1090,5,8,2,0,6,2
1090,4,12,4,0,8,4
1090,3,6,3,0,3,3
1090,2,7,4,0,3,4
1619,8,2,1,0,1,1
1619,7,7,1,0,6,1
1619,6,11,2,0,9,2
1619,5,14,3,0,11,3
1619,4,8,2,0,6,2
39372,5,7,2,0,5,2
39372,3,9,4,0,5,4
39372,2,4,2,0,2,2
39372,1,3,1,0,2,1
33023,8,3,1,0,2,1
33023,6,11,2,0,9,2
33023,4,10,1,0,9,1
33023,3,4,3,0,1,3
33023,2,3,1,0,2,1
27388,8,4,1,0,3,1
27388,7,11,3,0,8,3
27388,6,13,6,0,7,6
27388,5,6,1,0,5,1
27388,4,6,1,0,5,1
109017,8,1,1,0,0,1
109017,7,9,1,0,8,1
109017,6,16,6,0,10,6
109017,5,7,2,0,5,2
109017,4,7,1,0,6,1
109017,2,2,2,0,0,2
257924,8,8,3,0,5,3
257924,7,14,4,0,10,4
257924,5,7,2,0,5,2
257924,3,2,1,0,1,1
9357,7,6,3,0,3,3
9357,6,11,4,0,7,4
9357,5,5,2,0,3,2
9357,4,6,1,0,5,1
9357,3,4,2,0,2,2
9357,2,5,3,0,2,3
9357,1,3,3,0,0,3
26855,10,2,1,0,1,1
26855,8,11,5,0,6,5
26855,7,12,5,0,7,5
26855,6,9,4,0,5,4
26855,5,1,1,0,0,1
26855,4,1,1,0,0,1
9597,9,1,1,0,0,1
9597,8,6,1,0,5,1
9597,7,10,2,0,8,2
9597,6,13,4,0,9,4
9597,5,7,1,0,6,1
6913,8,1,1,0,0,1
6913,7,5,1,0,4,1
6913,6,14,5,0,9,5
6913,5,13,4,0,9,4
6913,4,4,2,0,2,2
6913,3,3,1,0,2,1
8448,8,3,2,0,1,2
8448,7,6,2,0,4,2
8448,6,6,2,0,4,2
8448,5,13,6,0,7,6
8448,4,7,3,0,4,3
8448,3,2,1,0,1,1
8448,2,2,2,0,0,2
150971,8,4,2,0,2,2
150971,7,10,2,0,8,2
150971,6,24,3,0,21,3
150971,5,3,1,0,2,1
172875,10,2,1,0,1,1
172875,9,3,1,0,2,1
172875,8,9,3,0,6,3
172875,6,11,2,0,9,2
172875,4,7,1,0,6,1
5197,8,3,1,0,2,1
5197,7,12,2,0,10,2
5197,6,16,5,0,11,5
5197,5,6,2,0,4,2
5197,4,3,1,0,2,1
2489,9,1,1,0,0,1
2489,8,2,1,0,1,1
2489,7,7,5,0,2,5
2489,6,10,5,0,5,5
2489,5,10,4,0,6,4
2489,4,6,4,0,2,4
2489,3,2,2,0,0,2
2489,2,2,1,0,1,1
2489,1,2,1,0,1,1
824,10,2,2,0,0,2
824,9,1,1,0,0,1
824,7,6,4,0,2,4
824,6,16,2,0,14,2
824,5,8,3,0,5,3
824,4,6,3,0,3,3
21465,8,3,2,0,1,2
21465,7,6,2,0,4,2
21465,6,15,4,0,11,4
21465,5,5,3,0,2,3
21465,4,9,3,0,6,3
21465,3,3,2,0,1,2
21465,2,1,1,0,0,1
14034,8,4,2,0,2,2
14034,6,15,4,0,11,4
14034,5,9,3,0,6,3
14034,4,3,2,0,1,2
14034,3,4,2,0,2,2
8848,7,9,1,0,8,1
8848,6,15,6,0,9,6
8848,5,6,3,0,3,3
8848,4,3,2,0,1,2
8848,2,1,1,0,0,1
21437,10,2,1,0,1,1
21437,7,13,2,0,11,2
21437,6,14,5,0,9,5
21437,5,2,1,0,1,1
21437,3,1,1,0,0,1
2493,7,3,1,0,2,1
2493,5,16,6,0,10,6
2493,4,7,4,0,3,4
2493,3,5,1,0,4,1
2493,2,1,1,0,0,1
2493,1,1,1,0,0,1
49394,8,7,1,0,6,1
49394,7,13,1,0,12,1
49394,6,8,2,0,6,2
49394,4,1,1,0,0,1
201551,10,14,7,0,7,7
201551,9,4,2,0,2,2
201551,8,7,2,0,5,2
201551,7,4,1,0,3,1
201551,5,1,1,0,0,1
201551,4,3,2,0,1,2
201551,3,5,3,0,2,3
8426,9,3,1,0,2,1
8426,8,3,2,0,1,2
8426,7,8,1,0,7,1
8426,6,14,7,0,7,7
8426,5,9,3,0,6,3
8426,4,4,1,0,3,1
6771,9,4,1,0,3,1
6771,8,5,2,0,3,2
6771,7,11,5,0,6,5
6771,6,15,2,0,13,2
6771,5,5,1,0,4,1
33288,10,2,1,0,1,1
33288,8,3,1,0,2,1
33288,7,11,4,0,7,4
33288,5,5,2,0,3,2
33288,4,6,1,0,5,1
33288,2,1,1,0,0,1
200593,9,3,2,0,1,2
200593,8,8,1,0,7,1
200593,6,14,1,0,13,1
130042,9,3,2,0,1,2
130042,8,18,5,0,13,5
130042,7,11,6,0,5,6
130042,6,3,1,0,2,1
130042,5,2,1,0,1,1
130042,4,2,2,0,0,2
130042,3,1,1,0,0,1
116970,10,1,1,0,0,1
116970,7,8,1,0,7,1
116970,6,13,3,0,10,3
116970,5,10,1,0,9,1
116970,3,3,1,0,2,1
246355,9,3,1,0,2,1
246355,8,15,4,0,11,4
246355,7,11,2,0,9,2
246355,6,6,2,0,4,2
246355,5,1,1,0,0,1
227527,8,13,6,0,7,6
227527,7,15,4,0,11,4
227527,6,8,1,0,7,1
227527,5,2,1,0,1,1
146299,8,6,3,0,3,3
146299,6,13,1,0,12,1
146299,3,4,1,0,3,1
6744,10,7,2,0,5,2
6744,8,19,4,0,15,4
6744,7,5,1,0,4,1
6744,6,5,3,0,2,3
6744,2,1,1,0,0,1
28755,8,4,1,0,3,1
28755,7,5,3,0,2,3
28755,6,13,1,0,12,1
28755,5,8,1,0,7,1
28755,4,7,3,0,4,3
28755,3,4,2,0,2,2
8356,10,2,1,0,1,1
8356,9,4,2,0,2,2
8356,8,8,5,0,3,5
8356,7,13,2,0,11,2
8356,6,11,4,0,7,4
8356,5,3,2,0,1,2
258544,9,2,2,0,0,2
258544,8,4,1,0,3,1
258544,7,8,2,0,6,2
258544,6,12,2,0,10,2
258544,4,7,2,0,5,2
258544,3,4,1,0,3,1
19044,8,3,2,0,1,2
19044,7,5,1,0,4,1
19044,6,16,7,0,9,7
19044,5,7,3,0,4,3
19044,4,5,1,0,4,1
19044,2,3,1,0,2,1
257063,10,16,6,0,10,6
257063,9,12,2,0,10,2
257063,8,14,1,0,13,1
257063,7,1,1,0,0,1
257063,6,2,1,1,1,0
235494,10,11,7,0,4,7
235494,9,9,4,0,5,4
235494,8,11,5,0,6,5
235494,7,5,1,0,4,1
235494,5,3,2,0,1,2
34403,10,5,4,0,1,4
34403,9,9,3,0,6,3
34403,8,14,2,0,12,2
34403,7,4,3,0,1,3
34403,6,6,4,0,2,4
179124,8,4,2,0,2,2
179124,7,6,2,0,4,2
179124,6,15,4,0,11,4
179124,5,6,5,0,1,5
179124,4,5,2,0,3,2
179124,3,2,1,0,1,1
179124,2,3,2,0,1,2
5933,9,2,1,0,1,1
5933,8,6,2,0,4,2
5933,7,9,4,0,5,4
5933,6,14,3,0,11,3
78436,8,3,1,0,2,1
78436,7,4,2,0,2,2
78436,6,15,1,0,14,1
78436,4,9,2,0,7,2
78436,2,4,2,0,2,2
17996,9,2,1,0,1,1
17996,7,13,2,0,11,2
17996,6,8,2,0,6,2
41310,8,2,1,0,1,1
41310,7,4,1,0,3,1
41310,6,14,7,0,7,7
41310,5,12,5,0,7,5
41310,4,7,1,0,6,1
3686,6,4,2,0,2,2
3686,5,10,2,0,8,2
3686,4,17,2,0,15,2
3686,3,4,2,0,2,2
145632,6,15,1,0,14,1
145632,5,4,1,0,3,1
145632,4,4,1,0,3,1
145632,3,3,2,0,1,2
145632,2,1,1,0,0,1
4735,8,2,1,0,1,1
4735,7,3,1,0,2,1
4735,6,11,6,0,5,6
4735,5,10,3,0,7,3
4735,4,10,1,0,9,1
137331,7,9,3,0,6,3
137331,6,15,2,0,13,2
220843,10,5,1,0,4,1
220843,8,10,3,1,7,2
220843,7,9,1,0,8,1
220843,6,13,3,0,10,3
220843,5,1,1,1,0,0
220843,1,1,1,0,0,1
20135,4,12,2,0,10,2
20135,3,11,3,0,8,3
20135,1,2,2,0,0,2
25469,6,12,3,0,9,3
25469,5,13,4,0,9,4
25469,4,8,1,0,7,1
25469,1,1,1,0,0,1
42641,9,5,1,0,4,1
42641,8,15,5,0,10,5
42641,7,9,1,0,8,1
42641,6,6,3,0,3,3
42641,5,4,1,0,3,1
42641,4,1,1,0,0,1
3144,8,2,1,0,1,1
3144,7,7,3,0,4,3
3144,6,14,3,0,11,3
3144,5,9,3,0,6,3
3144,4,8,4,0,4,4
7746,7,4,1,0,3,1
7746,6,10,5,0,5,5
7746,4,8,5,0,3,5
7746,3,6,2,0,4,2
7746,2,5,2,0,3,2
7746,1,1,1,0,0,1
4574,8,7,3,0,4,3
4574,7,11,3,0,8,3
4574,6,12,1,0,11,1
4574,5,7,3,0,4,3
4574,4,2,2,0,0,2
21577,7,8,2,0,6,2
21577,6,13,7,0,6,7
21577,5,11,4,0,7,4
21577,4,5,2,0,3,2
21577,3,2,1,0,1,1
21577,2,1,1,0,0,1
42062,6,11,3,0,8,3
42062,5,8,1,0,7,1
42062,4,7,1,0,6,1
42062,3,5,1,0,4,1
42062,2,3,2,0,1,2
136523,7,9,4,0,5,4
136523,6,16,1,0,15,1
136523,5,4,2,0,2,2
21488,9,2,2,0,0,2
21488,8,5,3,0,2,3
21488,7,5,1,0,4,1
21488,6,20,6,0,14,6
21488,5,4,4,0,0,4
21488,4,2,1,0,1,1
21488,3,2,1,0,1,1
39278,9,5,2,0,3,2
39278,8,22,5,0,17,5
39278,7,10,1,0,9,1
257964,8,4,1,0,3,1
257964,6,13,2,0,11,2
257964,5,3,1,0,2,1
114405,8,4,1,0,3,1
114405,7,4,1,0,3,1
114405,6,18,7,0,11,7
114405,5,8,1,0,7,1
114405,4,6,1,0,5,1
22203,10,11,4,0,7,4
22203,9,6,2,0,4,2
22203,8,13,6,0,7,6
22203,7,6,1,0,5,1
9913,8,6,1,0,5,1
9913,7,11,2,0,9,2
9913,6,13,2,0,11,2
9913,5,5,1,0,4,1
5156,10,1,1,0,0,1
5156,8,1,1,0,0,1
5156,7,5,3,0,2,3
5156,6,14,4,0,10,4
5156,5,10,3,0,7,3
5156,4,5,2,0,3,2
5156,3,2,1,0,1,1
5156,2,2,1,0,1,1
64431,8,4,1,0,3,1
64431,7,7,2,0,5,2
64431,5,8,3,0,5,3
64431,2,1,1,0,0,1
130922,10,12,4,0,8,4
130922,9,11,4,0,7,4
130922,8,8,3,0,5,3
130922,7,5,1,0,4,1
130922,5,2,1,0,1,1
239877,10,5,1,0,4,1
239877,9,5,1,0,4,1
239877,8,11,1,0,10,1
239877,7,9,1,0,8,1
239877,6,7,3,0,4,3
239877,5,2,2,0,0,2
239877,4,2,1,0,1,1
7752,10,2,1,0,1,1
7752,9,7,2,0,5,2
7752,8,17,5,0,12,5
7752,7,10,3,0,7,3
7752,3,1,1,0,0,1
7752,2,1,1,0,0,1
8446,8,3,1,0,2,1
8446,7,7,3,0,4,3
8446,6,12,8,0,4,8
8446,5,12,3,0,9,3
8446,3,2,1,0,1,1
8455,7,3,1,0,2,1
8455,6,14,4,0,10,4
8455,5,9,5,0,4,5
8455,4,7,3,0,4,3
8455,3,5,4,0,1,4
94916,10,1,1,0,0,1
94916,9,1,1,0,0,1
94916,8,7,2,0,5,2
94916,7,11,6,0,5,6
94916,6,12,4,0,8,4
94916,5,4,1,0,3,1
94916,4,2,1,0,1,1
94916,2,3,2,0,1,2
199766,9,4,2,0,2,2
199766,8,12,1,0,11,1
199766,7,11,3,0,8,3
199766,6,9,4,0,5,4
262273,8,8,2,0,6,2
262273,7,11,4,0,7,4
262273,6,13,2,0,11,2
262273,5,6,3,0,3,3
262273,3,1,1,0,0,1
50356,9,4,3,0,1,3
50356,8,9,2,0,7,2
50356,7,4,1,0,3,1
50356,6,9,1,0,8,1
50356,4,6,3,0,3,3
50356,3,2,1,0,1,1
50356,2,1,1,0,0,1
11235,7,8,4,0,4,4
11235,6,17,7,0,10,7
11235,5,7,2,0,5,2
11235,4,4,2,0,2,2
11235,3,2,1,0,1,1
1120,8,1,1,0,0,1
1120,6,20,3,0,17,3
1120,5,7,2,0,5,2
1120,3,1,1,0,0,1
73091,9,2,1,0,1,1
73091,8,6,3,0,3,3
73091,7,10,3,0,7,3
73091,6,12,6,0,6,6
73091,5,6,4,0,2,4
73091,4,1,1,0,0,1
73091,3,1,1,0,0,1
81486,8,2,1,0,1,1
81486,7,4,2,0,2,2
81486,6,14,4,0,10,4
81486,5,10,1,0,9,1
81486,3,3,1,0,2,1
1550,9,2,2,0,0,2
1550,8,4,2,0,2,2
1550,7,6,4,0,2,4
1550,6,11,2,0,9,2
1550,5,9,4,0,5,4
1550,4,5,1,0,4,1
1550,2,3,3,0,0,3
14709,9,4,1,0,3,1
14709,8,11,5,0,6,5
14709,7,13,7,0,6,7
14709,6,7,6,0,1,6
14709,3,1,1,0,0,1
101766,8,3,1,0,2,1
101766,7,4,1,0,3,1
101766,6,21,7,0,14,7
101766,5,8,3,0,5,3
16802,9,2,1,0,1,1
16802,7,9,2,0,7,2
16802,6,10,2,0,8,2
16802,4,6,3,0,3,3
16802,3,3,2,0,1,2
16802,2,1,1,0,0,1
249746,10,9,1,0,8,1
249746,8,9,2,0,7,2
249746,7,8,1,0,7,1
249746,6,4,1,0,3,1
249746,5,1,1,0,0,1
249746,1,1,1,0,0,1
58139,7,8,1,0,7,1
58139,6,16,4,0,12,4
58139,4,6,4,0,2,4
58139,3,5,1,0,4,1
97329,8,7,2,0,5,2
97329,7,15,4,0,11,4
97329,6,12,3,0,9,3
97329,5,2,1,0,1,1
203381,8,13,1,0,12,1
203381,6,5,1,0,4,1
166972,7,10,1,0,9,1
166972,6,14,3,0,11,3
166972,4,3,1,0,2,1
166972,2,4,1,0,3,1
209090,10,3,3,0,0,3
209090,9,4,3,0,1,3
209090,8,14,6,2,8,4
209090,7,15,6,1,9,5
209090,6,4,1,0,3,1
167466,6,15,2,0,13,2
167466,2,2,1,0,1,1
2697,7,8,3,0,5,3
2697,6,14,2,0,12,2
2697,5,11,3,0,8,3
2697,2,2,2,0,0,2
192225,7,6,1,0,5,1
192225,6,9,3,0,6,3
192225,5,11,1,0,10,1
192225,3,6,3,0,3,3
192225,2,2,1,0,1,1
242630,10,6,1,0,5,1
242630,8,19,9,0,10,9
26920,8,6,1,0,5,1
26920,7,8,2,0,6,2
26920,6,11,5,0,6,5
26920,5,6,3,0,3,3
26920,4,5,3,0,2,3
26920,3,1,1,0,0,1
26920,2,1,1,0,0,1
9471,8,3,2,0,1,2
9471,7,8,3,0,5,3
9471,6,10,2,0,8,2
9471,4,8,3,0,5,3
126069,8,7,4,0,3,4
126069,7,18,8,0,10,8
126069,6,12,5,0,7,5
177061,9,7,3,0,4,3
177061,8,12,2,0,10,2
177061,7,7,3,0,4,3
177061,5,3,1,0,2,1
121043,10,1,1,0,0,1
121043,7,8,4,0,4,4
121043,6,17,4,0,13,4
121043,5,7,1,0,6,1
6367,8,5,3,0,2,3
6367,6,19,7,0,12,7
6367,5,11,3,0,8,3
6367,4,5,1,0,4,1
25246,8,8,4,0,4,4
25246,6,14,3,0,11,3
25246,5,4,1,0,3,1
25246,4,3,1,0,2,1
18341,10,7,5,0,2,5
18341,9,12,7,0,5,7
18341,8,11,2,0,9,2
18341,7,7,4,0,3,4
18341,4,1,1,0,0,1
158589,10,2,1,0,1,1
158589,9,8,2,0,6,2
158589,8,13,4,0,9,4
158589,7,7,5,0,2,5
158589,6,2,1,0,1,1
158589,5,2,2,0,0,2
158589,3,4,1,0,3,1
158589,2,1,1,0,0,1
10820,8,6,1,0,5,1
10820,6,12,3,0,9,3
10820,5,11,3,0,8,3
10820,4,3,3,0,0,3
111841,9,1,1,0,0,1
111841,8,9,3,0,6,3
111841,6,9,3,0,6,3
111841,5,8,1,0,7,1
111841,4,2,1,0,1,1
111841,3,4,2,0,2,2
111841,1,1,1,0,0,1
198991,8,6,1,0,5,1
198991,7,3,1,0,2,1
198991,6,17,2,0,15,2
198991,5,5,1,0,4,1
198991,2,1,1,0,0,1
184044,10,5,4,1,1,3
184044,6,11,2,0,9,2
184044,5,5,2,0,3,2
184044,4,4,1,0,3,1
184044,3,3,1,0,2,1
184044,2,6,3,0,3,3
176466,9,4,1,0,3,1
176466,8,16,5,0,11,5
176466,7,11,3,0,8,3
176466,6,8,2,0,6,2
176466,5,1,1,0,0,1
104770,8,3,2,0,1,2
104770,6,8,3,0,5,3
104770,5,10,2,0,8,2
104770,4,9,2,0,7,2
104770,3,2,2,0,0,2
246310,9,8,2,1,6,1
246310,8,11,2,1,9,1
246310,7,11,1,0,10,1
246310,4,2,2,0,0,2
124598,8,4,1,0,3,1
124598,7,8,4,0,4,4
124598,6,15,1,0,14,1
124598,5,8,1,0,7,1
22186,8,14,7,0,7,7
22186,7,9,2,0,7,2
22186,6,10,3,0,7,3
22186,5,2,1,0,1,1
5649,8,2,2,0,0,2
5649,7,2,2,0,0,2
5649,6,8,3,0,5,3
5649,5,10,3,0,7,3
5649,4,7,4,0,3,4
5649,3,9,2,0,7,2
5649,2,1,1,0,0,1
13667,10,3,1,0,2,1
13667,9,2,2,0,0,2
13667,8,9,3,0,6,3
13667,7,14,7,0,7,7
13667,6,12,6,0,6,6
76481,10,1,1,0,0,1
76481,9,3,1,0,2,1
76481,8,8,4,0,4,4
76481,7,10,1,0,9,1
76481,6,7,2,0,5,2
76481,5,4,2,0,2,2
76481,4,2,1,0,1,1
76481,3,4,3,0,1,3
76481,2,2,1,0,1,1
23999,10,2,1,0,1,1
23999,8,9,6,0,3,6
23999,7,6,3,0,3,3
23999,6,10,3,0,7,3
23999,5,6,1,0,5,1
23999,4,5,1,0,4,1
16649,8,1,1,0,0,1
16649,7,6,2,0,4,2
16649,6,11,5,0,6,5
16649,5,11,4,0,7,4
16649,4,8,3,0,5,3
203002,4,3,1,0,2,1
216367,8,8,3,0,5,3
216367,6,9,2,0,7,2
216367,5,4,1,0,3,1
216367,2,1,1,0,0,1
9633,10,2,1,0,1,1
9633,8,3,2,0,1,2
9633,7,8,6,0,2,6
9633,6,5,3,0,2,3
9633,5,7,1,0,6,1
9633,4,5,2,0,3,2
9633,3,4,1,0,3,1
9633,2,6,3,0,3,3
4607,8,2,2,0,0,2
4607,7,10,3,0,7,3
4607,6,17,11,0,6,11
4607,5,6,2,0,4,2
4607,4,3,1,0,2,1
4607,3,2,2,0,0,2
4607,2,1,1,0,0,1
6874,7,6,1,0,5,1
6874,6,10,1,0,9,1
6874,5,6,2,0,4,2
6874,4,8,1,0,7,1
6874,3,6,1,0,5,1
6874,2,3,1,0,2,1
14715,8,4,1,0,3,1
14715,7,6,4,0,2,4
14715,6,12,4,0,8,4
14715,5,8,5,0,3,5
14715,4,5,4,0,1,4
140995,10,8,3,0,5,3
140995,9,8,3,0,5,3
140995,8,7,1,0,6,1
140995,7,8,2,0,6,2
119525,7,10,2,0,8,2
119525,6,16,2,0,14,2
119525,5,8,2,0,6,2
119525,4,3,2,0,1,2
4561,6,8,2,0,6,2
4561,5,11,4,0,7,4
4561,3,5,2,0,3,2
501,8,6,2,0,4,2
501,7,9,2,0,7,2
501,6,16,3,0,13,3
501,5,4,2,0,2,2
501,4,6,3,0,3,3
41326,10,1,1,0,0,1
41326,8,4,2,0,2,2
41326,7,8,2,0,6,2
41326,6,16,7,0,9,7
41326,5,4,1,0,3,1
41326,4,8,4,0,4,4
2391,9,1,1,0,0,1
2391,8,2,1,0,1,1
2391,6,8,3,0,5,3
2391,5,12,2,0,10,2
2391,4,9,4,0,5,4
2391,3,4,1,0,3,1
2391,2,1,1,0,0,1
204617,6,12,4,0,8,4
204617,4,5,3,0,2,3
204617,2,5,3,0,2,3
245206,9,4,1,0,3,1
245206,8,15,5,0,10,5
245206,5,2,1,0,1,1
208801,9,2,1,0,1,1
208801,8,4,1,0,3,1
208801,7,13,4,0,9,4
208801,6,12,3,0,9,3
208801,4,4,1,0,3,1
208801,3,3,3,0,0,3
200871,9,1,1,0,0,1
200871,8,8,4,0,4,4
200871,7,10,3,0,7,3
200871,6,13,5,0,8,5
200871,4,4,1,0,3,1
156118,10,10,8,1,2,7
156118,9,3,1,0,2,1
156118,6,6,1,0,5,1
156118,4,5,1,0,4,1
156118,3,2,1,0,1,1
156118,2,3,2,0,1,2
156118,1,2,1,0,1,1
11600,7,7,1,0,6,1
11600,6,12,2,0,10,2
11600,5,8,2,0,6,2
11600,3,3,2,0,1,2
11600,2,3,1,0,2,1
202025,7,8,1,0,7,1
202025,6,16,3,1,13,2
202025,5,7,4,0,3,4
202025,4,4,1,0,3,1
202025,1,1,1,0,0,1
255702,8,4,1,0,3,1
255702,7,17,2,0,15,2
255702,6,14,2,0,12,2
255702,5,2,1,0,1,1
169470,8,8,2,0,6,2
169470,7,9,3,0,6,3
169470,6,10,2,0,8,2
169470,5,6,1,0,5,1
169470,4,4,2,0,2,2
169470,2,1,1,0,0,1
24447,8,3,2,0,1,2
24447,7,3,2,0,1,2
24447,6,13,4,0,9,4
24447,5,6,2,0,4,2
24447,4,7,4,0,3,4
24447,3,7,4,0,3,4
107703,9,2,1,0,1,1
107703,8,6,4,0,2,4
107703,7,20,5,0,15,5
107703,6,10,1,0,9,1
107703,5,2,1,0,1,1
187801,7,2,1,0,1,1
187801,6,9,1,0,8,1
187801,5,8,1,0,7,1
187801,4,6,1,0,5,1
187801,3,5,1,0,4,1
187801,2,8,2,0,6,2
187801,1,2,1,0,1,1
22464,9,1,1,0,0,1
22464,8,3,2,0,1,2
22464,7,10,5,0,5,5
22464,6,13,7,0,6,7
22464,5,10,6,0,4,6
22464,4,3,1,0,2,1
13226,8,3,3,0,0,3
13226,7,8,4,0,4,4
13226,6,14,5,0,9,5
13226,5,9,1,0,8,1
13226,4,7,3,0,4,3
9113,8,12,6,0,6,6
9113,7,10,2,0,8,2
9113,6,11,3,0,8,3
9113,5,4,2,0,2,2
9113,4,2,1,0,1,1
67499,7,9,2,0,7,2
67499,6,20,3,0,17,3
25104,7,11,1,0,10,1
25104,5,9,1,0,8,1
25104,4,4,1,0,3,1
25104,2,1,1,0,0,1
2283,6,13,4,0,9,4
2283,5,8,1,0,7,1
2283,4,6,4,0,2,4
2283,3,8,3,0,5,3
2283,2,2,1,0,1,1
203083,7,8,2,0,6,2
203083,6,10,4,1,6,3
203083,5,3,2,0,1,2
203083,3,2,1,0,1,1
203083,2,3,2,0,1,2
203083,1,4,1,0,3,1
172159,10,4,1,0,3,1
172159,9,2,2,0,0,2
172159,8,7,1,0,6,1
172159,7,10,1,0,9,1
172159,6,11,3,0,8,3
172159,4,2,1,0,1,1
172159,3,1,1,0,0,1
8670,7,8,2,0,6,2
8670,6,16,1,0,15,1
8670,5,8,2,0,6,2
136246,8,3,1,0,2,1
136246,7,11,5,0,6,5
136246,6,14,2,0,12,2
136246,5,7,1,0,6,1
34096,10,1,1,0,0,1
34096,8,3,1,0,2,1
34096,7,11,1,0,10,1
1221,7,3,2,0,1,2
1221,6,8,4,0,4,4
1221,5,12,4,0,8,4
1221,4,10,4,0,6,4
1221,2,2,1,0,1,1
196634,10,2,1,0,1,1
196634,9,7,1,0,6,1
196634,8,13,1,0,12,1
196634,7,9,2,0,7,2
196634,6,5,3,0,2,3
196634,5,3,2,0,1,2
196634,3,1,1,0,0,1
5089,7,8,4,0,4,4
5089,6,11,4,0,7,4
5089,5,8,4,0,4,4
5089,4,6,1,0,5,1
5089,3,3,2,0,1,2
5089,2,1,1,0,0,1
3156,10,2,1,0,1,1
3156,8,1,1,0,0,1
3156,7,6,4,0,2,4
3156,6,14,5,0,9,5
3156,5,13,1,0,12,1
3156,2,1,1,0,0,1
5209,7,3,1,0,2,1
5209,6,14,3,0,11,3
5209,5,5,1,0,4,1
5209,3,3,1,0,2,1
810,8,5,3,0,2,3
810,7,9,5,0,4,5
810,6,13,4,0,9,4
810,5,11,1,0,10,1
810,4,2,1,0,1,1
184797,10,4,2,0,2,2
184797,8,7,1,0,6,1
184797,7,14,1,0,13,1
184797,4,1,1,0,0,1
20131,10,1,1,0,0,1
20131,7,2,2,0,0,2
20131,6,16,5,0,11,5
20131,5,13,4,0,9,4
20131,4,6,4,0,2,4
20131,2,1,1,0,0,1
6129,7,8,1,0,7,1
6129,6,16,2,0,14,2
6129,5,9,3,0,6,3
6129,4,2,1,0,1,1
6129,2,1,1,0,0,1
6129,1,1,1,0,0,1
154180,8,3,2,0,1,2
154180,7,9,2,0,7,2
154180,6,11,2,0,9,2
154180,5,9,2,0,7,2
154180,4,6,1,0,5,1
154180,2,1,1,0,0,1
177995,8,4,1,0,3,1
177995,7,19,2,0,17,2
177995,6,13,4,0,9,4
7693,5,9,1,0,8,1
7693,4,9,2,0,7,2
7693,3,7,2,0,5,2
7693,2,8,1,0,7,1
7693,1,2,1,0,1,1
161543,10,3,1,0,2,1
161543,9,4,2,1,2,1
161543,8,13,5,2,8,3
161543,7,10,2,0,8,2
161543,6,8,2,0,6,2
161543,5,1,1,0,0,1
219348,8,6,1,0,5,1
219348,7,11,3,0,8,3
219348,6,12,1,0,11,1
219348,1,1,1,0,0,1
103811,5,9,2,0,7,2
103811,4,6,1,0,5,1
103811,3,2,1,0,1,1
5617,6,12,2,0,10,2
5617,5,9,2,0,7,2
5617,4,4,1,0,3,1
5617,3,6,3,0,3,3
5617,2,5,4,0,1,4
5617,1,1,1,0,0,1
4976,7,7,2,0,5,2
4976,6,5,1,0,4,1
4976,5,13,3,0,10,3
4976,4,8,4,0,4,4
4976,3,1,1,0,0,1
4976,2,5,2,0,3,2
6765,9,4,1,0,3,1
6765,8,5,2,0,3,2
6765,7,17,4,0,13,4
6765,6,9,3,0,6,3
6765,5,6,1,0,5,1
188968,8,3,1,0,2,1
188968,7,4,1,0,3,1
188968,6,13,2,0,11,2
188968,5,9,1,0,8,1
188968,4,7,3,0,4,3
188968,3,3,2,0,1,2
188968,1,1,1,0,0,1
19257,9,7,6,0,1,6
19257,8,6,5,0,1,5
19257,7,17,10,0,7,10
19257,5,4,1,0,3,1
19257,4,2,1,0,1,1
18097,7,5,1,0,4,1
18097,6,10,1,0,9,1
18097,4,9,2,0,7,2
18097,3,4,1,0,3,1
229243,6,18,3,0,15,3
229243,5,8,1,0,7,1
168005,7,4,2,0,2,2
168005,6,9,4,0,5,4
168005,5,11,3,0,8,3
168005,4,10,2,0,8,2
18679,7,2,2,0,0,2
18679,6,8,2,0,6,2
18679,5,7,5,0,2,5
18679,4,6,3,0,3,3
18679,3,5,1,0,4,1
18679,2,7,3,0,4,3
18679,1,3,2,0,1,2
40804,9,1,1,0,0,1
40804,8,4,1,0,3,1
40804,7,7,2,0,5,2
40804,6,11,1,0,10,1
40804,5,6,2,0,4,2
40804,3,2,1,0,1,1
40804,1,2,1,0,1,1
42453,9,1,1,0,0,1
42453,8,4,2,0,2,2
42453,7,8,4,0,4,4
42453,6,14,4,0,10,4
42453,5,9,3,0,6,3
42453,4,5,2,0,3,2
175868,6,6,1,0,5,1
175868,5,9,1,0,8,1
175868,3,4,1,0,3,1
21528,10,1,1,0,0,1
21528,7,1,1,0,0,1
21528,6,8,2,0,6,2
21528,5,7,3,0,4,3
21528,4,8,3,0,5,3
21528,3,6,3,0,3,3
21528,2,3,1,0,2,1
21528,1,7,3,0,4,3
153486,9,5,1,0,4,1
153486,8,4,3,0,1,3
153486,7,8,4,0,4,4
153486,6,18,8,0,10,8
153486,4,3,2,0,1,2
22205,8,1,1,0,0,1
22205,7,10,4,0,6,4
22205,6,23,8,0,15,8
22205,5,5,1,0,4,1
22205,4,2,1,0,1,1
209506,10,2,1,0,1,1
209506,8,3,1,0,2,1
209506,7,12,2,0,10,2
209506,6,10,1,0,9,1
209506,2,3,1,0,2,1
209506,1,2,1,0,1,1
39976,10,2,2,0,0,2
39976,9,4,2,0,2,2
39976,8,17,6,0,11,6
39976,7,8,4,0,4,4
39976,6,6,1,0,5,1
39976,5,4,3,0,1,3
192730,7,10,1,0,9,1
192730,6,14,3,0,11,3
192730,5,8,2,0,6,2
192730,2,2,1,0,1,1
10885,8,1,1,0,0,1
10885,7,14,2,0,12,2
10885,6,10,1,0,9,1
10885,5,7,3,0,4,3
10885,4,4,2,0,2,2
10885,3,3,1,0,2,1
3371,7,5,1,0,4,1
3371,6,14,2,0,12,2
3371,5,11,2,0,9,2
3371,4,4,1,0,3,1
172729,7,5,3,0,2,3
172729,6,5,2,0,3,2
172729,5,9,1,0,8,1
172729,4,8,2,0,6,2
172729,2,5,2,0,3,2
172729,1,1,1,0,0,1
251228,10,3,2,0,1,2
251228,9,5,1,0,4,1
251228,8,18,6,0,12,6
251228,7,11,2,0,9,2
251228,6,4,2,0,2,2
15412,8,6,2,0,4,2
15412,7,6,1,0,5,1
15412,6,12,4,0,8,4
15412,5,6,3,0,3,3
15412,4,6,3,0,3,3
15412,3,3,1,0,2,1
15412,2,2,1,0,1,1
239189,10,18,5,0,13,5
239189,9,4,1,1,3,0
239189,5,2,1,0,1,1
239189,1,9,7,1,2,6
168834,9,3,1,0,2,1
168834,8,6,2,0,4,2
168834,7,12,3,0,9,3
168834,6,15,3,0,12,3
168834,5,3,1,0,2,1
168834,4,2,1,0,1,1
153372,9,2,1,0,1,1
153372,7,9,1,0,8,1
153372,4,9,1,0,8,1
95695,5,7,1,0,6,1
95695,4,9,2,0,7,2
95695,2,5,1,0,4,1
95695,1,4,1,0,3,1
111097,9,7,1,0,6,1
111097,8,7,3,0,4,3
111097,6,9,2,0,7,2
111097,5,7,1,0,6,1
43080,7,13,4,0,9,4
43080,6,13,5,0,8,5
43080,5,10,6,0,4,6
43080,4,1,1,0,0,1
43080,2,1,1,0,0,1
184664,10,2,1,0,1,1
184664,9,3,1,0,2,1
184664,8,12,6,1,6,5
184664,7,9,1,0,8,1
184664,5,2,2,0,0,2
184664,3,3,1,0,2,1
9234,7,2,1,0,1,1
9234,6,13,4,0,9,4
9234,5,11,2,0,9,2
9234,4,12,5,0,7,5
9234,3,3,1,0,2,1
206666,8,8,5,1,3,4
206666,7,13,1,0,12,1
206666,6,9,3,0,6,3
234299,10,2,1,0,1,1
234299,9,3,2,0,1,2
234299,8,5,1,0,4,1
234299,7,16,4,0,12,4
234299,6,10,1,0,9,1
7986,8,6,4,0,2,4
7986,7,10,2,0,8,2
7986,6,16,3,0,13,3
7986,5,6,1,0,5,1
7986,3,1,1,0,0,1
132406,8,5,2,1,3,1
132406,7,11,2,0,9,2
132406,6,12,4,0,8,4
132406,5,4,1,0,3,1
132406,3,2,1,0,1,1
132406,1,1,1,1,0,0
16530,10,1,1,0,0,1
16530,7,4,1,0,3,1
16530,6,8,1,0,7,1
16530,5,5,1,0,4,1
16530,4,6,1,0,5,1
16530,3,3,1,0,2,1
16530,2,7,4,0,3,4
611,10,1,1,0,0,1
611,8,7,2,0,5,2
611,7,4,2,0,2,2
611,6,13,5,0,8,5
611,5,9,4,0,5,4
611,4,5,4,0,1,4
9339,9,6,5,0,1,5
9339,8,8,4,0,4,4
9339,6,10,1,0,9,1
9339,4,2,1,0,1,1
16432,9,2,1,0,1,1
16432,8,6,4,0,2,4
16432,7,15,2,0,13,2
16432,6,12,4,0,8,4
16432,5,3,2,0,1,2
16432,4,2,1,0,1,1
222424,10,6,2,0,4,2
222424,9,4,1,0,3,1
222424,8,7,1,1,6,0
222424,7,7,1,0,6,1
222424,6,10,4,0,6,4
222424,5,3,2,0,1,2
235513,9,4,1,0,3,1
235513,6,16,3,0,13,3
146309,8,3,1,0,2,1
146309,7,9,3,0,6,3
146309,6,14,3,0,11,3
153484,7,3,1,0,2,1
153484,6,16,4,0,12,4
153484,5,11,1,0,10,1
37142,8,4,1,0,3,1
37142,7,8,1,0,7,1
37142,6,13,5,0,8,5
37142,4,5,1,0,4,1
37142,3,2,1,0,1,1
37142,2,1,1,0,0,1
241490,10,2,1,0,1,1
241490,9,1,1,0,0,1
241490,7,8,3,0,5,3
241490,6,10,1,0,9,1
241490,5,3,1,0,2,1
241490,4,6,1,0,5,1
241490,3,4,1,0,3,1
241490,1,4,1,0,3,1
191879,8,6,1,0,5,1
191879,6,12,1,0,11,1
191879,5,7,3,0,4,3
191879,4,5,1,0,4,1
145586,7,19,2,0,17,2
145586,6,15,3,0,12,3
4340,10,1,1,0,0,1
4340,8,1,1,0,0,1
4340,7,7,5,0,2,5
4340,6,16,4,0,12,4
4340,5,5,1,0,4,1
4340,4,5,2,0,3,2
4340,2,4,2,0,2,2
25248,6,10,2,0,8,2
25248,4,13,4,0,9,4
8457,8,2,2,0,0,2
8457,7,10,2,0,8,2
8457,6,16,6,0,10,6
8457,5,4,1,0,3,1
8457,4,5,1,0,4,1
8457,3,1,1,0,0,1
216631,7,11,4,0,7,4
216631,6,8,3,0,5,3
216631,5,11,2,0,9,2
216631,3,3,1,0,2,1
206068,10,4,3,1,1,2
206068,9,6,3,0,3,3
206068,8,9,1,0,8,1
206068,4,2,2,1,0,1
38836,10,3,1,0,2,1
38836,9,3,1,0,2,1
38836,8,14,7,0,7,7
38836,6,8,3,0,5,3
38836,5,2,1,0,1,1
38836,1,1,1,0,0,1
18536,10,2,2,0,0,2
18536,9,6,1,0,5,1
18536,8,4,1,0,3,1
18536,7,6,4,0,2,4
18536,6,10,3,0,7,3
18536,5,9,4,0,5,4
37392,9,2,2,0,0,2
37392,8,10,3,0,7,3
37392,7,11,7,0,4,7
37392,6,10,3,0,7,3
37392,5,4,2,0,2,2
37392,2,1,1,0,0,1
1660,6,4,3,0,1,3
1660,5,8,1,0,7,1
1660,4,10,4,0,6,4
1660,3,4,2,0,2,2
1660,2,3,1,0,2,1
1660,1,8,5,0,3,5
161126,10,2,1,0,1,1
161126,9,3,1,1,2,0
161126,8,7,2,0,5,2
161126,6,2,1,0,1,1
12043,8,2,1,0,1,1
12043,7,9,3,0,6,3
12043,6,8,1,0,7,1
12043,4,7,2,0,5,2
13672,10,1,1,0,0,1
13672,9,1,1,0,0,1
13672,4,11,2,0,9,2
13672,3,13,3,0,10,3
245203,8,7,2,0,5,2
245203,7,8,2,0,6,2
245203,5,7,1,0,6,1
245203,4,3,1,0,2,1
245203,3,3,1,0,2,1
257313,9,5,2,0,3,2
257313,8,12,2,0,10,2
257313,7,8,2,0,6,2
257313,5,3,1,0,2,1
257313,3,2,1,0,1,1
146262,7,15,2,0,13,2
146262,6,13,2,0,11,2
100798,9,1,1,0,0,1
100798,8,13,3,0,10,3
100798,7,11,1,0,10,1
100798,2,1,1,0,0,1
3639,8,3,2,0,1,2
3639,7,6,2,0,4,2
3639,6,18,8,0,10,8
3639,5,7,3,0,4,3
3639,4,5,2,0,3,2
3639,3,1,1,0,0,1
16760,8,5,4,0,1,4
16760,7,7,3,0,4,3
16760,6,11,8,0,3,8
16760,5,12,10,0,2,10
11469,8,4,1,0,3,1
11469,7,11,8,0,3,8
11469,6,11,5,0,6,5
11469,5,5,2,0,3,2
11469,4,3,1,0,2,1
15957,10,8,1,0,7,1
15957,9,6,1,0,5,1
15957,8,9,3,0,6,3
15957,6,11,3,0,8,3
15957,5,3,1,0,2,1
8355,10,2,1,0,1,1
8355,9,2,1,0,1,1
8355,8,16,6,0,10,6
8355,7,12,5,0,7,5
8355,6,5,2,0,3,2
8355,5,3,1,0,2,1
178933,9,2,1,0,1,1
178933,6,17,1,0,16,1
178933,5,5,1,0,4,1
178933,4,2,1,0,1,1
178933,3,2,1,0,1,1
201243,6,16,2,1,14,1
201243,5,5,1,0,4,1
5742,7,6,1,0,5,1
5742,5,6,3,0,3,3
5742,4,10,4,0,6,4
5742,3,5,1,0,4,1
29107,9,1,1,0,0,1
29107,8,5,4,0,1,4
29107,7,9,4,0,5,4
29107,6,11,3,0,8,3
29107,5,7,3,0,4,3
29107,3,2,1,0,1,1
15427,6,6,1,0,5,1
15427,5,6,1,0,5,1
15427,4,7,1,0,6,1
15427,3,8,2,0,6,2
15427,2,8,4,0,4,4
15427,1,4,3,0,1,3
9607,7,3,2,0,1,2
9607,6,10,2,0,8,2
9607,5,10,3,0,7,3
9607,3,9,3,0,6,3
9607,2,5,2,0,3,2
882,9,2,1,0,1,1
882,8,2,1,0,1,1
882,6,17,4,0,13,4
882,5,6,3,0,3,3
882,4,3,2,0,1,2
228550,10,6,4,0,2,4
228550,8,14,1,0,13,1
228550,7,10,4,1,6,3
228550,6,4,1,0,3,1
228550,1,1,1,1,0,0
38562,9,7,2,0,5,2
38562,8,12,4,0,8,4
38562,7,7,1,0,6,1
1054,10,1,1,0,0,1
1054,9,2,1,0,1,1
1054,8,5,1,0,4,1
1054,7,10,3,0,7,3
1054,6,9,5,0,4,5
1054,5,7,3,0,4,3
1054,4,3,2,0,1,2
1054,3,2,2,0,0,2
1054,2,1,1,0,0,1
20694,6,7,1,0,6,1
20694,5,10,2,0,8,2
20694,4,9,2,0,7,2
20694,3,9,2,0,7,2
244817,7,10,3,0,7,3
244817,6,15,1,0,14,1
244817,5,4,1,0,3,1
154281,10,8,7,0,1,7
154281,9,3,2,0,1,2
154281,8,7,1,0,6,1
154281,7,5,2,0,3,2
154281,6,7,1,0,6,1
154281,5,3,1,0,2,1
154281,4,5,2,0,3,2
154281,3,1,1,0,0,1
154281,1,1,1,0,0,1
248702,8,7,1,0,6,1
248702,7,12,1,0,11,1
248702,6,10,1,0,9,1
167590,9,2,2,0,0,2
167590,8,2,1,0,1,1
167590,7,3,2,0,1,2
167590,6,2,1,0,1,1
167590,5,4,1,0,3,1
167590,4,3,1,0,2,1
167590,2,6,2,0,4,2
167590,1,18,12,0,6,12
10855,9,3,1,0,2,1
10855,7,10,5,0,5,5
10855,6,16,8,0,8,8
10855,5,6,2,0,4,2
10855,2,2,2,0,0,2
9489,10,1,1,0,0,1
9489,9,1,1,0,0,1
9489,8,11,8,0,3,8
9489,7,12,5,0,7,5
9489,6,11,2,0,9,2
9489,3,1,1,0,0,1
143459,8,4,1,0,3,1
143459,7,8,1,0,7,1
143459,6,11,5,0,6,5
143459,5,7,2,0,5,2
143459,4,4,1,0,3,1
143459,2,2,1,0,1,1
143459,1,2,1,0,1,1
18687,8,15,3,0,12,3
18687,7,11,5,0,6,5
18687,6,5,2,0,3,2
18687,3,1,1,0,0,1
17239,10,5,4,0,1,4
17239,9,9,5,0,4,5
17239,8,9,4,0,5,4
17239,7,9,3,0,6,3
17239,6,7,2,0,5,2
224010,9,1,1,0,0,1
224010,8,3,1,0,2,1
224010,7,9,2,0,7,2
224010,6,19,4,0,15,4
36639,8,4,2,0,2,2
36639,7,9,6,0,3,6
36639,6,12,5,0,7,5
36639,5,7,2,0,5,2
36639,4,4,2,0,2,2
36639,3,3,1,0,2,1
7939,10,4,3,0,1,3
7939,9,3,2,0,1,2
7939,7,11,5,0,6,5
7939,6,10,5,0,5,5
7939,5,7,1,0,6,1
7939,4,2,1,0,1,1
7939,2,1,1,0,0,1
11674,10,3,1,0,2,1
11674,8,5,1,0,4,1
11674,7,18,5,0,13,5
11674,6,10,4,0,6,4
11674,5,1,1,0,0,1
164010,10,2,1,0,1,1
164010,8,10,4,2,6,2
164010,6,9,1,0,8,1
164010,4,3,1,0,2,1
164010,1,3,3,0,0,3
15334,8,4,1,0,3,1
15334,7,13,4,0,9,4
15334,6,9,1,0,8,1
15334,5,6,1,0,5,1
15334,4,4,2,0,2,2
20379,10,4,1,0,3,1
20379,8,9,1,0,8,1
20379,7,11,4,0,7,4
20379,6,11,2,0,9,2
102150,9,3,1,0,2,1
102150,8,8,3,0,5,3
102150,7,13,3,0,10,3
102150,6,10,6,0,4,6
102150,5,4,2,0,2,2
9835,9,2,1,0,1,1
9835,8,5,2,0,3,2
9835,7,14,5,0,9,5
9835,6,14,5,0,9,5
9835,4,1,1,0,0,1
99696,8,12,4,0,8,4
99696,7,11,5,0,6,5
99696,6,6,1,0,5,1
99696,5,3,1,0,2,1
3598,8,3,1,0,2,1
3598,7,5,2,0,3,2
3598,6,14,2,0,12,2
3598,5,11,1,0,10,1
3598,4,4,1,0,3,1
3598,3,3,2,0,1,2
6232,10,2,1,0,1,1
6232,9,2,1,0,1,1
6232,8,3,2,0,1,2
6232,7,4,1,0,3,1
6232,6,10,3,0,7,3
6232,4,7,3,0,4,3
6232,3,6,3,0,3,3
6920,10,2,1,0,1,1
6920,8,7,1,0,6,1
6920,7,15,3,0,12,3
6920,6,9,3,0,6,3
253608,10,4,1,0,3,1
253608,9,7,2,0,5,2
253608,8,22,4,1,18,3
253608,7,3,1,0,2,1
253608,5,1,1,0,0,1
253608,3,2,1,0,1,1
213301,10,8,6,1,2,5
213301,9,3,2,0,1,2
213301,8,9,2,0,7,2
213301,7,13,4,0,9,4
213301,4,2,1,0,1,1
93997,8,7,2,0,5,2
93997,7,15,6,0,9,6
93997,6,14,4,0,10,4
93997,4,2,1,0,1,1
93997,3,2,1,0,1,1
249868,10,5,1,0,4,1
249868,9,11,4,0,7,4
249868,8,18,8,0,10,8
249868,7,4,1,0,3,1
249868,4,1,1,0,0,1
173240,6,18,3,0,15,3
173240,5,3,1,0,2,1
6417,10,3,3,0,0,3
6417,9,7,5,0,2,5
6417,8,4,3,0,1,3
6417,7,9,3,0,6,3
6417,6,8,1,0,7,1
6417,2,1,1,0,0,1
93271,10,1,1,0,0,1
93271,9,3,1,0,2,1
93271,6,14,4,0,10,4
93271,5,9,1,0,8,1
94456,8,7,2,0,5,2
94456,7,12,1,0,11,1
94456,6,13,4,0,9,4
94456,5,5,1,0,4,1
94456,4,1,1,0,0,1
16030,9,8,3,0,5,3
16030,8,12,4,0,8,4
16030,7,8,2,0,6,2
16030,6,11,3,0,8,3
8589,9,1,1,0,0,1
8589,8,6,2,0,4,2
8589,7,7,1,0,6,1
8589,6,12,2,0,10,2
8589,5,10,4,0,6,4
8589,4,3,1,0,2,1
177014,10,18,11,5,7,6
177014,9,12,5,0,7,5
177014,8,5,2,0,3,2
212883,7,10,1,0,9,1
212883,6,15,2,0,13,2
212883,5,4,1,0,3,1
6659,6,6,3,0,3,3
6659,5,10,2,0,8,2
6659,4,9,2,0,7,2
6659,2,4,2,0,2,2
6659,1,4,2,0,2,2
26956,8,6,4,0,2,4
26956,7,3,2,0,1,2
26956,6,17,7,0,10,7
26956,5,10,5,0,5,5
172012,9,4,2,0,2,2
172012,8,10,2,0,8,2
172012,7,18,3,0,15,3
172012,6,6,2,0,4,2
172012,5,2,1,0,1,1
3666,10,3,1,0,2,1
3666,8,8,2,0,6,2
3666,7,16,4,0,12,4
3666,6,8,3,0,5,3
208073,8,11,3,1,8,2
208073,7,10,3,0,7,3
208073,5,1,1,0,0,1
208073,4,1,1,0,0,1
3830,9,1,1,0,0,1
3830,8,1,1,0,0,1
3830,6,5,1,0,4,1
3830,5,7,2,0,5,2
3830,4,11,3,0,8,3
3830,3,8,2,0,6,2
3830,2,2,1,0,1,1
14424,8,5,2,0,3,2
14424,7,8,2,0,6,2
14424,6,17,7,0,10,7
14424,5,6,1,0,5,1
14424,4,3,1,0,2,1
14424,3,1,1,0,0,1
34374,8,1,1,0,0,1
34374,7,2,1,0,1,1
34374,6,17,7,0,10,7
34374,5,14,3,0,11,3
34374,4,5,3,0,2,3
167552,10,4,3,0,1,3
167552,9,5,1,0,4,1
167552,8,10,3,0,7,3
167552,7,10,2,0,8,2
167552,6,9,3,1,6,2
60280,9,4,3,0,1,3
60280,8,14,7,0,7,7
60280,7,11,4,0,7,4
60280,6,6,1,0,5,1
60280,3,1,1,0,0,1
94633,10,6,3,0,3,3
94633,9,3,2,0,1,2
94633,8,5,1,0,4,1
94633,6,11,4,1,7,3
94633,5,4,1,0,3,1
94633,3,2,1,0,1,1
148973,10,2,1,0,1,1
148973,9,1,1,0,0,1
148973,8,1,1,0,0,1
148973,7,7,2,0,5,2
148973,6,10,1,1,9,0
148973,5,6,1,0,5,1
148973,4,6,2,0,4,2
148973,1,1,1,0,0,1
4897,7,5,1,0,4,1
4897,6,12,5,0,7,5
4897,5,12,3,0,9,3
4897,4,9,4,0,5,4
4897,2,1,1,0,0,1
36333,9,5,4,0,1,4
36333,8,16,6,0,10,6
36333,7,4,4,0,0,4
36333,6,7,4,0,3,4
36333,5,3,2,0,1,2
36333,4,1,1,0,0,1
36333,3,3,1,0,2,1
121790,10,1,1,0,0,1
121790,6,14,1,0,13,1
121790,5,4,2,0,2,2
121790,3,7,2,0,5,2
16723,5,6,2,0,4,2
16723,4,10,4,0,6,4
16723,3,8,3,0,5,3
16723,2,2,1,0,1,1
3760,10,1,1,0,0,1
3760,7,9,1,0,8,1
3760,6,12,2,0,10,2
3760,2,2,1,0,1,1
8743,10,3,1,0,2,1
8743,8,9,6,0,3,6
8743,7,11,4,0,7,4
8743,6,8,1,0,7,1
8743,5,6,4,0,2,4
8743,3,1,1,0,0,1
8743,2,1,1,0,0,1
99038,8,2,1,0,1,1
99038,7,8,3,0,5,3
99038,6,16,5,0,11,5
99038,5,10,2,0,8,2
99038,3,2,1,0,1,1
99038,2,1,1,0,0,1
22380,6,11,3,0,8,3
22380,5,13,2,0,11,2
22380,4,4,2,0,2,2
22380,3,5,2,0,3,2
22380,2,2,1,0,1,1
174688,8,14,3,0,11,3
174688,7,17,5,0,12,5
174688,4,4,1,0,3,1
3719,8,2,1,0,1,1
3719,6,5,3,0,2,3
3719,5,13,4,0,9,4
3719,4,9,3,0,6,3
3719,3,3,1,0,2,1
3719,2,3,2,0,1,2
3719,1,2,1,0,1,1
257991,9,3,1,0,2,1
257991,8,12,2,0,10,2
257991,7,7,1,0,6,1
257991,6,6,1,0,5,1
257991,5,3,2,0,1,2
257991,2,1,1,0,0,1
6699,9,3,1,0,2,1
6699,8,9,2,0,7,2
6699,7,10,3,0,7,3
6699,6,6,2,0,4,2
6699,4,3,1,0,2,1
151603,7,10,1,0,9,1
151603,6,10,2,0,8,2
151603,4,6,1,0,5,1
151603,3,1,1,0,0,1
42660,9,2,1,0,1,1
42660,8,18,4,0,14,4
42660,7,7,4,0,3,4
42660,6,10,6,0,4,6
42660,5,2,1,0,1,1
181246,8,1,1,0,0,1
181246,7,6,3,0,3,3
181246,6,10,3,0,7,3
181246,4,7,2,0,5,2
181246,3,3,1,0,2,1
271321,10,3,2,0,1,2
271321,9,8,3,0,5,3
271321,8,10,5,0,5,5
271321,7,11,2,0,9,2
12691,5,6,3,0,3,3
12691,4,2,1,0,1,1
12691,3,1,1,0,0,1
12691,2,7,3,0,4,3
12691,1,22,11,0,11,11
11052,8,3,1,0,2,1
11052,7,5,4,0,1,4
11052,6,6,1,0,5,1
11052,5,7,3,0,4,3
11052,4,8,3,0,5,3
11052,3,5,4,0,1,4
11052,2,4,3,0,1,3
218923,10,6,5,1,1,4
218923,8,10,2,0,8,2
218923,7,9,2,1,7,1
218923,4,2,1,0,1,1
183883,8,9,1,0,8,1
183883,4,5,2,0,3,2
183883,2,3,2,0,1,2
224678,9,8,4,0,4,4
224678,8,17,1,0,16,1
224678,7,9,2,0,7,2
224678,6,4,2,0,2,2
8382,8,5,4,0,1,4
8382,7,12,2,0,10,2
8382,6,9,2,0,7,2
8382,5,5,1,0,4,1
8382,4,5,1,0,4,1
244946,10,12,4,0,8,4
244946,9,11,2,0,9,2
244946,8,11,2,0,9,2
244946,7,6,2,0,4,2
244946,1,1,1,0,0,1
98261,8,13,2,0,11,2
98261,6,6,2,0,4,2
98261,4,2,1,0,1,1
8358,8,10,3,0,7,3
8358,7,15,6,0,9,6
8358,6,13,1,0,12,1
6338,10,2,1,0,1,1
6338,9,4,3,0,1,3
6338,7,7,3,0,4,3
6338,6,10,2,0,8,2
6338,5,5,1,0,4,1
6995,9,2,2,0,0,2
6995,8,7,5,0,2,5
6995,7,11,7,0,4,7
6995,6,9,8,0,1,8
6995,5,7,4,0,3,4
178177,10,1,1,0,0,1
178177,9,1,1,0,0,1
178177,7,9,1,0,8,1
178177,6,15,2,0,13,2
178177,4,4,1,0,3,1
2031,10,4,2,0,2,2
2031,9,2,1,0,1,1
2031,8,7,3,0,4,3
2031,7,10,3,0,7,3
2031,6,12,4,0,8,4
2031,5,5,1,0,4,1
2031,3,1,1,0,0,1
188952,8,2,1,0,1,1
188952,7,10,1,0,9,1
188952,6,15,5,0,10,5
188952,4,3,1,0,2,1
188952,3,4,2,0,2,2
36905,9,1,1,0,0,1
36905,8,2,1,0,1,1
36905,7,6,1,0,5,1
36905,4,11,1,0,10,1
7622,10,3,2,0,1,2
7622,8,6,1,0,5,1
7622,7,7,1,0,6,1
7622,6,10,1,0,9,1
7622,5,5,2,0,3,2
7622,4,4,1,0,3,1
7622,2,1,1,0,0,1
22866,8,1,1,0,0,1
22866,7,7,1,0,6,1
22866,6,11,4,0,7,4
22866,4,7,1,0,6,1
35466,8,6,2,0,4,2
35466,7,6,3,0,3,3
35466,6,11,3,0,8,3
35466,5,8,2,0,6,2
35466,4,4,3,0,1,3
35466,2,2,1,0,1,1
23970,9,2,1,0,1,1
23970,7,1,1,0,0,1
23970,6,5,1,0,4,1
23970,5,8,1,0,7,1
23970,4,11,6,0,5,6
23970,3,7,3,0,4,3
8405,9,2,1,0,1,1
8405,8,4,2,0,2,2
8405,7,7,2,0,5,2
8405,6,12,2,0,10,2
8405,5,10,2,0,8,2
8405,3,1,1,0,0,1
66276,4,7,2,0,5,2
66276,2,3,1,0,2,1
22176,9,3,1,0,2,1
22176,8,4,3,0,1,3
22176,7,7,3,0,4,3
22176,6,15,7,0,8,7
22176,4,5,4,0,1,4
22176,2,2,2,0,0,2
161682,10,3,1,0,2,1
161682,9,4,3,0,1,3
161682,8,18,10,0,8,10
161682,7,9,4,0,5,4
161682,6,3,2,0,1,2
161682,4,2,1,0,1,1
40376,7,6,2,0,4,2
40376,6,13,6,0,7,6
40376,5,6,3,0,3,3
40376,4,6,1,0,5,1
40376,1,1,1,0,0,1
143085,9,3,1,0,2,1
143085,8,9,3,0,6,3
143085,7,9,4,0,5,4
143085,6,11,2,0,9,2
143085,5,6,1,0,5,1
18945,10,1,1,0,0,1
18945,8,5,5,0,0,5
18945,7,5,2,0,3,2
18945,6,14,9,0,5,9
18945,5,6,3,0,3,3
18945,4,3,2,0,1,2
18945,3,2,1,0,1,1
652,5,14,3,0,11,3
239082,9,4,1,0,3,1
239082,8,8,1,0,7,1
239082,7,11,2,0,9,2
239082,5,3,1,0,2,1
239082,4,2,1,0,1,1
25991,8,4,2,0,2,2
25991,7,5,2,0,3,2
25991,6,16,6,0,10,6
25991,5,5,2,0,3,2
25991,4,7,3,0,4,3
19368,6,3,1,0,2,1
19368,5,8,2,0,6,2
19368,4,6,3,0,3,3
19368,3,2,2,0,0,2
19368,2,13,10,0,3,10
19368,1,6,4,0,2,4
130823,8,3,1,0,2,1
130823,6,11,3,0,8,3
130823,5,6,2,0,4,2
130823,4,10,1,0,9,1
130823,3,6,1,0,5,1
130823,1,2,1,0,1,1
21269,10,1,1,0,0,1
21269,9,3,1,0,2,1
21269,8,11,4,0,7,4
21269,6,14,6,0,8,6
21269,5,6,2,0,4,2
13837,9,1,1,0,0,1
13837,8,11,3,0,8,3
13837,7,15,4,0,11,4
13837,6,6,2,0,4,2
13837,5,1,1,0,0,1
13837,4,1,1,0,0,1
13837,3,2,1,0,1,1
13837,1,1,1,0,0,1
26017,7,1,1,0,0,1
26017,6,17,3,0,14,3
26017,5,7,3,0,4,3
26017,4,6,2,0,4,2
26017,2,2,1,0,1,1
223742,7,8,1,0,7,1
223742,6,12,1,0,11,1
223742,3,2,1,0,1,1
8081,8,1,1,0,0,1
8081,7,1,1,0,0,1
8081,6,4,1,0,3,1
8081,5,8,4,0,4,4
8081,4,9,4,0,5,4
8081,3,10,3,0,7,3
8081,2,6,4,0,2,4
8081,1,1,1,0,0,1
2172,7,9,2,0,7,2
2172,6,10,3,0,7,3
2172,5,9,3,0,6,3
2172,4,6,1,0,5,1
4265,10,4,3,0,1,3
4265,9,6,1,0,5,1
4265,8,12,6,0,6,6
4265,7,10,4,0,6,4
4265,6,3,1,0,2,1
4265,5,2,1,0,1,1
4265,3,1,1,0,0,1
149035,10,4,2,0,2,2
149035,9,1,1,0,0,1
149035,8,4,1,0,3,1
149035,7,9,2,0,7,2
149035,6,13,2,0,11,2
149035,5,3,1,0,2,1
149035,4,3,1,0,2,1
149035,3,2,1,0,1,1
162888,10,8,1,0,7,1
162888,9,10,3,0,7,3
162888,8,8,3,0,5,3
162888,1,1,1,0,0,1
231575,10,5,2,0,3,2
231575,8,12,4,0,8,4
231575,7,8,1,0,7,1
231575,6,11,2,0,9,2
231575,2,1,1,0,0,1
5492,10,3,2,0,1,2
5492,9,3,1,0,2,1
5492,8,6,1,0,5,1
5492,7,7,2,0,5,2
5492,6,12,1,0,11,1
5492,5,4,1,0,3,1
5492,4,1,1,0,0,1
5492,2,3,1,0,2,1
136856,6,18,2,0,16,2
136856,4,4,1,0,3,1
8456,7,4,2,0,2,2
8456,6,15,8,0,7,8
8456,5,10,1,0,9,1
8456,4,5,3,0,2,3
8456,1,3,2,0,1,2
203673,9,2,1,0,1,1
203673,8,12,5,0,7,5
203673,7,9,2,0,7,2
203673,6,6,1,0,5,1
203673,5,6,1,0,5,1
203673,4,3,2,0,1,2
147465,9,5,1,0,4,1
147465,8,10,1,0,9,1
147465,7,4,2,1,2,1
147465,6,13,5,0,8,5
6896,9,2,1,0,1,1
6896,8,5,2,0,3,2
6896,6,12,4,0,8,4
6896,5,4,3,0,1,3
6896,4,3,1,0,2,1
141250,6,12,2,0,10,2
141250,5,11,2,0,9,2
141250,4,7,1,0,6,1
141250,3,4,1,0,3,1
243697,9,4,2,0,2,2
243697,8,12,5,1,7,4
243697,7,12,1,1,11,0
243697,6,10,2,1,8,1
211852,10,8,6,1,2,5
211852,9,11,5,2,6,3
211852,8,6,1,0,5,1
211852,7,4,2,2,2,0
211852,6,8,1,0,7,1
211852,5,2,1,0,1,1
211852,4,1,1,0,0,1
73361,10,2,2,0,0,2
73361,9,4,3,0,1,3
73361,8,10,6,0,4,6
73361,7,11,3,0,8,3
73361,6,11,4,0,7,4
181080,7,10,1,0,9,1
181080,6,11,2,0,9,2
181080,5,8,2,0,6,2
181080,4,5,1,0,4,1
181080,3,2,1,0,1,1
22600,10,7,3,0,4,3
22600,9,4,1,0,3,1
22600,8,13,4,0,9,4
22600,7,8,1,0,7,1
22600,6,6,3,0,3,3
22600,2,2,1,0,1,1
209716,10,4,4,0,0,4
209716,9,5,2,0,3,2
209716,8,9,2,0,7,2
209716,7,8,1,0,7,1
209716,5,4,2,0,2,2
144420,6,12,2,0,10,2
151468,10,2,1,0,1,1
151468,8,1,1,0,0,1
151468,7,2,1,0,1,1
151468,6,6,3,0,3,3
151468,5,8,1,0,7,1
151468,3,8,2,0,6,2
151468,2,7,4,0,3,4
12160,10,2,1,0,1,1
12160,8,15,6,0,9,6
12160,7,4,2,0,2,2
12160,6,6,5,0,1,5
12160,5,6,2,0,4,2
12160,4,4,2,0,2,2
12160,3,2,1,0,1,1
209748,9,1,1,0,0,1
209748,7,12,5,0,7,5
209748,6,16,6,2,10,4
209748,5,3,1,0,2,1
3108,10,2,2,0,0,2
3108,8,7,1,0,6,1
3108,7,7,3,0,4,3
3108,6,12,6,0,6,6
3108,5,7,2,0,5,2
3108,4,3,1,0,2,1
11421,8,5,2,0,3,2
11421,7,8,1,0,7,1
11421,6,10,3,0,7,3
11421,5,6,2,0,4,2
11421,4,6,3,0,3,3
5459,10,2,2,0,0,2
5459,9,1,1,0,0,1
5459,8,7,2,0,5,2
5459,7,16,9,0,7,9
5459,6,10,6,0,4,6
5459,5,3,2,0,1,2
255970,8,9,2,0,7,2
255970,7,11,2,0,9,2
255970,4,2,1,0,1,1
138729,10,9,5,0,4,5
138729,9,2,1,0,1,1
138729,8,12,2,0,10,2
138729,6,5,1,0,4,1
138729,5,3,2,0,1,2
68504,10,5,2,0,3,2
68504,9,4,4,0,0,4
68504,8,13,4,0,9,4
68504,7,3,1,0,2,1
68504,6,11,5,0,6,5
68504,1,1,1,0,0,1
86169,10,2,1,0,1,1
86169,9,1,1,0,0,1
86169,8,7,3,1,4,2
86169,7,9,4,0,5,4
86169,6,15,6,1,9,5
86169,5,4,1,0,3,1
86169,4,2,1,0,1,1
237800,8,18,1,0,17,1
237800,7,14,1,0,13,1
180595,8,1,1,0,0,1
180595,7,14,4,0,10,4
180595,6,17,4,0,13,4
180595,5,4,1,0,3,1
124761,8,3,1,0,2,1
124761,7,8,1,0,7,1
124761,6,20,4,0,16,4
124761,3,2,1,0,1,1
167238,10,2,1,0,1,1
167238,8,7,4,0,3,4
167238,7,14,1,0,13,1
167238,6,8,2,0,6,2
167238,5,6,3,0,3,3
167238,3,2,1,0,1,1
246814,8,1,1,0,0,1
246814,7,12,1,0,11,1
246814,5,6,1,0,5,1
246814,4,3,1,0,2,1
9259,9,4,1,0,3,1
9259,8,5,2,0,3,2
9259,7,11,2,0,9,2
9259,6,13,2,0,11,2
9259,5,5,3,0,2,3
8221,8,1,1,0,0,1
8221,7,10,5,0,5,5
8221,6,8,3,0,5,3
8221,5,8,1,0,7,1
8221,4,5,2,0,3,2
8221,3,4,1,0,3,1
8221,2,2,1,0,1,1
15238,10,13,7,0,6,7
15238,9,12,4,0,8,4
15238,8,7,3,0,4,3
15238,7,3,1,0,2,1
15238,6,1,1,0,0,1
15238,1,2,1,0,1,1
177868,10,3,2,0,1,2
177868,8,11,6,0,5,6
177868,7,8,1,0,7,1
177868,6,10,2,0,8,2
177868,4,1,1,0,0,1
58672,6,15,3,0,12,3
58672,5,8,3,0,5,3
58672,4,8,2,0,6,2
15490,6,7,2,0,5,2
15490,5,13,1,0,12,1
15490,4,11,2,0,9,2
15490,2,3,1,0,2,1
257089,9,10,1,0,9,1
257089,8,19,3,0,16,3
257089,7,2,2,0,0,2
257089,1,2,2,0,0,2
1925,7,5,1,0,4,1
1925,6,6,4,0,2,4
1925,5,10,3,0,7,3
1925,4,9,1,0,8,1
1925,3,5,1,0,4,1
1925,2,3,1,0,2,1
225235,8,11,5,0,6,5
225235,7,11,4,0,7,4
225235,4,3,3,0,0,3
58003,8,10,2,0,8,2
58003,6,11,2,0,9,2
58003,4,3,1,0,2,1
58003,2,1,1,0,0,1
25994,10,3,1,0,2,1
25994,9,3,2,0,1,2
25994,8,8,2,0,6,2
25994,7,14,5,0,9,5
25994,6,5,2,0,3,2
25994,5,3,3,0,0,3
25994,3,2,1,0,1,1
21529,7,2,1,0,1,1
21529,6,10,4,0,6,4
21529,5,9,3,0,6,3
21529,4,8,3,0,5,3
21529,3,6,1,0,5,1
21529,2,1,1,0,0,1
21529,1,2,1,0,1,1
237174,10,12,5,0,7,5
237174,9,9,3,0,6,3
237174,8,8,6,0,2,6
237174,7,6,2,0,4,2
32828,7,3,2,0,1,2
32828,6,9,3,0,6,3
32828,5,12,3,0,9,3
32828,4,6,3,0,3,3
32828,3,3,1,0,2,1
32828,2,3,1,0,2,1
32828,1,1,1,0,0,1
58375,10,2,1,0,1,1
58375,7,5,1,0,4,1
58375,6,7,3,0,4,3
58375,5,8,3,0,5,3
58375,4,8,2,0,6,2
58375,3,3,1,0,2,1
58375,2,5,3,0,2,3
3716,8,8,3,0,5,3
3716,7,12,5,0,7,5
3716,6,5,2,0,3,2
3716,4,5,1,0,4,1
3716,3,2,1,0,1,1
3716,1,1,1,0,0,1
92465,9,4,1,0,3,1
92465,3,2,2,0,0,2
14377,8,4,2,0,2,2
14377,7,7,4,0,3,4
14377,6,19,6,0,13,6
14377,5,7,2,0,5,2
7947,7,12,6,0,6,6
7947,6,12,3,0,9,3
7947,5,7,1,0,6,1
7947,4,5,2,0,3,2
152848,9,2,1,0,1,1
152848,8,13,6,0,7,6
152848,7,8,1,0,7,1
152848,6,10,1,0,9,1
152848,5,2,1,0,1,1
152848,4,3,1,0,2,1
164829,10,1,1,0,0,1
164829,8,7,3,0,4,3
164829,7,9,1,0,8,1
164829,6,12,5,0,7,5
164829,5,7,4,0,3,4
198548,8,6,2,0,4,2
198548,7,11,3,0,8,3
198548,6,15,5,0,10,5
198548,5,4,2,0,2,2
198548,3,1,1,0,0,1
2074,7,6,3,0,3,3
2074,5,10,1,0,9,1
2074,4,8,3,0,5,3
2074,2,2,2,0,0,2
182168,8,4,1,0,3,1
182168,6,9,2,0,7,2
182168,4,7,2,0,5,2
230995,10,3,1,0,2,1
230995,8,2,1,0,1,1
230995,2,3,1,0,2,1
230995,1,2,1,0,1,1
239452,10,9,7,0,2,7
239452,9,5,2,0,3,2
239452,8,7,3,0,4,3
239452,7,4,1,0,3,1
239452,6,4,1,0,3,1
239452,5,5,2,0,3,2
239452,3,1,1,0,0,1
239452,2,3,1,0,2,1
15542,6,11,4,0,7,4
15542,5,6,1,0,5,1
15542,4,8,2,0,6,2
15542,3,4,1,0,3,1
15542,2,2,1,0,1,1
12243,7,4,1,0,3,1
12243,6,9,4,0,5,4
12243,5,9,3,0,6,3
12243,4,6,2,0,4,2
12243,3,6,3,0,3,3
12243,2,3,1,0,2,1
38418,5,7,1,0,6,1
38418,4,11,2,0,9,2
38418,2,3,1,0,2,1
20587,10,3,2,0,1,2
20587,9,2,1,0,1,1
20587,8,9,2,0,7,2
20587,7,12,2,0,10,2
20587,6,6,1,0,5,1
20587,5,3,2,0,1,2
20587,3,1,1,0,0,1
2762,10,2,2,0,0,2
2762,8,9,5,0,4,5
2762,7,13,8,0,5,8
2762,6,10,6,0,4,6
2762,5,4,1,0,3,1
140939,10,2,1,0,1,1
140939,8,10,3,0,7,3
140939,7,7,2,0,5,2
140939,6,13,5,0,8,5
140939,5,3,1,0,2,1
140939,4,2,1,0,1,1
5121,6,10,6,0,4,6
5121,5,15,3,0,12,3
5121,4,6,2,0,4,2
5121,2,2,1,0,1,1
2370,6,13,3,0,10,3
2370,5,11,4,0,7,4
2370,4,8,5,0,3,5
2370,3,3,1,0,2,1
91438,9,3,1,0,2,1
91438,8,13,6,0,7,6
91438,7,14,7,0,7,7
91438,6,6,1,0,5,1
91438,5,3,1,0,2,1
75418,10,4,2,0,2,2
75418,9,7,2,0,5,2
75418,8,17,3,0,14,3
75418,7,9,2,0,7,2
141569,9,1,1,0,0,1
141569,7,11,2,0,9,2
141569,5,12,4,0,8,4
141569,4,6,1,0,5,1
141569,2,1,1,0,0,1
180295,8,8,2,1,6,1
180295,6,9,3,0,6,3
180295,5,7,3,2,4,1
180295,4,5,2,0,3,2
38524,8,5,2,0,3,2
38524,7,9,3,0,6,3
38524,6,17,5,0,12,5
38524,5,6,3,0,3,3
38524,3,2,1,0,1,1
275,7,6,4,0,2,4
275,6,9,5,0,4,5
275,5,10,4,0,6,4
275,4,8,4,0,4,4
275,3,4,3,0,1,3
275,1,1,1,0,0,1
2230,10,2,1,0,1,1
2230,9,1,1,0,0,1
2230,8,14,4,0,10,4
2230,7,10,2,0,8,2
2230,6,9,2,0,7,2
15380,6,7,3,0,4,3
15380,5,8,1,0,7,1
15380,4,11,5,0,6,5
15380,3,2,1,0,1,1
15380,2,3,1,0,2,1
15380,1,1,1,0,0,1
28301,4,7,1,0,6,1
28301,3,3,1,0,2,1
28301,1,1,1,0,0,1
33383,8,2,1,0,1,1
33383,7,10,3,0,7,3
33383,6,13,3,0,10,3
33383,5,6,2,0,4,2
33383,2,2,1,0,1,1
13960,9,1,1,0,0,1
13960,8,9,4,0,5,4
13960,7,12,4,0,8,4
13960,6,15,9,0,6,9
13960,5,2,2,0,0,2
19793,8,5,1,0,4,1
19793,7,9,6,0,3,6
19793,6,16,4,0,12,4
19793,5,5,1,0,4,1
19793,4,1,1,0,0,1
19793,3,2,2,0,0,2
3486,8,1,1,0,0,1
3486,6,10,1,0,9,1
3486,5,13,3,0,10,3
3486,4,4,2,0,2,2
3486,3,6,3,0,3,3
3486,2,2,1,0,1,1
34218,8,3,1,0,2,1
34218,7,13,8,0,5,8
34218,6,15,9,0,6,9
34218,5,4,1,0,3,1
34218,3,2,1,0,1,1
227318,10,4,2,0,2,2
227318,9,3,1,0,2,1
227318,8,9,2,0,7,2
227318,6,10,1,0,9,1
227318,4,2,1,1,1,0
88957,7,4,1,0,3,1
88957,6,6,3,0,3,3
88957,5,11,3,0,8,3
88957,4,5,1,0,4,1
88957,3,6,2,0,4,2
88957,2,4,1,0,3,1
57422,7,6,2,0,4,2
57422,6,7,1,0,6,1
57422,5,12,3,0,9,3
57422,4,9,3,0,6,3
234383,8,5,1,0,4,1
234383,6,15,2,0,13,2
234383,5,8,2,0,6,2
234383,4,6,2,0,4,2
234383,3,2,1,0,1,1
42256,10,2,1,0,1,1
42256,8,2,1,0,1,1
42256,7,18,6,0,12,6
42256,6,13,8,0,5,8
7443,7,3,2,0,1,2
7443,6,13,4,0,9,4
7443,5,13,3,0,10,3
7443,4,5,2,0,3,2
18647,8,6,2,0,4,2
18647,6,11,1,0,10,1
18647,5,6,2,0,4,2
18647,4,2,1,0,1,1
120509,9,2,1,0,1,1
120509,8,16,2,0,14,2
120509,7,13,4,0,9,4
120509,6,6,4,0,2,4
120509,3,1,1,0,0,1
231152,9,3,1,0,2,1
231152,8,12,7,0,5,7
231152,7,13,3,0,10,3
231152,6,9,2,0,7,2
231152,3,1,1,0,0,1
217884,9,5,4,0,1,4
217884,8,9,2,0,7,2
217884,7,9,2,0,7,2
217884,6,6,1,0,5,1
217884,5,7,3,0,4,3
217884,4,1,1,0,0,1
1391,6,10,4,0,6,4
1391,5,9,2,0,7,2
1391,4,13,2,0,11,2
1391,2,3,1,0,2,1
64430,10,3,2,0,1,2
64430,9,1,1,0,0,1
64430,8,11,4,0,7,4
64430,6,8,1,0,7,1
64430,4,3,1,0,2,1
64430,3,1,1,0,0,1
38881,8,15,5,0,10,5
38881,7,12,4,0,8,4
38881,6,8,4,0,4,4
38881,5,2,1,0,1,1
5496,9,1,1,0,0,1
5496,8,3,1,0,2,1
5496,7,1,1,0,0,1
5496,6,8,5,0,3,5
5496,5,9,3,0,6,3
5496,4,11,5,0,6,5
5496,3,3,2,0,1,2
168436,7,10,1,0,9,1
168436,6,17,1,0,16,1
26617,7,6,4,0,2,4
26617,6,9,2,0,7,2
26617,5,8,1,0,7,1
26617,4,8,2,0,6,2
26617,3,5,4,0,1,4
26617,1,1,1,0,0,1
224680,10,5,2,1,3,1
224680,9,2,1,0,1,1
224680,8,3,1,0,2,1
224680,7,8,2,0,6,2
224680,4,2,1,0,1,1
7566,8,7,3,0,4,3
7566,7,8,4,0,4,4
7566,6,10,4,0,6,4
7566,5,7,2,0,5,2
7566,4,2,1,0,1,1
7566,3,2,1,0,1,1
158495,8,10,2,0,8,2
158495,7,13,3,0,10,3
158495,6,8,1,0,7,1
158495,5,2,1,0,1,1
158495,4,4,1,0,3,1
158495,3,1,1,0,0,1
157995,8,7,3,0,4,3
157995,7,9,1,0,8,1
157995,6,16,2,0,14,2
157995,4,1,1,0,0,1
8406,7,7,3,0,4,3
8406,6,16,4,0,12,4
8406,5,9,4,0,5,4
8406,4,2,1,0,1,1
9263,8,4,1,0,3,1
9263,7,7,3,0,4,3
9263,6,16,3,0,13,3
9263,5,6,3,0,3,3
9263,3,2,1,0,1,1
10776,9,2,1,0,1,1
10776,8,5,2,0,3,2
10776,7,16,4,0,12,4
10776,6,8,2,0,6,2
10776,4,3,1,0,2,1
10776,1,1,1,0,0,1
24698,10,3,3,0,0,3
24698,9,6,2,0,4,2
24698,8,14,7,0,7,7
24698,7,9,2,0,7,2
24698,5,5,2,0,3,2
24698,4,1,1,0,0,1
181153,8,3,1,0,2,1
181153,7,3,1,0,2,1
181153,6,15,5,0,10,5
181153,4,8,5,0,3,5
225214,9,1,1,0,0,1
225214,8,10,1,0,9,1
225214,7,17,1,0,16,1
225214,6,9,3,0,6,3
225214,5,2,1,0,1,1
207602,10,7,2,0,5,2
207602,8,11,2,0,9,2
207602,7,10,1,1,9,0
141042,8,4,2,0,2,2
141042,6,9,1,0,8,1
141042,5,12,3,0,9,3
141042,4,3,1,0,2,1
192201,8,5,2,0,3,2
192201,7,13,5,0,8,5
192201,6,13,2,0,11,2
192201,5,5,1,0,4,1
192201,4,2,1,0,1,1
212688,9,2,1,0,1,1
212688,8,8,1,1,7,0
212688,7,8,1,0,7,1
212688,4,2,2,0,0,2
142219,10,4,1,0,3,1
142219,9,2,1,0,1,1
142219,8,11,6,1,5,5
142219,7,9,1,0,8,1
142219,6,7,2,0,5,2
142219,5,4,2,0,2,2
142219,4,2,1,0,1,1
107680,8,2,1,0,1,1
107680,7,4,1,0,3,1
107680,6,13,2,0,11,2
107680,5,8,2,0,6,2
107680,4,7,2,0,5,2
107680,2,2,1,0,1,1
18199,8,2,2,0,0,2
18199,7,2,1,0,1,1
18199,6,14,7,0,7,7
18199,5,11,2,0,9,2
18199,4,6,1,0,5,1
18199,2,2,1,0,1,1
204407,8,9,3,0,6,3
204407,7,11,2,0,9,2
204407,6,11,3,0,8,3
204407,5,5,1,0,4,1
204407,4,2,1,0,1,1
11997,10,4,3,0,1,3
11997,9,6,6,0,0,6
11997,8,12,5,0,7,5
11997,7,6,2,0,4,2
11997,6,8,2,0,6,2
11997,5,2,2,0,0,2
11997,4,1,1,0,0,1
9603,7,2,2,0,0,2
9603,6,7,1,0,6,1
9603,5,14,6,0,8,6
9603,4,6,5,0,1,5
9603,3,4,4,0,0,4
9603,2,3,3,0,0,3
9603,1,3,1,0,2,1
124160,9,1,1,0,0,1
124160,8,6,2,0,4,2
124160,5,1,1,0,0,1
124160,3,2,1,0,1,1
124160,1,18,10,0,8,10
114386,9,3,1,0,2,1
114386,8,14,3,0,11,3
114386,7,14,2,0,12,2
114386,6,6,4,0,2,4
23346,7,4,1,0,3,1
23346,4,9,3,0,6,3
23346,3,6,5,0,1,5
23346,2,3,1,0,2,1
23346,1,4,1,0,3,1
41189,6,10,4,0,6,4
41189,5,10,1,0,9,1
41189,3,8,4,0,4,4
41189,2,5,3,0,2,3
179228,8,6,1,0,5,1
179228,6,7,2,0,5,2
179228,5,7,3,1,4,2
179228,4,5,1,0,4,1
179228,3,5,3,0,2,3
179228,1,3,3,1,0,2
192801,10,4,1,0,3,1
192801,9,1,1,0,0,1
192801,8,4,1,0,3,1
192801,7,7,1,0,6,1
192801,2,2,1,0,1,1
37491,10,2,1,0,1,1
37491,9,4,1,0,3,1
37491,8,11,8,0,3,8
37491,7,17,6,0,11,6
37491,6,4,1,0,3,1
45437,7,5,1,0,4,1
45437,6,12,1,0,11,1
45437,5,8,2,0,6,2
45437,4,4,2,0,2,2
45437,3,5,1,0,4,1
231362,8,5,1,0,4,1
231362,7,4,1,0,3,1
231362,6,12,1,0,11,1
231362,5,10,4,0,6,4
231362,4,6,5,0,1,5
231362,3,1,1,0,0,1
110864,8,8,2,0,6,2
110864,7,9,1,0,8,1
110864,6,9,1,0,8,1
110864,5,4,1,0,3,1
110864,2,1,1,0,0,1
10593,9,1,1,0,0,1
10593,7,3,1,0,2,1
10593,6,17,9,0,8,9
10593,5,5,2,0,3,2
10593,4,6,2,0,4,2
135492,7,6,1,0,5,1
135492,6,19,1,0,18,1
1355,8,5,1,0,4,1
1355,7,6,1,0,5,1
1355,6,15,5,0,10,5
1355,5,10,2,0,8,2
259972,8,7,5,0,2,5
259972,7,9,3,0,6,3
259972,5,6,1,0,5,1
8178,8,2,1,0,1,1
8178,7,7,2,0,5,2
8178,6,12,4,0,8,4
8178,5,7,3,0,4,3
8178,4,4,3,0,1,3
8178,3,4,1,0,3,1
3772,9,3,1,0,2,1
3772,8,8,5,0,3,5
3772,7,14,5,0,9,5
3772,6,7,4,0,3,4
3772,5,5,2,0,3,2
8502,8,6,3,0,3,3
8502,7,6,2,0,4,2
8502,6,4,1,0,3,1
8502,5,12,2,0,10,2
8502,4,7,1,0,6,1
6774,8,5,1,0,4,1
6774,7,8,3,0,5,3
6774,6,14,7,0,7,7
6774,5,5,2,0,3,2
6774,4,5,3,0,2,3
3266,7,2,2,0,0,2
3266,5,7,4,0,3,4
3266,4,10,5,0,5,5
3266,3,8,3,0,5,3
3266,2,5,2,0,3,2
3266,1,1,1,0,0,1
34091,6,15,2,0,13,2
34091,5,8,1,0,7,1
34091,4,5,1,0,4,1
34091,3,5,1,0,4,1
205156,8,9,3,0,6,3
205156,7,11,3,0,8,3
205156,5,6,3,0,3,3
205156,4,4,2,0,2,2
205156,3,1,1,0,0,1
17041,10,8,2,0,6,2
17041,9,8,1,0,7,1
17041,8,13,5,0,8,5
17041,7,3,1,0,2,1
17041,6,4,2,0,2,2
5902,10,1,1,0,0,1
5902,9,1,1,0,0,1
5902,8,5,2,0,3,2
5902,7,8,3,0,5,3
5902,6,10,3,0,7,3
5902,5,12,4,0,8,4
5902,3,2,2,0,0,2
146014,9,3,1,0,2,1
146014,8,7,1,0,6,1
146014,7,11,1,0,10,1
146014,6,9,4,0,5,4
235760,8,6,1,0,5,1
235760,7,7,2,0,5,2
235760,6,13,3,0,10,3
235760,5,7,2,0,5,2
10996,10,2,1,0,1,1
10996,9,3,2,0,1,2
10996,8,8,2,0,6,2
10996,7,9,1,0,8,1
10996,6,9,4,0,5,4
10996,5,6,3,0,3,3
10996,4,2,1,0,1,1
155412,10,6,5,0,1,5
155412,9,4,1,0,3,1
155412,8,10,7,0,3,7
155412,7,5,3,0,2,3
155412,6,3,2,0,1,2
155412,5,3,2,0,1,2
155412,3,1,1,0,0,1
155412,2,2,2,0,0,2
155412,1,3,3,0,0,3
124248,10,10,10,0,0,10
124248,9,4,4,0,0,4
124248,8,13,5,0,8,5
124248,3,1,1,0,0,1
9845,8,1,1,0,0,1
9845,7,6,1,0,5,1
9845,6,23,4,0,19,4
9845,5,5,2,0,3,2
9845,4,2,1,0,1,1
17644,8,5,1,0,4,1
17644,7,16,7,0,9,7
17644,6,10,1,0,9,1
17644,5,4,2,0,2,2
17644,4,1,1,0,0,1
17644,3,1,1,0,0,1
16830,9,2,2,0,0,2
16830,8,5,1,0,4,1
16830,7,6,2,0,4,2
16830,6,13,6,0,7,6
16830,4,3,1,0,2,1
16830,1,1,1,0,0,1
64426,8,2,1,0,1,1
64426,7,12,1,0,11,1
64426,6,12,3,0,9,3
64426,5,6,2,0,4,2
64426,4,3,2,0,1,2
64426,3,2,1,0,1,1
64426,2,1,1,0,0,1
232827,10,4,1,0,3,1
232827,9,2,1,0,1,1
232827,8,9,1,0,8,1
232827,7,14,1,0,13,1
232827,6,8,2,0,6,2
5134,9,4,1,0,3,1
5134,8,4,3,0,1,3
5134,7,9,4,0,5,4
5134,6,11,3,0,8,3
5134,4,2,2,0,0,2
5134,3,2,1,0,1,1
5134,2,3,1,0,2,1
64064,7,4,1,0,3,1
64064,6,17,4,0,13,4
64064,5,8,3,0,5,3
253318,9,1,1,0,0,1
253318,8,13,3,0,10,3
253318,7,17,3,0,14,3
253318,6,5,2,0,3,2
253318,4,2,2,0,0,2
173292,9,2,1,0,1,1
173292,8,7,2,0,5,2
173292,7,5,1,0,4,1
173292,6,10,1,0,9,1
173292,5,7,2,0,5,2
173292,4,5,1,0,4,1
173292,3,3,1,0,2,1
192323,10,4,1,0,3,1
192323,9,2,2,0,0,2
192323,6,9,1,0,8,1
192323,3,1,1,0,0,1
182581,10,3,2,0,1,2
182581,9,4,2,1,2,1
182581,8,7,2,1,5,1
182581,7,7,2,0,5,2
182581,6,10,2,0,8,2
182581,5,2,1,0,1,1
182581,3,2,1,0,1,1
182581,1,3,1,0,2,1
14539,6,4,2,0,2,2
14539,5,14,5,0,9,5
14539,4,9,4,0,5,4
14539,3,9,1,0,8,1
14539,2,2,2,0,0,2
4163,9,2,2,0,0,2
4163,8,5,4,0,1,4
4163,7,6,4,0,2,4
4163,6,15,5,0,10,5
4163,5,9,3,0,6,3
8962,9,2,1,0,1,1
8962,8,3,2,0,1,2
8962,7,8,4,0,4,4
8962,6,13,7,0,6,7
8962,5,5,2,0,3,2
8962,4,4,1,0,3,1
8962,3,1,1,0,0,1
8962,2,3,2,0,1,2
22182,10,8,6,0,2,6
22182,8,12,6,0,6,6
22182,7,10,3,0,7,3
22182,6,3,1,0,2,1
27296,6,6,1,0,5,1
27296,5,8,3,0,5,3
27296,4,13,3,0,10,3
15614,6,15,1,0,14,1
15614,5,3,2,0,1,2
3306,8,1,1,0,0,1
3306,7,3,2,0,1,2
3306,6,5,1,0,4,1
3306,5,7,4,0,3,4
3306,4,10,4,0,6,4
3306,3,3,1,0,2,1
3306,2,7,2,0,5,2
3306,1,3,2,0,1,2
3107,8,3,1,0,2,1
3107,6,14,5,0,9,5
3107,5,9,2,0,7,2
3107,4,3,1,0,2,1
3107,3,4,1,0,3,1
20419,8,1,1,0,0,1
20419,6,4,2,0,2,2
20419,5,9,4,0,5,4
20419,4,9,2,0,7,2
20419,3,6,2,0,4,2
20419,2,5,3,0,2,3
20419,1,4,1,0,3,1
931,10,1,1,0,0,1
931,8,6,1,0,5,1
931,7,13,5,0,8,5
931,6,10,1,0,9,1
931,3,1,1,0,0,1
19036,8,2,1,0,1,1
19036,6,12,2,0,10,2
19036,5,13,4,0,9,4
19036,4,3,2,0,1,2
19036,3,2,2,0,0,2
14468,8,6,1,0,5,1
14468,7,10,3,0,7,3
14468,6,15,8,0,7,8
14468,5,2,2,0,0,2
14468,3,1,1,0,0,1
14468,2,1,1,0,0,1
260942,7,8,2,0,6,2
260942,6,12,4,0,8,4
260942,5,10,2,0,8,2
10757,8,2,1,0,1,1
10757,6,15,4,0,11,4
10757,5,6,2,0,4,2
10757,4,7,4,0,3,4
184563,10,10,2,0,8,2
184563,9,8,1,0,7,1
184563,8,14,3,0,11,3
165417,8,11,3,1,8,2
165417,7,8,1,0,7,1
165417,6,6,2,1,4,1
165417,5,10,5,0,5,5
165417,4,3,2,0,1,2
165417,2,1,1,0,0,1
19614,5,4,1,0,3,1
19614,4,5,2,0,3,2
19614,2,12,9,0,3,9
19614,1,10,7,0,3,7
154526,10,5,3,0,2,3
154526,9,13,6,0,7,6
154526,8,13,3,0,10,3
154526,6,2,1,0,1,1
199590,9,2,1,0,1,1
199590,6,7,1,0,6,1
199590,5,5,1,0,4,1
199590,4,5,1,0,4,1
199590,2,5,2,0,3,2
212288,7,8,1,0,7,1
212288,6,13,3,0,10,3
212288,5,11,1,0,10,1
239982,10,6,3,0,3,3
239982,9,5,2,0,3,2
239982,8,5,3,1,2,2
239982,7,8,3,1,5,2
239982,5,5,2,1,3,1
239982,1,1,1,0,0,1
5675,8,2,2,0,0,2
5675,7,4,1,0,3,1
5675,6,5,2,0,3,2
5675,5,9,4,0,5,4
5675,4,6,2,0,4,2
5675,3,6,1,0,5,1
5675,2,7,2,0,5,2
42644,8,2,1,0,1,1
42644,7,2,1,0,1,1
42644,6,14,3,0,11,3
10075,7,5,4,0,1,4
10075,6,9,1,0,8,1
10075,5,9,1,0,8,1
10075,4,5,1,0,4,1
8972,8,2,1,0,1,1
8972,6,6,1,0,5,1
8972,5,11,3,0,8,3
8972,4,7,3,0,4,3
8972,3,7,2,0,5,2
8972,2,2,2,0,0,2
160406,8,6,2,0,4,2
160406,7,6,1,0,5,1
160406,6,10,4,0,6,4
160406,5,5,1,0,4,1
160406,4,4,2,0,2,2
160406,2,3,1,0,2,1
150429,8,8,3,0,5,3
150429,7,13,3,0,10,3
150429,6,12,4,0,8,4
150429,5,1,1,0,0,1
150429,4,2,1,0,1,1
12988,8,2,1,0,1,1
12988,7,2,1,0,1,1
12988,6,12,6,0,6,6
12988,5,12,1,0,11,1
12988,4,6,1,0,5,1
12988,3,4,2,0,2,2
143588,9,4,1,1,3,0
143588,8,7,2,1,5,1
143588,7,11,4,1,7,3
143588,5,3,1,0,2,1
10008,7,5,1,0,4,1
10008,6,15,7,0,8,7
10008,5,7,4,0,3,4
10008,4,5,2,0,3,2
10008,3,4,3,0,1,3
256980,10,3,1,0,2,1
256980,9,5,1,0,4,1
256980,8,10,2,0,8,2
256980,7,9,2,0,7,2
256980,6,9,1,0,8,1
256980,4,3,1,0,2,1
96440,7,7,2,0,5,2
96440,1,2,1,0,1,1
4025,8,4,2,0,2,2
4025,6,13,7,0,6,7
4025,5,9,2,0,7,2
4025,4,7,5,0,2,5
234452,10,3,1,0,2,1
234452,8,15,1,0,14,1
234452,6,5,1,0,4,1
234452,5,3,1,0,2,1
13094,7,17,2,0,15,2
13094,6,10,1,0,9,1
13094,5,4,1,0,3,1
130388,10,4,2,0,2,2
130388,9,4,2,0,2,2
130388,8,4,3,0,1,3
130388,6,7,1,0,6,1
130388,4,4,1,0,3,1
130388,3,3,1,0,2,1
130388,2,2,2,0,0,2
5055,10,2,1,0,1,1
5055,9,4,2,0,2,2
5055,8,5,2,0,3,2
5055,7,10,4,0,6,4
5055,5,10,1,0,9,1
5055,4,2,1,0,1,1
3919,7,3,2,0,1,2
3919,6,11,6,0,5,6
3919,5,14,6,0,8,6
3919,4,8,4,0,4,4
3919,2,1,1,0,0,1
205667,8,5,2,1,3,1
205667,7,10,4,0,6,4
205667,6,19,3,1,16,2
4410,7,9,6,0,3,6
4410,6,17,6,0,11,6
4410,4,4,4,0,0,4
16699,7,6,2,0,4,2
16699,4,8,4,0,4,4
16699,3,3,1,0,2,1
255696,9,4,2,0,2,2
255696,8,2,1,0,1,1
255696,7,10,2,0,8,2
255696,6,8,2,0,6,2
255696,5,8,1,0,7,1
255696,4,1,1,0,0,1
255696,3,4,2,0,2,2
22980,6,6,1,0,5,1
22980,5,5,1,0,4,1
22980,4,6,2,0,4,2
22980,3,10,2,0,8,2
22980,2,5,2,0,3,2
218996,10,8,2,0,6,2
218996,9,4,2,1,2,1
218996,8,13,4,1,9,3
218996,7,8,2,0,6,2
123506,8,5,1,0,4,1
123506,7,7,2,0,5,2
123506,5,5,1,0,4,1
123506,4,6,1,0,5,1
123506,3,1,1,0,0,1
92838,10,3,1,0,2,1
92838,9,7,3,0,4,3
92838,8,13,1,0,12,1
92838,6,5,1,0,4,1
66047,8,2,1,0,1,1
66047,7,5,2,0,3,2
66047,6,16,6,0,10,6
66047,5,6,1,0,5,1
66047,4,6,1,0,5,1
69,8,3,1,0,2,1
69,7,13,5,0,8,5
69,6,16,8,0,8,8
69,3,1,1,0,0,1
51401,9,2,1,0,1,1
51401,8,9,4,0,5,4
51401,7,11,1,0,10,1
51401,6,11,2,0,9,2
51401,4,1,1,0,0,1
51401,2,1,1,0,0,1
144874,10,9,2,0,7,2
144874,9,1,1,0,0,1
144874,8,8,4,0,4,4
144874,7,7,3,0,4,3
144874,6,7,2,0,5,2
144874,5,3,2,0,1,2
144874,2,3,1,0,2,1
186501,9,3,2,0,1,2
186501,8,17,6,1,11,5
186501,7,4,2,0,2,2
186501,6,8,3,0,5,3
186501,4,2,1,0,1,1
186501,2,1,1,0,0,1
6706,7,7,2,0,5,2
6706,6,10,4,0,6,4
6706,5,10,2,0,8,2
176557,9,1,1,0,0,1
176557,8,6,2,0,4,2
176557,7,13,2,0,11,2
176557,6,10,4,0,6,4
176557,5,5,1,0,4,1
176557,3,1,1,0,0,1
121195,7,10,2,0,8,2
121195,6,15,4,0,11,4
121195,5,6,1,0,5,1
210465,7,9,2,0,7,2
210465,6,11,1,0,10,1
1750,10,1,1,0,0,1
1750,8,4,2,0,2,2
1750,7,7,5,0,2,5
1750,6,14,4,0,10,4
1750,5,9,2,0,7,2
1750,4,1,1,0,0,1
1750,3,1,1,0,0,1
145390,10,5,2,0,3,2
145390,9,4,2,0,2,2
145390,8,15,6,0,9,6
145390,7,11,4,0,7,4
145390,5,1,1,0,0,1
145390,4,1,1,0,0,1
26386,10,21,1,0,20,1
26386,9,7,1,0,6,1
26386,6,3,1,0,2,1
26386,1,3,2,0,1,2
11121,6,22,8,0,14,8
11121,5,3,3,0,0,3
11121,4,5,2,0,3,2
11121,3,3,2,0,1,2
36993,9,1,1,0,0,1
36993,8,5,1,0,4,1
36993,7,8,1,0,7,1
36993,6,14,7,0,7,7
36993,5,3,1,0,2,1
36993,4,4,1,0,3,1
107811,9,1,1,0,0,1
107811,8,5,2,0,3,2
107811,7,3,1,0,2,1
107811,6,14,5,0,9,5
107811,5,7,1,0,6,1
107811,4,4,1,0,3,1
107811,2,2,2,0,0,2
182062,10,2,1,0,1,1
182062,7,10,3,0,7,3
182062,5,4,1,0,3,1
182062,4,2,1,0,1,1
182062,2,3,2,0,1,2
3233,8,2,1,0,1,1
3233,7,6,2,0,4,2
3233,6,13,5,0,8,5
3233,5,8,1,0,7,1
3233,4,3,2,0,1,2
3233,3,4,3,0,1,3
3233,1,2,1,0,1,1
16914,10,3,2,0,1,2
16914,8,5,2,0,3,2
16914,7,2,1,0,1,1
16914,6,10,4,0,6,4
16914,5,8,3,0,5,3
16914,4,6,2,0,4,2
16914,1,3,2,0,1,2
198513,9,3,2,0,1,2
198513,8,4,2,0,2,2
198513,6,6,2,2,4,0
198513,5,7,2,1,5,1
198513,4,6,4,1,2,3
198513,3,5,2,0,3,2
198513,2,3,1,0,2,1
206798,9,7,1,0,6,1
206798,7,8,1,0,7,1
206798,6,8,3,0,5,3
11957,10,2,1,0,1,1
11957,8,15,3,0,12,3
11957,7,10,4,0,6,4
11957,6,8,5,0,3,5
7966,9,4,2,0,2,2
7966,8,10,4,0,6,4
7966,7,13,4,0,9,4
7966,4,2,1,0,1,1
184780,10,1,1,0,0,1
184780,9,1,1,0,0,1
184780,8,4,1,0,3,1
184780,7,16,5,0,11,5
184780,6,14,5,0,9,5
5735,6,9,1,0,8,1
5735,5,17,4,0,13,4
5735,4,5,2,0,3,2
18050,10,2,1,0,1,1
18050,9,2,1,0,1,1
18050,8,3,1,0,2,1
18050,7,4,3,0,1,3
18050,6,12,1,0,11,1
18050,5,6,1,0,5,1
18050,4,4,1,0,3,1
18050,3,5,1,0,4,1
6720,9,5,3,0,2,3
6720,8,12,6,0,6,6
6720,7,7,3,0,4,3
6720,6,6,2,0,4,2
6720,4,2,2,0,0,2
6720,3,1,1,0,0,1
6720,1,1,1,0,0,1
4650,10,2,1,0,1,1
4650,9,2,2,0,0,2
4650,8,10,4,0,6,4
4650,7,9,4,0,5,4
4650,6,9,3,0,6,3
4650,4,4,2,0,2,2
1268,9,3,1,0,2,1
1268,8,5,1,0,4,1
1268,7,10,6,0,4,6
1268,6,11,4,0,7,4
1268,5,5,3,0,2,3
158947,8,3,1,0,2,1
158947,6,12,6,0,6,6
158947,4,7,3,0,4,3
158947,3,3,1,0,2,1
118294,10,2,1,0,1,1
118294,7,10,3,0,7,3
118294,6,10,3,0,7,3
118294,5,5,2,0,3,2
118294,3,2,2,0,0,2
89386,8,5,1,0,4,1
89386,7,9,1,0,8,1
89386,6,12,3,0,9,3
89386,5,6,1,0,5,1
11965,6,15,2,0,13,2
11965,4,7,1,0,6,1
5438,8,3,1,0,2,1
5438,7,8,3,0,5,3
5438,6,15,5,0,10,5
5438,4,3,3,0,0,3
5438,3,1,1,0,0,1
30852,7,7,3,0,4,3
30852,6,16,5,0,11,5
30852,5,7,2,0,5,2
30852,4,3,1,0,2,1
30852,3,3,1,0,2,1
232981,9,8,2,0,6,2
232981,8,19,3,1,16,2
232981,7,5,1,0,4,1
13593,10,2,1,0,1,1
13593,9,1,1,0,0,1
13593,8,9,5,0,4,5
13593,7,5,3,0,2,3
13593,6,14,6,0,8,6
13593,5,2,2,0,0,2
13593,3,2,1,0,1,1
13593,2,1,1,0,0,1
163062,9,3,1,0,2,1
163062,8,11,1,0,10,1
163062,6,4,1,0,3,1
163062,5,5,3,0,2,3
163062,3,3,3,0,0,3
17849,9,1,1,0,0,1
17849,7,10,3,0,7,3
17849,6,8,3,0,5,3
17849,5,5,2,0,3,2
17849,4,5,2,0,3,2
17849,3,5,2,0,3,2
217275,6,16,3,0,13,3
217275,3,3,1,0,2,1
217275,1,3,2,0,1,2
5040,7,3,2,0,1,2
5040,5,6,2,0,4,2
5040,3,5,1,0,4,1
5040,2,3,3,0,0,3
5040,1,6,4,0,2,4
99044,10,3,1,0,2,1
99044,9,2,1,0,1,1
99044,8,2,1,0,1,1
99044,7,9,3,0,6,3
99044,6,13,3,0,10,3
99044,5,3,1,0,2,1
99044,4,3,2,0,1,2
99044,3,1,1,0,0,1
99044,2,1,1,0,0,1
73367,8,4,1,0,3,1
73367,6,12,2,0,10,2
73367,5,10,3,0,7,3
73367,4,5,2,0,3,2
164279,10,4,1,0,3,1
164279,9,7,1,0,6,1
164279,8,9,3,0,6,3
164279,7,9,3,0,6,3
164279,6,6,3,0,3,3
1318,8,1,1,0,0,1
1318,7,8,3,0,5,3
1318,6,12,4,0,8,4
1318,5,14,4,0,10,4
1318,3,1,1,0,0,1
17779,10,4,2,0,2,2
17779,8,10,5,0,5,5
17779,7,7,1,0,6,1
17779,6,12,4,0,8,4
17779,5,2,1,0,1,1
17779,4,2,1,0,1,1
11399,9,6,2,0,4,2
11399,8,3,1,0,2,1
11399,7,5,2,0,3,2
11399,6,12,5,0,7,5
11399,5,6,1,0,5,1
11399,4,4,1,0,3,1
11399,2,1,1,0,0,1
38561,8,1,1,0,0,1
38561,5,10,5,0,5,5
38561,4,11,3,0,8,3
38561,3,6,1,0,5,1
38561,2,5,2,0,3,2
10842,8,2,2,0,0,2
10842,7,11,5,0,6,5
10842,6,11,4,0,7,4
10842,5,8,2,0,6,2
10842,4,5,1,0,4,1
147892,7,9,5,0,4,5
147892,6,14,3,0,11,3
147892,5,5,2,0,3,2
147892,4,4,3,0,1,3
147892,3,1,1,0,0,1
11888,9,2,1,0,1,1
11888,7,7,4,0,3,4
11888,6,14,4,0,10,4
11888,4,3,1,0,2,1
34590,10,1,1,0,0,1
34590,7,6,1,0,5,1
39998,8,9,3,0,6,3
39998,7,6,3,0,3,3
39998,6,7,4,0,3,4
39998,5,5,3,0,2,3
39998,4,3,1,0,2,1
39998,1,2,1,0,1,1
69233,7,10,1,0,9,1
69233,5,6,3,0,3,3
26101,7,3,1,0,2,1
26101,6,4,1,0,3,1
26101,5,4,2,0,2,2
26101,4,7,2,0,5,2
26101,3,6,1,0,5,1
26101,2,6,2,0,4,2
26101,1,8,4,0,4,4
111543,8,1,1,0,0,1
111543,7,9,1,0,8,1
111543,6,14,2,0,12,2
111543,5,9,1,0,8,1
2103,7,4,2,0,2,2
2103,6,13,4,0,9,4
2103,5,15,3,0,12,3
2103,2,1,1,0,0,1
179701,7,7,1,0,6,1
179701,6,13,1,0,12,1
179701,5,5,1,0,4,1
179701,3,3,1,0,2,1
179701,1,2,1,0,1,1
142043,10,2,1,0,1,1
142043,8,11,6,1,5,5
142043,7,9,3,1,6,2
142043,6,8,1,0,7,1
142043,5,2,1,0,1,1
142043,4,4,1,0,3,1
142043,3,1,1,0,0,1
148939,9,3,1,0,2,1
148939,8,7,3,0,4,3
148939,7,11,4,0,7,4
148939,6,12,1,0,11,1
148939,5,1,1,0,0,1
148939,4,1,1,0,0,1
148939,3,1,1,0,0,1
11714,6,10,1,0,9,1
11714,5,15,2,0,13,2
11714,4,7,1,0,6,1
11714,3,4,1,0,3,1
166300,10,20,19,0,1,19
166300,9,2,2,0,0,2
166300,8,9,6,0,3,6
166300,6,3,2,0,1,2
15159,8,6,2,0,4,2
15159,7,5,1,0,4,1
15159,6,5,1,0,4,1
38828,9,1,1,0,0,1
38828,8,6,1,0,5,1
38828,7,16,7,0,9,7
38828,6,9,4,0,5,4
38828,5,2,1,0,1,1
38828,2,1,1,0,0,1
19513,4,8,2,0,6,2
19513,3,11,1,0,10,1
19513,2,8,2,0,6,2
3338,7,7,4,0,3,4
3338,6,15,2,0,13,2
3338,5,5,1,0,4,1
3338,3,2,1,0,1,1
74312,10,2,1,0,1,1
74312,9,4,2,0,2,2
74312,8,10,6,0,4,6
74312,7,13,4,0,9,4
74312,6,7,3,0,4,3
227163,8,15,6,0,9,6
227163,7,10,3,0,7,3
227163,6,8,2,0,6,2
227163,5,2,1,0,1,1
238883,10,5,4,0,1,4
238883,8,4,1,0,3,1
238883,6,11,2,0,9,2
238883,3,7,3,0,4,3
238883,2,1,1,0,0,1
128419,10,1,1,0,0,1
128419,8,7,3,0,4,3
128419,7,6,3,0,3,3
128419,6,13,6,0,7,6
128419,5,5,2,0,3,2
128419,4,2,1,0,1,1
128419,3,3,1,0,2,1
3650,7,3,1,0,2,1
3650,6,10,2,0,8,2
3650,5,8,3,0,5,3
3650,4,11,2,0,9,2
3650,3,2,2,0,0,2
3650,1,2,2,0,0,2
43167,6,16,5,0,11,5
43167,3,1,1,0,0,1
9915,8,8,1,0,7,1
9915,7,10,2,0,8,2
9915,6,11,4,0,7,4
9915,5,5,2,0,3,2
9915,4,1,1,0,0,1
253743,10,12,2,0,10,2
253743,9,9,1,0,8,1
253743,8,8,5,0,3,5
253743,7,8,3,0,5,3
253743,1,1,1,1,0,0
132773,8,12,1,0,11,1
132773,7,13,2,0,11,2
132773,6,7,3,0,4,3
256480,10,11,9,0,2,9
256480,9,6,4,0,2,4
256480,8,6,2,0,4,2
256480,7,7,4,1,3,3
256480,6,3,1,0,2,1
256480,4,3,2,0,1,2
29376,10,2,1,0,1,1
29376,9,5,1,0,4,1
29376,8,17,6,0,11,6
29376,7,8,2,0,6,2
29376,6,5,3,0,2,3
29376,2,1,1,0,0,1
2120,7,2,1,0,1,1
2120,6,3,1,0,2,1
2120,5,3,1,0,2,1
2120,4,9,3,0,6,3
2120,3,10,6,0,4,6
2120,2,7,3,0,4,3
2120,1,4,3,0,1,3
9790,8,4,1,0,3,1
9790,7,14,3,0,11,3
9790,6,13,2,0,11,2
166764,8,5,2,0,3,2
166764,7,4,1,0,3,1
166764,6,15,3,0,12,3
189615,4,7,1,0,6,1
127989,9,8,3,0,5,3
127989,8,16,6,0,10,6
127989,7,9,2,0,7,2
127989,6,3,2,0,1,2
127989,5,1,1,0,0,1
57702,7,5,2,0,3,2
57702,6,11,5,0,6,5
57702,4,8,3,0,5,3
23616,7,6,2,0,4,2
23616,6,12,2,0,10,2
23616,4,4,1,0,3,1
23616,2,1,1,0,0,1
23616,1,2,1,0,1,1
49391,10,4,1,0,3,1
49391,8,6,1,0,5,1
49391,7,11,1,0,10,1
49391,6,7,2,0,5,2
49391,4,1,1,0,0,1
223669,9,14,4,0,10,4
223669,8,17,7,0,10,7
223669,6,1,1,0,0,1
229319,10,23,5,3,18,2
229319,8,9,1,0,8,1
229319,6,1,1,0,0,1
24994,8,10,4,0,6,4
24994,7,12,5,0,7,5
24994,6,9,2,0,7,2
24994,5,2,1,0,1,1
24994,1,1,1,0,0,1
11512,10,2,1,0,1,1
11512,8,6,3,0,3,3
11512,7,6,2,0,4,2
11512,6,12,3,0,9,3
11512,5,6,3,0,3,3
11512,3,2,1,0,1,1
31556,8,3,2,0,1,2
31556,7,10,4,0,6,4
31556,6,18,9,0,9,9
31556,4,2,2,0,0,2
85504,8,2,1,0,1,1
85504,7,4,2,0,2,2
85504,6,10,4,0,6,4
85504,5,5,1,0,4,1
85504,4,8,2,0,6,2
85504,3,4,2,0,2,2
85504,1,1,1,0,0,1
30000,8,1,1,0,0,1
30000,6,18,6,0,12,6
30000,5,9,2,0,7,2
234101,9,5,3,0,2,3
234101,8,8,2,0,6,2
234101,7,7,3,0,4,3
234101,6,13,2,0,11,2
234101,4,3,3,0,0,3
2260,9,1,1,0,0,1
2260,8,4,1,0,3,1
2260,7,7,1,0,6,1
2260,6,13,4,0,9,4
2260,5,4,1,0,3,1
2260,3,3,1,0,2,1
51008,10,1,1,0,0,1
51008,6,4,1,0,3,1
51008,3,3,1,0,2,1
51008,2,10,3,0,7,3
51008,1,6,2,0,4,2
8731,9,1,1,0,0,1
8731,8,5,2,0,3,2
8731,7,8,3,0,5,3
8731,6,17,3,0,14,3
8731,5,5,1,0,4,1
8731,4,2,1,0,1,1
34311,8,6,4,0,2,4
34311,7,13,3,0,10,3
34311,6,10,3,0,7,3
2066,7,6,1,0,5,1
2066,6,11,2,0,9,2
2066,5,11,2,0,9,2
2066,4,5,2,0,3,2
12562,9,2,1,0,1,1
12562,8,9,2,0,7,2
12562,7,7,1,0,6,1
12562,6,13,6,0,7,6
12562,5,3,1,0,2,1
180257,8,9,2,1,7,1
180257,7,1,1,0,0,1
180257,6,4,1,1,3,0
180257,3,4,2,0,2,2
180257,2,2,2,1,0,1
62374,8,9,2,0,7,2
62374,7,6,2,0,4,2
62374,6,10,1,0,9,1
62374,4,6,1,0,5,1
62374,2,1,1,0,0,1
62374,1,1,1,0,0,1
234510,8,10,2,0,8,2
234510,7,10,1,0,9,1
5057,8,4,4,0,0,4
5057,7,5,1,0,4,1
5057,6,14,3,0,11,3
5057,5,9,4,0,5,4
5057,2,2,1,0,1,1
176642,8,6,2,0,4,2
176642,7,11,3,0,8,3
176642,6,13,3,0,10,3
176642,4,1,1,0,0,1
176642,2,1,1,0,0,1
92777,8,11,5,0,6,5
92777,7,13,5,0,8,5
92777,6,9,4,0,5,4
92777,5,2,2,0,0,2
92777,4,2,2,0,0,2
3112,9,2,2,0,0,2
3112,8,2,1,0,1,1
3112,7,8,4,0,4,4
3112,6,11,5,0,6,5
3112,5,12,6,0,6,6
99949,10,6,4,0,2,4
99949,9,4,2,0,2,2
99949,8,3,2,0,1,2
99949,7,3,2,0,1,2
99949,6,6,2,0,4,2
99949,4,1,1,0,0,1
99949,3,2,1,0,1,1
99949,2,3,1,0,2,1
99949,1,8,3,0,5,3
88900,8,6,3,0,3,3
88900,7,7,1,0,6,1
88900,6,11,2,0,9,2
88900,5,5,1,0,4,1
88900,4,4,1,0,3,1
158492,10,2,1,0,1,1
158492,9,9,5,0,4,5
158492,8,13,5,0,8,5
158492,7,9,2,0,7,2
158492,6,4,3,0,1,3
158492,5,1,1,0,0,1
144735,10,2,1,0,1,1
144735,8,7,2,0,5,2
144735,7,4,2,0,2,2
144735,6,2,1,0,1,1
144735,5,9,2,0,7,2
144735,4,6,1,0,5,1
144735,3,3,2,1,1,1
144735,2,2,1,0,1,1
144735,1,3,2,0,1,2
3492,8,4,2,0,2,2
3492,7,4,2,0,2,2
3492,6,11,4,0,7,4
3492,5,8,1,0,7,1
3492,4,4,1,0,3,1
3492,2,2,1,0,1,1
1000,9,2,1,0,1,1
1000,8,8,3,0,5,3
1000,7,7,1,0,6,1
1000,6,17,5,0,12,5
1000,5,2,1,0,1,1
1000,4,2,2,0,0,2
25014,8,16,8,0,8,8
25014,7,11,5,0,6,5
25014,5,3,2,0,1,2
25014,4,2,2,0,0,2
1820,10,2,2,0,0,2
1820,8,8,1,0,7,1
1820,7,11,3,0,8,3
1820,6,5,2,0,3,2
1820,5,5,1,0,4,1
1820,3,3,1,0,2,1
3909,8,1,1,0,0,1
3909,7,4,1,0,3,1
3909,6,9,5,0,4,5
3909,5,17,8,0,9,8
3909,4,4,2,0,2,2
3909,3,1,1,0,0,1
15863,8,1,1,0,0,1
15863,7,3,2,0,1,2
15863,6,7,2,0,5,2
15863,5,6,1,0,5,1
15863,4,9,2,0,7,2
15863,3,5,2,0,3,2
15863,2,6,3,0,3,3
15863,1,1,1,0,0,1
26305,9,8,5,0,3,5
26305,8,16,4,0,12,4
26305,7,3,2,0,1,2
26305,6,6,1,0,5,1
26305,4,2,2,0,0,2
26305,1,2,2,0,0,2
226,7,15,2,0,13,2
226,6,12,4,0,8,4
3999,8,5,5,0,0,5
3999,7,4,1,0,3,1
3999,6,6,3,0,3,3
3999,5,7,1,0,6,1
32187,7,9,4,0,5,4
32187,6,15,5,0,10,5
32187,4,5,1,0,4,1
193329,7,6,1,0,5,1
228373,9,2,1,0,1,1
228373,8,15,1,0,14,1
228373,7,8,3,0,5,3
228373,6,7,1,0,6,1
228373,5,3,1,0,2,1
228373,4,2,2,0,0,2
8599,7,3,1,0,2,1
8599,5,8,3,0,5,3
8599,4,10,2,0,8,2
8599,3,4,1,0,3,1
8599,2,4,1,0,3,1
8599,1,4,1,0,3,1
12924,10,2,1,0,1,1
12924,9,1,1,0,0,1
12924,8,3,3,0,0,3
12924,7,3,1,0,2,1
12924,6,6,2,0,4,2
12924,5,5,1,0,4,1
12924,4,5,2,0,3,2
12924,3,5,1,0,4,1
12924,2,3,2,0,1,2
12924,1,5,3,0,2,3
235697,8,11,4,0,7,4
235697,7,14,5,0,9,5
235697,6,9,3,0,6,3
235697,5,2,1,0,1,1
235697,4,1,1,0,0,1
178984,10,2,2,0,0,2
178984,9,4,1,0,3,1
178984,8,4,1,1,3,0
178984,7,15,3,0,12,3
178984,6,9,2,0,7,2
178984,4,1,1,0,0,1
178984,3,2,1,0,1,1
18840,8,6,1,0,5,1
18840,7,6,1,0,5,1
18840,6,8,1,0,7,1
18840,5,12,2,0,10,2
18840,1,1,1,0,0,1
74311,8,16,8,0,8,8
74311,7,11,3,0,8,3
74311,6,4,1,0,3,1
74311,4,1,1,0,0,1
190828,9,3,2,0,1,2
190828,7,16,2,0,14,2
190828,6,8,1,0,7,1
124760,8,7,4,0,3,4
124760,7,6,1,0,5,1
124760,6,19,4,0,15,4
3849,8,1,1,0,0,1
3849,7,3,1,0,2,1
3849,6,7,2,0,5,2
3849,4,7,1,0,6,1
3849,3,4,2,0,2,2
3849,2,2,2,0,0,2
3849,1,4,2,0,2,2
10808,4,10,1,0,9,1
10808,3,11,1,0,10,1
18104,7,2,1,0,1,1
18104,6,7,2,0,5,2
18104,5,9,3,0,6,3
18104,4,10,2,0,8,2
18104,3,5,1,0,4,1
18104,2,4,1,0,3,1
65061,10,4,3,0,1,3
65061,9,5,2,0,3,2
65061,8,18,4,0,14,4
65061,7,6,3,0,3,3
65061,6,3,3,0,0,3
9115,4,8,2,0,6,2
9115,3,3,1,0,2,1
9115,2,4,2,0,2,2
8981,10,3,1,0,2,1
8981,9,2,1,0,1,1
8981,8,4,2,0,2,2
8981,7,3,1,0,2,1
8981,6,15,2,0,13,2
8981,5,5,1,0,4,1
8981,4,6,3,0,3,3
9736,8,1,1,0,0,1
9736,7,5,3,0,2,3
9736,6,15,7,0,8,7
9736,5,6,2,0,4,2
9736,4,4,1,0,3,1
9736,2,1,1,0,0,1
9736,1,1,1,0,0,1
101519,6,17,5,0,12,5
101519,4,5,1,0,4,1
101519,3,3,1,0,2,1
2871,8,1,1,0,0,1
2871,7,4,1,0,3,1
2871,6,9,5,0,4,5
2871,5,13,6,0,7,6
2871,4,6,4,0,2,4
2871,2,3,1,0,2,1
257994,7,10,3,0,7,3
257994,6,12,6,0,6,6
257994,2,2,1,0,1,1
11124,8,3,3,0,0,3
11124,7,11,5,0,6,5
11124,6,16,4,0,12,4
11124,5,5,1,0,4,1
11124,2,1,1,0,0,1
6983,8,5,2,0,3,2
6983,7,12,2,0,10,2
6983,6,10,3,0,7,3
2765,7,3,1,0,2,1
2765,6,7,2,0,5,2
2765,5,8,2,0,6,2
2765,4,3,1,0,2,1
2765,3,2,1,0,1,1
18472,9,4,1,0,3,1
18472,8,11,6,0,5,6
18472,7,14,3,0,11,3
18472,6,3,2,0,1,2
18472,5,3,2,0,1,2
18472,1,1,1,0,0,1
15049,10,10,1,0,9,1
15049,8,11,6,0,5,6
15049,7,5,1,0,4,1
15049,5,2,2,0,0,2
15049,4,1,1,0,0,1
15049,2,1,1,0,0,1
194986,10,4,1,0,3,1
194986,9,8,3,0,5,3
194986,8,13,5,0,8,5
194986,7,4,2,0,2,2
194986,6,7,5,0,2,5
130043,8,12,4,0,8,4
130043,7,16,8,0,8,8
130043,6,7,3,0,4,3
130043,5,1,1,0,0,1
170472,10,8,3,0,5,3
170472,9,9,3,0,6,3
170472,8,15,2,0,13,2
170472,6,3,2,0,1,2
13290,10,2,2,0,0,2
13290,9,4,3,0,1,3
13290,8,8,4,0,4,4
13290,7,11,5,0,6,5
13290,6,7,3,0,4,3
13290,5,3,1,0,2,1
13290,3,2,1,0,1,1
1365,8,6,5,0,1,5
1365,7,5,3,0,2,3
1365,6,17,3,0,14,3
1365,5,6,3,0,3,3
1365,2,1,1,0,0,1
243694,9,3,2,0,1,2
243694,8,6,2,0,4,2
243694,7,12,3,0,9,3
243694,5,6,2,0,4,2
243694,3,1,1,0,0,1
243694,2,2,1,0,1,1
11215,7,7,3,0,4,3
11215,6,9,1,0,8,1
11215,5,9,2,0,7,2
11215,4,2,2,0,0,2
11683,6,8,3,0,5,3
11683,5,10,5,0,5,5
11683,4,7,1,0,6,1
11683,3,3,2,0,1,2
11683,2,3,1,0,2,1
11683,1,4,3,0,1,3
19304,8,11,5,0,6,5
19304,7,9,3,0,6,3
19304,6,9,3,0,6,3
19304,5,7,3,0,4,3
19304,4,1,1,0,0,1
25950,9,2,2,0,0,2
25950,6,8,2,0,6,2
25950,5,6,1,0,5,1
25950,4,10,1,0,9,1
25950,3,5,1,0,4,1
25950,2,4,2,0,2,2
199800,9,5,1,0,4,1
199800,6,14,5,0,9,5
199800,5,4,1,0,3,1
8001,9,1,1,0,0,1
8001,8,4,2,0,2,2
8001,7,9,3,0,6,3
8001,6,11,7,0,4,7
8001,5,7,1,0,6,1
8001,3,3,2,0,1,2
12049,8,13,2,0,11,2
12049,7,13,4,0,9,4
12049,4,1,1,0,0,1
12049,3,3,2,0,1,2
206851,6,12,3,0,9,3
206851,5,7,2,0,5,2
206851,4,10,2,0,8,2
206851,3,7,3,0,4,3
206851,2,1,1,0,0,1
2863,8,5,1,0,4,1
2863,7,7,5,0,2,5
2863,6,18,4,0,14,4
2863,4,5,1,0,4,1
225932,9,22,11,0,11,11
225932,8,8,1,1,7,0
23270,10,1,1,0,0,1
23270,9,2,1,0,1,1
23270,8,4,4,0,0,4
23270,7,10,7,0,3,7
23270,6,9,4,0,5,4
23270,5,4,4,0,0,4
23270,4,7,2,0,5,2
23270,2,1,1,0,0,1
8888,8,8,3,0,5,3
8888,7,13,2,0,11,2
8888,6,8,2,0,6,2
8888,5,4,2,0,2,2
8888,4,2,1,0,1,1
130520,10,1,1,0,0,1
130520,8,3,1,0,2,1
130520,7,12,2,0,10,2
130520,6,11,2,0,9,2
130520,5,4,1,0,3,1
130520,4,3,3,0,0,3
130520,3,2,1,0,1,1
130520,1,1,1,0,0,1
3612,9,3,2,0,1,2
3612,8,11,4,0,7,4
3612,7,6,2,0,4,2
3612,6,6,2,0,4,2
3612,5,4,2,0,2,2
3612,4,4,3,0,1,3
3612,3,1,1,0,0,1
108459,10,6,3,0,3,3
108459,9,2,1,0,1,1
108459,8,7,5,0,2,5
108459,7,6,1,0,5,1
108459,6,11,4,0,7,4
150797,8,3,1,0,2,1
150797,7,7,3,1,4,2
150797,6,15,4,0,11,4
150797,4,5,2,0,3,2
241478,10,1,1,0,0,1
241478,9,3,2,0,1,2
241478,8,9,2,0,7,2
241478,7,16,3,0,13,3
110511,6,9,2,0,7,2
110511,5,4,1,0,3,1
110511,4,14,4,0,10,4
110511,3,6,3,0,3,3
110511,2,3,1,0,2,1
33614,10,2,1,0,1,1
33614,8,3,2,0,1,2
33614,7,2,1,0,1,1
33614,6,8,6,0,2,6
33614,5,7,2,0,5,2
33614,4,10,3,0,7,3
33614,3,1,1,0,0,1
33614,2,4,2,0,2,2
33614,1,1,1,0,0,1
99992,8,4,1,0,3,1
99992,7,2,1,0,1,1
99992,6,4,1,0,3,1
99992,5,8,3,0,5,3
99992,4,4,1,0,3,1
99992,3,3,2,0,1,2
99992,2,5,4,0,1,4
99992,1,7,2,0,5,2
97747,10,1,1,0,0,1
97747,9,7,1,0,6,1
97747,5,6,2,0,4,2
97747,4,3,1,0,2,1
39549,10,3,1,0,2,1
39549,7,2,1,0,1,1
39549,6,10,2,0,8,2
39549,5,11,2,0,9,2
39549,4,6,2,0,4,2
39549,3,2,2,0,0,2
39549,2,1,1,0,0,1
39549,1,1,1,0,0,1
93134,9,1,1,0,0,1
93134,7,12,3,0,9,3
93134,6,13,5,0,8,5
93134,4,2,2,0,0,2
93134,3,1,1,0,0,1
15855,7,2,1,0,1,1
15855,6,4,1,0,3,1
15855,5,8,3,0,5,3
15855,4,11,1,0,10,1
15855,3,9,5,0,4,5
15855,2,4,3,0,1,3
40388,8,1,1,0,0,1
40388,6,11,1,0,10,1
40388,5,8,1,0,7,1
40388,4,4,1,0,3,1
37097,10,1,1,0,0,1
37097,9,1,1,0,0,1
37097,8,9,4,0,5,4
37097,7,12,8,0,4,8
37097,6,13,5,0,8,5
37097,5,2,1,0,1,1
10511,7,5,1,0,4,1
10511,6,11,3,0,8,3
10511,5,8,3,0,5,3
10511,4,6,3,0,3,3
10511,2,1,1,0,0,1
10511,1,3,1,0,2,1
105305,8,1,1,0,0,1
105305,7,13,2,0,11,2
105305,6,14,1,0,13,1
105305,5,3,1,0,2,1
105305,4,3,1,0,2,1
105305,2,1,1,0,0,1
211168,7,7,1,0,6,1
211168,6,17,2,0,15,2
211168,5,4,2,0,2,2
211168,4,2,1,0,1,1
73233,8,7,5,0,2,5
73233,7,9,1,0,8,1
73233,6,7,3,0,4,3
73233,5,4,2,0,2,2
73233,4,7,2,0,5,2
73233,3,1,1,0,0,1
73233,2,1,1,0,0,1
10257,8,1,1,0,0,1
10257,7,3,2,0,1,2
10257,6,9,1,0,8,1
10257,5,14,5,0,9,5
10257,4,7,1,0,6,1
10257,2,1,1,0,0,1
210181,7,5,1,0,4,1
210181,6,12,3,0,9,3
210181,4,8,2,0,6,2
210181,3,2,1,0,1,1
8419,7,8,1,0,7,1
8419,6,15,2,0,13,2
8419,5,5,1,0,4,1
8419,4,5,1,0,4,1
8419,3,2,1,0,1,1
8419,2,1,1,0,0,1
28109,7,10,5,0,5,5
28109,6,20,12,0,8,12
28109,5,7,6,0,1,6
11115,7,4,1,0,3,1
11115,6,8,3,0,5,3
11115,5,10,6,0,4,6
11115,4,5,3,0,2,3
11115,3,2,1,0,1,1
129038,10,8,1,0,7,1
129038,9,9,2,0,7,2
129038,7,4,1,0,3,1
6524,8,2,1,0,1,1
6524,6,7,4,0,3,4
6524,5,9,3,0,6,3
6524,4,10,2,0,8,2
6524,3,3,2,0,1,2
6524,2,1,1,0,0,1
6524,1,1,1,0,0,1
4259,9,1,1,0,0,1
4259,8,3,2,0,1,2
4259,7,11,6,0,5,6
4259,6,10,1,0,9,1
4259,5,6,2,0,4,2
4259,4,4,3,0,1,3
4259,2,1,1,0,0,1
4259,1,1,1,0,0,1
31298,7,3,2,0,1,2
31298,6,7,2,0,5,2
31298,3,4,1,0,3,1
31298,2,4,1,0,3,1
31298,1,7,1,0,6,1
7711,8,4,1,0,3,1
7711,7,5,2,0,3,2
7711,6,12,3,0,9,3
7711,5,10,3,0,7,3
7711,3,4,2,0,2,2
7711,2,1,1,0,0,1
4677,8,7,3,0,4,3
4677,7,12,4,0,8,4
4677,6,8,2,0,6,2
4677,5,4,3,0,1,3
4677,2,1,1,0,0,1
21915,10,4,1,0,3,1
21915,9,6,1,0,5,1
21915,8,10,2,0,8,2
21915,7,13,3,0,10,3
21915,6,3,1,0,2,1
202245,10,10,6,0,4,6
202245,9,3,2,0,1,2
202245,7,9,1,0,8,1
172484,10,5,1,0,4,1
172484,9,4,2,0,2,2
172484,8,12,2,0,10,2
172484,7,8,1,0,7,1
18584,10,1,1,0,0,1
18584,9,1,1,0,0,1
18584,8,6,5,0,1,5
18584,7,5,1,0,4,1
18584,6,16,6,0,10,6
156930,8,4,1,0,3,1
156930,5,16,1,0,15,1
156930,4,8,1,0,7,1
137910,8,3,1,0,2,1
137910,7,9,1,0,8,1
137910,6,13,2,0,11,2
137910,5,8,1,0,7,1
3844,10,1,1,0,0,1
3844,8,3,1,0,2,1
3844,7,11,5,0,6,5
3844,6,6,2,0,4,2
3844,5,9,6,0,3,6
3844,4,6,1,0,5,1
3844,2,1,1,0,0,1
247860,10,14,7,0,7,7
247860,9,5,3,0,2,3
247860,8,4,1,0,3,1
247860,7,4,1,0,3,1
247860,5,4,1,0,3,1
247860,1,1,1,0,0,1
104029,9,1,1,0,0,1
104029,8,6,4,0,2,4
104029,7,7,3,0,4,3
104029,6,13,5,0,8,5
104029,5,5,2,0,3,2
104029,3,2,1,0,1,1
25313,9,3,2,0,1,2
25313,8,10,3,0,7,3
25313,6,4,3,0,1,3
25313,5,3,1,0,2,1
25313,4,4,1,0,3,1
25313,3,3,1,0,2,1
26700,7,4,1,0,3,1
26700,6,9,2,0,7,2
26700,5,11,1,0,10,1
26700,4,7,2,0,5,2
176918,6,8,1,0,7,1
176918,5,12,2,0,10,2
176918,1,3,3,0,0,3
38991,7,5,4,0,1,4
38991,6,11,3,0,8,3
38991,5,7,3,0,4,3
38991,4,5,2,0,3,2
38991,3,6,1,0,5,1
2776,6,16,4,0,12,4
2776,5,7,2,0,5,2
2776,4,5,1,0,4,1
2776,3,1,1,0,0,1
2776,2,1,1,0,0,1
132785,7,5,3,0,2,3
132785,6,18,2,0,16,2
132785,4,4,2,0,2,2
5893,10,2,1,0,1,1
5893,9,4,3,0,1,3
5893,8,5,3,0,2,3
5893,7,5,3,0,2,3
5893,6,15,9,0,6,9
5893,4,3,1,0,2,1
29386,10,3,2,0,1,2
29386,9,3,1,0,2,1
29386,8,13,3,0,10,3
29386,7,11,5,0,6,5
29386,6,4,3,0,1,3
29386,4,1,1,0,0,1
29386,3,2,1,0,1,1
26306,10,2,1,0,1,1
26306,8,8,4,0,4,4
26306,7,12,4,0,8,4
26306,6,12,5,0,7,5
26306,5,3,3,0,0,3
224992,10,1,1,0,0,1
224992,9,4,1,0,3,1
224992,7,11,1,0,10,1
224992,6,12,3,0,9,3
32414,8,6,3,0,3,3
32414,7,17,1,0,16,1
32414,6,10,4,0,6,4
32414,5,4,1,0,3,1
259551,8,7,1,0,6,1
259551,6,12,2,0,10,2
259551,5,6,3,0,3,3
259551,3,1,1,0,0,1
40352,10,2,2,0,0,2
40352,8,7,1,0,6,1
40352,7,9,3,0,6,3
40352,6,10,2,0,8,2
40352,3,2,1,0,1,1
253607,10,9,3,0,6,3
253607,9,12,4,0,8,4
253607,8,9,2,0,7,2
144993,10,3,1,0,2,1
144993,9,2,2,0,0,2
144993,8,12,2,0,10,2
144993,7,7,4,0,3,4
144993,6,5,1,0,4,1
144993,5,5,1,0,4,1
244725,8,5,2,0,3,2
244725,7,10,3,0,7,3
244725,6,8,3,0,5,3
244725,5,4,1,0,3,1
244725,4,5,2,0,3,2
10625,6,4,1,0,3,1
10625,5,8,2,0,6,2
10625,4,12,4,0,8,4
10625,3,7,3,0,4,3
10625,2,3,1,0,2,1
194976,9,6,3,0,3,3
194976,8,13,3,0,10,3
194976,7,11,3,0,8,3
203195,8,6,1,0,5,1
203195,7,8,1,0,7,1
203195,6,10,1,0,9,1
203195,5,2,1,0,1,1
34207,10,3,2,0,1,2
34207,8,10,5,0,5,5
34207,7,9,1,0,8,1
34207,6,9,4,0,5,4
17073,10,1,1,0,0,1
17073,9,4,3,0,1,3
17073,8,9,5,0,4,5
17073,7,12,2,0,10,2
17073,6,8,5,0,3,5
17073,5,2,1,0,1,1
42897,9,6,4,0,2,4
42897,8,7,1,0,6,1
42897,7,14,7,0,7,7
42897,6,8,3,0,5,3
42897,1,1,1,0,0,1
8454,7,3,2,0,1,2
8454,6,6,3,0,3,3
8454,5,8,1,0,7,1
8454,4,11,4,0,7,4
8454,3,3,1,0,2,1
8454,2,4,2,0,2,2
8454,1,1,1,0,0,1
8245,8,11,5,0,6,5
8245,7,10,4,0,6,4
8245,6,6,3,0,3,3
8245,5,5,1,0,4,1
8245,3,2,1,0,1,1
149129,8,14,5,0,9,5
149129,7,9,1,0,8,1
149129,6,3,1,0,2,1
6478,9,1,1,0,0,1
6478,8,3,1,0,2,1
6478,7,15,4,0,11,4
6478,6,13,6,0,7,6
6478,4,2,1,0,1,1
27480,10,10,7,0,3,7
27480,9,3,2,0,1,2
27480,8,15,7,0,8,7
27480,7,4,2,0,2,2
97494,9,2,1,0,1,1
97494,8,10,7,0,3,7
97494,7,9,4,0,5,4
97494,6,10,2,0,8,2
97494,5,5,4,0,1,4
97494,4,1,1,0,0,1
267735,8,8,1,0,7,1
267735,1,1,1,0,0,1
2793,7,3,1,0,2,1
2793,6,6,1,0,5,1
2793,4,10,4,0,6,4
2793,3,7,1,0,6,1
2793,2,2,2,0,0,2
2793,1,1,1,0,0,1
4034,7,2,2,0,0,2
4034,6,7,1,0,6,1
4034,5,13,1,0,12,1
4034,4,11,2,0,9,2
4034,3,4,2,0,2,2
14275,6,9,4,0,5,4
14275,5,11,1,0,10,1
14275,4,8,4,0,4,4
14275,3,4,4,0,0,4
14275,1,4,1,0,3,1
182955,9,2,1,0,1,1
182955,8,7,1,0,6,1
182955,7,10,2,0,8,2
182955,5,3,1,0,2,1
182955,4,3,1,0,2,1
182955,2,1,1,0,0,1
182955,1,1,1,0,0,1
227563,10,5,2,0,3,2
227563,9,7,5,0,2,5
227563,8,10,3,0,7,3
227563,7,9,1,0,8,1
227563,3,3,2,0,1,2
231872,10,2,2,0,0,2
231872,9,3,1,0,2,1
231872,8,10,1,0,9,1
231872,7,11,3,0,8,3
231872,6,5,2,0,3,2
231872,5,1,1,0,0,1
231872,4,3,1,0,2,1
12436,6,6,3,0,3,3
12436,5,9,1,0,8,1
12436,4,7,4,0,3,4
12436,3,8,5,0,3,5
12436,1,4,3,0,1,3
185456,10,2,1,0,1,1
185456,9,3,2,0,1,2
185456,8,15,7,0,8,7
185456,7,9,4,1,5,3
185456,5,2,2,0,0,2
185456,2,1,1,0,0,1
221367,10,4,1,0,3,1
221367,8,13,3,0,10,3
221367,7,8,1,0,7,1
221367,6,7,1,0,6,1
221367,5,2,1,0,1,1
32361,9,1,1,0,0,1
32361,6,6,1,0,5,1
32361,5,4,1,0,3,1
512,8,6,4,0,2,4
512,7,15,5,0,10,5
512,6,7,4,0,3,4
512,5,5,3,0,2,3
512,4,2,1,0,1,1
247576,9,3,1,0,2,1
247576,7,14,6,0,8,6
247576,6,8,2,0,6,2
247576,5,3,1,0,2,1
247576,4,1,1,0,0,1
110962,8,2,1,1,1,0
110962,6,6,1,0,5,1
110962,3,7,4,0,3,4
110962,2,7,2,0,5,2
220443,10,2,1,0,1,1
220443,9,2,1,0,1,1
220443,8,8,2,0,6,2
220443,6,9,3,0,6,3
220443,5,6,2,0,4,2
10105,7,5,1,0,4,1
10105,6,4,1,0,3,1
10105,5,7,1,0,6,1
10105,2,5,2,0,3,2
227026,10,2,1,0,1,1
227026,7,7,3,0,4,3
227026,6,13,1,1,12,0
227026,5,3,1,1,2,0
227026,2,2,1,0,1,1
18736,7,2,1,0,1,1
18736,5,5,3,0,2,3
18736,4,5,1,0,4,1
18736,3,7,2,0,5,2
18736,2,8,2,0,6,2
18736,1,3,1,0,2,1
11125,10,2,1,0,1,1
11125,8,2,1,0,1,1
11125,7,8,4,0,4,4
11125,6,16,8,0,8,8
11125,5,6,3,0,3,3
11125,3,2,1,0,1,1
94476,8,5,2,0,3,2
94476,7,10,5,0,5,5
94476,6,18,13,0,5,13
94476,5,3,1,0,2,1
94476,4,1,1,0,0,1
231748,10,2,1,0,1,1
231748,9,4,1,0,3,1
231748,8,3,2,0,1,2
231748,6,12,4,0,8,4
231748,5,2,1,0,1,1
231748,4,3,2,0,1,2
231748,3,1,1,0,0,1
248830,10,7,1,0,6,1
248830,9,10,3,0,7,3
248830,8,11,5,0,6,5
18083,9,2,1,0,1,1
18083,7,7,1,0,6,1
18083,4,2,1,0,1,1
18083,3,1,1,0,0,1
258636,7,16,1,0,15,1
258636,6,5,1,0,4,1
225740,10,6,1,0,5,1
225740,9,7,2,0,5,2
225740,8,5,1,0,4,1
225740,7,8,2,0,6,2
225740,6,7,2,0,5,2
225740,4,3,2,0,1,2
67251,8,16,2,0,14,2
67251,4,2,1,0,1,1
63379,7,3,2,0,1,2
63379,6,2,1,0,1,1
63379,5,3,3,0,0,3
63379,2,13,5,0,8,5
63379,1,11,1,0,10,1
218615,7,13,3,0,10,3
218615,6,9,2,0,7,2
218615,5,8,1,0,7,1
4740,9,1,1,0,0,1
4740,7,10,3,0,7,3
4740,6,9,4,0,5,4
4740,5,7,3,0,4,3
259393,10,6,1,0,5,1
259393,9,6,1,0,5,1
259393,8,12,2,0,10,2
259393,7,9,2,0,7,2
147616,8,9,4,1,5,3
147616,7,6,1,0,5,1
147616,6,13,1,0,12,1
147616,5,7,1,1,6,0
170583,9,2,1,0,1,1
170583,8,9,4,0,5,4
170583,7,8,3,1,5,2
170583,6,6,1,0,5,1
170583,5,5,1,0,4,1
170583,4,3,2,1,1,1
170583,3,1,1,0,0,1
220124,9,1,1,0,0,1
220124,8,10,4,0,6,4
220124,7,4,2,0,2,2
220124,6,12,3,0,9,3
220124,4,2,1,0,1,1
137156,10,2,1,0,1,1
137156,9,1,1,0,0,1
137156,8,5,2,1,3,1
137156,7,12,5,0,7,5
137156,6,6,2,0,4,2
137156,5,4,1,0,3,1
137156,3,1,1,0,0,1
3687,7,4,1,0,3,1
3687,6,7,5,0,2,5
3687,5,6,1,0,5,1
3687,4,11,4,0,7,4
3687,3,4,1,0,3,1
3687,2,3,1,0,2,1
3687,1,1,1,0,0,1
75587,9,4,1,0,3,1
75587,8,13,3,0,10,3
75587,7,12,3,0,9,3
75587,6,4,1,0,3,1
75587,5,3,2,0,1,2
75587,3,1,1,0,0,1
84609,9,1,1,0,0,1
84609,8,11,2,0,9,2
84609,7,4,1,0,3,1
84609,6,10,1,0,9,1
84609,5,7,2,0,5,2
96564,10,3,2,0,1,2
96564,9,4,3,0,1,3
96564,8,13,4,0,9,4
96564,7,6,4,0,2,4
96564,6,3,3,0,0,3
96564,4,5,5,0,0,5
96564,3,1,1,0,0,1
9350,8,4,3,0,1,3
9350,7,10,6,0,4,6
9350,6,19,8,0,11,8
9350,5,3,3,0,0,3
138015,8,6,2,0,4,2
138015,7,8,1,0,7,1
138015,6,11,1,0,10,1
138015,5,6,1,0,5,1
138015,3,2,2,0,0,2
2209,8,5,3,0,2,3
2209,7,10,5,0,5,5
2209,6,9,1,0,8,1
2209,5,8,4,0,4,4
2209,4,2,1,0,1,1
5899,7,2,2,0,0,2
5899,6,9,4,0,5,4
5899,5,8,1,0,7,1
5899,4,11,4,0,7,4
5899,2,3,1,0,2,1
13918,7,2,1,0,1,1
13918,6,5,1,0,4,1
13918,5,9,4,0,5,4
13918,4,6,2,0,4,2
13918,3,6,3,0,3,3
13918,2,2,1,0,1,1
13918,1,5,4,0,1,4
170954,10,1,1,0,0,1
170954,6,7,1,0,6,1
170954,5,8,1,0,7,1
170954,4,11,2,0,9,2
170954,3,3,2,0,1,2
170954,2,1,1,0,0,1
170954,1,4,1,0,3,1
231331,10,7,1,0,6,1
231331,8,8,1,0,7,1
231331,6,8,3,0,5,3
231331,5,4,1,0,3,1
18657,6,6,1,0,5,1
18657,5,6,3,0,3,3
18657,4,6,4,0,2,4
18657,3,3,2,0,1,2
18657,2,2,1,0,1,1
41428,10,1,1,0,0,1
41428,8,7,2,0,5,2
41428,7,10,5,0,5,5
41428,6,10,3,0,7,3
41428,5,5,1,0,4,1
165471,8,5,1,0,4,1
165471,7,12,2,0,10,2
165471,6,13,1,0,12,1
256701,10,3,1,0,2,1
256701,9,5,2,0,3,2
256701,8,12,2,0,10,2
256701,7,7,2,0,5,2
256701,6,5,3,0,2,3
256701,5,1,1,0,0,1
1415,6,4,1,0,3,1
1415,5,10,3,0,7,3
1415,4,7,2,0,5,2
1415,3,5,2,0,3,2
1415,1,6,4,0,2,4
164202,9,1,1,0,0,1
164202,7,7,2,1,5,1
164202,6,10,1,0,9,1
169768,10,6,2,0,4,2
169768,9,7,1,0,6,1
169768,8,5,1,0,4,1
169768,7,5,1,0,4,1
169768,6,3,1,0,2,1
169768,4,4,1,0,3,1
154482,8,2,2,0,0,2
154482,6,6,1,1,5,0
154482,5,4,1,0,3,1
154482,4,6,1,0,5,1
154482,3,5,2,0,3,2
155577,9,3,1,0,2,1
155577,8,7,1,0,6,1
155577,6,11,1,0,10,1
7368,9,2,1,0,1,1
7368,8,4,2,0,2,2
7368,7,15,4,0,11,4
7368,6,7,1,0,6,1
7368,5,3,1,0,2,1
7368,4,4,2,0,2,2
11179,10,4,1,0,3,1
11179,9,2,1,0,1,1
11179,8,15,4,0,11,4
11179,7,6,1,0,5,1
11179,3,1,1,0,0,1
192496,10,4,1,0,3,1
192496,9,2,1,0,1,1
192496,8,7,1,0,6,1
192496,5,4,1,0,3,1
192496,4,2,2,0,0,2
68201,9,4,2,0,2,2
68201,8,6,2,0,4,2
68201,7,12,3,0,9,3
68201,6,10,2,0,8,2
68201,4,1,1,0,0,1
68201,3,2,2,0,0,2
258160,10,3,1,0,2,1
258160,9,2,1,0,1,1
258160,8,11,2,0,9,2
258160,7,8,2,0,6,2
258160,5,2,1,0,1,1
258160,4,3,2,0,1,2
6042,8,5,2,0,3,2
6042,7,7,4,0,3,4
6042,6,12,2,0,10,2
6042,5,4,1,0,3,1
6042,4,3,2,0,1,2
40766,10,3,1,0,2,1
40766,9,7,1,0,6,1
40766,8,9,1,0,8,1
40766,7,9,2,0,7,2
40766,6,7,4,0,3,4
40766,2,1,1,0,0,1
138670,10,11,3,0,8,3
138670,9,5,1,0,4,1
138670,8,9,2,0,7,2
138670,1,2,1,0,1,1
142963,10,7,5,0,2,5
142963,9,1,1,0,0,1
142963,8,5,2,0,3,2
142963,7,9,2,0,7,2
142963,6,8,4,0,4,4
142963,5,2,1,0,1,1
142963,4,2,1,0,1,1
142963,2,2,1,0,1,1
142963,1,1,1,0,0,1
198142,8,9,3,0,6,3
198142,6,7,2,0,5,2
198142,5,6,3,0,3,3
198142,3,3,1,0,2,1
69676,6,5,1,0,4,1
69676,4,10,1,0,9,1
4971,10,2,1,0,1,1
4971,9,3,2,0,1,2
4971,8,7,3,0,4,3
4971,7,6,2,0,4,2
4971,6,9,3,0,6,3
4971,5,6,3,0,3,3
235927,8,8,2,0,6,2
235927,7,11,1,0,10,1
235927,6,9,2,0,7,2
235927,5,2,1,0,1,1
10268,9,4,1,0,3,1
10268,7,17,7,0,10,7
10268,6,11,5,0,6,5
174218,10,1,1,0,0,1
174218,9,1,1,0,0,1
174218,8,9,1,0,8,1
174218,6,14,6,1,8,5
174218,5,5,1,0,4,1
174218,4,2,1,0,1,1
16466,10,5,2,0,3,2
16466,9,13,7,0,6,7
16466,8,7,4,0,3,4
16466,7,5,3,0,2,3
16466,6,3,1,0,2,1
16466,5,2,1,0,1,1
136606,10,7,1,0,6,1
136606,9,6,2,1,4,1
136606,7,6,2,1,4,1
136606,5,2,1,0,1,1
23456,9,1,1,0,0,1
23456,6,13,2,0,11,2
23456,5,9,1,0,8,1
23456,4,3,1,0,2,1
23456,3,3,1,0,2,1
13488,10,1,1,0,0,1
13488,9,1,1,0,0,1
13488,7,4,1,0,3,1
13488,6,9,3,0,6,3
13488,5,13,4,0,9,4
13488,4,4,1,0,3,1
13488,3,2,1,0,1,1
13488,2,2,1,0,1,1
2845,8,2,2,0,0,2
2845,7,6,1,0,5,1
2845,5,10,1,0,9,1
2845,4,4,3,0,1,3
2845,3,3,1,0,2,1
2845,1,1,1,0,0,1
7604,8,2,2,0,0,2
7604,7,5,1,0,4,1
7604,6,10,2,0,8,2
7604,4,6,1,0,5,1
7604,2,1,1,0,0,1
71899,7,5,3,0,2,3
71899,6,11,3,0,8,3
71899,5,6,1,0,5,1
71899,4,6,2,0,4,2
165578,7,7,1,0,6,1
165578,6,11,1,0,10,1
165578,4,6,1,0,5,1
40774,8,5,1,0,4,1
40774,7,10,2,0,8,2
40774,6,6,2,0,4,2
40774,5,11,2,0,9,2
40774,4,4,2,0,2,2
7102,10,1,1,0,0,1
7102,8,4,2,0,2,2
7102,7,8,3,0,5,3
7102,6,12,3,0,9,3
7102,5,7,1,0,6,1
139177,9,2,1,0,1,1
139177,8,4,1,0,3,1
139177,7,6,1,0,5,1
139177,6,6,2,0,4,2
139177,5,6,1,0,5,1
139177,4,3,1,0,2,1
24443,8,2,1,0,1,1
24443,7,5,1,0,4,1
24443,6,10,3,0,7,3
24443,5,9,4,0,5,4
24443,4,7,3,0,4,3
24443,3,2,2,0,0,2
24443,2,2,1,0,1,1
2832,10,1,1,0,0,1
2832,6,11,4,0,7,4
2832,5,13,4,0,9,4
2832,4,4,1,0,3,1
2832,2,1,1,0,0,1
39193,7,3,1,0,2,1
39193,5,13,1,0,12,1
39193,4,6,3,0,3,3
39193,3,2,1,0,1,1
27939,8,3,1,0,2,1
27939,7,11,1,0,10,1
27939,6,14,1,0,13,1
27939,4,3,1,0,2,1
7868,9,1,1,0,0,1
7868,8,4,2,0,2,2
7868,7,4,3,0,1,3
7868,6,9,6,0,3,6
7868,5,11,7,0,4,7
7868,4,6,4,0,2,4
7868,3,1,1,0,0,1
7868,1,1,1,0,0,1
10742,8,7,2,0,5,2
10742,7,4,2,0,2,2
10742,6,7,1,0,6,1
10742,5,10,3,0,7,3
10742,3,6,1,0,5,1
1977,7,6,2,0,4,2
1977,6,14,3,0,11,3
1977,5,9,1,0,8,1
1977,3,1,1,0,0,1
1977,2,2,1,0,1,1
220721,7,10,3,0,7,3
220721,6,8,3,0,5,3
220721,4,3,1,0,2,1
220721,3,3,1,0,2,1
33418,8,3,1,0,2,1
33418,7,3,1,0,2,1
33418,6,9,1,0,8,1
33418,5,8,1,0,7,1
33418,4,8,2,0,6,2
33418,3,4,1,0,3,1
6789,8,3,1,0,2,1
6789,5,8,1,0,7,1
6789,4,4,1,0,3,1
140961,8,2,1,0,1,1
140961,7,7,3,0,4,3
140961,6,16,6,0,10,6
140961,5,5,2,0,3,2
140961,1,2,1,0,1,1
8049,10,8,2,0,6,2
8049,9,5,1,0,4,1
8049,8,12,5,0,7,5
8049,7,4,2,0,2,2
8049,6,6,2,0,4,2
8049,5,1,1,0,0,1
35163,7,10,3,0,7,3
35163,6,14,7,0,7,7
35163,5,2,1,0,1,1
35163,1,2,1,0,1,1
110525,7,5,1,0,4,1
110525,6,12,2,0,10,2
110525,5,10,2,0,8,2
110525,4,8,1,0,7,1
103687,7,9,2,0,7,2
103687,6,11,1,0,10,1
103687,5,4,1,0,3,1
103687,4,3,1,0,2,1
103687,2,2,1,0,1,1
103687,1,3,1,0,2,1
4237,8,1,1,0,0,1
4237,7,8,3,0,5,3
4237,6,13,4,0,9,4
4237,5,10,6,0,4,6
4237,1,1,1,0,0,1
2390,7,4,1,0,3,1
2390,6,12,3,0,9,3
2390,5,9,1,0,8,1
7631,10,1,1,0,0,1
7631,9,1,1,0,0,1
7631,7,9,4,0,5,4
7631,6,5,1,0,4,1
7631,5,9,3,0,6,3
7631,4,7,1,0,6,1
7071,10,1,1,0,0,1
7071,8,13,3,0,10,3
7071,7,6,4,0,2,4
7071,6,10,4,0,6,4
7071,4,1,1,0,0,1
7071,3,1,1,0,0,1
7071,2,1,1,0,0,1
7948,9,2,2,0,0,2
7948,8,3,1,0,2,1
7948,7,8,4,0,4,4
7948,6,12,3,0,9,3
7948,5,5,1,0,4,1
7948,4,2,1,0,1,1
7948,2,1,1,0,0,1
7948,1,1,1,0,0,1
28553,9,3,1,0,2,1
28553,8,10,4,0,6,4
28553,7,12,3,0,9,3
28553,6,6,2,0,4,2
28553,4,1,1,0,0,1
10303,10,2,1,0,1,1
10303,8,3,2,0,1,2
10303,7,5,1,0,4,1
10303,6,6,4,0,2,4
10303,5,5,1,0,4,1
10303,4,5,4,0,1,4
10303,3,2,1,0,1,1
10303,2,2,1,0,1,1
10303,1,7,2,0,5,2
4537,8,7,1,0,6,1
4537,7,8,2,0,6,2
4537,6,11,2,0,9,2
4537,3,1,1,0,0,1
36380,7,3,1,0,2,1
36380,6,9,2,0,7,2
36380,4,7,2,0,5,2
36380,1,1,1,0,0,1
9861,8,5,1,0,4,1
9861,7,9,1,0,8,1
9861,6,10,2,0,8,2
9861,3,1,1,0,0,1
8210,9,1,1,0,0,1
8210,8,2,1,0,1,1
8210,6,6,3,0,3,3
8210,5,5,1,0,4,1
8210,4,9,2,0,7,2
8210,3,4,1,0,3,1
8210,2,5,2,0,3,2
183344,8,3,1,0,2,1
183344,7,12,1,0,11,1
183344,6,15,2,0,13,2
183344,4,3,2,0,1,2
162915,8,2,1,0,1,1
162915,6,12,1,0,11,1
162915,4,5,1,0,4,1
162915,1,3,1,0,2,1
11562,8,2,1,0,1,1
11562,6,17,2,0,15,2
11562,5,5,1,0,4,1
11562,4,1,1,0,0,1
131164,10,1,1,0,0,1
131164,9,1,1,0,0,1
131164,7,4,1,0,3,1
131164,6,11,2,0,9,2
131164,4,9,3,0,6,3
131164,3,5,3,0,2,3
20642,8,6,1,0,5,1
20642,7,7,1,0,6,1
20642,6,15,5,0,10,5
20642,4,3,2,0,1,2
20642,3,2,2,0,0,2
149611,9,2,1,0,1,1
149611,7,4,1,0,3,1
149611,5,10,3,0,7,3
149611,4,5,4,0,1,4
149611,3,3,1,0,2,1
149611,1,2,1,0,1,1
224108,10,7,3,0,4,3
224108,9,5,1,0,4,1
224108,8,12,2,0,10,2
224108,7,3,1,0,2,1
124838,10,6,2,0,4,2
124838,9,15,7,0,8,7
124838,4,1,1,0,0,1
9398,9,4,4,0,0,4
9398,7,7,2,0,5,2
9398,6,8,4,0,4,4
9398,5,7,1,0,6,1
9398,4,2,1,0,1,1
9398,3,2,1,0,1,1
148628,9,5,4,0,1,4
148628,8,4,1,0,3,1
148628,7,3,3,0,0,3
148628,6,8,1,0,7,1
148628,5,5,2,0,3,2
148628,4,4,1,0,3,1
148628,3,3,1,0,2,1
148628,1,2,1,0,1,1
147423,7,4,2,0,2,2
147423,6,11,5,0,6,5
147423,5,6,1,0,5,1
147423,4,8,2,0,6,2
147423,3,6,1,0,5,1
2068,7,4,1,0,3,1
2068,6,10,1,0,9,1
2068,5,11,1,0,10,1
2068,4,5,1,0,4,1
2068,3,5,1,0,4,1
2068,2,1,1,0,0,1
3842,9,1,1,0,0,1
3842,8,5,1,0,4,1
3842,6,4,1,0,3,1
3842,5,10,2,0,8,2
3842,2,4,2,0,2,2
37490,10,1,1,0,0,1
37490,8,4,2,0,2,2
37490,5,11,4,0,7,4
37490,3,5,2,0,3,2
37490,2,2,1,0,1,1
8484,10,1,1,0,0,1
8484,8,3,2,0,1,2
8484,6,11,7,0,4,7
8484,5,7,2,0,5,2
8484,3,5,3,0,2,3
8484,1,1,1,0,0,1
238721,7,10,3,0,7,3
238721,6,7,1,0,6,1
238721,5,4,1,0,3,1
238721,4,5,2,0,3,2
238721,2,2,1,0,1,1
34291,8,5,1,0,4,1
34291,4,3,1,0,2,1
1994,8,3,2,0,1,2
1994,6,13,5,0,8,5
1994,5,7,1,0,6,1
1994,4,4,2,0,2,2
1994,3,4,2,0,2,2
1994,2,3,1,0,2,1
18907,7,7,1,0,6,1
18907,6,11,2,0,9,2
18907,5,7,4,0,3,4
18907,4,2,1,0,1,1
18907,3,2,2,0,0,2
18907,2,3,1,0,2,1
18907,1,1,1,0,0,1
10813,6,14,4,0,10,4
10813,5,13,1,0,12,1
10813,4,3,3,0,0,3
10813,3,2,2,0,0,2
23081,8,5,1,0,4,1
23081,6,11,4,0,7,4
23081,5,3,1,0,2,1
23081,4,4,1,0,3,1
23081,3,1,1,0,0,1
150978,6,21,2,0,19,2
150978,5,3,1,0,2,1
3669,7,3,1,0,2,1
3669,6,16,7,0,9,7
3669,5,10,3,0,7,3
3669,4,3,1,0,2,1
3669,3,1,1,0,0,1
220987,10,4,1,0,3,1
220987,9,11,5,0,6,5
220987,8,14,5,0,9,5
220987,7,4,1,1,3,0
153710,8,4,3,0,1,3
153710,7,4,2,0,2,2
153710,6,13,4,0,9,4
153710,5,7,1,0,6,1
153710,4,3,1,0,2,1
3354,10,2,1,0,1,1
3354,8,6,5,0,1,5
3354,7,5,3,0,2,3
3354,6,10,3,0,7,3
3354,5,7,3,0,4,3
3354,4,3,1,0,2,1
154585,7,7,1,0,6,1
154585,6,16,1,0,15,1
154585,5,9,2,0,7,2
8388,8,2,2,0,0,2
8388,7,5,1,0,4,1
8388,6,17,5,0,12,5
8388,5,9,1,0,8,1
8388,4,2,1,0,1,1
8388,2,1,1,0,0,1
260233,8,2,1,0,1,1
260233,7,10,4,0,6,4
260233,6,12,2,0,10,2
10154,9,3,1,0,2,1
10154,8,6,4,0,2,4
10154,7,5,4,0,1,4
10154,6,8,2,0,6,2
10154,5,3,1,0,2,1
10154,4,9,5,0,4,5
5030,9,2,1,0,1,1
5030,8,4,2,0,2,2
5030,7,2,2,0,0,2
5030,5,10,3,0,7,3
5030,4,6,1,0,5,1
5030,3,2,2,0,0,2
117891,9,1,1,0,0,1
117891,7,5,1,0,4,1
117891,6,11,1,0,10,1
117891,4,5,1,0,4,1
117891,2,2,1,0,1,1
11253,8,4,1,0,3,1
11253,7,3,1,0,2,1
11253,6,11,5,0,6,5
11253,5,7,2,0,5,2
11253,4,4,2,0,2,2
170511,7,7,1,0,6,1
170511,6,12,2,0,10,2
170511,5,9,1,0,8,1
170511,4,5,1,0,4,1
19909,10,2,1,0,1,1
19909,9,3,3,0,0,3
19909,8,12,4,0,8,4
19909,7,17,4,0,13,4
19909,1,1,1,0,0,1
189833,10,1,1,0,0,1
189833,9,2,1,0,1,1
189833,8,2,1,0,1,1
189833,6,9,2,0,7,2
189833,5,6,1,0,5,1
189833,3,1,1,0,0,1
189833,2,3,1,0,2,1
189833,1,2,1,0,1,1
60210,8,7,2,0,5,2
60210,6,6,2,0,4,2
60210,5,6,1,0,5,1
60210,2,2,1,0,1,1
10543,8,3,1,0,2,1
10543,7,3,1,0,2,1
10543,6,11,5,0,6,5
10543,5,11,7,0,4,7
10543,2,1,1,0,0,1
10543,1,1,1,0,0,1
3129,8,5,1,0,4,1
3129,7,7,2,0,5,2
3129,6,14,2,0,12,2
3129,5,5,4,0,1,4
3129,4,1,1,0,0,1
3129,3,2,1,0,1,1
1913,7,7,1,0,6,1
1913,6,12,4,0,8,4
1913,5,11,5,0,6,5
1913,4,3,1,0,2,1
11601,8,10,4,0,6,4
11601,7,14,10,0,4,10
11601,6,7,4,0,3,4
11601,5,3,3,0,0,3
11601,4,2,1,0,1,1
57183,10,3,2,0,1,2
57183,9,1,1,0,0,1
57183,8,3,1,0,2,1
57183,7,6,1,0,5,1
57183,6,10,3,0,7,3
57183,5,9,1,0,8,1
57183,2,1,1,0,0,1
166156,9,3,1,0,2,1
166156,8,6,1,0,5,1
166156,6,12,1,0,11,1
166156,4,8,1,0,7,1
137685,8,3,2,0,1,2
137685,7,8,5,0,3,5
137685,6,12,5,0,7,5
137685,5,9,4,0,5,4
137685,4,2,1,0,1,1
137685,3,2,1,0,1,1
137685,2,1,1,0,0,1
141679,7,8,4,0,4,4
141679,6,13,6,0,7,6
141679,5,8,1,0,7,1
141679,4,4,1,0,3,1
141679,3,2,1,0,1,1
16273,8,1,1,0,0,1
16273,7,5,1,0,4,1
16273,6,7,2,0,5,2
16273,5,6,2,0,4,2
16273,4,3,1,0,2,1
9474,8,4,1,0,3,1
9474,7,5,4,0,1,4
9474,6,14,5,0,9,5
9474,5,7,2,0,5,2
9474,4,3,2,0,1,2
9474,3,3,1,0,2,1
9901,6,7,2,0,5,2
9901,5,9,3,0,6,3
9901,4,6,3,0,3,3
9901,3,4,1,0,3,1
265381,7,13,1,0,12,1
265381,6,9,1,0,8,1
22257,6,8,2,0,6,2
22257,4,8,1,0,7,1
25229,7,2,2,0,0,2
25229,6,14,4,0,10,4
25229,5,7,4,0,3,4
25229,4,5,1,0,4,1
25229,3,3,3,0,0,3
4621,8,2,1,0,1,1
4621,7,4,2,0,2,2
4621,6,10,3,0,7,3
4621,5,12,6,0,6,6
4621,4,6,2,0,4,2
4621,3,1,1,0,0,1
10175,10,2,2,0,0,2
10175,6,8,1,0,7,1
10175,5,11,3,0,8,3
10175,4,5,1,0,4,1
10175,2,1,1,0,0,1
10175,1,1,1,0,0,1
8585,9,2,1,0,1,1
8585,8,1,1,0,0,1
8585,7,7,2,0,5,2
8585,6,10,3,0,7,3
8585,5,7,2,0,5,2
8585,4,3,2,0,1,2
8585,3,4,1,0,3,1
8585,2,3,3,0,0,3
4248,10,2,1,0,1,1
4248,8,1,1,0,0,1
4248,7,1,1,0,0,1
4248,6,13,5,0,8,5
4248,5,7,2,0,5,2
4248,4,9,4,0,5,4
4248,3,3,2,0,1,2
6678,10,2,2,0,0,2
6678,8,2,1,0,1,1
6678,7,4,2,0,2,2
6678,6,14,5,0,9,5
6678,5,4,3,0,1,3
6678,4,4,2,0,2,2
6678,3,5,2,0,3,2
6678,1,1,1,0,0,1
183197,10,1,1,0,0,1
183197,8,5,2,0,3,2
183197,6,10,1,0,9,1
183197,4,9,1,0,8,1
4614,9,2,1,0,1,1
4614,6,17,9,0,8,9
4614,5,7,4,0,3,4
4614,3,4,2,0,2,2
5067,7,8,1,0,7,1
5067,6,12,6,0,6,6
5067,5,9,1,0,8,1
5067,3,2,1,0,1,1
5067,1,2,1,0,1,1
230065,9,1,1,1,0,0
230065,7,8,1,0,7,1
230065,6,14,1,0,13,1
230065,5,7,1,0,6,1
230065,4,3,1,0,2,1
203019,8,7,1,0,6,1
203019,3,3,1,0,2,1
203019,1,2,1,0,1,1
142829,10,4,3,1,1,2
142829,9,2,1,0,1,1
142829,8,8,2,0,6,2
142829,7,8,3,0,5,3
142829,6,10,2,0,8,2
142829,4,1,1,0,0,1
142829,1,2,1,0,1,1
82037,8,1,1,0,0,1
82037,7,6,4,0,2,4
82037,6,13,2,0,11,2
82037,4,2,1,0,1,1
82037,3,6,1,0,5,1
24325,8,4,1,0,3,1
24325,6,11,4,0,7,4
24325,5,5,2,0,3,2
24325,4,5,2,0,3,2
24325,3,5,5,0,0,5
24325,2,1,1,0,0,1
2315,8,2,1,0,1,1
2315,7,5,1,0,4,1
2315,6,12,6,0,6,6
2315,5,8,3,0,5,3
2315,3,4,1,0,3,1
157061,5,6,2,0,4,2
157061,3,5,1,0,4,1
3356,9,1,1,0,0,1
3356,7,5,2,0,3,2
3356,6,12,3,0,9,3
3356,5,6,1,0,5,1
3356,4,6,1,0,5,1
3356,3,2,2,0,0,2
177572,9,1,1,0,0,1
177572,7,11,3,0,8,3
177572,6,9,2,0,7,2
177572,5,2,1,0,1,1
177572,4,5,1,0,4,1
177572,1,1,1,0,0,1
17939,9,6,2,0,4,2
17939,8,8,1,0,7,1
17939,7,12,4,0,8,4
17939,6,5,2,0,3,2
17939,5,2,1,0,1,1
17939,4,1,1,0,0,1
17939,3,1,1,0,0,1
17939,2,2,1,0,1,1
148442,4,5,1,0,4,1
148442,3,4,1,0,3,1
13072,9,1,1,0,0,1
13072,6,18,4,0,14,4
13072,4,4,1,0,3,1
13072,3,3,2,0,1,2
40966,8,4,1,0,3,1
40966,6,13,1,0,12,1
40966,5,6,2,0,4,2
40966,3,3,1,0,2,1
2730,8,3,1,0,2,1
2730,7,4,1,0,3,1
2730,6,17,4,0,13,4
2730,5,6,1,0,5,1
2730,4,3,1,0,2,1
2730,3,2,1,0,1,1
2730,2,1,1,0,0,1
1793,8,5,2,0,3,2
1793,7,12,4,0,8,4
1793,6,9,1,0,8,1
1793,5,7,2,0,5,2
1793,4,3,1,0,2,1
239116,10,1,1,0,0,1
239116,6,11,2,0,9,2
239116,4,4,2,0,2,2
239116,2,4,1,0,3,1
234378,10,4,2,0,2,2
234378,6,9,1,0,8,1
104239,8,8,1,0,7,1
104239,7,9,1,0,8,1
104239,6,10,1,0,9,1
104239,3,1,1,0,0,1
104239,2,2,1,0,1,1
104239,1,1,1,0,0,1
4433,6,6,2,0,4,2
4433,5,14,3,0,11,3
4433,4,8,2,0,6,2
4433,3,4,2,0,2,2
4433,1,1,1,0,0,1
167589,2,1,1,0,0,1
165189,10,1,1,0,0,1
165189,9,2,1,0,1,1
165189,3,6,1,0,5,1
33414,8,5,1,0,4,1
33414,7,13,2,0,11,2
33414,6,11,4,0,7,4
33414,5,5,1,0,4,1
33414,4,2,1,0,1,1
4559,7,3,1,0,2,1
4559,6,11,2,0,9,2
4559,5,9,2,0,7,2
4559,4,7,3,0,4,3
4559,3,2,2,0,0,2
4559,2,4,1,0,3,1
179322,9,5,1,0,4,1
179322,8,10,4,1,6,3
179322,7,11,4,0,7,4
179322,6,9,1,0,8,1
4267,8,2,2,0,0,2
4267,6,10,6,0,4,6
4267,5,3,2,0,1,2
4267,4,10,3,0,7,3
4267,3,4,2,0,2,2
4267,2,3,1,0,2,1
4267,1,1,1,0,0,1
9385,8,4,1,0,3,1
9385,7,7,3,0,4,3
9385,6,11,1,0,10,1
9385,5,5,1,0,4,1
9385,4,5,2,0,3,2
9385,3,1,1,0,0,1
28699,7,3,1,0,2,1
28699,6,15,1,0,14,1
28699,5,10,2,0,8,2
28699,4,3,1,0,2,1
3915,8,3,2,0,1,2
3915,6,8,2,0,6,2
3915,5,14,6,0,8,6
3915,4,4,1,0,3,1
3915,3,2,1,0,1,1
7006,9,1,1,0,0,1
7006,7,4,2,0,2,2
7006,6,15,7,0,8,7
7006,5,9,2,0,7,2
7006,3,4,2,0,2,2
244433,10,4,1,0,3,1
244433,9,4,1,0,3,1
244433,7,7,1,0,6,1
244433,6,9,1,0,8,1
244433,5,3,1,0,2,1
20899,9,7,1,0,6,1
20899,8,8,1,0,7,1
20899,7,10,1,0,9,1
20899,6,5,1,0,4,1
21881,7,3,1,0,2,1
21881,6,8,1,0,7,1
21881,5,4,1,0,3,1
21881,4,10,2,0,8,2
21881,3,7,1,0,6,1
21881,2,4,1,0,3,1
24137,6,9,3,0,6,3
24137,4,10,4,0,6,4
24137,3,3,1,0,2,1
24137,1,2,2,0,0,2
200188,9,2,2,0,0,2
200188,8,2,1,0,1,1
200188,6,10,1,0,9,1
200188,5,5,1,0,4,1
200188,4,2,1,0,1,1
200188,1,2,2,0,0,2
3503,6,5,2,0,3,2
3503,5,6,2,0,4,2
3503,4,11,2,0,9,2
3503,3,8,5,0,3,5
3503,2,4,1,0,3,1
217863,10,1,1,0,0,1
217863,9,3,1,0,2,1
217863,8,6,2,1,4,1
217863,5,3,1,0,2,1
217863,4,3,1,0,2,1
217863,1,2,1,0,1,1
197073,10,7,4,0,3,4
197073,9,4,2,0,2,2
197073,8,5,1,0,4,1
197073,7,6,2,0,4,2
197073,6,9,3,0,6,3
197073,5,1,1,0,0,1
197073,4,3,1,0,2,1
197073,2,1,1,0,0,1
232267,9,3,2,0,1,2
232267,8,17,7,0,10,7
232267,7,11,2,0,9,2
232267,6,4,2,0,2,2
33595,9,2,1,0,1,1
33595,8,14,4,0,10,4
33595,7,15,4,0,11,4
7827,7,5,1,0,4,1
7827,6,13,3,0,10,3
7827,4,7,3,0,4,3
7827,2,2,1,0,1,1
5059,9,3,1,0,2,1
5059,8,4,1,0,3,1
5059,7,9,2,0,7,2
5059,6,8,3,0,5,3
5059,5,7,2,0,5,2
5059,3,2,2,0,0,2
38826,7,7,4,0,3,4
38826,6,15,8,0,7,8
38826,5,3,2,0,1,2
38826,4,2,1,0,1,1
37267,9,2,2,0,0,2
37267,8,6,3,0,3,3
37267,7,6,1,0,5,1
37267,6,6,3,0,3,3
37267,4,4,2,0,2,2
37267,2,3,2,0,1,2
37267,1,4,2,0,2,2
4957,8,7,1,0,6,1
4957,7,7,2,0,5,2
4957,6,12,5,0,7,5
4957,5,6,2,0,4,2
27678,8,5,5,0,0,5
27678,7,5,4,0,1,4
27678,6,17,13,0,4,13
27678,5,4,3,0,1,3
27678,4,2,1,0,1,1
27678,3,1,1,0,0,1
27678,2,2,1,0,1,1
11764,9,4,3,0,1,3
11764,8,11,3,0,8,3
11764,7,11,4,0,7,4
11764,6,7,2,0,5,2
11764,5,2,1,0,1,1
167580,10,2,1,0,1,1
167580,9,12,3,0,9,3
167580,8,16,4,0,12,4
167580,7,5,2,0,3,2
6936,8,1,1,0,0,1
6936,7,9,2,0,7,2
6936,6,15,7,0,8,7
6936,5,5,1,0,4,1
6936,4,3,1,0,2,1
6936,3,2,1,0,1,1
9854,9,4,2,0,2,2
9854,8,13,1,0,12,1
9854,7,7,1,0,6,1
9854,5,4,1,0,3,1
97248,8,15,4,1,11,3
97248,7,5,1,0,4,1
97248,6,8,3,0,5,3
97248,5,2,2,0,0,2
97248,4,1,1,0,0,1
3384,9,1,1,0,0,1
3384,7,9,2,0,7,2
3384,6,7,1,0,6,1
3384,5,12,1,0,11,1
192023,9,3,1,0,2,1
192023,8,17,9,0,8,9
192023,7,9,3,0,6,3
192023,6,5,1,0,4,1
257372,8,5,1,0,4,1
257372,7,10,1,0,9,1
257372,6,14,1,0,13,1
257372,5,3,1,0,2,1
257372,4,1,1,0,0,1
27852,7,11,4,0,7,4
27852,6,9,3,0,6,3
27852,5,6,1,0,5,1
27852,3,3,1,0,2,1
5361,7,2,1,0,1,1
5361,6,13,7,0,6,7
5361,5,10,3,0,7,3
5361,4,3,1,0,2,1
5361,3,2,1,0,1,1
5361,2,4,3,0,1,3
213787,10,13,3,1,10,2
213787,7,4,1,0,3,1
213787,6,2,2,0,0,2
213787,2,3,3,1,0,2
213787,1,13,6,0,7,6
20203,6,6,1,0,5,1
20203,5,8,2,0,6,2
20203,4,10,1,0,9,1
20203,3,7,1,0,6,1
94486,8,4,3,0,1,3
94486,7,5,1,0,4,1
94486,6,10,3,0,7,3
94486,4,2,1,0,1,1
94486,3,4,2,0,2,2
96157,10,5,1,0,4,1
96157,9,4,3,0,1,3
96157,8,9,3,0,6,3
96157,7,7,2,0,5,2
96157,6,7,2,0,5,2
96157,4,2,2,0,0,2
86443,6,13,1,0,12,1
86443,5,5,1,0,4,1
86443,4,8,1,0,7,1
86443,3,3,2,0,1,2
86443,2,2,1,0,1,1
27675,6,5,3,0,2,3
27675,5,7,2,0,5,2
27675,4,13,6,0,7,6
27675,3,5,1,0,4,1
27675,2,2,1,0,1,1
28176,8,3,1,0,2,1
28176,6,9,2,0,7,2
28176,5,9,4,0,5,4
28176,4,5,1,0,4,1
28176,3,5,2,0,3,2
8538,9,3,2,0,1,2
8538,8,15,4,0,11,4
8538,7,12,3,0,9,3
8538,6,3,2,0,1,2
11763,10,1,1,0,0,1
11763,8,9,7,0,2,7
11763,7,12,4,0,8,4
11763,6,9,4,0,5,4
176633,9,4,1,0,3,1
176633,8,14,6,3,8,3
176633,7,6,1,0,5,1
176633,6,5,1,0,4,1
35312,8,2,1,0,1,1
35312,7,6,4,0,2,4
35312,6,11,7,0,4,7
35312,5,7,3,0,4,3
35312,4,6,3,0,3,3
35312,3,3,3,0,0,3
31604,8,5,2,0,3,2
31604,7,7,5,0,2,5
31604,6,13,6,0,7,6
31604,5,7,2,0,5,2
3402,10,2,1,0,1,1
3402,9,4,1,0,3,1
3402,8,7,3,0,4,3
3402,7,10,1,0,9,1
3402,6,8,3,0,5,3
3402,5,2,1,0,1,1
3402,4,1,1,0,0,1
176400,10,6,4,1,2,3
176400,9,2,2,1,0,1
176400,8,5,3,1,2,2
176400,6,15,5,0,10,5
176400,5,3,1,0,2,1
37592,9,4,1,0,3,1
37592,8,20,8,0,12,8
37592,5,3,1,0,2,1
37592,4,1,1,0,0,1
129952,9,2,1,0,1,1
129952,8,5,1,0,4,1
129952,6,9,3,0,6,3
129952,5,7,1,0,6,1
129952,4,3,2,0,1,2
12519,5,11,3,0,8,3
12519,4,1,1,0,0,1
12519,3,4,4,0,0,4
20306,5,14,3,0,11,3
20306,4,7,1,0,6,1
20306,3,4,1,0,3,1
8100,5,13,4,0,9,4
8100,3,4,1,0,3,1
8100,2,1,1,0,0,1
99062,10,3,1,0,2,1
99062,9,3,2,0,1,2
99062,8,8,4,0,4,4
99062,7,7,1,0,6,1
99062,6,5,2,0,3,2
99062,5,3,1,0,2,1
99062,4,2,1,0,1,1
99062,3,4,3,0,1,3
230548,10,3,1,0,2,1
230548,9,4,1,0,3,1
230548,8,8,1,0,7,1
230081,10,8,5,0,3,5
230081,9,4,1,0,3,1
230081,8,6,2,0,4,2
230081,7,6,1,0,5,1
230081,6,8,3,0,5,3
230081,5,3,1,0,2,1
132322,9,1,1,0,0,1
132322,8,4,1,0,3,1
132322,7,9,2,0,7,2
132322,6,17,7,0,10,7
157254,10,3,1,0,2,1
157254,9,4,1,0,3,1
157254,8,12,4,0,8,4
157254,7,9,1,0,8,1
157254,6,5,1,0,4,1
157254,5,2,1,0,1,1
8168,8,3,1,0,2,1
8168,7,13,2,0,11,2
8168,6,8,2,0,6,2
8168,5,4,2,0,2,2
8168,4,4,1,0,3,1
154841,9,3,1,0,2,1
154841,8,5,2,0,3,2
154841,7,6,2,0,4,2
154841,6,6,2,0,4,2
154841,4,3,1,0,2,1
154841,2,4,2,0,2,2
172510,7,9,2,0,7,2
172510,6,14,3,0,11,3
172510,2,2,1,0,1,1
138064,9,1,1,0,0,1
138064,8,1,1,0,0,1
138064,7,9,4,0,5,4
138064,6,10,2,0,8,2
138064,5,9,5,0,4,5
138064,4,3,3,0,0,3
138064,2,2,1,0,1,1
451,7,7,1,0,6,1
451,6,15,5,0,10,5
451,4,3,1,0,2,1
451,2,1,1,0,0,1
145275,8,6,2,0,4,2
145275,7,5,1,1,4,0
145275,6,12,2,0,10,2
145275,5,9,3,1,6,2
145275,4,2,1,0,1,1
198984,10,10,7,2,3,5
198984,9,6,4,1,2,3
198984,7,2,1,0,1,1
198984,5,3,2,0,1,2
198984,3,1,1,0,0,1
9547,10,2,1,0,1,1
9547,5,11,2,0,9,2
9547,4,11,3,0,8,3
9547,2,3,1,0,2,1
10188,10,2,2,0,0,2
10188,9,1,1,0,0,1
10188,8,8,7,0,1,7
10188,7,7,1,0,6,1
10188,6,9,5,0,4,5
10188,4,4,2,0,2,2
10188,3,1,1,0,0,1
31557,8,3,2,0,1,2
31557,7,8,6,0,2,6
31557,6,14,6,0,8,6
31557,5,9,3,0,6,3
31557,4,1,1,0,0,1
175313,8,4,1,0,3,1
175313,6,11,1,0,10,1
175313,4,2,2,0,0,2
10258,7,8,1,0,7,1
10258,6,13,7,0,6,7
10258,2,2,1,0,1,1
16617,9,3,2,0,1,2
16617,7,12,5,0,7,5
16617,6,13,6,0,7,6
116737,8,6,4,0,2,4
116737,7,16,5,0,11,5
116737,6,10,1,0,9,1
116737,5,2,1,0,1,1
145274,10,3,2,0,1,2
145274,8,9,2,0,7,2
145274,7,6,1,0,5,1
145274,6,9,4,1,5,3
145274,5,5,1,0,4,1
145274,4,3,3,0,0,3
87748,9,3,1,0,2,1
87748,8,2,2,0,0,2
87748,6,8,2,0,6,2
87748,5,6,1,0,5,1
87748,4,5,2,0,3,2
87748,2,1,1,0,0,1
87748,1,1,1,0,0,1
5564,7,5,1,0,4,1
5564,6,6,2,0,4,2
5564,5,10,4,0,6,4
5564,4,9,5,0,4,5
5564,3,3,1,0,2,1
5564,2,2,1,0,1,1
201971,10,2,1,0,1,1
201971,8,3,1,0,2,1
201971,6,14,5,0,9,5
12479,8,8,3,0,5,3
12479,6,13,5,0,8,5
12479,5,5,1,0,4,1
3268,7,2,1,0,1,1
3268,6,11,1,0,10,1
3268,5,8,1,0,7,1
3268,4,10,4,0,6,4
3268,2,2,1,0,1,1
8429,8,1,1,0,0,1
8429,7,3,2,0,1,2
8429,6,8,2,0,6,2
8429,5,11,5,0,6,5
8429,4,8,3,0,5,3
8429,3,2,1,0,1,1
8429,2,2,1,0,1,1
38825,10,3,1,0,2,1
38825,9,2,1,0,1,1
38825,7,16,7,0,9,7
38825,6,8,3,0,5,3
38825,4,2,1,0,1,1
38825,3,1,1,0,0,1
26163,7,1,1,0,0,1
26163,6,7,1,0,6,1
26163,5,7,3,0,4,3
26163,4,9,1,0,8,1
26163,3,7,4,0,3,4
26163,2,3,1,0,2,1
14163,10,2,1,0,1,1
14163,8,3,1,0,2,1
14163,7,5,4,0,1,4
14163,6,10,4,0,6,4
14163,5,10,6,0,4,6
14163,4,4,2,0,2,2
14163,3,2,1,0,1,1
11347,7,3,2,0,1,2
11347,6,15,4,0,11,4
11347,5,8,4,0,4,4
11347,4,7,1,0,6,1
11347,3,1,1,0,0,1
195180,9,1,1,1,0,0
195180,7,14,3,1,11,2
195180,6,5,1,0,4,1
195180,5,5,2,0,3,2
195180,4,3,1,0,2,1
195180,3,1,1,0,0,1
253862,9,1,1,0,0,1
253862,8,5,2,0,3,2
253862,7,9,1,0,8,1
253862,6,11,2,0,9,2
253862,5,4,1,0,3,1
14117,8,3,2,0,1,2
14117,7,10,1,0,9,1
14117,6,11,6,0,5,6
14117,5,7,2,0,5,2
14117,4,2,1,0,1,1
13742,10,1,1,0,0,1
13742,9,4,1,0,3,1
13742,8,5,4,0,1,4
13742,7,8,2,0,6,2
13742,6,13,4,0,9,4
13742,5,4,2,0,2,2
217431,9,2,2,0,0,2
217431,8,12,2,0,10,2
217431,7,8,4,0,4,4
217431,6,10,2,0,8,2
217431,3,1,1,0,0,1
85992,7,8,4,0,4,4
85992,5,6,1,0,5,1
85992,4,4,1,0,3,1
85992,3,2,1,0,1,1
85992,1,2,1,0,1,1
3468,10,2,2,0,0,2
3468,7,6,4,0,2,4
3468,6,9,4,0,5,4
3468,5,4,3,0,1,3
3468,4,6,3,0,3,3
3468,2,2,1,0,1,1
36687,8,6,2,0,4,2
36687,7,6,2,0,4,2
36687,6,16,5,0,11,5
36687,4,2,1,0,1,1
36687,3,2,1,0,1,1
36687,2,1,1,0,0,1
2577,8,1,1,0,0,1
2577,7,7,4,0,3,4
2577,6,10,6,0,4,6
2577,5,9,4,0,5,4
2577,4,5,2,0,3,2
2577,3,4,2,0,2,2
36332,8,8,2,0,6,2
36332,7,10,6,0,4,6
36332,6,5,3,0,2,3
36332,5,4,1,0,3,1
36332,2,1,1,0,0,1
36332,1,1,1,0,0,1
145764,6,6,1,0,5,1
145764,3,2,1,0,1,1
145764,1,6,5,1,1,4
192500,9,1,1,0,0,1
192500,7,9,2,0,7,2
192500,6,14,1,0,13,1
192500,3,3,1,0,2,1
218993,8,2,1,0,1,1
218993,7,9,4,0,5,4
218993,6,15,6,0,9,6
218993,5,6,1,0,5,1
218993,3,1,1,0,0,1
165926,9,3,1,0,2,1
165926,8,2,2,0,0,2
165926,6,17,1,0,16,1
165926,4,2,1,0,1,1
8279,8,4,2,0,2,2
8279,7,5,4,0,1,4
8279,6,16,8,0,8,8
8279,5,5,2,0,3,2
12169,10,1,1,0,0,1
12169,8,3,2,0,1,2
12169,7,11,1,0,10,1
12169,6,11,3,0,8,3
12169,5,4,1,0,3,1
12169,1,2,1,0,1,1
237745,10,2,1,0,1,1
237745,9,6,3,0,3,3
237745,8,15,4,0,11,4
237745,7,7,4,0,3,4
237745,6,3,3,0,0,3
237745,5,3,1,0,2,1
16875,8,15,8,0,7,8
16875,7,8,2,0,6,2
16875,6,7,5,0,2,5
16875,4,1,1,0,0,1
12181,10,5,1,0,4,1
12181,9,6,4,0,2,4
12181,8,9,6,0,3,6
12181,7,9,3,0,6,3
12181,6,7,6,0,1,6
6965,6,5,2,0,3,2
6965,4,10,4,0,6,4
6965,3,6,1,0,5,1
6965,2,3,1,0,2,1
6397,7,3,1,0,2,1
6397,6,6,3,0,3,3
6397,5,12,7,0,5,7
6397,3,3,2,0,1,2
6397,2,7,4,0,3,4
13786,8,5,2,0,3,2
13786,7,7,1,0,6,1
13786,5,1,1,0,0,1
13786,4,5,2,0,3,2
13786,3,1,1,0,0,1
13786,1,2,1,0,1,1
13832,8,6,2,0,4,2
13832,7,8,3,0,5,3
13832,6,14,5,0,9,5
13832,5,4,1,0,3,1
13832,4,3,2,0,1,2
5638,8,2,1,0,1,1
5638,7,5,1,0,4,1
5638,6,4,2,0,2,2
5638,5,7,2,0,5,2
5638,4,4,1,0,3,1
180202,8,3,1,0,2,1
180202,7,8,4,0,4,4
180202,6,19,7,0,12,7
180202,3,1,1,0,0,1
4181,7,5,2,0,3,2
4181,5,11,2,0,9,2
4181,4,6,3,0,3,3
4181,2,5,4,0,1,4
161743,7,8,2,0,6,2
161743,6,8,1,0,7,1
161743,5,10,1,0,9,1
161743,4,2,1,0,1,1
161743,3,3,2,0,1,2
161743,2,2,1,0,1,1
246129,10,4,3,0,1,3
246129,8,14,4,0,10,4
246129,7,10,4,0,6,4
246129,6,4,3,0,1,3
41529,8,5,1,0,4,1
41529,7,9,2,0,7,2
41529,6,5,1,0,4,1
41529,5,5,2,0,3,2
41529,4,1,1,0,0,1
3349,8,1,1,0,0,1
3349,7,10,5,0,5,5
3349,6,14,2,0,12,2
3349,5,8,3,0,5,3
11483,7,5,2,0,3,2
11483,6,12,5,0,7,5
11483,5,11,5,0,6,5
11483,4,5,3,0,2,3
11483,3,2,1,0,1,1
100015,9,1,1,0,0,1
100015,8,10,5,0,5,5
100015,7,9,2,0,7,2
100015,5,5,1,0,4,1
100015,4,2,1,0,1,1
100015,3,2,1,0,1,1
3188,10,1,1,0,0,1
3188,8,1,1,0,0,1
3188,6,4,2,0,2,2
3188,4,5,1,0,4,1
3188,3,8,1,0,7,1
3188,2,8,6,0,2,6
3188,1,4,2,0,2,2
164339,6,6,3,0,3,3
164339,5,10,3,0,7,3
164339,4,4,1,0,3,1
164339,3,4,2,0,2,2
164339,2,2,2,0,0,2
164339,1,4,1,0,3,1
207713,9,5,1,0,4,1
207713,8,5,2,0,3,2
207713,7,4,2,0,2,2
207713,6,4,1,0,3,1
207713,5,5,1,0,4,1
207713,4,6,2,0,4,2
207713,3,1,1,0,0,1
207713,1,3,1,0,2,1
162677,9,3,2,0,1,2
162677,8,16,2,0,14,2
162677,7,13,4,0,9,4
162677,6,2,1,0,1,1
162677,4,1,1,0,0,1
2609,9,1,1,0,0,1
2609,8,1,1,0,0,1
2609,7,7,6,0,1,6
2609,6,18,7,0,11,7
2609,5,7,3,0,4,3
2609,3,1,1,0,0,1
262370,5,4,3,0,1,3
262370,4,2,1,0,1,1
262370,1,2,1,0,1,1
32598,8,4,1,0,3,1
32598,7,12,2,0,10,2
32598,6,12,2,0,10,2
32598,5,6,2,0,4,2
185246,10,8,3,0,5,3
185246,9,3,1,0,2,1
185246,8,5,3,2,2,1
185246,7,7,1,0,6,1
185246,6,4,1,0,3,1
185246,3,1,1,0,0,1
4303,8,8,4,0,4,4
4303,7,3,1,0,2,1
4303,6,10,5,0,5,5
4303,5,3,1,0,2,1
4303,4,5,1,0,4,1
4303,3,4,1,0,3,1
252165,10,5,2,0,3,2
252165,9,8,5,0,3,5
252165,8,17,4,0,13,4
252165,7,5,1,0,4,1
184247,10,7,2,0,5,2
184247,9,4,1,0,3,1
184247,8,9,4,1,5,3
184247,7,2,1,0,1,1
184247,6,4,1,0,3,1
184247,4,1,1,0,0,1
184247,3,4,3,0,1,3
254341,8,3,1,0,2,1
254341,7,10,2,0,8,2
254341,6,9,1,0,8,1
254341,2,1,1,0,0,1
20834,9,5,1,0,4,1
20834,8,9,2,0,7,2
20834,7,8,1,0,7,1
20834,6,7,2,0,5,2
150143,10,6,3,0,3,3
150143,9,6,1,0,5,1
150143,8,7,3,0,4,3
150143,6,8,1,0,7,1
150143,5,1,1,0,0,1
231477,8,15,5,0,10,5
231477,7,11,2,0,9,2
231477,5,3,1,0,2,1
94958,6,13,1,0,12,1
125461,7,3,1,0,2,1
125461,4,9,2,0,7,2
125461,2,4,4,0,0,4
125461,1,2,2,0,0,2
22354,7,5,1,0,4,1
22354,4,9,3,0,6,3
22354,3,4,1,0,3,1
22354,1,2,1,0,1,1
130304,10,9,4,0,5,4
130304,9,5,4,0,1,4
130304,8,11,1,0,10,1
130304,6,2,1,0,1,1
130304,4,1,1,0,0,1
5031,6,7,2,0,5,2
5031,5,7,2,0,5,2
5031,4,9,2,0,7,2
5031,3,7,2,0,5,2
5031,2,4,3,0,1,3
147852,9,3,1,0,2,1
147852,7,11,1,0,10,1
147852,2,2,1,0,1,1
7040,8,2,1,0,1,1
7040,7,7,2,0,5,2
7040,6,14,3,0,11,3
7040,5,6,5,0,1,5
7040,3,2,1,0,1,1
7040,2,2,1,0,1,1
19456,8,2,1,0,1,1
19456,6,9,3,0,6,3
19456,5,10,3,0,7,3
19456,4,9,2,0,7,2
19456,3,3,1,0,2,1
19456,1,1,1,0,0,1
63433,7,8,1,0,7,1
63433,6,11,4,0,7,4
63433,5,5,1,0,4,1
1079,8,6,4,0,2,4
1079,7,14,4,0,10,4
1079,6,12,4,0,8,4
1079,5,2,1,0,1,1
238360,9,3,1,0,2,1
238360,6,13,1,0,12,1
4012,8,6,4,0,2,4
4012,7,9,2,0,7,2
4012,6,15,6,0,9,6
4012,5,2,1,0,1,1
34866,7,8,2,0,6,2
34866,6,7,1,0,6,1
34866,5,13,3,0,10,3
34866,4,4,1,0,3,1
24110,10,1,1,0,0,1
24110,8,3,2,0,1,2
24110,7,2,1,0,1,1
24110,6,7,1,0,6,1
24110,5,6,2,0,4,2
24110,4,2,1,0,1,1
24110,3,8,5,0,3,5
24110,2,2,1,0,1,1
24110,1,5,2,0,3,2
113456,10,1,1,0,0,1
113456,8,6,1,0,5,1
113456,7,5,3,0,2,3
113456,6,17,3,0,14,3
209659,10,11,1,0,10,1
209659,9,4,1,0,3,1
209659,8,13,2,0,11,2
209659,7,7,1,0,6,1
18870,8,6,1,0,5,1
18870,7,11,3,0,8,3
18870,6,11,4,0,7,4
18870,5,7,1,0,6,1
175230,10,4,4,0,0,4
175230,9,5,1,0,4,1
175230,8,11,1,0,10,1
175230,7,8,3,0,5,3
175230,6,5,3,0,2,3
175230,5,3,2,0,1,2
177750,7,5,1,0,4,1
177750,6,12,1,0,11,1
177750,5,6,1,1,5,0
177750,4,3,1,0,2,1
177750,3,2,1,0,1,1
177750,2,3,1,1,2,0
12856,10,2,1,0,1,1
12856,9,1,1,0,0,1
12856,8,5,1,0,4,1
12856,7,7,3,0,4,3
12856,6,8,5,0,3,5
12856,5,8,4,0,4,4
8746,8,4,2,0,2,2
8746,7,7,2,0,5,2
8746,6,7,2,0,5,2
8746,5,5,3,0,2,3
8746,4,5,3,0,2,3
8746,3,1,1,0,0,1
8746,2,2,2,0,0,2
37847,7,6,1,0,5,1
37847,6,2,1,0,1,1
37847,5,7,3,0,4,3
37847,4,13,5,0,8,5
37847,3,5,2,0,3,2
37847,2,2,1,0,1,1
3205,6,12,2,0,10,2
3205,5,8,2,0,6,2
3205,1,1,1,0,0,1
17146,8,9,3,0,6,3
17146,7,16,3,0,13,3
17146,6,7,3,0,4,3
17146,5,1,1,0,0,1
17146,3,1,1,0,0,1
914,8,2,1,0,1,1
914,6,17,7,0,10,7
914,5,7,4,0,3,4
914,4,3,2,0,1,2
914,3,4,4,0,0,4
914,2,2,1,0,1,1
914,1,2,1,0,1,1
25223,10,2,1,0,1,1
25223,9,1,1,0,0,1
25223,7,6,3,0,3,3
25223,6,15,5,0,10,5
9016,8,2,1,0,1,1
9016,6,14,4,0,10,4
9016,5,10,2,0,8,2
9016,4,5,2,0,3,2
9016,3,2,1,0,1,1
9016,2,1,1,0,0,1
198060,10,1,1,0,0,1
198060,9,6,2,0,4,2
198060,8,4,2,0,2,2
198060,7,7,2,0,5,2
198060,4,2,1,0,1,1
59309,8,7,3,0,4,3
59309,7,10,1,0,9,1
59309,6,9,1,0,8,1
59309,5,5,1,0,4,1
59309,4,1,1,0,0,1
183481,6,11,1,0,10,1
183481,4,4,2,0,2,2
183481,3,1,1,0,0,1
183481,2,2,1,0,1,1
183481,1,2,1,0,1,1
229369,10,1,1,0,0,1
229369,9,2,2,0,0,2
229369,8,5,1,0,4,1
229369,4,2,1,0,1,1
164542,8,2,1,0,1,1
164542,7,8,1,0,7,1
164542,6,14,3,0,11,3
164542,5,5,1,0,4,1
164542,2,1,1,0,0,1
164542,1,3,1,0,2,1
203661,10,1,1,0,0,1
203661,7,4,2,0,2,2
203661,6,10,1,0,9,1
203661,5,10,1,0,9,1
203661,4,4,3,0,1,3
203661,2,1,1,0,0,1
3918,9,1,1,0,0,1
3918,7,7,3,0,4,3
3918,6,11,6,0,5,6
3918,5,6,1,0,5,1
3918,4,5,2,0,3,2
3918,3,2,1,0,1,1
3918,2,1,1,0,0,1
271896,10,9,1,0,8,1
271896,9,8,2,0,6,2
271896,8,8,3,0,5,3
271896,7,3,1,0,2,1
271896,5,3,1,0,2,1
15009,6,13,7,0,6,7
15009,5,7,1,0,6,1
3946,8,2,1,0,1,1
3946,7,9,2,0,7,2
3946,6,7,4,0,3,4
3946,5,11,3,0,8,3
17649,9,1,1,0,0,1
17649,8,11,5,0,6,5
17649,7,11,2,0,9,2
34310,7,4,2,0,2,2
34310,6,13,1,0,12,1
34310,5,6,3,0,3,3
34310,4,3,1,0,2,1
34310,3,2,2,0,0,2
256960,10,8,4,2,4,2
256960,9,10,3,0,7,3
256960,8,11,2,0,9,2
256960,7,5,1,0,4,1
198517,10,8,2,0,6,2
198517,9,11,6,0,5,6
198517,8,10,1,0,9,1
198517,7,5,1,0,4,1
229640,8,10,1,0,9,1
229640,6,12,1,0,11,1
159570,7,4,1,0,3,1
159570,6,13,5,0,8,5
159570,5,6,2,0,4,2
159570,3,1,1,0,0,1
6990,9,2,2,0,0,2
6990,5,9,3,0,6,3
6990,4,7,1,0,6,1
6990,3,6,4,0,2,4
6990,2,2,1,0,1,1
14374,7,3,1,0,2,1
14374,6,13,1,0,12,1
14374,5,8,4,0,4,4
14374,4,6,3,0,3,3
14374,3,4,2,0,2,2
103640,7,5,2,0,3,2
103640,6,11,2,0,9,2
103640,5,8,1,0,7,1
103640,2,1,1,0,0,1
10971,10,3,2,0,1,2
10971,9,2,1,0,1,1
10971,8,17,9,0,8,9
10971,7,7,2,0,5,2
10971,5,4,1,0,3,1
10971,4,1,1,0,0,1
819,8,6,3,0,3,3
819,7,5,1,0,4,1
819,6,15,6,0,9,6
819,5,5,1,0,4,1
819,4,1,1,0,0,1
819,3,2,2,0,0,2
231196,6,10,4,0,6,4
231196,4,3,2,0,1,2
231196,2,1,1,0,0,1
8046,10,3,2,0,1,2
8046,9,2,1,0,1,1
8046,8,7,4,0,3,4
8046,7,12,5,0,7,5
8046,6,6,2,0,4,2
8046,5,4,3,0,1,3
193131,8,10,2,0,8,2
193131,7,8,2,0,6,2
193131,5,2,1,0,1,1
15112,9,4,2,0,2,2
15112,8,3,2,0,1,2
15112,7,6,3,0,3,3
15112,6,4,1,0,3,1
15112,5,9,1,0,8,1
15112,4,5,1,0,4,1
15112,3,3,3,0,0,3
131684,8,2,1,0,1,1
131684,7,4,2,0,2,2
131684,6,13,1,0,12,1
131684,5,6,2,0,4,2
131684,4,6,1,0,5,1
131684,3,3,3,0,0,3
22299,10,3,1,0,2,1
22299,8,4,1,0,3,1
22299,7,7,2,0,5,2
22299,6,13,4,0,9,4
22299,5,5,1,0,4,1
22299,4,3,2,0,1,2
22299,3,1,1,0,0,1
6684,8,1,1,0,0,1
6684,6,5,1,0,4,1
6684,5,6,3,0,3,3
6684,4,14,5,0,9,5
6684,3,6,2,0,4,2
6684,2,2,1,0,1,1
5688,8,3,1,0,2,1
5688,7,3,1,0,2,1
5688,5,10,2,0,8,2
5688,4,6,1,0,5,1
5688,3,4,2,0,2,2
220630,8,12,3,0,9,3
220630,6,7,3,0,4,3
206083,9,4,2,0,2,2
206083,8,5,1,0,4,1
206083,7,5,2,0,3,2
206083,6,7,2,0,5,2
206083,4,3,2,0,1,2
206083,2,5,2,0,3,2
118688,10,2,2,0,0,2
118688,9,9,5,0,4,5
118688,8,14,5,0,9,5
118688,7,6,1,0,5,1
1029,10,2,1,0,1,1
1029,8,9,2,0,7,2
1029,7,9,2,0,7,2
1029,6,10,1,0,9,1
1029,4,2,2,0,0,2
1029,1,1,1,0,0,1
209578,9,1,1,0,0,1
209578,8,5,3,0,2,3
209578,7,7,2,0,5,2
209578,6,9,2,0,7,2
209578,5,8,1,0,7,1
14082,9,3,1,0,2,1
14082,8,17,6,0,11,6
14082,7,6,1,0,5,1
14082,6,6,2,0,4,2
14082,5,1,1,0,0,1
160868,9,2,1,0,1,1
160868,8,8,5,1,3,4
160868,7,6,2,0,4,2
160868,6,8,3,0,5,3
160868,1,3,2,0,1,2
182915,10,4,2,0,2,2
182915,9,5,4,0,1,4
182915,8,13,9,1,4,8
182915,7,6,1,0,5,1
182915,6,4,1,0,3,1
182915,1,2,1,0,1,1
85899,9,5,2,0,3,2
85899,8,14,3,0,11,3
85899,7,10,2,0,8,2
131346,8,9,2,0,7,2
131346,6,6,2,0,4,2
152359,7,13,4,0,9,4
152359,6,11,3,0,8,3
152359,3,2,2,0,0,2
160273,6,8,1,0,7,1
160273,5,9,1,0,8,1
160273,4,4,2,0,2,2
160273,2,6,1,0,5,1
120924,7,3,1,0,2,1
120924,6,15,3,0,12,3
13716,8,3,1,0,2,1
13716,7,7,1,0,6,1
13716,6,9,6,0,3,6
13716,5,5,3,0,2,3
13716,3,5,2,0,3,2
13716,2,1,1,0,0,1
13716,1,1,1,0,0,1
41190,7,6,3,0,3,3
41190,6,7,2,0,5,2
41190,5,14,4,0,10,4
41190,3,3,1,0,2,1
5922,7,4,1,0,3,1
5922,6,17,6,0,11,6
5922,4,3,1,0,2,1
5922,3,2,2,0,0,2
5922,2,1,1,0,0,1
34933,7,4,1,0,3,1
34933,6,4,2,0,2,2
34933,5,10,4,0,6,4
34933,4,4,3,0,1,3
34933,3,6,3,0,3,3
34933,2,3,3,0,0,3
34933,1,3,1,0,2,1
136092,8,1,1,0,0,1
136092,6,10,3,0,7,3
136092,5,9,1,0,8,1
136092,4,6,3,0,3,3
136092,3,2,1,0,1,1
1983,10,5,4,0,1,4
1983,7,10,5,0,5,5
1983,6,9,7,0,2,7
1983,5,5,1,0,4,1
1983,3,3,1,0,2,1
185813,9,3,1,0,2,1
185813,8,12,6,0,6,6
185813,7,8,3,0,5,3
185813,6,9,5,0,4,5
185813,5,2,1,0,1,1
207905,7,14,2,0,12,2
35654,10,4,1,0,3,1
35654,9,7,2,0,5,2
35654,8,17,2,0,15,2
223762,9,3,1,0,2,1
223762,8,3,1,0,2,1
223762,7,6,1,0,5,1
223762,6,9,2,0,7,2
223762,1,2,1,0,1,1
223327,9,4,1,0,3,1
223327,8,13,3,0,10,3
223327,7,9,1,0,8,1
223327,6,6,1,0,5,1
223327,5,1,1,0,0,1
231972,10,11,4,0,7,4
231972,8,15,2,0,13,2
231972,7,5,2,0,3,2
69544,8,1,1,0,0,1
69544,7,4,1,0,3,1
69544,6,4,1,0,3,1
69544,5,4,1,0,3,1
69544,4,12,2,0,10,2
69544,1,5,2,0,3,2
57865,10,1,1,0,0,1
57865,9,4,1,0,3,1
57865,8,10,3,0,7,3
57865,7,6,2,0,4,2
57865,6,9,3,0,6,3
57865,5,3,2,0,1,2
2935,7,5,3,0,2,3
2935,6,9,3,0,6,3
2935,5,9,4,0,5,4
2935,4,6,2,0,4,2
8560,8,2,1,0,1,1
8560,7,5,1,0,4,1
8560,6,10,2,0,8,2
8560,4,6,1,0,5,1
8560,1,2,2,0,0,2
4426,9,2,1,0,1,1
4426,7,5,2,0,3,2
4426,6,8,2,0,6,2
4426,5,4,1,0,3,1
4426,4,5,3,0,2,3
4426,2,1,1,0,0,1
4038,7,2,1,0,1,1
4038,6,7,1,0,6,1
4038,5,5,2,0,3,2
4038,4,16,3,0,13,3
4038,3,3,2,0,1,2
7526,9,3,1,0,2,1
7526,7,9,4,0,5,4
7526,6,8,2,0,6,2
7526,5,6,1,0,5,1
7526,4,2,2,0,0,2
879,8,7,3,0,4,3
879,7,6,3,0,3,3
879,6,13,4,0,9,4
879,5,7,2,0,5,2
98475,8,6,1,0,5,1
98475,7,14,3,0,11,3
98475,6,8,2,0,6,2
98475,5,3,1,0,2,1
150623,9,2,2,0,0,2
150623,8,14,3,1,11,2
12478,9,2,1,0,1,1
12478,8,7,3,0,4,3
12478,7,7,3,0,4,3
12478,6,12,4,0,8,4
12478,5,4,3,0,1,3
1665,8,3,2,0,1,2
1665,7,7,3,0,4,3
1665,6,10,7,0,3,7
1665,5,9,4,0,5,4
1665,4,4,3,0,1,3
1665,3,1,1,0,0,1
213834,10,5,1,0,4,1
213834,8,9,4,0,5,4
213834,7,10,2,0,8,2
213834,6,5,1,0,4,1
17021,8,1,1,0,0,1
17021,7,8,3,0,5,3
17021,6,14,7,0,7,7
17021,5,7,1,0,6,1
17021,4,3,1,0,2,1
17021,3,2,1,0,1,1
7921,10,1,1,0,0,1
7921,9,1,1,0,0,1
7921,8,5,1,0,4,1
7921,7,11,7,0,4,7
7921,6,7,5,0,2,5
7921,5,7,3,0,4,3
7921,2,1,1,0,0,1
8201,8,5,2,0,3,2
8201,7,15,3,0,12,3
8201,6,9,2,0,7,2
8201,5,3,1,0,2,1
151334,8,8,2,0,6,2
151334,7,8,3,0,5,3
151334,6,10,2,0,8,2
151334,3,3,1,0,2,1
5859,9,1,1,0,0,1
5859,8,6,3,0,3,3
5859,7,5,1,0,4,1
5859,6,10,4,0,6,4
5859,5,5,1,0,4,1
5859,4,4,2,0,2,2
5859,2,2,1,0,1,1
175418,10,6,1,1,5,0
175418,7,10,1,0,9,1
175418,6,10,2,0,8,2
175418,3,3,1,0,2,1
206464,8,12,6,0,6,6
206464,7,11,6,0,5,6
206464,6,5,2,0,3,2
206464,3,1,1,0,0,1
208377,9,5,2,0,3,2
208377,8,13,1,0,12,1
208377,5,4,1,0,3,1
255175,10,5,1,1,4,0
255175,9,8,6,0,2,6
255175,8,6,1,0,5,1
255175,7,8,3,0,5,3
255175,6,8,3,0,5,3
36299,10,1,1,0,0,1
36299,8,1,1,0,0,1
36299,7,3,3,0,0,3
36299,6,10,3,0,7,3
36299,5,7,3,0,4,3
36299,4,7,3,0,4,3
36299,3,3,1,0,2,1
36299,1,2,2,0,0,2
168055,6,13,2,0,11,2
168055,5,7,3,0,4,3
168055,4,4,1,0,3,1
127317,8,3,1,0,2,1
127317,7,7,4,0,3,4
127317,6,14,8,0,6,8
127317,5,4,3,0,1,3
127317,4,6,3,0,3,3
127317,3,1,1,0,0,1
14474,9,1,1,0,0,1
14474,8,4,1,0,3,1
14474,7,9,5,0,4,5
14474,6,8,3,0,5,3
14474,5,8,3,0,5,3
14474,4,3,1,0,2,1
19381,10,1,1,0,0,1
19381,7,3,2,0,1,2
19381,6,6,3,0,3,3
19381,5,11,3,0,8,3
19381,4,6,3,0,3,3
19381,3,5,1,0,4,1
19381,2,2,1,0,1,1
151448,9,5,2,0,3,2
151448,8,9,3,0,6,3
151448,7,7,3,0,4,3
151448,3,1,1,0,0,1
151448,1,1,1,0,0,1
39087,9,1,1,0,0,1
39087,8,6,2,0,4,2
39087,7,12,7,0,5,7
39087,6,5,2,0,3,2
39087,5,4,2,0,2,2
39087,3,4,1,0,3,1
39087,1,3,2,0,1,2
163310,10,1,1,0,0,1
163310,9,2,1,0,1,1
163310,8,7,3,0,4,3
163310,7,13,4,0,9,4
163310,6,8,4,0,4,4
163310,5,3,1,0,2,1
12784,10,1,1,0,0,1
12784,6,7,2,0,5,2
12784,4,9,2,0,7,2
141594,7,4,1,0,3,1
141594,6,11,4,0,7,4
141594,5,7,2,0,5,2
141594,4,6,1,0,5,1
141594,3,3,1,0,2,1
34713,8,6,2,0,4,2
34713,7,8,2,0,6,2
34713,6,10,4,0,6,4
34713,5,4,2,0,2,2
34713,4,2,1,0,1,1
34713,1,4,2,0,2,2
26067,8,7,3,0,4,3
26067,7,11,2,0,9,2
26067,6,5,1,0,4,1
26067,4,2,1,0,1,1
7799,8,6,3,0,3,3
7799,7,9,4,0,5,4
7799,6,12,5,0,7,5
7799,4,2,1,0,1,1
7799,3,1,1,0,0,1
7799,2,1,1,0,0,1
91448,6,16,2,0,14,2
91448,5,4,1,0,3,1
91448,4,6,2,0,4,2
91448,1,2,1,0,1,1
13863,8,10,2,0,8,2
13863,7,6,1,0,5,1
13863,5,3,1,0,2,1
13863,2,2,1,0,1,1
131914,7,4,1,0,3,1
131914,6,7,2,0,5,2
131914,5,6,1,0,5,1
131914,4,7,2,0,5,2
131914,2,2,1,0,1,1
131914,1,4,1,0,3,1
27781,9,1,1,0,0,1
27781,8,2,2,0,0,2
27781,7,9,4,0,5,4
27781,6,18,6,0,12,6
27781,5,5,2,0,3,2
8353,8,10,4,0,6,4
8353,7,12,5,0,7,5
8353,6,9,2,0,7,2
227425,7,8,2,0,6,2
227425,6,15,1,0,14,1
34296,8,2,2,0,0,2
34296,7,7,2,0,5,2
34296,6,14,7,0,7,7
34296,5,5,2,0,3,2
34296,4,5,4,0,1,4
34296,3,1,1,0,0,1
219666,10,18,12,0,6,12
219666,9,9,7,0,2,7
219666,8,3,1,0,2,1
219666,7,1,1,0,0,1
219666,6,3,1,0,2,1
3329,6,11,3,0,8,3
3329,5,5,1,0,4,1
3329,4,6,1,0,5,1
3329,3,5,1,0,4,1
3329,2,3,2,0,1,2
8161,10,1,1,0,0,1
8161,9,4,2,0,2,2
8161,8,9,4,0,5,4
8161,7,10,5,0,5,5
8161,6,6,3,0,3,3
8161,5,3,1,0,2,1
8161,2,2,2,0,0,2
630,8,15,6,0,9,6
630,7,5,2,0,3,2
630,6,9,3,0,6,3
630,4,1,1,0,0,1
2782,6,4,4,0,0,4
2782,5,10,2,0,8,2
2782,4,12,4,0,8,4
2782,2,4,2,0,2,2
2782,1,2,2,0,0,2
103039,10,2,1,0,1,1
103039,9,4,2,0,2,2
103039,8,12,4,0,8,4
103039,7,8,1,0,7,1
103039,6,4,1,0,3,1
103039,5,1,1,0,0,1
103039,4,3,1,0,2,1
102750,8,2,1,0,1,1
102750,6,6,4,0,2,4
102750,5,12,3,0,9,3
102750,4,7,4,0,3,4
32264,7,2,2,0,0,2
32264,6,4,2,0,2,2
32264,4,9,1,0,8,1
197321,10,2,1,1,1,0
197321,9,6,1,0,5,1
197321,8,10,2,0,8,2
197321,7,6,2,0,4,2
197321,6,8,2,0,6,2
3920,9,3,1,0,2,1
3920,8,2,2,0,0,2
3920,7,6,1,0,5,1
3920,6,12,2,0,10,2
3920,5,7,1,0,6,1
3920,4,2,2,0,0,2
3920,3,3,1,0,2,1
139780,7,7,1,0,6,1
139780,6,12,1,0,11,1
139780,4,2,1,0,1,1
139780,3,2,1,0,1,1
120618,8,3,1,0,2,1
120618,6,15,2,0,13,2
120618,5,7,1,0,6,1
42227,8,4,1,0,3,1
42227,7,6,2,0,4,2
42227,6,14,4,0,10,4
42227,2,1,1,0,0,1
31820,6,15,9,0,6,9
31820,5,10,3,0,7,3
31820,4,1,1,0,0,1
31820,2,1,1,0,0,1
87681,9,1,1,0,0,1
87681,7,5,1,0,4,1
87681,5,9,1,0,8,1
9152,8,8,2,0,6,2
9152,7,10,2,0,8,2
9152,6,4,1,0,3,1
9152,5,6,3,0,3,3
9152,2,2,1,0,1,1
9152,1,1,1,0,0,1
165640,9,2,1,0,1,1
165640,8,9,5,1,4,4
165640,7,10,4,0,6,4
165640,5,7,2,0,5,2
165640,4,2,1,0,1,1
162571,10,4,4,1,0,3
162571,8,6,3,2,3,1
162571,6,5,3,0,2,3
162571,5,2,1,0,1,1
162571,4,6,1,0,5,1
162571,3,5,2,0,3,2
162571,2,5,2,0,3,2
40433,6,14,3,0,11,3
40433,5,5,2,0,3,2
40433,4,7,1,0,6,1
40433,2,2,1,0,1,1
114284,10,2,1,0,1,1
114284,8,5,1,0,4,1
114284,7,4,1,0,3,1
114284,5,5,2,0,3,2
245222,10,1,1,0,0,1
245222,8,8,2,0,6,2
245222,7,8,1,0,7,1
245222,6,9,1,0,8,1
245222,5,5,1,0,4,1
245222,4,1,1,0,0,1
66517,9,3,2,0,1,2
66517,8,10,7,0,3,7
66517,7,12,2,0,10,2
66517,6,7,1,0,6,1
66517,5,2,1,0,1,1
41611,10,5,1,0,4,1
41611,9,7,3,0,4,3
41611,8,8,2,0,6,2
41611,7,10,1,0,9,1
41611,3,1,1,0,0,1
20112,8,4,1,0,3,1
20112,7,12,2,0,10,2
20112,6,11,5,0,6,5
8966,10,2,1,0,1,1
8966,6,12,2,0,10,2
8966,5,8,2,0,6,2
8966,3,6,4,0,2,4
8966,2,3,1,0,2,1
27359,10,2,1,0,1,1
27359,8,11,4,0,7,4
27359,7,11,2,0,9,2
27359,6,5,2,0,3,2
27359,4,1,1,0,0,1
13879,7,5,1,0,4,1
13879,6,10,2,0,8,2
13879,5,8,1,0,7,1
13879,4,6,1,0,5,1
13879,3,3,2,0,1,2
13879,1,1,1,0,0,1
12520,8,8,3,0,5,3
12520,7,11,1,0,10,1
12520,6,10,3,0,7,3
12520,4,2,2,0,0,2
221982,10,11,1,0,10,1
221982,9,2,2,0,0,2
221982,8,6,1,0,5,1
221982,7,5,1,0,4,1
235899,8,5,1,0,4,1
235899,6,14,4,0,10,4
2306,8,2,2,0,0,2
2306,7,2,2,0,0,2
2306,6,8,2,0,6,2
2306,5,7,2,0,5,2
2306,4,6,2,0,4,2
2306,3,4,3,0,1,3
2306,2,4,3,0,1,3
8724,9,4,1,0,3,1
8724,8,11,7,0,4,7
8724,7,8,1,0,7,1
8724,6,9,3,0,6,3
215521,10,11,5,0,6,5
215521,9,7,3,0,4,3
215521,8,8,2,0,6,2
215521,2,1,1,0,0,1
215521,1,1,1,0,0,1
2378,8,2,2,0,0,2
2378,6,6,3,0,3,3
2378,5,12,1,0,11,1
2378,4,7,2,0,5,2
2378,3,7,3,0,4,3
52626,10,3,1,0,2,1
52626,6,10,1,0,9,1
52626,4,5,1,0,4,1
150216,8,4,2,0,2,2
150216,7,9,3,0,6,3
150216,6,16,3,0,13,3
150216,5,2,1,0,1,1
185769,10,3,3,0,0,3
185769,9,5,3,0,2,3
185769,8,12,2,0,10,2
185769,3,1,1,0,0,1
165584,8,5,1,0,4,1
165584,6,9,1,0,8,1
165584,4,6,1,0,5,1
165584,3,1,1,0,0,1
30838,7,10,3,0,7,3
30838,5,4,2,0,2,2
30838,4,4,1,0,3,1
20057,8,4,1,0,3,1
20057,7,9,6,0,3,6
20057,6,9,4,0,5,4
20057,5,5,1,0,4,1
20057,4,4,1,0,3,1
20057,3,3,3,0,0,3
20057,2,1,1,0,0,1
15958,7,5,1,0,4,1
15958,6,6,2,0,4,2
15958,5,8,3,0,5,3
15958,4,6,2,0,4,2
151005,6,7,1,0,6,1
151005,5,7,1,1,6,0
151005,3,7,2,0,5,2
151005,2,1,1,0,0,1
6907,9,2,1,0,1,1
6907,8,6,1,0,5,1
6907,7,10,1,0,9,1
6907,6,9,1,0,8,1
6907,5,3,1,0,2,1
6907,4,3,1,0,2,1
109786,8,8,3,0,5,3
109786,7,9,3,0,6,3
109786,6,12,6,0,6,6
109786,4,3,1,0,2,1
240175,9,2,1,0,1,1
240175,8,10,2,0,8,2
240175,6,10,1,0,9,1
240175,5,4,2,0,2,2
5137,8,4,1,0,3,1
5137,7,7,3,0,4,3
5137,6,10,2,0,8,2
5137,5,4,1,0,3,1
5137,4,6,3,0,3,3
5137,1,1,1,0,0,1
102676,8,11,4,0,7,4
102676,7,8,3,0,5,3
102676,6,8,2,0,6,2
102676,5,5,2,0,3,2
11855,8,8,5,0,3,5
11855,7,6,2,0,4,2
11855,6,8,3,0,5,3
11855,5,9,2,0,7,2
11855,4,1,1,0,0,1
11855,3,1,1,0,0,1
8544,10,1,1,0,0,1
8544,9,3,1,0,2,1
8544,8,9,4,0,5,4
8544,7,8,4,0,4,4
8544,6,11,4,0,7,4
8544,5,3,1,0,2,1
148534,5,7,2,0,5,2
148534,4,4,1,0,3,1
148534,3,2,2,0,0,2
9581,9,1,1,0,0,1
9581,6,8,1,0,7,1
9581,5,10,2,0,8,2
9581,4,5,1,0,4,1
9581,2,4,2,0,2,2
9581,1,1,1,0,0,1
218007,10,3,1,0,2,1
218007,9,6,2,0,4,2
218007,8,15,2,0,13,2
218007,7,9,3,0,6,3
218007,5,1,1,0,0,1
10345,6,12,4,0,8,4
10345,5,8,1,0,7,1
10345,4,4,1,0,3,1
10345,3,3,2,0,1,2
10345,1,2,1,0,1,1
107834,8,9,1,0,8,1
107834,7,7,2,0,5,2
107834,6,7,3,0,4,3
107834,5,5,2,0,3,2
107834,4,3,1,0,2,1
7802,9,1,1,0,0,1
7802,8,7,4,0,3,4
7802,5,6,1,0,5,1
7802,4,8,3,0,5,3
1688,9,1,1,0,0,1
1688,8,3,2,0,1,2
1688,7,12,4,0,8,4
1688,5,8,2,0,6,2
1688,4,2,1,0,1,1
220980,9,2,1,0,1,1
220980,8,9,5,0,4,5
220980,7,11,2,1,9,1
220980,6,6,1,0,5,1
220980,2,1,1,0,0,1
137354,10,4,1,0,3,1
137354,7,9,2,0,7,2
137354,6,8,2,0,6,2
137354,5,5,1,0,4,1
137354,4,5,1,0,4,1
137354,3,1,1,0,0,1
2320,7,8,1,0,7,1
2320,6,11,1,0,10,1
2320,4,3,1,0,2,1
2320,3,3,1,0,2,1
6386,6,9,1,0,8,1
6386,5,6,1,0,5,1
6386,4,10,2,0,8,2
149459,9,3,2,0,1,2
149459,8,12,3,0,9,3
149459,7,7,2,0,5,2
149459,6,6,2,0,4,2
149459,4,1,1,0,0,1
149459,2,1,1,0,0,1
51199,7,8,3,0,5,3
51199,6,7,3,0,4,3
51199,5,3,1,0,2,1
51199,3,1,1,0,0,1
21447,10,4,1,0,3,1
21447,9,5,1,0,4,1
21447,7,12,5,0,7,5
21447,6,4,3,0,1,3
21447,5,1,1,0,0,1
21447,4,3,2,0,1,2
12455,9,1,1,0,0,1
12455,8,8,4,0,4,4
12455,7,8,1,0,7,1
12455,6,11,4,0,7,4
12455,5,5,1,0,4,1
12455,4,1,1,0,0,1
153916,10,4,2,1,2,1
153916,9,5,1,0,4,1
153916,8,6,2,1,4,1
153916,7,11,1,0,10,1
153916,6,5,2,0,3,2
153916,4,2,2,1,0,1
153916,2,1,1,0,0,1
2664,7,4,2,0,2,2
2664,6,5,3,0,2,3
2664,5,13,8,0,5,8
2664,4,4,1,0,3,1
2664,3,6,1,0,5,1
2664,2,1,1,0,0,1
37741,10,10,1,0,9,1
37741,5,1,1,0,0,1
37741,4,1,1,0,0,1
27181,6,2,1,0,1,1
27181,5,2,1,0,1,1
27181,4,7,1,0,6,1
27181,3,4,3,0,1,3
27181,2,14,3,0,11,3
27181,1,6,2,0,4,2
14040,7,6,1,0,5,1
14040,6,14,1,0,13,1
14040,5,3,1,0,2,1
14040,2,1,1,0,0,1
14040,1,1,1,0,0,1
41878,8,9,5,0,4,5
41878,7,14,5,0,9,5
41878,6,7,3,0,4,3
41878,5,3,3,0,0,3
41878,4,2,1,0,1,1
132145,8,3,1,0,2,1
132145,6,7,2,0,5,2
132145,5,9,1,0,8,1
10631,8,3,2,0,1,2
10631,7,9,4,0,5,4
10631,6,12,7,0,5,7
10631,5,5,2,0,3,2
10631,4,3,2,0,1,2
10631,3,2,1,0,1,1
226237,10,18,7,0,11,7
226237,9,7,1,0,6,1
226237,8,8,3,0,5,3
12054,10,5,4,0,1,4
12054,9,12,4,0,8,4
12054,8,10,4,0,6,4
12054,7,5,2,0,3,2
256708,10,26,6,1,20,5
256708,9,5,3,0,2,3
128910,7,12,3,0,9,3
128910,6,12,6,0,6,6
128910,5,7,1,0,6,1
128910,3,3,1,0,2,1
207335,10,6,3,0,3,3
207335,8,6,4,0,2,4
19001,7,2,1,0,1,1
19001,6,2,1,0,1,1
19001,4,8,2,0,6,2
19001,3,7,2,0,5,2
19001,2,6,3,0,3,3
19001,1,6,5,0,1,5
5216,8,4,1,0,3,1
5216,7,8,3,0,5,3
5216,6,9,3,0,6,3
5216,4,1,1,0,0,1
5216,3,3,1,0,2,1
144412,10,5,3,0,2,3
144412,9,3,1,0,2,1
144412,7,7,3,0,4,3
144412,5,2,1,0,1,1
202674,8,6,4,0,2,4
202674,7,9,4,0,5,4
202674,6,11,1,0,10,1
202674,4,6,2,0,4,2
11112,10,2,1,0,1,1
11112,8,2,1,0,1,1
11112,6,12,2,0,10,2
11112,5,9,1,0,8,1
11112,4,3,1,0,2,1
11112,1,2,1,0,1,1
328,7,4,3,0,1,3
328,5,9,2,0,7,2
328,4,3,2,0,1,2
328,3,3,3,0,0,3
328,2,3,1,0,2,1
328,1,2,1,0,1,1
66197,7,11,1,0,10,1
66197,6,7,2,0,5,2
66197,5,5,1,0,4,1
66197,4,3,1,0,2,1
5863,7,8,3,0,5,3
5863,6,9,5,0,4,5
5863,5,7,3,0,4,3
5863,4,7,1,0,6,1
5863,3,2,2,0,0,2
5863,1,1,1,0,0,1
12496,9,1,1,0,0,1
12496,7,8,2,0,6,2
12496,6,11,4,0,7,4
12496,5,7,3,0,4,3
12496,4,3,2,0,1,2
12496,3,2,1,0,1,1
7140,8,3,1,0,2,1
7140,7,7,2,0,5,2
7140,3,2,1,0,1,1
182540,8,3,1,0,2,1
182540,7,8,2,0,6,2
182540,5,7,2,0,5,2
26244,9,2,2,0,0,2
26244,7,3,1,0,2,1
26244,6,16,1,0,15,1
26244,4,1,1,0,0,1
26244,2,1,1,0,0,1
180746,9,2,2,0,0,2
180746,6,4,2,0,2,2
180746,4,3,1,0,2,1
180746,1,3,3,0,0,3
37059,8,4,4,0,0,4
37059,7,11,7,0,4,7
37059,6,12,9,0,3,9
37059,5,4,3,0,1,3
37059,4,3,1,0,2,1
37059,1,1,1,0,0,1
76994,8,10,5,0,5,5
76994,7,12,6,0,6,6
76994,6,8,4,0,4,4
76994,5,3,3,0,0,3
179304,8,5,1,0,4,1
179304,7,7,1,0,6,1
179304,6,11,2,1,9,1
179304,5,2,1,0,1,1
31361,10,2,1,0,1,1
31361,7,1,1,0,0,1
31361,6,16,6,0,10,6
31361,5,7,4,0,3,4
31361,4,6,3,0,3,3
31361,3,2,1,0,1,1
31361,2,1,1,0,0,1
16332,8,11,4,0,7,4
16332,7,11,2,0,9,2
16332,4,3,2,0,1,2
22427,10,4,3,0,1,3
22427,9,1,1,0,0,1
22427,8,6,3,0,3,3
22427,7,3,1,0,2,1
22427,6,13,6,0,7,6
22427,5,3,2,0,1,2
22427,4,5,2,0,3,2
191999,7,8,2,0,6,2
191999,6,15,3,0,12,3
191999,5,4,2,0,2,2
191999,3,1,1,0,0,1
4625,9,1,1,0,0,1
4625,7,8,1,0,7,1
4625,6,13,4,0,9,4
4625,5,7,1,0,6,1
4625,4,2,1,0,1,1
4625,1,1,1,0,0,1
3649,8,2,1,0,1,1
3649,7,7,3,0,4,3
3649,6,11,5,0,6,5
3649,3,2,1,0,1,1
3649,2,1,1,0,0,1
153168,8,4,1,0,3,1
153168,7,5,1,0,4,1
153168,6,11,1,0,10,1
153168,5,8,1,0,7,1
153168,4,3,1,0,2,1
153168,2,1,1,0,0,1
17298,8,3,3,0,0,3
17298,7,7,1,0,6,1
17298,6,13,8,0,5,8
17298,5,11,2,0,9,2
182409,10,2,1,0,1,1
182409,9,4,2,0,2,2
182409,8,8,5,0,3,5
182409,7,9,1,0,8,1
182409,6,6,2,0,4,2
182409,5,3,2,0,1,2
182409,4,1,1,0,0,1
182409,3,1,1,0,0,1
2558,7,12,3,0,9,3
2558,6,8,1,0,7,1
2558,5,7,3,0,4,3
2558,4,5,2,0,3,2
2558,2,1,1,0,0,1
25627,10,4,2,0,2,2
25627,9,7,2,1,5,1
25627,8,9,5,0,4,5
25627,7,9,6,0,3,6
25627,6,5,3,0,2,3
25627,5,1,1,0,0,1
11320,7,6,1,0,5,1
11320,6,5,2,0,3,2
2497,6,9,1,0,8,1
2497,5,11,2,0,9,2
2497,4,7,2,0,5,2
2497,3,3,1,0,2,1
2497,2,4,3,0,1,3
75644,10,3,1,0,2,1
75644,9,7,1,0,6,1
75644,8,14,7,0,7,7
75644,7,6,2,0,4,2
75644,6,2,1,0,1,1
75644,4,2,1,0,1,1
27007,8,6,4,0,2,4
27007,7,12,6,0,6,6
27007,6,8,3,0,5,3
27007,3,1,1,0,0,1
27007,2,2,2,0,0,2
34890,8,5,1,0,4,1
34890,7,17,7,0,10,7
34890,6,9,4,0,5,4
34890,5,3,1,0,2,1
18828,6,11,2,0,9,2
18828,5,7,2,0,5,2
18828,4,4,3,0,1,3
18828,3,4,1,0,3,1
18828,2,3,1,0,2,1
18828,1,3,1,0,2,1
126749,7,5,1,0,4,1
126749,6,14,2,0,12,2
126749,5,5,2,0,3,2
126749,4,4,1,0,3,1
126749,3,4,1,0,3,1
70222,10,5,2,0,3,2
70222,9,4,3,0,1,3
70222,8,9,2,0,7,2
70222,7,12,1,0,11,1
70222,6,5,1,0,4,1
37370,9,4,2,0,2,2
37370,8,5,2,0,3,2
37370,7,15,5,0,10,5
37370,6,6,4,0,2,4
37370,5,3,2,0,1,2
37370,4,1,1,0,0,1
225653,8,5,1,0,4,1
225653,6,5,1,0,4,1
17836,10,2,1,0,1,1
17836,9,1,1,0,0,1
17836,7,10,3,0,7,3
38860,8,5,2,0,3,2
38860,7,3,1,0,2,1
38860,6,6,1,0,5,1
38860,5,4,2,0,2,2
38860,4,4,3,0,1,3
38860,3,6,2,0,4,2
38860,2,1,1,0,0,1
38860,1,6,4,0,2,4
170390,10,2,1,0,1,1
170390,9,4,2,0,2,2
170390,8,15,7,0,8,7
170390,7,9,1,0,8,1
170390,6,5,2,0,3,2
256334,10,5,3,0,2,3
256334,9,6,2,0,4,2
256334,8,11,4,0,7,4
256334,7,1,1,0,0,1
256334,6,7,4,1,3,3
164201,8,6,1,0,5,1
164201,7,12,2,0,10,2
16455,9,5,2,0,3,2
16455,8,15,5,0,10,5
16455,7,8,2,0,6,2
16455,6,4,1,0,3,1
16455,5,2,1,0,1,1
224979,10,5,3,0,2,3
224979,9,2,1,0,1,1
224979,8,9,3,0,6,3
224979,7,9,1,0,8,1
224979,5,3,2,0,1,2
131477,8,2,1,0,1,1
131477,7,6,3,0,3,3
131477,6,10,2,0,8,2
131477,5,9,5,0,4,5
131477,4,3,1,0,2,1
131477,3,3,1,0,2,1
240423,9,2,1,0,1,1
240423,6,8,2,0,6,2
240423,4,5,1,0,4,1
13818,7,8,1,0,7,1
13818,6,8,4,0,4,4
13818,4,3,2,0,1,2
146747,10,2,2,0,0,2
146747,8,3,1,0,2,1
146747,7,15,1,0,14,1
187673,7,8,1,0,7,1
187673,6,7,1,0,6,1
187673,4,4,2,0,2,2
187673,2,1,1,0,0,1
9094,7,3,1,0,2,1
9094,6,18,6,0,12,6
9094,4,5,1,0,4,1
31585,7,5,1,0,4,1
31585,5,8,1,0,7,1
150530,8,5,1,0,4,1
150530,6,14,2,0,12,2
150530,4,4,1,0,3,1
48867,9,1,1,0,0,1
48867,7,6,1,0,5,1
48867,6,11,4,0,7,4
48867,5,6,2,0,4,2
129668,8,13,3,0,10,3
129668,7,12,5,0,7,5
129668,6,7,2,0,5,2
129668,4,1,1,0,0,1
26157,8,1,1,0,0,1
26157,7,10,3,0,7,3
26157,5,8,1,0,7,1
3892,9,2,1,0,1,1
3892,8,11,6,0,5,6
3892,7,12,4,0,8,4
3892,6,5,1,0,4,1
20139,10,1,1,0,0,1
20139,7,2,1,0,1,1
20139,6,10,5,0,5,5
20139,4,8,1,0,7,1
20139,3,4,2,0,2,2
2657,8,3,2,0,1,2
2657,6,16,7,0,9,7
2657,5,8,2,0,6,2
32601,7,2,1,0,1,1
32601,3,5,2,0,3,2
32601,2,5,3,0,2,3
32601,1,2,1,0,1,1
9083,9,1,1,0,0,1
9083,7,6,2,0,4,2
9083,6,9,5,0,4,5
9083,5,7,1,0,6,1
9083,3,4,2,0,2,2
9083,2,2,1,0,1,1
190064,8,3,1,0,2,1
190064,6,18,3,0,15,3
67630,7,3,1,0,2,1
67630,6,7,4,0,3,4
67630,5,10,2,0,8,2
67630,4,6,3,0,3,3
67630,3,2,1,0,1,1
67630,2,4,2,0,2,2
67630,1,1,1,0,0,1
224122,9,3,2,0,1,2
224122,8,6,1,0,5,1
224122,7,5,1,0,4,1
224122,6,12,1,0,11,1
224122,5,6,1,0,5,1
224122,3,1,1,0,0,1
6675,8,3,3,0,0,3
6675,7,2,2,0,0,2
6675,6,11,9,0,2,9
6675,5,7,3,0,4,3
6675,4,8,5,0,3,5
6675,3,1,1,0,0,1
6675,2,2,1,0,1,1
166183,8,8,5,1,3,4
166183,7,8,1,0,7,1
166183,6,7,2,0,5,2
166183,4,6,2,0,4,2
131444,8,2,1,0,1,1
131444,7,12,1,0,11,1
131444,6,14,5,0,9,5
131444,5,4,1,0,3,1
131444,4,3,1,0,2,1
133246,9,4,1,0,3,1
133246,8,2,1,0,1,1
133246,7,6,1,0,5,1
133246,6,7,1,0,6,1
133246,4,1,1,0,0,1
133246,3,4,1,0,3,1
133246,2,3,1,0,2,1
1191,6,5,2,0,3,2
1191,5,11,1,0,10,1
1191,4,10,3,0,7,3
1191,3,2,1,0,1,1
1191,2,3,1,0,2,1
1191,1,2,1,0,1,1
8740,10,3,1,0,2,1
8740,8,4,1,0,3,1
8740,7,7,3,0,4,3
8740,6,8,3,0,5,3
8740,2,2,1,0,1,1
165711,5,9,1,0,8,1
165711,3,8,1,0,7,1
166371,10,2,1,0,1,1
166371,8,2,1,0,1,1
166371,6,11,6,2,5,4
166371,5,4,3,0,1,3
166371,4,5,2,0,3,2
201502,5,8,1,0,7,1
201502,2,4,1,0,3,1
81588,10,1,1,0,0,1
81588,9,6,3,0,3,3
81588,8,16,7,0,9,7
81588,7,2,1,0,1,1
81588,6,3,2,0,1,2
81588,5,4,3,0,1,3
81588,4,2,1,0,1,1
81588,1,1,1,0,0,1
3629,7,3,3,0,0,3
3629,6,13,3,0,10,3
3629,5,1,1,0,0,1
3629,4,10,7,0,3,7
3629,3,4,1,0,3,1
3629,2,4,3,0,1,3
184337,8,4,2,0,2,2
184337,7,6,2,0,4,2
184337,6,12,1,0,11,1
184337,5,5,1,0,4,1
184337,4,4,1,0,3,1
236332,10,28,12,0,16,12
236332,9,2,1,0,1,1
236332,8,2,1,0,1,1
236332,5,1,1,0,0,1
9816,9,1,1,0,0,1
9816,8,1,1,0,0,1
9816,7,5,1,0,4,1
9816,6,10,3,0,7,3
9816,5,7,2,0,5,2
9816,4,7,3,0,4,3
9816,2,2,1,0,1,1
113332,9,1,1,0,0,1
113332,7,6,1,0,5,1
113332,6,9,4,0,5,4
113332,5,6,1,0,5,1
113332,3,4,2,0,2,2
232210,9,4,1,0,3,1
232210,8,16,2,0,14,2
232210,6,4,1,0,3,1
232210,2,1,1,0,0,1
5618,10,12,11,0,1,11
5618,9,9,5,0,4,5
5618,8,6,4,0,2,4
5618,7,5,2,0,3,2
165828,8,6,1,0,5,1
165828,7,4,1,0,3,1
165828,4,2,1,0,1,1
165828,3,5,2,0,3,2
165828,1,1,1,0,0,1
1427,8,1,1,0,0,1
1427,7,7,5,0,2,5
1427,6,16,7,0,9,7
1427,5,8,1,0,7,1
7683,8,6,2,0,4,2
7683,5,4,1,0,3,1
33541,9,7,3,0,4,3
33541,8,15,2,0,13,2
33541,7,7,1,0,6,1
33541,6,2,2,0,0,2
33541,4,1,1,0,0,1
136265,9,1,1,0,0,1
136265,7,6,3,0,3,3
136265,6,13,4,0,9,4
136265,5,7,3,0,4,3
136265,3,3,1,0,2,1
165651,6,10,1,0,9,1
23605,10,3,1,0,2,1
23605,8,7,2,0,5,2
23605,7,10,2,0,8,2
23605,6,9,1,0,8,1
23605,4,1,1,0,0,1
20240,8,6,5,0,1,5
20240,7,10,3,0,7,3
20240,6,10,7,0,3,7
20240,5,7,7,0,0,7
20240,4,2,1,0,1,1
4627,7,2,2,0,0,2
4627,6,8,1,0,7,1
4627,5,4,1,0,3,1
4627,3,7,5,0,2,5
4627,2,4,2,0,2,2
4627,1,4,3,0,1,3
38763,9,2,1,0,1,1
38763,8,12,4,0,8,4
38763,7,4,1,0,3,1
38763,6,8,5,0,3,5
38763,5,1,1,0,0,1
38763,1,2,2,0,0,2
17195,9,2,1,0,1,1
17195,7,3,1,0,2,1
17195,6,12,4,0,8,4
17195,5,5,3,0,2,3
17195,4,5,4,0,1,4
17195,3,1,1,0,0,1
17195,1,1,1,0,0,1
148211,10,3,1,0,2,1
148211,8,2,1,0,1,1
148211,7,3,1,0,2,1
148211,6,12,1,0,11,1
148211,4,6,2,0,4,2
148211,1,4,2,0,2,2
11433,8,9,2,0,7,2
11433,7,12,1,0,11,1
11433,6,7,1,0,6,1
192320,10,6,1,0,5,1
192320,8,5,1,0,4,1
192320,7,9,1,0,8,1
192320,3,1,1,0,0,1
185244,10,3,1,0,2,1
185244,9,3,1,0,2,1
185244,8,2,1,0,1,1
185244,7,7,2,0,5,2
185244,6,14,6,0,8,6
185244,5,3,1,0,2,1
123495,8,1,1,0,0,1
123495,7,8,2,0,6,2
123495,6,10,1,0,9,1
123495,5,7,1,0,6,1
123495,4,4,2,0,2,2
123495,3,2,1,0,1,1
183472,4,5,1,0,4,1
183472,2,5,1,0,4,1
183472,1,3,2,0,1,2
171540,7,3,1,0,2,1
171540,6,12,2,0,10,2
171540,5,6,2,0,4,2
171540,1,1,1,0,0,1
48154,8,4,2,0,2,2
48154,7,4,1,0,3,1
48154,6,10,5,0,5,5
48154,4,7,3,0,4,3
7762,7,5,1,0,4,1
7762,6,13,2,0,11,2
7762,5,8,3,0,5,3
7762,3,2,1,0,1,1
7762,1,1,1,0,0,1
180339,8,6,3,0,3,3
180339,7,9,3,0,6,3
180339,6,10,2,0,8,2
180339,5,4,1,0,3,1
180339,4,2,1,0,1,1
32324,7,6,2,0,4,2
32324,6,8,3,0,5,3
32324,5,11,2,0,9,2
32324,4,3,1,0,2,1
32324,3,2,1,0,1,1
6231,7,3,1,0,2,1
6231,6,4,1,0,3,1
6231,5,4,2,0,2,2
6231,4,2,1,0,1,1
6231,3,10,6,0,4,6
6231,2,4,2,0,2,2
6231,1,7,4,0,3,4
203238,10,1,1,0,0,1
203238,9,3,3,0,0,3
203238,8,8,3,0,5,3
203238,7,11,3,0,8,3
203238,6,5,2,0,3,2
203238,5,4,1,0,3,1
203238,4,2,1,0,1,1
154274,8,11,1,0,10,1
154274,6,8,1,0,7,1
154274,5,1,1,0,0,1
164091,8,6,1,0,5,1
164091,7,14,3,0,11,3
216695,6,12,3,0,9,3
216695,4,6,1,0,5,1
66533,7,12,5,0,7,5
66533,6,7,2,0,5,2
66533,5,3,2,0,1,2
66533,4,2,2,0,0,2
66533,3,2,1,0,1,1
66533,2,1,1,0,0,1
5743,9,3,1,0,2,1
5743,8,4,2,0,2,2
5743,7,8,1,0,7,1
5743,6,14,1,0,13,1
5743,4,2,1,0,1,1
6880,6,7,4,0,3,4
6880,5,5,2,0,3,2
6880,4,2,1,0,1,1
6880,1,16,6,0,10,6
2341,9,3,1,0,2,1
2341,8,6,1,0,5,1
2341,7,9,4,0,5,4
2341,6,9,4,0,5,4
2341,5,3,1,0,2,1
2341,4,2,2,0,0,2
15852,8,2,1,0,1,1
15852,5,6,1,0,5,1
15852,4,7,3,0,4,3
15852,3,8,3,0,5,3
15852,2,3,1,0,2,1
15852,1,5,3,0,2,3
10537,10,1,1,0,0,1
10537,6,11,3,0,8,3
10537,5,8,2,0,6,2
10537,4,3,2,0,1,2
10537,3,4,1,0,3,1
10537,2,2,1,0,1,1
131448,7,6,2,0,4,2
131448,6,15,2,0,13,2
131448,4,6,1,0,5,1
228310,8,5,3,0,2,3
228310,7,8,1,0,7,1
228310,6,14,2,0,12,2
9989,7,6,2,0,4,2
9989,6,14,4,0,10,4
9989,5,6,1,0,5,1
9989,3,2,2,0,0,2
202723,8,12,5,0,7,5
202723,7,6,3,0,3,3
202723,6,7,2,0,5,2
202723,5,2,1,0,1,1
34065,8,5,2,0,3,2
34065,7,7,2,0,5,2
34065,6,10,2,0,8,2
34065,5,7,2,0,5,2
34065,4,2,2,0,0,2
34065,3,3,2,0,1,2
220440,8,5,2,0,3,2
220440,7,7,3,0,4,3
220440,5,6,1,0,5,1
220440,4,5,3,0,2,3
220440,3,4,2,0,2,2
220440,2,3,1,0,2,1
122961,9,6,2,0,4,2
122961,8,10,3,0,7,3
122961,7,10,5,0,5,5
122961,6,4,2,0,2,2
99881,7,9,2,0,7,2
99881,4,5,1,0,4,1
37997,10,4,1,0,3,1
37997,9,3,1,0,2,1
37997,8,9,5,0,4,5
37997,7,4,1,0,3,1
37997,6,6,1,0,5,1
37997,3,1,1,0,0,1
188204,6,12,3,0,9,3
188204,4,8,3,0,5,3
21716,10,1,1,0,0,1
21716,8,6,2,0,4,2
21716,7,3,1,0,2,1
21716,6,13,3,0,10,3
21716,5,3,2,0,1,2
21716,2,2,1,0,1,1
261838,10,14,6,0,8,6
261838,9,9,5,1,4,4
261838,8,8,5,0,3,5
261838,7,3,3,0,0,3
5794,8,2,2,0,0,2
5794,7,4,1,0,3,1
5794,6,3,1,0,2,1
5794,5,7,7,0,0,7
5794,4,11,3,0,8,3
5794,3,4,1,0,3,1
5794,1,1,1,0,0,1
196220,10,22,12,1,10,11
196220,9,4,3,0,1,3
196220,8,1,1,0,0,1
196220,6,2,1,0,1,1
196220,5,3,2,0,1,2
114228,9,1,1,0,0,1
114228,7,4,2,0,2,2
114228,6,9,1,0,8,1
114228,5,11,3,0,8,3
114228,4,3,1,0,2,1
18600,10,9,4,0,5,4
18600,9,8,3,0,5,3
18600,8,5,2,0,3,2
18600,7,4,1,0,3,1
18600,6,4,2,0,2,2
18600,1,2,1,0,1,1
1975,7,6,1,0,5,1
1975,5,11,3,0,8,3
151215,7,12,1,0,11,1
151215,6,11,2,0,9,2
151215,5,8,2,0,6,2
238510,10,2,1,0,1,1
238510,9,3,1,0,2,1
238510,8,3,1,0,2,1
238510,7,6,3,0,3,3
238510,6,12,2,0,10,2
153496,4,5,1,0,4,1
153496,3,4,1,0,3,1
133104,8,3,1,0,2,1
133104,7,6,1,0,5,1
133104,5,7,1,0,6,1
9843,8,3,1,0,2,1
9843,7,11,1,0,10,1
9843,6,13,2,0,11,2
9843,4,1,1,0,0,1
1343,8,3,2,0,1,2
1343,7,8,5,0,3,5
1343,6,9,2,0,7,2
1343,5,6,2,0,4,2
1343,4,6,3,0,3,3
3198,9,3,2,0,1,2
3198,8,2,1,0,1,1
3198,7,9,1,0,8,1
3198,4,4,1,0,3,1
13989,6,6,1,0,5,1
13989,5,9,2,0,7,2
13989,4,8,1,0,7,1
13989,3,3,1,0,2,1
13989,1,1,1,0,0,1
226757,10,5,1,0,4,1
226757,6,7,1,0,6,1
226757,4,4,1,0,3,1
226757,3,4,1,0,3,1
7931,8,7,5,0,2,5
7931,7,10,4,0,6,4
7931,5,4,1,0,3,1
30164,10,1,1,0,0,1
30164,8,3,1,0,2,1
30164,7,10,3,0,7,3
30164,6,6,1,0,5,1
30164,5,8,4,0,4,4
30164,4,3,2,0,1,2
30164,3,2,1,0,1,1
133886,7,8,2,1,6,1
133886,6,11,4,0,7,4
133886,5,7,2,0,5,2
133886,4,3,1,0,2,1
133886,3,2,2,0,0,2
173121,9,2,1,0,1,1
173121,6,5,1,0,4,1
173121,5,4,2,0,2,2
73251,7,11,3,0,8,3
73251,6,10,4,0,6,4
73251,5,2,1,0,1,1
73251,4,4,3,0,1,3
73251,3,2,2,0,0,2
253568,8,7,1,0,6,1
253568,7,10,1,0,9,1
253568,6,9,2,0,7,2
253568,5,3,1,0,2,1
253568,3,3,2,0,1,2
30111,9,4,1,0,3,1
30111,8,7,2,0,5,2
30111,7,5,2,0,3,2
30111,6,11,3,0,8,3
30111,5,5,1,0,4,1
30111,3,1,1,0,0,1
203401,6,7,2,0,5,2
203401,5,5,1,0,4,1
203401,4,6,1,0,5,1
203401,3,3,1,0,2,1
19498,8,4,1,0,3,1
19498,6,11,3,0,8,3
19498,5,6,2,0,4,2
128001,8,3,2,0,1,2
128001,6,9,1,0,8,1
128001,5,8,2,0,6,2
128001,4,7,1,0,6,1
27982,7,7,2,0,5,2
27982,6,10,3,0,7,3
27982,5,7,1,0,6,1
27982,4,7,2,0,5,2
92186,8,13,5,0,8,5
92186,7,7,2,0,5,2
92186,6,6,4,0,2,4
92186,5,4,2,0,2,2
92186,3,1,1,0,0,1
91513,7,7,2,0,5,2
91513,6,12,6,0,6,6
91513,5,6,2,0,4,2
91513,3,2,1,0,1,1
203560,10,8,4,0,4,4
203560,9,9,2,0,7,2
203560,8,13,3,0,10,3
203560,7,1,1,0,0,1
203560,6,2,1,0,1,1
174943,10,4,2,0,2,2
174943,5,5,1,0,4,1
174943,4,2,1,0,1,1
141107,6,13,1,0,12,1
32444,8,2,1,0,1,1
32444,7,3,2,0,1,2
32444,6,11,2,0,9,2
32444,5,7,2,0,5,2
32444,4,8,5,0,3,5
32444,3,3,1,0,2,1
157053,10,5,3,1,2,2
157053,8,6,2,1,4,1
157053,7,15,5,2,10,3
157053,6,5,3,0,2,3
13031,8,7,5,0,2,5
13031,7,4,1,0,3,1
13031,6,10,6,0,4,6
13031,5,9,4,0,5,4
13031,4,1,1,0,0,1
13031,3,3,1,0,2,1
203710,10,8,5,0,3,5
203710,9,8,1,0,7,1
203710,8,4,3,0,1,3
203710,7,7,1,0,6,1
203710,6,5,2,0,3,2
23389,7,7,2,0,5,2
23389,6,12,4,0,8,4
23389,5,7,1,0,6,1
23389,4,4,2,0,2,2
142981,8,5,4,0,1,4
142981,7,12,6,0,6,6
142981,6,13,4,0,9,4
142981,3,1,1,0,0,1
142981,2,1,1,0,0,1
220258,10,3,2,0,1,2
220258,9,5,2,0,3,2
220258,8,13,3,0,10,3
220258,7,9,1,1,8,0
20610,9,6,2,0,4,2
20610,8,7,4,0,3,4
20610,7,5,4,0,1,4
20610,6,9,5,0,4,5
20610,4,4,2,0,2,2
141681,8,3,2,0,1,2
141681,7,10,4,0,6,4
141681,6,11,4,0,7,4
141681,5,7,1,0,6,1
141681,4,2,1,0,1,1
16746,7,5,2,0,3,2
16746,6,8,1,0,7,1
16746,5,9,3,0,6,3
16746,4,2,1,0,1,1
16746,3,4,1,0,3,1
28253,9,2,1,0,1,1
28253,8,7,3,0,4,3
28253,7,7,5,0,2,5
28253,6,9,1,0,8,1
28253,5,7,1,0,6,1
11116,8,2,1,0,1,1
11116,7,6,5,0,1,5
11116,6,13,2,0,11,2
11116,5,7,1,0,6,1
11116,4,3,2,0,1,2
11116,3,2,1,0,1,1
122873,8,2,1,0,1,1
122873,5,7,2,0,5,2
122873,3,4,1,0,3,1
194075,9,1,1,0,0,1
194075,7,6,1,0,5,1
194075,6,9,2,0,7,2
194075,5,7,1,0,6,1
194075,3,4,1,0,3,1
4010,10,2,1,0,1,1
4010,9,2,1,0,1,1
4010,8,12,4,0,8,4
4010,7,5,2,0,3,2
4010,6,4,3,0,1,3
4010,3,2,1,0,1,1
4010,2,1,1,0,0,1
102346,10,2,1,0,1,1
102346,8,11,2,0,9,2
102346,7,9,1,0,8,1
102346,6,9,4,0,5,4
31453,9,1,1,0,0,1
31453,8,2,1,0,1,1
31453,6,8,4,0,4,4
31453,5,3,1,0,2,1
31453,3,3,2,0,1,2
18690,10,1,1,0,0,1
18690,8,7,4,0,3,4
18690,7,10,1,0,9,1
18690,6,6,1,0,5,1
18690,5,4,3,0,1,3
176826,8,13,1,0,12,1
176826,7,9,1,0,8,1
176826,6,6,1,0,5,1
5789,8,3,3,0,0,3
5789,7,4,3,0,1,3
5789,6,8,5,0,3,5
5789,5,9,3,0,6,3
5789,3,4,1,0,3,1
235014,10,12,4,0,8,4
235014,8,5,1,1,4,0
235014,5,1,1,1,0,0
14746,8,1,1,0,0,1
14746,7,7,3,0,4,3
14746,6,12,6,0,6,6
14746,5,7,4,0,3,4
14746,4,4,2,0,2,2
14746,3,1,1,0,0,1
14746,2,1,1,0,0,1
7156,10,1,1,0,0,1
7156,6,6,1,0,5,1
7156,4,8,3,0,5,3
7156,3,2,1,0,1,1
762,7,6,1,0,5,1
762,6,9,6,0,3,6
762,5,6,1,0,5,1
762,4,5,2,0,3,2
762,2,3,3,0,0,3
762,1,2,2,0,0,2
145206,10,2,1,0,1,1
145206,9,2,1,0,1,1
145206,8,8,4,0,4,4
145206,7,10,5,0,5,5
145206,6,8,2,0,6,2
145206,2,1,1,0,0,1
87926,10,4,2,0,2,2
87926,8,1,1,0,0,1
87926,7,10,5,0,5,5
87926,6,6,1,0,5,1
87926,5,4,2,0,2,2
87926,4,2,1,0,1,1
87926,3,2,2,0,0,2
211485,10,3,1,0,2,1
211485,8,10,3,0,7,3
211485,7,7,1,0,6,1
211485,6,6,1,0,5,1
9133,9,2,1,0,1,1
9133,8,5,3,0,2,3
9133,7,5,2,0,3,2
9133,6,13,5,0,8,5
9133,5,6,1,0,5,1
17926,10,1,1,0,0,1
17926,8,1,1,0,0,1
17926,7,4,2,0,2,2
17926,6,14,3,0,11,3
37731,9,6,1,0,5,1
37731,8,6,2,0,4,2
37731,6,13,4,0,9,4
37731,5,4,3,0,1,3
110598,7,3,1,0,2,1
110598,6,9,1,0,8,1
110598,2,3,2,0,1,2
110598,1,2,1,0,1,1
271785,9,2,1,0,1,1
271785,8,10,2,0,8,2
271785,6,6,1,0,5,1
26204,6,9,2,0,7,2
26204,5,6,1,0,5,1
26204,3,7,1,0,6,1
3884,7,6,4,0,2,4
3884,6,5,1,0,4,1
3884,5,12,5,0,7,5
3884,4,6,2,0,4,2
3884,3,2,2,0,0,2
3884,2,1,1,0,0,1
3884,1,1,1,0,0,1
14360,8,4,2,0,2,2
14360,6,10,1,0,9,1
14360,5,6,1,0,5,1
14360,4,5,4,0,1,4
14360,3,4,3,0,1,3
14360,2,4,1,0,3,1
6848,9,5,2,0,3,2
6848,8,9,3,0,6,3
6848,7,13,5,0,8,5
6848,6,3,3,0,0,3
6848,5,2,1,0,1,1
6848,4,2,1,0,1,1
9578,9,2,1,0,1,1
9578,7,3,1,0,2,1
9578,6,9,2,0,7,2
9578,5,7,2,0,5,2
9578,4,4,2,0,2,2
9578,1,4,1,0,3,1
10893,10,4,3,0,1,3
10893,9,5,3,0,2,3
10893,8,5,3,0,2,3
10893,7,4,3,0,1,3
10893,6,9,2,0,7,2
10893,5,3,1,0,2,1
10893,4,2,1,0,1,1
10893,2,1,1,0,0,1
215532,6,9,1,0,8,1
215532,3,5,2,0,3,2
215532,2,2,1,0,1,1
11689,8,6,2,0,4,2
11689,6,16,2,0,14,2
11689,5,5,2,0,3,2
11689,3,1,1,0,0,1
208887,9,3,1,0,2,1
208887,8,17,5,0,12,5
208887,7,9,1,0,8,1
208887,6,5,2,0,3,2
161869,7,5,2,0,3,2
161869,6,6,1,0,5,1
161869,5,10,4,0,6,4
161869,4,7,1,0,6,1
15683,10,4,1,0,3,1
15683,9,4,1,0,3,1
15683,8,6,3,0,3,3
15683,7,9,2,0,7,2
15683,6,8,2,0,6,2
15683,5,2,1,0,1,1
161553,6,10,2,0,8,2
161553,5,11,1,0,10,1
161553,4,4,1,0,3,1
22999,9,3,2,0,1,2
22999,8,8,3,0,5,3
22999,7,13,8,0,5,8
22999,6,7,1,0,6,1
22999,5,1,1,0,0,1
22999,4,1,1,0,0,1
3330,9,5,2,0,3,2
3330,8,7,3,0,4,3
3330,7,11,1,0,10,1
3330,3,1,1,0,0,1
193792,9,4,2,0,2,2
193792,8,17,3,0,14,3
193792,6,5,2,0,3,2
242325,8,6,1,0,5,1
242325,6,8,2,0,6,2
242325,5,4,1,0,3,1
40803,9,4,1,0,3,1
40803,8,17,6,0,11,6
40803,7,4,2,0,2,2
40803,6,7,2,0,5,2
251153,8,9,3,0,6,3
251153,7,7,1,0,6,1
251153,6,9,3,0,6,3
240002,8,7,3,0,4,3
240002,7,11,3,0,8,3
240002,6,6,2,0,4,2
240002,4,2,1,0,1,1
118697,7,8,3,0,5,3
118697,3,1,1,0,0,1
193240,10,4,3,0,1,3
193240,9,8,3,0,5,3
193240,8,12,4,0,8,4
193240,7,3,2,0,1,2
193240,6,2,1,0,1,1
193240,5,4,2,0,2,2
7541,7,2,1,0,1,1
7541,6,12,6,0,6,6
7541,5,9,1,0,8,1
7541,3,2,1,0,1,1
7541,2,1,1,0,0,1
8691,5,10,2,0,8,2
8691,4,12,4,0,8,4
156927,9,1,1,0,0,1
156927,8,5,2,0,3,2
156927,7,9,3,0,6,3
156927,6,6,2,0,4,2
156927,5,4,1,0,3,1
156927,4,4,2,0,2,2
156927,2,1,1,0,0,1
4810,7,7,3,0,4,3
4810,6,7,3,0,4,3
4810,5,10,5,0,5,5
4810,4,2,2,0,0,2
4810,3,8,5,0,3,5
14128,8,4,3,0,1,3
14128,7,7,2,0,5,2
14128,6,15,4,0,11,4
14128,5,4,2,0,2,2
14128,3,3,1,0,2,1
6245,7,3,2,0,1,2
6245,5,10,3,0,7,3
6245,3,5,2,0,3,2
6245,2,2,1,0,1,1
6245,1,2,1,0,1,1
204397,10,5,2,0,3,2
204397,9,2,1,0,1,1
204397,8,6,3,0,3,3
204397,7,12,2,0,10,2
204397,5,2,1,0,1,1
204397,1,3,1,0,2,1
261321,10,4,1,0,3,1
261321,9,13,5,0,8,5
261321,8,11,2,0,9,2
261321,7,5,1,0,4,1
73243,8,4,2,0,2,2
73243,7,12,5,0,7,5
73243,6,12,4,0,8,4
73243,5,2,1,0,1,1
73243,3,1,1,0,0,1
73243,2,2,2,0,0,2
272409,10,18,4,2,14,2
272409,8,3,1,1,2,0
272409,2,1,1,0,0,1
272409,1,5,4,1,1,3
221122,10,8,5,0,3,5
221122,9,4,2,0,2,2
221122,8,9,1,0,8,1
221122,7,8,2,0,6,2
221122,6,4,1,0,3,1
221122,3,1,1,0,0,1
67891,10,3,2,0,1,2
67891,8,9,4,0,5,4
67891,7,11,6,0,5,6
67891,6,7,2,0,5,2
67891,5,2,1,0,1,1
236881,9,4,2,1,2,1
236881,8,12,4,1,8,3
236881,7,8,2,1,6,1
236881,6,6,1,0,5,1
7977,7,5,3,0,2,3
7977,6,12,6,0,6,6
7977,5,6,2,0,4,2
7977,3,3,2,0,1,2
205263,9,1,1,0,0,1
205263,8,5,1,0,4,1
205263,7,8,1,0,7,1
205263,6,7,3,0,4,3
205263,5,7,3,0,4,3
205263,4,3,1,0,2,1
7864,7,1,1,0,0,1
7864,6,12,5,0,7,5
7864,5,7,4,0,3,4
7864,4,8,2,0,6,2
7864,3,4,3,0,1,3
7864,2,2,1,0,1,1
529,8,3,1,0,2,1
529,5,5,2,0,3,2
146728,9,1,1,0,0,1
146728,8,7,2,0,5,2
146728,6,8,1,0,7,1
146728,5,7,3,0,4,3
146728,4,4,2,0,2,2
9863,10,2,1,0,1,1
9863,7,13,1,0,12,1
9863,6,9,2,0,7,2
9863,5,2,1,0,1,1
7964,7,1,1,0,0,1
7964,6,11,4,0,7,4
7964,5,5,2,0,3,2
7964,4,4,1,0,3,1
7964,3,6,2,0,4,2
7964,2,3,1,0,2,1
193141,8,1,1,0,0,1
193141,7,3,2,0,1,2
193141,6,3,1,0,2,1
193141,5,9,1,0,8,1
193141,4,10,2,0,8,2
193141,1,2,1,0,1,1
3325,10,3,3,0,0,3
3325,9,2,1,0,1,1
3325,8,9,5,0,4,5
3325,7,7,3,0,4,3
3325,6,8,3,0,5,3
3325,4,2,1,0,1,1
8749,8,4,2,0,2,2
8749,7,9,3,0,6,3
8749,6,8,5,0,3,5
8749,5,8,2,0,6,2
8749,4,2,1,0,1,1
263918,10,4,1,0,3,1
263918,9,7,2,0,5,2
263918,8,16,2,0,14,2
156023,9,2,1,0,1,1
156023,8,5,1,0,4,1
156023,7,11,2,0,9,2
156023,6,8,1,0,7,1
156023,5,4,1,0,3,1
156023,4,1,1,0,0,1
156023,2,1,1,0,0,1
4596,6,10,1,0,9,1
4596,5,5,1,0,4,1
4596,3,3,1,0,2,1
5295,9,1,1,0,0,1
5295,8,2,1,0,1,1
5295,6,11,3,0,8,3
5295,5,12,5,0,7,5
5295,4,2,1,0,1,1
112811,7,13,3,0,10,3
112811,6,9,2,0,7,2
112811,5,7,1,0,6,1
112811,4,2,1,0,1,1
196256,10,3,1,0,2,1
196256,9,2,1,0,1,1
196256,8,8,3,1,5,2
196256,6,10,3,1,7,2
16562,7,1,1,0,0,1
16562,5,11,2,0,9,2
16562,4,10,1,0,9,1
16562,3,3,1,0,2,1
9512,8,6,2,0,4,2
9512,7,5,1,0,4,1
9512,6,11,3,0,8,3
9512,5,5,1,0,4,1
9512,4,3,2,0,1,2
9512,2,1,1,0,0,1
11563,7,4,1,0,3,1
11563,6,6,2,0,4,2
11563,5,12,4,0,8,4
11563,2,4,4,0,0,4
11563,1,2,1,0,1,1
28879,10,6,3,0,3,3
28879,9,3,2,0,1,2
28879,6,5,1,0,4,1
28879,4,1,1,0,0,1
28879,1,2,1,0,1,1
29268,6,12,4,0,8,4
29268,1,1,1,0,0,1
2783,6,6,2,0,4,2
2783,5,8,2,0,6,2
2783,4,11,3,0,8,3
2783,3,4,1,0,3,1
2783,1,2,2,0,0,2
29018,8,2,2,0,0,2
29018,7,9,2,0,7,2
29018,6,12,3,0,9,3
29018,5,4,2,0,2,2
2788,7,3,1,0,2,1
2788,6,8,3,0,5,3
2788,5,9,2,0,7,2
2788,4,7,2,0,5,2
2788,3,4,1,0,3,1
2788,2,2,2,0,0,2
85123,10,2,1,0,1,1
85123,8,6,1,0,5,1
85123,7,5,2,0,3,2
85123,6,10,4,0,6,4
85123,5,3,2,0,1,2
85123,4,2,1,0,1,1
85123,3,4,2,0,2,2
85123,2,2,1,0,1,1
98371,8,3,2,0,1,2
98371,6,7,2,0,5,2
98371,5,8,2,0,6,2
98371,4,11,5,0,6,5
98371,3,3,1,0,2,1
12491,9,1,1,0,0,1
12491,6,8,3,0,5,3
12491,5,10,3,0,7,3
12491,4,9,4,0,5,4
12491,3,1,1,0,0,1
12491,1,1,1,0,0,1
16003,8,1,1,0,0,1
16003,7,3,2,0,1,2
16003,6,5,1,0,4,1
16003,5,4,2,0,2,2
16003,4,10,1,0,9,1
16003,3,5,3,0,2,3
16003,2,3,1,0,2,1
16003,1,3,2,0,1,2
6228,8,2,1,0,1,1
6228,6,7,2,0,5,2
6228,5,6,2,0,4,2
6228,4,3,2,0,1,2
6228,3,6,2,0,4,2
6228,2,4,4,0,0,4
6228,1,2,1,0,1,1
13935,9,1,1,0,0,1
13935,8,3,1,0,2,1
13935,6,9,1,0,8,1
13935,4,7,4,0,3,4
13935,3,2,1,0,1,1
13935,2,4,1,0,3,1
241590,8,9,1,0,8,1
241590,6,10,2,0,8,2
20732,7,4,1,0,3,1
20732,6,14,1,0,13,1
20732,5,5,1,0,4,1
85468,8,9,1,0,8,1
85468,7,7,1,0,6,1
85468,4,3,1,0,2,1
19530,7,6,2,0,4,2
19530,6,9,1,0,8,1
19530,5,8,2,0,6,2
19530,4,7,2,0,5,2
19530,3,3,2,0,1,2
19530,2,1,1,0,0,1
136283,7,2,1,0,1,1
136283,6,11,1,0,10,1
136283,5,8,2,0,6,2
136283,2,1,1,0,0,1
236114,9,4,2,0,2,2
236114,6,13,3,0,10,3
236114,5,6,3,0,3,3
236114,3,1,1,0,0,1
88925,10,3,1,0,2,1
88925,8,9,3,0,6,3
4441,8,2,1,0,1,1
4441,7,7,3,0,4,3
4441,6,10,6,0,4,6
4441,5,7,4,0,3,4
8364,10,2,1,0,1,1
8364,8,4,2,0,2,2
8364,7,10,3,0,7,3
8364,6,9,3,0,6,3
8364,5,3,2,0,1,2
8364,3,2,2,0,0,2
115370,9,5,1,0,4,1
115370,8,12,1,0,11,1
115370,6,5,3,0,2,3
115370,4,1,1,0,0,1
44715,8,3,1,0,2,1
44715,7,13,1,0,12,1
44715,6,11,1,0,10,1
44715,5,3,1,0,2,1
44715,4,2,1,0,1,1
126464,6,14,3,0,11,3
126464,5,8,1,0,7,1
126464,3,2,1,0,1,1
11510,8,3,1,0,2,1
11510,7,11,3,0,8,3
11510,5,5,1,0,4,1
11510,4,2,1,0,1,1
11510,3,1,1,0,0,1
11510,2,1,1,0,0,1
415,6,12,3,0,9,3
415,5,5,3,0,2,3
415,4,5,2,0,3,2
164428,10,3,1,1,2,0
164428,9,2,1,0,1,1
164428,8,7,2,0,5,2
164428,7,12,2,0,10,2
34938,9,1,1,0,0,1
34938,8,2,1,0,1,1
34938,6,8,2,0,6,2
34938,5,4,2,0,2,2
34938,4,6,2,0,4,2
34938,2,5,1,0,4,1
8359,10,3,2,0,1,2
8359,9,4,2,0,2,2
8359,8,16,6,0,10,6
8359,7,5,4,0,1,4
8359,6,3,3,0,0,3
8359,5,2,1,0,1,1
40653,8,8,7,0,1,7
40653,7,6,3,0,3,3
40653,6,8,4,0,4,4
40653,5,7,2,0,5,2
40653,3,2,1,0,1,1
138746,8,4,1,0,3,1
138746,7,7,3,0,4,3
138746,6,9,3,0,6,3
138746,5,4,1,0,3,1
138746,3,2,1,0,1,1
12870,9,1,1,0,0,1
12870,8,4,2,0,2,2
12870,7,11,2,0,9,2
12870,6,11,3,0,8,3
12870,5,3,1,0,2,1
12870,4,3,1,0,2,1
7611,7,2,1,0,1,1
7611,6,10,3,0,7,3
7611,5,10,2,0,8,2
7611,4,4,1,0,3,1
19725,8,5,1,0,4,1
19725,7,5,1,0,4,1
19725,6,12,4,0,8,4
19725,5,6,1,0,5,1
19725,3,2,1,0,1,1
4912,9,1,1,0,0,1
4912,7,3,1,0,2,1
4912,6,6,2,0,4,2
4912,3,4,2,0,2,2
4912,2,3,1,0,2,1
4912,1,1,1,0,0,1
103016,9,2,1,0,1,1
103016,7,9,1,0,8,1
103016,6,9,3,0,6,3
103016,5,4,2,0,2,2
2547,8,3,1,0,2,1
2547,6,3,1,0,2,1
2547,5,8,1,0,7,1
2547,4,10,2,0,8,2
2547,3,3,1,0,2,1
2547,2,3,1,0,2,1
2547,1,1,1,0,0,1
56244,7,13,2,0,11,2
56244,6,11,2,0,9,2
56244,5,4,1,0,3,1
56244,4,2,1,0,1,1
43110,7,10,1,0,9,1
43110,6,9,3,0,6,3
43110,4,1,1,0,0,1
257307,7,14,1,0,13,1
257307,5,4,3,0,1,3
16314,8,2,1,0,1,1
16314,4,5,2,0,3,2
194966,10,7,3,0,4,3
194966,9,5,1,0,4,1
194966,7,5,1,0,4,1
194966,6,8,1,0,7,1
69347,8,11,6,1,5,5
69347,7,9,5,0,4,5
69347,6,6,2,0,4,2
69347,5,2,1,0,1,1
69347,4,2,2,0,0,2
69347,2,1,1,0,0,1
5174,7,6,1,0,5,1
5174,6,12,2,0,10,2
24373,10,2,1,0,1,1
24373,8,3,2,0,1,2
24373,7,10,6,0,4,6
24373,6,7,4,0,3,4
24373,5,5,3,0,2,3
24373,4,3,1,0,2,1
24373,3,2,1,0,1,1
12111,10,4,4,0,0,4
12111,9,3,3,0,0,3
12111,8,7,4,0,3,4
12111,7,8,4,0,4,4
12111,6,6,2,0,4,2
12111,4,3,1,0,2,1
3045,10,1,1,0,0,1
3045,8,2,1,0,1,1
3045,7,7,2,0,5,2
3045,6,8,5,0,3,5
3045,5,7,2,0,5,2
3045,3,2,2,0,0,2
39527,8,4,1,0,3,1
39527,7,7,4,0,3,4
39527,6,11,5,0,6,5
39527,5,5,1,0,4,1
39527,4,3,1,0,2,1
21861,7,10,6,0,4,6
21861,6,11,7,0,4,7
21861,5,7,3,0,4,3
21861,4,2,1,0,1,1
21861,3,2,2,0,0,2
5934,8,2,1,0,1,1
5934,7,5,1,0,4,1
5934,6,11,1,0,10,1
5934,5,8,3,0,5,3
5934,3,2,1,0,1,1
94371,10,4,2,0,2,2
94371,8,10,1,0,9,1
94371,7,8,4,0,4,4
94371,6,4,1,0,3,1
94371,5,3,1,0,2,1
94371,4,1,1,0,0,1
94371,3,1,1,0,0,1
10783,10,4,1,0,3,1
10783,8,10,3,0,7,3
10783,7,5,1,0,4,1
10783,6,7,3,0,4,3
10783,5,3,1,0,2,1
10783,3,1,1,0,0,1
202617,10,2,1,0,1,1
202617,9,5,2,0,3,2
202617,8,11,2,0,9,2
202617,7,11,1,0,10,1
192233,8,5,2,0,3,2
192233,7,7,1,0,6,1
192233,6,11,1,0,10,1
192233,3,3,1,0,2,1
149705,10,6,4,0,2,4
149705,9,8,4,0,4,4
149705,8,11,5,0,6,5
149705,7,6,2,0,4,2
20710,9,2,1,0,1,1
20710,8,9,7,0,2,7
20710,7,8,3,0,5,3
20710,5,6,3,0,3,3
20710,4,1,1,0,0,1
20710,3,2,1,0,1,1
20710,2,1,1,0,0,1
151070,10,18,2,0,16,2
151070,9,10,4,0,6,4
71304,8,4,1,0,3,1
71304,7,9,3,0,6,3
71304,6,16,4,0,12,4
71304,5,4,1,0,3,1
7920,9,1,1,0,0,1
7920,8,4,3,0,1,3
7920,7,10,7,0,3,7
7920,6,12,5,0,7,5
7920,5,4,1,0,3,1
42882,10,2,1,0,1,1
42882,8,5,2,0,3,2
42882,7,8,2,0,6,2
42882,6,10,2,0,8,2
42882,5,6,3,0,3,3
42882,3,1,1,0,0,1
15819,10,4,3,0,1,3
15819,8,3,1,0,2,1
15819,7,3,1,0,2,1
15819,6,4,1,0,3,1
15819,5,8,4,0,4,4
15819,3,7,6,0,1,6
7837,7,2,1,0,1,1
7837,6,12,2,0,10,2
7837,5,6,1,0,5,1
7837,4,9,2,0,7,2
7837,2,2,2,0,0,2
11642,6,13,4,0,9,4
11642,5,9,4,0,5,4
11642,4,5,1,0,4,1
11642,2,1,1,0,0,1
200314,10,7,3,0,4,3
200314,9,2,1,0,1,1
200314,7,9,1,0,8,1
200314,4,3,2,0,1,2
163957,10,2,1,0,1,1
163957,9,6,4,0,2,4
163957,8,4,4,0,0,4
163957,6,5,3,0,2,3
163957,4,5,2,0,3,2
163957,3,3,1,1,2,0
33782,10,2,1,0,1,1
33782,6,5,1,0,4,1
33782,5,7,1,0,6,1
33782,1,1,1,0,0,1
167827,7,6,2,0,4,2
167827,6,9,2,0,7,2
167827,2,3,1,0,2,1
94073,9,2,1,0,1,1
94073,6,9,2,0,7,2
94073,5,10,1,0,9,1
94073,4,6,1,0,5,1
11737,5,4,3,0,1,3
11737,4,7,2,0,5,2
11737,3,7,1,0,6,1
11737,2,6,1,0,5,1
11737,1,4,1,0,3,1
3826,10,2,2,0,0,2
3826,9,7,4,0,3,4
3826,8,13,6,0,7,6
3826,7,3,1,0,2,1
3826,6,7,4,0,3,4
15430,8,1,1,0,0,1
15430,7,10,4,0,6,4
15430,6,12,1,0,11,1
15430,4,2,2,0,0,2
15430,1,1,1,0,0,1
165888,10,3,1,0,2,1
165888,9,3,3,0,0,3
165888,8,5,2,0,3,2
165888,7,9,4,0,5,4
165888,6,5,1,0,4,1
165888,4,1,1,0,0,1
165888,3,1,1,0,0,1
165888,2,1,1,0,0,1
165888,1,1,1,0,0,1
12269,10,9,7,0,2,7
12269,9,7,4,0,3,4
12269,8,9,3,0,6,3
12269,7,6,3,0,3,3
12269,5,1,1,0,0,1
16158,7,4,2,0,2,2
16158,5,6,3,0,3,3
16158,4,7,3,0,4,3
16158,3,8,2,0,6,2
3557,8,4,3,0,1,3
3557,7,6,3,0,3,3
3557,6,12,5,0,7,5
3557,4,2,1,0,1,1
14765,10,4,2,0,2,2
14765,9,4,1,0,3,1
14765,8,8,3,0,5,3
14765,6,4,2,0,2,2
14765,5,5,2,0,3,2
14765,4,2,2,0,0,2
171126,7,8,1,0,7,1
171126,6,12,3,0,9,3
171126,3,2,1,0,1,1
163255,9,5,4,0,1,4
163255,8,9,2,0,7,2
163255,7,10,4,0,6,4
163255,6,8,2,0,6,2
163255,3,1,1,0,0,1
14514,10,4,4,0,0,4
14514,9,6,2,0,4,2
14514,8,6,2,0,4,2
14514,7,5,1,0,4,1
14514,6,8,1,0,7,1
14514,5,2,2,0,0,2
14514,4,1,1,0,0,1
149814,9,4,1,0,3,1
149814,8,7,2,0,5,2
149814,7,10,2,0,8,2
149814,6,6,1,0,5,1
149814,5,3,1,0,2,1
149814,4,2,1,0,1,1
147039,9,1,1,1,0,0
147039,8,5,1,0,4,1
147039,6,8,2,0,6,2
147039,3,1,1,0,0,1
147039,2,5,1,0,4,1
40171,7,9,3,0,6,3
40171,6,13,4,0,9,4
40171,5,8,1,0,7,1
117815,8,4,1,0,3,1
117815,7,8,1,0,7,1
117815,4,2,1,0,1,1
117815,3,3,1,0,2,1
117815,2,2,1,0,1,1
29019,6,7,1,0,6,1
29019,5,7,2,0,5,2
29019,4,6,2,0,4,2
29019,3,3,1,0,2,1
29019,2,3,3,0,0,3
6883,7,8,4,0,4,4
6883,6,10,4,0,6,4
6883,4,2,1,0,1,1
6883,3,3,3,0,0,3
170608,9,3,2,0,1,2
170608,8,20,6,0,14,6
170608,7,8,1,0,7,1
6574,9,1,1,0,0,1
6574,8,1,1,0,0,1
6574,7,3,2,0,1,2
6574,6,11,4,0,7,4
6574,5,9,4,0,5,4
6574,3,2,2,0,0,2
192237,9,2,1,0,1,1
192237,8,2,1,0,1,1
192237,7,6,1,0,5,1
192237,6,11,1,0,10,1
192237,5,8,1,0,7,1
192237,2,1,1,0,0,1
2319,8,9,1,0,8,1
2319,7,4,2,0,2,2
2319,6,13,1,0,12,1
2319,5,3,1,0,2,1
2319,4,1,1,0,0,1
13800,9,4,3,0,1,3
13800,8,8,4,0,4,4
13800,7,6,2,0,4,2
13800,6,8,2,0,6,2
21807,8,1,1,0,0,1
21807,6,7,3,0,4,3
21807,5,9,2,0,7,2
21807,4,10,4,0,6,4
41604,10,3,1,0,2,1
41604,8,12,6,0,6,6
41604,7,10,3,0,7,3
41604,6,5,2,0,3,2
41604,4,1,1,0,0,1
67041,6,12,1,0,11,1
6681,6,11,3,0,8,3
6681,5,8,2,0,6,2
6681,4,7,3,0,4,3
6681,3,3,1,0,2,1
6681,2,2,1,0,1,1
174556,10,2,1,0,1,1
174556,9,8,2,0,6,2
174556,8,15,5,0,10,5
174556,7,5,1,0,4,1
6412,7,4,3,0,1,3
6412,6,6,2,0,4,2
6412,5,5,2,0,3,2
6412,4,5,2,0,3,2
6412,3,9,3,0,6,3
6412,2,1,1,0,0,1
8619,8,2,2,0,0,2
8619,7,5,2,0,3,2
8619,6,5,1,0,4,1
8619,5,8,3,0,5,3
8619,4,4,2,0,2,2
8619,3,3,1,0,2,1
8619,2,4,1,0,3,1
8723,10,1,1,0,0,1
8723,9,4,3,0,1,3
8723,8,9,1,0,8,1
8723,7,9,1,0,8,1
8723,6,8,2,0,6,2
9418,8,6,3,0,3,3
9418,7,6,2,0,4,2
9418,6,8,1,0,7,1
9418,3,2,1,0,1,1
9418,2,2,1,0,1,1
9418,1,1,1,0,0,1
157942,8,6,2,1,4,1
157942,7,3,1,0,2,1
157942,6,9,2,0,7,2
157942,4,5,1,0,4,1
181089,9,2,1,0,1,1
181089,7,6,1,0,5,1
181089,6,12,2,0,10,2
181089,4,4,2,0,2,2
12030,7,4,1,0,3,1
12030,6,3,1,0,2,1
12030,5,4,1,0,3,1
12030,4,9,6,0,3,6
12030,3,6,3,0,3,3
12030,2,4,1,0,3,1
95705,6,10,2,0,8,2
95705,5,10,2,0,8,2
95705,4,5,1,0,4,1
152247,5,11,4,0,7,4
152247,2,2,1,0,1,1
188530,8,6,1,0,5,1
188530,7,12,5,0,7,5
18205,10,2,1,0,1,1
18205,9,3,2,0,1,2
18205,8,18,5,0,13,5
11534,7,9,5,0,4,5
11534,6,15,3,0,12,3
11534,5,4,1,0,3,1
127590,9,1,1,0,0,1
127590,8,3,1,0,2,1
127590,7,7,1,0,6,1
30281,3,8,2,0,6,2
30281,2,5,1,0,4,1
30281,1,13,6,0,7,6
143250,8,7,3,0,4,3
143250,7,6,2,0,4,2
143250,6,10,3,0,7,3
143250,5,5,2,0,3,2
143250,3,2,1,0,1,1
175689,9,2,1,0,1,1
175689,8,11,4,1,7,3
175689,7,11,4,1,7,3
175689,6,5,1,0,4,1
175689,3,1,1,1,0,0
3240,8,8,3,0,5,3
3240,7,11,2,0,9,2
3240,6,7,1,0,6,1
3240,5,1,1,0,0,1
154931,9,2,1,0,1,1
154931,8,7,5,1,2,4
154931,7,10,3,0,7,3
154931,5,3,1,0,2,1
154931,4,4,1,0,3,1
14567,7,7,3,0,4,3
14567,6,14,6,0,8,6
14567,5,6,3,0,3,3
14567,4,2,1,0,1,1
14567,3,3,2,0,1,2
14567,2,1,1,0,0,1
118713,6,10,2,0,8,2
118713,5,8,1,0,7,1
118713,3,2,1,0,1,1
13440,8,1,1,0,0,1
13440,7,6,3,0,3,3
13440,6,10,5,0,5,5
13440,5,3,1,0,2,1
13440,4,6,4,0,2,4
13440,3,1,1,0,0,1
13440,2,2,1,0,1,1
13440,1,1,1,0,0,1
208583,6,3,1,0,2,1
208583,4,8,3,0,5,3
208583,3,7,2,0,5,2
208583,1,1,1,0,0,1
135801,5,2,1,0,1,1
135801,4,2,1,0,1,1
135801,3,4,1,0,3,1
135801,2,10,5,0,5,5
135801,1,9,4,0,5,4
220642,8,4,2,0,2,2
220642,7,8,2,0,6,2
220642,6,5,1,0,4,1
220642,4,2,1,0,1,1
220642,3,2,2,0,0,2
6839,8,1,1,0,0,1
6839,7,4,1,0,3,1
6839,6,5,1,0,4,1
6839,5,8,2,0,6,2
6839,4,8,2,0,6,2
6839,3,5,1,0,4,1
6839,1,1,1,0,0,1
2111,7,8,1,0,7,1
2111,5,6,1,0,5,1
5165,7,6,1,0,5,1
5165,6,11,3,0,8,3
5165,5,9,2,0,7,2
5165,3,3,1,0,2,1
24923,10,3,2,0,1,2
24923,9,7,2,0,5,2
24923,8,7,4,0,3,4
24923,7,10,4,0,6,4
24923,6,3,2,0,1,2
24923,5,2,1,0,1,1
24923,3,1,1,0,0,1
15214,10,2,1,0,1,1
15214,9,1,1,0,0,1
15214,8,4,2,0,2,2
15214,7,8,2,0,6,2
15214,6,6,2,0,4,2
15214,5,6,4,0,2,4
15214,4,2,1,0,1,1
15214,3,2,1,0,1,1
15214,2,1,1,0,0,1
15214,1,1,1,0,0,1
212401,10,9,5,0,4,5
212401,9,7,1,0,6,1
212401,8,9,2,1,7,1
212401,7,5,1,0,4,1
172550,9,1,1,0,0,1
172550,8,7,1,0,6,1
172550,7,5,1,0,4,1
172550,6,9,1,0,8,1
172550,2,2,1,0,1,1
254613,10,1,1,0,0,1
254613,8,2,1,0,1,1
254613,7,6,1,0,5,1
254613,6,13,1,0,12,1
254613,3,3,2,0,1,2
75292,10,2,2,0,0,2
75292,8,3,1,0,2,1
75292,7,5,3,0,2,3
75292,6,12,2,0,10,2
75292,5,8,2,0,6,2
75292,3,2,2,0,0,2
75292,2,1,1,0,0,1
21141,8,8,3,0,5,3
21141,7,6,1,0,5,1
21141,6,10,7,0,3,7
21141,5,4,2,0,2,2
21141,3,1,1,0,0,1
21141,2,1,1,0,0,1
103573,4,9,1,0,8,1
103573,3,5,3,0,2,3
103573,2,4,1,0,3,1
244716,7,13,3,0,10,3
244716,6,9,1,0,8,1
247778,8,8,4,0,4,4
247778,7,11,4,0,7,4
247778,6,8,1,0,7,1
247778,5,5,3,0,2,3
233033,9,5,2,0,3,2
233033,8,11,4,0,7,4
233033,7,10,6,0,4,6
233033,6,5,2,0,3,2
8847,8,3,1,0,2,1
8847,6,5,2,0,3,2
8847,5,12,3,0,9,3
8847,4,3,1,0,2,1
8847,3,3,1,0,2,1
8847,2,2,2,0,0,2
172707,10,1,1,0,0,1
172707,8,5,2,0,3,2
172707,6,7,2,0,5,2
172707,2,3,2,0,1,2
172707,1,2,1,0,1,1
258070,10,4,1,0,3,1
258070,9,5,1,0,4,1
258070,8,5,1,0,4,1
258070,5,4,2,0,2,2
16471,7,16,4,0,12,4
16471,6,9,5,0,4,5
16471,4,2,2,0,0,2
190015,9,3,2,0,1,2
190015,8,7,2,0,5,2
190015,7,6,1,0,5,1
190015,6,5,2,0,3,2
190015,5,7,1,0,6,1
190015,3,2,1,0,1,1
4903,10,2,1,0,1,1
4903,8,1,1,0,0,1
4903,6,13,4,0,9,4
4903,5,9,3,0,6,3
4903,4,6,2,0,4,2
4903,2,1,1,0,0,1
56208,10,3,1,0,2,1
56208,9,1,1,0,0,1
56208,8,4,2,0,2,2
56208,7,10,4,0,6,4
56208,6,11,2,0,9,2
56208,4,3,2,0,1,2
191657,8,3,2,0,1,2
191657,7,5,3,0,2,3
191657,6,11,5,0,6,5
191657,5,3,1,0,2,1
191657,2,5,2,0,3,2
9111,8,4,2,0,2,2
9111,7,11,3,0,8,3
9111,6,3,1,0,2,1
27552,7,4,1,0,3,1
27552,6,10,4,0,6,4
27552,5,8,3,0,5,3
27552,4,5,1,0,4,1
27552,3,3,2,0,1,2
27552,2,2,1,0,1,1
27552,1,1,1,0,0,1
246571,9,4,1,0,3,1
246571,8,14,7,1,7,6
246571,7,9,2,0,7,2
11552,10,1,1,0,0,1
11552,8,5,2,0,3,2
11552,7,8,2,0,6,2
11552,6,6,4,0,2,4
11552,3,2,1,0,1,1
11552,2,1,1,0,0,1
5084,7,2,1,0,1,1
5084,6,5,2,0,3,2
5084,5,11,4,0,7,4
5084,4,8,1,0,7,1
5084,3,5,2,0,3,2
152824,10,1,1,0,0,1
152824,8,7,2,0,5,2
152824,7,9,3,0,6,3
152824,6,12,2,0,10,2
3376,8,2,1,0,1,1
3376,7,6,3,0,3,3
3376,6,15,9,0,6,9
3376,5,6,3,0,3,3
3376,4,4,2,0,2,2
9846,8,11,3,0,8,3
9846,7,8,2,0,6,2
9846,6,7,1,0,6,1
9846,5,2,2,0,0,2
234657,10,2,1,0,1,1
234657,7,7,3,0,4,3
234657,6,10,2,0,8,2
171258,10,6,1,0,5,1
171258,8,6,2,1,4,1
171258,7,7,2,0,5,2
171258,6,5,1,0,4,1
171258,5,2,1,0,1,1
171258,4,1,1,0,0,1
171258,2,1,1,0,0,1
171258,1,2,1,0,1,1
166991,10,9,5,0,4,5
166991,9,7,3,0,4,3
166991,8,3,2,1,1,1
166991,7,6,1,0,5,1
166991,5,1,1,0,0,1
582,6,8,1,0,7,1
582,5,13,1,0,12,1
582,4,4,1,0,3,1
5226,8,5,2,0,3,2
5226,7,14,2,0,12,2
5226,6,10,1,0,9,1
5226,4,1,1,0,0,1
38141,9,3,1,0,2,1
38141,8,5,2,0,3,2
38141,7,7,1,0,6,1
38141,5,7,1,0,6,1
38141,4,2,1,0,1,1
38141,3,4,2,0,2,2
38141,1,2,1,0,1,1
28053,10,1,1,0,0,1
28053,7,5,3,0,2,3
28053,6,9,2,0,7,2
28053,5,3,2,0,1,2
28053,4,8,2,0,6,2
28053,3,3,2,0,1,2
28053,1,1,1,0,0,1
153980,10,6,3,1,3,2
153980,9,3,3,0,0,3
153980,7,5,1,0,4,1
153980,6,10,1,0,9,1
153980,5,3,1,1,2,0
153980,4,3,1,0,2,1
9785,8,1,1,0,0,1
9785,6,8,2,0,6,2
9785,5,7,3,0,4,3
9785,4,2,1,0,1,1
9785,3,7,3,0,4,3
9785,2,2,1,0,1,1
36674,9,5,5,0,0,5
36674,8,9,4,0,5,4
36674,7,9,4,0,5,4
36674,6,5,1,0,4,1
36674,4,2,1,0,1,1
17520,6,4,2,0,2,2
17520,5,9,3,0,6,3
17520,4,8,5,0,3,5
17520,3,5,2,0,3,2
17520,1,4,3,0,1,3
4295,8,6,2,0,4,2
4295,7,9,3,0,6,3
4295,6,11,5,0,6,5
4295,2,1,1,0,0,1
3983,7,6,2,0,4,2
3983,6,9,1,0,8,1
3983,2,2,1,0,1,1
209053,10,2,1,0,1,1
209053,9,4,4,0,0,4
209053,8,3,2,0,1,2
209053,7,9,1,0,8,1
209053,6,10,1,0,9,1
209053,3,2,1,0,1,1
238915,10,6,2,0,4,2
238915,8,5,3,0,2,3
238915,7,3,1,0,2,1
238915,5,2,1,0,1,1
238915,4,2,1,0,1,1
238915,1,2,1,0,1,1
251642,8,3,1,0,2,1
251642,6,6,1,0,5,1
251642,4,3,1,0,2,1
251642,3,5,2,0,3,2
251642,2,2,1,1,1,0
251642,1,2,2,1,0,1
176663,8,2,1,0,1,1
176663,6,6,1,1,5,0
176663,5,7,3,1,4,2
176663,4,6,2,1,4,1
176663,3,2,2,0,0,2
176663,2,1,1,0,0,1
6713,4,7,2,0,5,2
6713,3,5,2,0,3,2
6713,2,6,1,0,5,1
213260,7,7,1,0,6,1
213260,5,5,1,0,4,1
213260,3,2,1,0,1,1
191288,8,14,4,0,10,4
191288,7,8,2,0,6,2
191288,6,8,4,0,4,4
3863,6,9,2,0,7,2
3863,5,6,2,0,4,2
3863,4,5,4,0,1,4
3863,2,3,1,0,2,1
73232,9,1,1,0,0,1
73232,8,4,2,0,2,2
73232,7,6,1,0,5,1
73232,6,11,5,0,6,5
73232,3,3,2,0,1,2
73232,2,1,1,0,0,1
73232,1,1,1,0,0,1
39279,9,2,2,0,0,2
39279,8,5,3,0,2,3
39279,7,11,1,0,10,1
39279,6,11,4,0,7,4
39279,5,3,1,0,2,1
87829,6,13,2,0,11,2
87829,3,3,1,0,2,1
201668,8,10,2,1,8,1
201668,7,11,3,0,8,3
201668,6,6,2,1,4,1
201668,4,1,1,0,0,1
144337,6,11,5,0,6,5
144337,5,6,2,0,4,2
144337,2,4,1,0,3,1
41587,7,8,3,0,5,3
41587,6,15,2,0,13,2
242312,10,9,5,0,4,5
242312,9,17,8,0,9,8
242312,8,5,1,0,4,1
242312,6,1,1,0,0,1
17005,9,1,1,0,0,1
17005,7,8,1,0,7,1
17005,6,7,1,0,6,1
17005,5,8,3,0,5,3
17005,4,3,1,0,2,1
17005,3,4,2,0,2,2
2705,10,1,1,0,0,1
2705,9,2,1,0,1,1
2705,8,5,2,0,3,2
2705,7,8,3,0,5,3
2705,6,14,6,0,8,6
2705,4,1,1,0,0,1
806,8,8,3,0,5,3
806,7,7,2,0,5,2
806,6,10,2,0,8,2
806,5,3,2,0,1,2
806,4,3,2,0,1,2
806,3,2,1,0,1,1
15520,9,2,1,0,1,1
15520,8,4,4,0,0,4
15520,7,4,1,0,3,1
15520,6,9,4,0,5,4
15520,5,3,1,0,2,1
15520,4,5,2,0,3,2
15520,3,4,2,0,2,2
15520,2,1,1,0,0,1
7447,10,10,7,0,3,7
7447,9,4,3,0,1,3
7447,8,10,3,0,7,3
7447,7,7,1,0,6,1
7447,4,1,1,0,0,1
88045,8,5,2,0,3,2
88045,7,14,6,0,8,6
88045,6,9,2,0,7,2
88045,5,2,1,0,1,1
5418,10,6,3,0,3,3
5418,9,6,2,0,4,2
5418,8,10,3,0,7,3
5418,7,3,1,0,2,1
5418,6,6,2,0,4,2
5418,5,2,1,0,1,1
146226,10,1,1,0,0,1
146226,8,2,1,0,1,1
146226,7,1,1,0,0,1
146226,6,13,4,0,9,4
146226,5,8,2,0,6,2
146226,4,3,1,0,2,1
146226,3,4,2,0,2,2
146226,2,1,1,0,0,1
147824,6,12,2,0,10,2
147824,5,8,1,0,7,1
266444,8,7,1,0,6,1
153478,8,3,1,0,2,1
153478,5,4,1,0,3,1
8600,7,6,2,0,4,2
8600,6,9,2,0,7,2
8600,5,9,1,0,8,1
8600,4,3,1,0,2,1
8600,3,4,2,0,2,2
189489,10,2,1,0,1,1
189489,4,4,1,0,3,1
189489,3,10,4,0,6,4
189489,2,1,1,0,0,1
14299,10,2,2,0,0,2
14299,9,1,1,0,0,1
14299,7,11,3,0,8,3
14299,6,13,3,0,10,3
191916,9,2,2,0,0,2
191916,8,9,1,0,8,1
191916,7,11,5,0,6,5
191916,6,7,1,0,6,1
191916,4,2,2,0,0,2
140153,8,1,1,0,0,1
140153,7,3,1,0,2,1
140153,6,13,2,0,11,2
140153,5,6,1,0,5,1
140153,4,6,1,0,5,1
13363,10,2,2,0,0,2
13363,8,5,2,0,3,2
13363,7,9,4,0,5,4
13363,6,8,3,0,5,3
13363,5,3,3,0,0,3
13363,4,2,1,0,1,1
13363,1,2,1,0,1,1
3916,8,8,5,0,3,5
3916,7,10,6,0,4,6
3916,6,8,5,0,3,5
121324,7,5,1,0,4,1
121324,6,16,7,0,9,7
121324,5,4,1,0,3,1
121324,4,3,1,0,2,1
121324,2,3,3,0,0,3
139894,8,4,1,0,3,1
139894,7,5,2,0,3,2
139894,6,6,2,0,4,2
139894,5,9,2,0,7,2
139894,4,3,1,0,2,1
139894,3,2,1,0,1,1
186208,10,4,1,0,3,1
186208,9,2,1,0,1,1
186208,8,1,1,0,0,1
186208,7,4,1,0,3,1
186208,4,1,1,0,0,1
186208,3,3,1,0,2,1
186208,1,10,5,0,5,5
17568,6,4,2,0,2,2
17568,5,10,5,0,5,5
17568,4,5,2,0,3,2
17568,3,7,2,0,5,2
17568,2,2,1,0,1,1
17568,1,5,2,0,3,2
67629,7,1,1,0,0,1
67629,5,9,3,0,6,3
67629,4,12,2,0,10,2
67629,3,4,3,0,1,3
4280,7,1,1,0,0,1
4280,6,7,1,0,6,1
4280,5,10,3,0,7,3
4280,4,6,2,0,4,2
4280,3,5,1,0,4,1
112557,8,8,4,0,4,4
112557,7,17,5,0,12,5
112557,6,6,4,0,2,4
15497,6,11,3,0,8,3
15497,5,4,1,0,3,1
15497,4,5,1,0,4,1
15497,2,4,1,0,3,1
4611,7,6,1,0,5,1
4611,5,11,1,0,10,1
39089,8,10,3,0,7,3
39089,7,14,6,0,8,6
39089,6,5,2,0,3,2
39089,5,2,1,0,1,1
9569,8,5,2,0,3,2
9569,7,6,2,0,4,2
9569,6,9,4,0,5,4
9569,5,6,1,0,5,1
9569,4,4,2,0,2,2
9569,3,2,1,0,1,1
19186,9,3,1,0,2,1
19186,8,4,1,0,3,1
19186,7,9,1,0,8,1
19186,6,13,5,0,8,5
19186,4,2,1,0,1,1
116739,8,11,3,0,8,3
116739,7,9,3,0,6,3
116739,6,11,4,0,7,4
116739,3,2,2,0,0,2
24388,8,2,2,0,0,2
24388,6,14,2,0,12,2
24388,5,5,1,0,4,1
24388,3,4,2,0,2,2
18248,8,9,3,0,6,3
18248,7,12,1,0,11,1
18248,6,7,2,0,5,2
18248,5,2,1,0,1,1
265912,7,7,1,0,6,1
265912,6,5,1,0,4,1
1047,10,3,3,0,0,3
1047,9,4,2,0,2,2
1047,8,10,5,0,5,5
1047,7,9,4,0,5,4
1047,6,3,2,0,1,2
1047,5,2,1,0,1,1
1047,4,1,1,0,0,1
1047,2,1,1,0,0,1
27339,10,3,1,0,2,1
27339,8,7,2,0,5,2
27339,7,6,1,0,5,1
27339,6,7,1,0,6,1
167718,7,5,1,0,4,1
167718,4,1,1,0,0,1
26786,10,6,1,0,5,1
26786,9,4,1,0,3,1
26786,8,6,1,0,5,1
26786,6,6,1,0,5,1
245325,8,1,1,0,0,1
245325,6,9,1,0,8,1
245325,5,6,3,0,3,3
245325,4,5,1,0,4,1
245325,3,3,1,0,2,1
245325,2,2,1,0,1,1
161528,10,3,1,0,2,1
161528,7,6,1,0,5,1
161528,3,4,1,0,3,1
161528,1,1,1,0,0,1
32086,10,4,1,0,3,1
32086,9,5,2,0,3,2
32086,8,4,1,0,3,1
32086,7,9,3,0,6,3
32086,5,1,1,0,0,1
40938,8,6,3,0,3,3
40938,7,5,2,0,3,2
40938,6,9,5,0,4,5
40938,5,6,4,0,2,4
40938,4,4,1,0,3,1
40938,2,1,1,0,0,1
16085,10,5,2,0,3,2
16085,9,6,2,0,4,2
16085,8,10,2,0,8,2
16085,7,6,2,0,4,2
16085,2,2,1,0,1,1
11551,7,6,3,0,3,3
11551,6,18,5,0,13,5
10626,8,1,1,0,0,1
10626,7,5,1,0,4,1
10626,6,6,1,0,5,1
10626,5,8,2,0,6,2
10626,4,1,1,0,0,1
10626,3,2,1,0,1,1
10626,2,5,4,0,1,4
217827,7,5,1,0,4,1
217827,6,9,2,0,7,2
217827,5,4,1,0,3,1
217827,4,5,2,0,3,2
137366,6,3,1,0,2,1
137366,5,3,2,0,1,2
137366,2,5,1,0,4,1
256381,10,4,2,0,2,2
256381,9,10,6,0,4,6
256381,8,8,4,0,4,4
256381,7,11,1,0,10,1
106560,10,8,2,0,6,2
106560,9,2,1,0,1,1
106560,8,8,2,0,6,2
106560,6,10,2,0,8,2
41788,8,5,3,0,2,3
41788,7,11,5,0,6,5
41788,6,12,7,0,5,7
41788,5,4,1,0,3,1
41788,2,1,1,0,0,1
219312,10,2,1,0,1,1
219312,9,4,2,0,2,2
219312,8,4,2,0,2,2
219312,7,10,2,0,8,2
219312,6,7,1,0,6,1
219312,1,2,2,0,0,2
255013,8,6,1,0,5,1
255013,7,11,3,0,8,3
255013,6,10,1,0,9,1
255013,5,2,1,0,1,1
255013,2,1,1,0,0,1
238636,10,6,3,0,3,3
238636,9,4,2,0,2,2
238636,8,9,2,0,7,2
238636,7,10,2,0,8,2
186461,9,1,1,0,0,1
186461,8,5,2,1,3,1
186461,7,12,1,0,11,1
186461,6,4,2,0,2,2
186461,5,1,1,0,0,1
186461,3,5,2,0,3,2
17967,9,1,1,0,0,1
17967,8,6,2,0,4,2
17967,7,9,3,0,6,3
17967,6,12,7,0,5,7
17967,4,1,1,0,0,1
17967,2,1,1,0,0,1
205865,6,3,1,0,2,1
205865,5,12,3,0,9,3
205865,4,6,1,0,5,1
205865,2,4,2,0,2,2
22329,9,3,1,0,2,1
22329,8,5,3,0,2,3
22329,7,13,6,0,7,6
22329,6,9,4,0,5,4
163263,8,3,2,0,1,2
163263,7,3,2,0,1,2
163263,6,10,2,0,8,2
163263,4,7,6,0,1,6
163263,3,2,1,0,1,1
163263,2,3,2,1,1,1
163263,1,1,1,0,0,1
33779,7,3,1,0,2,1
33779,6,14,7,0,7,7
33779,5,9,4,0,5,4
33779,3,1,1,0,0,1
30896,8,5,2,0,3,2
30896,7,6,1,0,5,1
30896,6,12,4,0,8,4
30896,3,1,1,0,0,1
172118,10,4,4,1,0,3
172118,9,3,3,0,0,3
172118,8,6,2,0,4,2
172118,5,3,1,0,2,1
2933,8,4,4,0,0,4
2933,6,6,2,0,4,2
2933,5,12,2,0,10,2
2933,3,3,1,0,2,1
2933,2,2,1,0,1,1
905,10,1,1,0,0,1
905,7,5,1,0,4,1
905,6,9,6,0,3,6
905,5,7,1,0,6,1
905,4,5,4,0,1,4
32946,9,3,1,0,2,1
32946,8,3,1,0,2,1
32946,7,8,1,0,7,1
32946,6,10,1,0,9,1
32946,5,1,1,0,0,1
32946,4,5,2,0,3,2
8503,8,3,1,0,2,1
8503,7,5,2,0,3,2
8503,6,10,5,0,5,5
8503,5,7,1,0,6,1
8503,4,5,2,0,3,2
8503,3,2,1,0,1,1
8621,6,6,1,0,5,1
8621,4,8,2,0,6,2
8621,3,4,2,0,2,2
8621,2,4,1,0,3,1
8621,1,4,1,0,3,1
10462,6,5,2,0,3,2
10462,5,3,2,0,1,2
10462,4,7,1,0,6,1
10462,3,8,1,0,7,1
10462,2,5,2,0,3,2
187383,10,5,4,2,1,2
187383,9,3,2,0,1,2
187383,8,8,3,0,5,3
187383,7,8,1,1,7,0
187383,6,3,1,1,2,0
184477,10,4,3,0,1,3
184477,9,5,1,0,4,1
184477,8,8,5,0,3,5
184477,7,8,2,0,6,2
184477,6,4,2,0,2,2
184477,5,3,1,0,2,1
143073,6,5,1,0,4,1
143073,4,2,1,0,1,1
9118,5,3,1,0,2,1
9118,4,4,3,0,1,3
9118,3,5,3,0,2,3
9118,2,6,3,0,3,3
9118,1,9,4,0,5,4
6109,8,5,1,0,4,1
6109,6,7,1,0,6,1
6109,4,4,2,0,2,2
11441,8,2,1,0,1,1
11441,7,4,1,0,3,1
11441,6,12,3,0,9,3
11441,5,5,2,0,3,2
11441,3,2,2,0,0,2
73241,8,6,3,0,3,3
73241,7,10,2,0,8,2
73241,6,8,4,0,4,4
73241,5,2,2,0,0,2
73241,4,3,1,0,2,1
73241,2,1,1,0,0,1
175845,10,3,1,0,2,1
175845,9,8,1,0,7,1
175845,8,9,3,0,6,3
175845,7,2,1,0,1,1
175845,6,9,1,0,8,1
10038,8,12,5,0,7,5
10038,7,9,2,0,7,2
10038,6,4,2,0,2,2
10038,5,5,1,0,4,1
206516,10,1,1,0,0,1
206516,8,5,1,0,4,1
206516,7,5,2,0,3,2
206516,6,4,1,0,3,1
206516,5,8,2,0,6,2
206516,4,2,2,0,0,2
206516,3,4,2,0,2,2
3342,10,1,1,0,0,1
3342,9,1,1,0,0,1
3342,8,3,1,0,2,1
3342,4,7,2,0,5,2
3342,3,7,2,0,5,2
3342,1,2,1,0,1,1
23723,7,6,4,0,2,4
23723,6,8,6,0,2,6
23723,5,5,4,0,1,4
23723,4,7,5,0,2,5
23723,2,2,1,0,1,1
23723,1,1,1,0,0,1
113518,8,2,1,0,1,1
113518,7,4,2,0,2,2
113518,6,11,3,0,8,3
113518,5,9,4,0,5,4
113518,3,4,1,0,3,1
9844,7,6,4,0,2,4
9844,6,11,1,0,10,1
21967,6,6,2,0,4,2
21967,4,3,1,0,2,1
21967,3,6,1,0,5,1
21967,2,2,1,0,1,1
189902,10,2,1,0,1,1
189902,8,4,1,1,3,0
189902,7,11,2,1,9,1
189902,6,10,4,1,6,3
16380,10,2,1,0,1,1
16380,6,4,1,0,3,1
16380,2,3,2,0,1,2
16380,1,2,1,0,1,1
11925,9,1,1,0,0,1
11925,8,5,1,0,4,1
11925,7,12,5,0,7,5
11925,6,11,3,0,8,3
7956,8,4,2,0,2,2
7956,6,12,1,0,11,1
7956,5,3,2,0,1,2
7956,4,3,1,0,2,1
5666,9,1,1,0,0,1
5666,7,4,1,0,3,1
5666,6,4,3,0,1,3
5666,5,8,3,0,5,3
5666,4,8,3,0,5,3
5666,2,4,1,0,3,1
29117,6,10,6,0,4,6
29117,4,8,3,0,5,3
29117,3,4,3,0,1,3
29117,1,3,1,0,2,1
69543,9,3,1,0,2,1
69543,8,14,8,0,6,8
69543,7,10,4,0,6,4
69543,6,4,2,0,2,2
69543,5,1,1,0,0,1
5000,8,4,2,0,2,2
5000,7,3,1,0,2,1
5000,6,12,3,0,9,3
5000,5,8,4,0,4,4
197633,10,3,1,0,2,1
197633,8,13,9,0,4,9
197633,5,3,2,0,1,2
154472,10,5,4,0,1,4
154472,9,7,4,0,3,4
154472,8,11,6,0,5,6
154472,6,1,1,0,0,1
154472,4,1,1,0,0,1
197377,10,7,3,0,4,3
197377,9,13,6,0,7,6
197377,8,8,2,0,6,2
197377,7,1,1,0,0,1
197377,5,1,1,0,0,1
232358,9,4,1,0,3,1
232358,8,10,2,0,8,2
232358,7,4,1,0,3,1
168082,10,4,1,0,3,1
168082,9,6,2,0,4,2
168082,8,8,3,0,5,3
168082,7,7,2,0,5,2
168082,6,6,3,0,3,3
19676,8,12,1,0,11,1
19676,5,1,1,0,0,1
10574,8,4,1,0,3,1
10574,6,10,1,0,9,1
10574,5,10,4,0,6,4
10574,4,3,1,0,2,1
10574,3,2,1,0,1,1
231019,8,7,2,0,5,2
231019,7,12,2,0,10,2
231019,5,5,2,0,3,2
231019,4,2,1,0,1,1
178266,9,4,1,0,3,1
178266,8,7,4,0,3,4
178266,7,8,3,1,5,2
178266,6,11,2,0,9,2
178266,4,1,1,0,0,1
131379,9,6,3,0,3,3
131379,8,16,6,0,10,6
131379,7,3,1,0,2,1
131379,4,2,1,0,1,1
131379,2,1,1,0,0,1
5885,8,1,1,0,0,1
5885,6,7,1,0,6,1
5885,5,5,2,0,3,2
5885,4,9,1,0,8,1
5885,3,7,1,0,6,1
13106,7,5,2,0,3,2
13106,6,7,1,0,6,1
13106,5,10,3,0,7,3
13106,4,4,1,0,3,1
13106,3,5,3,0,2,3
15563,8,3,1,0,2,1
15563,7,5,1,0,4,1
15563,5,9,1,0,8,1
15563,4,5,1,0,4,1
14021,8,1,1,0,0,1
14021,7,8,2,0,6,2
14021,6,8,4,0,4,4
14021,4,5,1,0,4,1
14021,3,2,1,0,1,1
14021,1,1,1,0,0,1
19361,7,9,3,0,6,3
19361,6,16,3,0,13,3
5679,10,2,2,1,0,1
5679,7,10,3,0,7,3
5679,6,4,2,0,2,2
5679,4,8,3,0,5,3
5679,3,2,1,0,1,1
5679,2,1,1,0,0,1
18163,10,2,1,0,1,1
18163,8,2,2,0,0,2
18163,6,14,9,0,5,9
18163,5,4,2,0,2,2
18163,4,4,1,0,3,1
18163,3,3,2,0,1,2
18163,2,1,1,0,0,1
256911,8,13,2,0,11,2
256911,7,9,3,0,6,3
256911,6,5,1,0,4,1
16450,10,1,1,0,0,1
16450,8,14,6,0,8,6
16450,7,9,1,0,8,1
16450,6,1,1,0,0,1
16450,5,4,2,0,2,2
16450,4,1,1,0,0,1
259525,8,7,1,0,6,1
259525,7,7,1,0,6,1
259525,6,4,1,0,3,1
259525,5,9,4,0,5,4
37307,10,1,1,0,0,1
37307,8,4,1,0,3,1
37307,7,14,5,0,9,5
37307,6,10,2,0,8,2
200407,7,8,1,0,7,1
200407,5,9,2,0,7,2
73574,7,7,3,0,4,3
73574,6,15,4,0,11,4
73574,5,8,4,0,4,4
73574,3,1,1,0,0,1
9010,10,4,1,0,3,1
9010,7,8,4,0,4,4
9010,6,13,7,0,6,7
9010,5,2,2,0,0,2
34129,6,7,1,0,6,1
34129,4,4,1,0,3,1
34129,3,12,2,0,10,2
34129,2,4,1,0,3,1
73589,9,6,1,0,5,1
73589,8,10,2,0,8,2
73589,7,6,1,0,5,1
73589,6,5,2,0,3,2
73589,4,1,1,0,0,1
73589,1,1,1,0,0,1
2650,8,3,2,0,1,2
2650,7,3,1,0,2,1
2650,6,7,1,0,6,1
2650,5,9,1,0,8,1
11751,8,3,1,0,2,1
11751,7,1,1,0,0,1
11751,6,13,4,0,9,4
11751,5,10,3,0,7,3
127093,8,5,3,0,2,3
127093,6,10,4,0,6,4
127093,5,5,1,0,4,1
191201,10,2,1,0,1,1
191201,9,5,1,0,4,1
191201,8,8,4,1,4,3
191201,7,8,2,1,6,1
191201,6,7,4,0,3,4
148668,8,8,3,2,5,1
148668,7,7,2,0,5,2
148668,6,8,3,0,5,3
148668,5,5,2,0,3,2
148668,4,3,1,0,2,1
19432,10,2,1,0,1,1
19432,9,6,2,0,4,2
19432,7,8,5,0,3,5
19432,6,6,2,0,4,2
19432,5,5,2,0,3,2
19432,4,1,1,0,0,1
19432,3,1,1,0,0,1
29138,6,14,3,0,11,3
258512,10,4,3,0,1,3
258512,9,5,1,0,4,1
258512,8,8,4,1,4,3
258512,6,5,1,0,4,1
258512,5,3,1,0,2,1
3996,7,7,3,0,4,3
3996,6,11,4,0,7,4
3996,5,5,3,0,2,3
3996,4,8,3,0,5,3
3996,3,1,1,0,0,1
90460,6,5,1,0,4,1
90460,5,11,3,0,8,3
90460,4,3,1,0,2,1
10307,10,1,1,0,0,1
10307,9,2,1,0,1,1
10307,8,14,3,0,11,3
10307,7,8,1,0,7,1
10307,6,5,1,0,4,1
10307,5,2,1,0,1,1
265684,9,5,2,0,3,2
265684,7,8,3,0,5,3
265684,6,10,3,0,7,3
265684,5,3,1,0,2,1
265684,4,3,1,0,2,1
265684,3,1,1,0,0,1
164808,8,6,1,0,5,1
164808,7,9,1,0,8,1
164808,6,12,1,0,11,1
164808,5,3,1,0,2,1
7318,8,1,1,0,0,1
7318,7,4,3,0,1,3
7318,6,12,8,0,4,8
7318,5,6,3,0,3,3
7318,3,3,2,0,1,2
7318,2,4,2,0,2,2
168236,7,6,3,0,3,3
168236,6,8,4,0,4,4
168236,5,6,2,0,4,2
168236,4,5,3,0,2,3
76362,6,5,1,0,4,1
76362,5,9,4,0,5,4
76362,4,4,2,0,2,2
76362,3,7,2,0,5,2
76362,2,4,3,0,1,3
76362,1,2,1,0,1,1
85429,7,9,2,0,7,2
85429,6,13,2,0,11,2
85429,5,5,1,0,4,1
85429,3,1,1,0,0,1
231837,7,9,1,0,8,1
231837,6,8,1,0,7,1
231837,5,3,1,0,2,1
231837,4,5,3,0,2,3
9847,7,6,1,0,5,1
9847,6,9,1,0,8,1
9847,5,6,5,0,1,5
9847,4,3,2,0,1,2
9847,3,2,1,0,1,1
151892,10,1,1,0,0,1
151892,9,3,1,0,2,1
151892,8,8,4,0,4,4
151892,7,9,1,0,8,1
151892,6,9,2,0,7,2
116736,10,2,1,0,1,1
116736,9,1,1,0,0,1
116736,8,7,4,0,3,4
116736,7,14,6,0,8,6
116736,6,7,2,0,5,2
116736,3,1,1,0,0,1
4736,7,3,1,0,2,1
4736,6,8,4,0,4,4
4736,5,8,4,0,4,4
4736,4,9,3,0,6,3
4736,3,1,1,0,0,1
4736,2,3,2,0,1,2
19763,7,6,4,0,2,4
19763,6,11,4,0,7,4
19763,5,7,2,0,5,2
19763,4,3,3,0,0,3
8452,8,1,1,0,0,1
8452,6,11,5,0,6,5
8452,5,11,2,0,9,2
27227,6,13,2,0,11,2
27227,4,2,1,0,1,1
201560,10,9,7,0,2,7
201560,8,4,1,0,3,1
201560,7,7,1,0,6,1
201560,6,7,2,0,5,2
148117,8,5,3,1,2,2
148117,7,6,3,0,3,3
148117,6,11,6,4,5,2
148117,5,5,1,0,4,1
148117,3,2,1,0,1,1
6153,7,4,2,0,2,2
6153,6,13,5,0,8,5
6153,5,3,2,0,1,2
6153,4,4,1,0,3,1
6153,3,3,1,0,2,1
69904,8,3,1,0,2,1
69904,7,7,2,0,5,2
69904,6,6,3,0,3,3
69904,5,4,2,0,2,2
69904,4,8,1,0,7,1
20833,8,4,1,0,3,1
20833,6,6,1,0,5,1
20833,5,10,2,0,8,2
20833,4,3,1,0,2,1
20833,3,4,2,0,2,2
7557,9,1,1,0,0,1
7557,8,2,1,0,1,1
7557,7,10,2,0,8,2
7557,6,13,3,0,10,3
7557,5,5,4,0,1,4
7557,4,1,1,0,0,1
5539,8,3,2,0,1,2
5539,7,7,1,0,6,1
5539,6,8,3,0,5,3
5539,5,8,4,0,4,4
5539,3,1,1,0,0,1
32794,7,1,1,0,0,1
32794,6,10,1,0,9,1
32794,5,10,1,0,9,1
32794,4,5,1,0,4,1
32794,1,1,1,0,0,1
145653,9,2,2,0,0,2
145653,8,7,4,0,3,4
145653,7,9,6,0,3,6
145653,6,7,3,0,4,3
145653,5,4,1,0,3,1
22259,8,3,3,0,0,3
22259,7,6,1,0,5,1
22259,6,9,3,0,6,3
22259,5,9,1,0,8,1
22259,4,2,1,0,1,1
22259,3,2,1,0,1,1
37401,10,3,1,0,2,1
37401,6,6,1,0,5,1
37401,5,5,1,0,4,1
37401,4,6,3,0,3,3
37401,2,1,1,0,0,1
1638,8,1,1,0,0,1
1638,7,2,2,0,0,2
1638,5,7,3,0,4,3
1638,4,9,3,0,6,3
1638,2,2,1,0,1,1
209773,10,3,2,0,1,2
209773,9,4,4,1,0,3
209773,8,11,1,0,10,1
209773,7,7,1,0,6,1
209773,6,5,1,0,4,1
802,9,1,1,0,0,1
802,8,2,2,0,0,2
802,7,4,1,0,3,1
802,6,16,5,0,11,5
802,5,4,3,0,1,3
802,3,1,1,0,0,1
9204,8,7,4,0,3,4
9204,7,7,1,0,6,1
9204,6,8,2,0,6,2
9204,5,5,3,0,2,3
9204,3,2,2,0,0,2
2012,10,1,1,0,0,1
2012,6,7,1,0,6,1
2012,4,8,1,0,7,1
2996,6,7,1,0,6,1
2996,5,12,4,0,8,4
2996,3,4,1,0,3,1
2996,2,1,1,0,0,1
33086,10,2,1,0,1,1
33086,8,4,1,0,3,1
33086,7,3,2,0,1,2
33086,6,13,5,0,8,5
33086,5,7,2,0,5,2
33086,4,1,1,0,0,1
33086,3,1,1,0,0,1
21257,7,4,1,0,3,1
21257,4,9,2,0,7,2
21257,3,7,3,0,4,3
21257,2,4,3,0,1,3
19442,6,12,1,0,11,1
110336,9,2,1,0,1,1
110336,8,6,1,0,5,1
110336,7,11,3,0,8,3
110336,6,11,2,0,9,2
242742,9,3,1,0,2,1
242742,8,5,1,0,4,1
242742,6,12,2,0,10,2
242742,4,2,1,0,1,1
22595,10,3,1,0,2,1
22595,4,5,1,0,4,1
22595,3,3,1,0,2,1
11924,8,3,1,0,2,1
11924,7,6,2,0,4,2
11924,6,12,2,0,10,2
11924,5,8,3,0,5,3
11924,4,2,1,0,1,1
176523,10,5,4,0,1,4
176523,9,6,5,0,1,5
176523,8,5,1,0,4,1
176523,6,4,2,0,2,2
176523,2,2,1,0,1,1
7536,8,3,1,0,2,1
7536,6,13,4,0,9,4
7536,5,8,3,0,5,3
7536,3,1,1,0,0,1
7536,2,1,1,0,0,1
192268,9,2,1,0,1,1
192268,8,3,2,0,1,2
192268,7,12,2,0,10,2
192268,6,8,1,0,7,1
192268,4,3,1,0,2,1
192268,3,2,1,0,1,1
192268,2,1,1,0,0,1
255478,8,5,1,0,4,1
255478,6,9,1,0,8,1
255478,3,3,1,0,2,1
167850,5,9,1,0,8,1
167850,3,4,1,0,3,1
167850,2,1,1,0,0,1
161765,10,9,7,0,2,7
161765,9,5,2,0,3,2
161765,8,10,5,0,5,5
161765,7,4,1,0,3,1
161765,6,2,1,1,1,0
107583,7,2,1,0,1,1
107583,6,14,4,0,10,4
107583,5,7,2,0,5,2
107583,4,7,1,0,6,1
107583,2,1,1,0,0,1
107583,1,1,1,0,0,1
111426,7,6,1,0,5,1
111426,6,9,1,0,8,1
111426,4,7,4,0,3,4
8330,8,4,1,0,3,1
8330,7,7,2,0,5,2
8330,5,10,6,0,4,6
24379,8,1,1,0,0,1
24379,6,12,2,0,10,2
24379,5,10,2,0,8,2
24379,4,3,1,0,2,1
24379,3,3,1,0,2,1
24379,2,1,1,0,0,1
160871,10,2,1,0,1,1
160871,8,5,4,0,1,4
160871,7,10,3,0,7,3
160871,6,9,3,0,6,3
160871,4,3,1,0,2,1
160871,2,1,1,0,0,1
67627,7,2,1,0,1,1
67627,3,7,1,0,6,1
67627,2,7,1,0,6,1
67627,1,2,2,0,0,2
150424,10,1,1,0,0,1
150424,8,4,1,0,3,1
150424,7,16,5,0,11,5
150424,6,9,4,0,5,4
226619,9,4,1,0,3,1
226619,7,12,2,0,10,2
226619,6,6,1,0,5,1
226619,3,2,1,0,1,1
155582,8,3,1,1,2,0
155582,1,26,17,9,9,8
3827,10,3,2,0,1,2
3827,9,4,2,0,2,2
3827,8,5,2,0,3,2
3827,7,2,2,0,0,2
3827,6,5,4,0,1,4
3827,5,11,4,0,7,4
3827,3,1,1,0,0,1
10348,7,10,5,0,5,5
10348,6,10,6,0,4,6
10348,3,1,1,0,0,1
139975,6,10,2,0,8,2
139975,3,3,1,0,2,1
139975,2,2,1,0,1,1
139975,1,1,1,0,0,1
171500,10,10,4,0,6,4
171500,9,11,4,0,7,4
171500,8,5,1,1,4,0
171500,7,3,2,0,1,2
171500,6,2,1,0,1,1
3689,7,4,3,0,1,3
3689,6,11,4,0,7,4
3689,5,6,2,0,4,2
3689,4,6,3,0,3,3
3689,3,3,2,0,1,2
3689,1,1,1,0,0,1
201458,9,3,2,0,1,2
201458,7,8,3,0,5,3
201458,6,5,2,0,3,2
201458,5,3,1,0,2,1
201458,3,2,1,0,1,1
95589,6,6,1,0,5,1
95589,5,8,3,0,5,3
95589,4,7,3,0,4,3
95589,3,7,1,0,6,1
148430,8,3,2,0,1,2
148430,7,12,1,0,11,1
148430,6,10,1,0,9,1
148430,5,5,2,0,3,2
148430,4,1,1,0,0,1
170676,8,4,1,0,3,1
170676,6,11,1,0,10,1
166390,8,5,1,0,4,1
166390,7,3,1,0,2,1
166390,6,11,4,0,7,4
166390,4,6,3,0,3,3
236861,10,14,11,1,3,10
236861,9,7,6,0,1,6
236861,8,5,3,0,2,3
236861,5,2,1,0,1,1
236861,4,1,1,0,0,1
84454,8,5,1,0,4,1
84454,3,3,1,0,2,1
10570,9,1,1,0,0,1
10570,8,1,1,0,0,1
10570,7,2,2,0,0,2
10570,6,6,3,0,3,3
10570,5,10,2,0,8,2
10570,4,8,1,0,7,1
10570,3,3,1,0,2,1
27981,8,2,1,0,1,1
27981,7,5,5,0,0,5
27981,6,5,4,0,1,4
27981,5,3,1,0,2,1
27981,4,10,4,0,6,4
27981,3,3,2,0,1,2
27981,1,1,1,0,0,1
21435,9,1,1,0,0,1
21435,7,10,5,0,5,5
21435,6,8,4,0,4,4
21435,5,4,1,0,3,1
21435,4,3,1,0,2,1
21435,3,3,1,0,2,1
21435,2,1,1,0,0,1
86174,7,7,3,0,4,3
86174,6,11,1,0,10,1
86174,5,7,2,0,5,2
86174,2,2,1,0,1,1
86849,8,9,1,0,8,1
86849,7,11,3,0,8,3
64896,9,1,1,0,0,1
25526,10,1,1,0,0,1
25526,6,7,2,0,5,2
25526,5,7,1,0,6,1
25526,4,5,2,0,3,2
25526,1,2,1,0,1,1
9070,9,3,1,0,2,1
9070,8,3,1,0,2,1
9070,7,3,1,0,2,1
9070,6,12,4,0,8,4
9070,3,2,2,0,0,2
9853,9,1,1,0,0,1
9853,7,8,1,0,7,1
9853,6,13,1,0,12,1
9853,5,3,2,0,1,2
8360,9,1,1,0,0,1
8360,8,2,1,0,1,1
8360,6,5,3,0,2,3
8360,5,9,7,0,2,7
8360,4,4,1,0,3,1
8360,3,1,1,0,0,1
8360,2,1,1,0,0,1
9013,10,3,1,0,2,1
9013,6,8,3,0,5,3
9013,5,9,6,0,3,6
9013,3,3,1,0,2,1
29119,6,8,4,0,4,4
29119,4,9,2,0,7,2
29119,3,4,3,0,1,3
100374,9,1,1,0,0,1
100374,8,2,1,0,1,1
100374,7,4,1,0,3,1
100374,6,9,3,0,6,3
100374,4,6,2,0,4,2
100374,3,6,3,0,3,3
100374,1,1,1,0,0,1
41712,6,6,1,0,5,1
41712,3,1,1,0,0,1
12146,10,4,2,0,2,2
12146,9,2,1,0,1,1
12146,8,6,3,0,3,3
12146,7,11,4,0,7,4
12146,6,4,1,0,3,1
12146,4,2,2,0,0,2
12146,2,1,1,0,0,1
224590,10,1,1,0,0,1
224590,8,12,4,1,8,3
224590,7,10,2,0,8,2
64570,9,7,3,0,4,3
64570,8,12,9,0,3,9
64570,7,8,3,0,5,3
64570,5,1,1,0,0,1
156746,8,3,2,0,1,2
156746,7,4,3,0,1,3
156746,6,12,2,1,10,1
156746,5,9,1,0,8,1
156746,4,4,1,0,3,1
167505,8,1,1,0,0,1
167505,6,11,2,0,9,2
167505,5,9,1,0,8,1
167505,4,6,3,0,3,3
167505,3,3,1,0,2,1
167505,1,2,1,0,1,1
26563,6,9,2,0,7,2
26563,4,5,3,0,2,3
26563,3,2,1,0,1,1
873,7,8,1,0,7,1
873,6,11,2,0,9,2
873,4,5,2,0,3,2
873,3,1,1,0,0,1
256151,7,6,1,0,5,1
256151,6,8,1,0,7,1
256151,5,5,1,0,4,1
9454,10,2,1,0,1,1
9454,7,2,2,0,0,2
9454,6,6,1,0,5,1
9454,4,7,3,0,4,3
9454,3,3,1,0,2,1
9454,2,3,1,0,2,1
51505,8,2,1,0,1,1
51505,6,10,3,0,7,3
51505,5,7,4,0,3,4
51505,4,3,1,0,2,1
51505,2,4,3,0,1,3
9033,9,2,2,0,0,2
9033,8,4,3,0,1,3
9033,7,8,3,0,5,3
9033,6,11,4,0,7,4
9033,5,3,1,0,2,1
9033,4,2,1,0,1,1
9033,3,1,1,0,0,1
89319,10,3,1,0,2,1
89319,9,6,4,1,2,3
89319,8,7,2,0,5,2
89319,7,6,2,0,4,2
89319,6,8,2,0,6,2
89319,5,2,2,0,0,2
37497,8,4,2,0,2,2
37497,7,6,4,0,2,4
37497,6,8,3,0,5,3
37497,4,5,2,0,3,2
37497,3,4,1,0,3,1
37497,1,1,1,0,0,1
73230,10,1,1,0,0,1
73230,8,7,4,0,3,4
73230,7,7,2,0,5,2
73230,6,8,3,0,5,3
73230,5,3,1,0,2,1
73230,4,4,3,0,1,3
73230,3,1,1,0,0,1
14591,7,4,1,0,3,1
14591,6,16,2,0,14,2
14591,5,8,2,0,6,2
14591,4,4,4,0,0,4
13936,10,8,4,0,4,4
13936,9,3,2,0,1,2
13936,8,9,3,0,6,3
13936,5,5,4,0,1,4
13936,3,1,1,0,0,1
29879,9,1,1,0,0,1
29879,8,5,3,0,2,3
29879,7,11,2,0,9,2
29879,6,8,2,0,6,2
29879,5,2,1,0,1,1
29879,4,3,3,0,0,3
29879,2,1,1,0,0,1
24857,9,1,1,0,0,1
24857,6,4,2,0,2,2
24857,5,5,2,0,3,2
24857,4,8,2,0,6,2
24857,3,4,1,0,3,1
24857,2,4,2,0,2,2
24857,1,4,2,0,2,2
270109,9,11,1,0,10,1
270109,8,9,2,0,7,2
270109,7,2,1,1,1,0
270109,3,2,2,0,0,2
67339,10,4,1,0,3,1
67339,8,12,1,0,11,1
67339,4,1,1,0,0,1
174491,9,5,2,0,3,2
174491,8,6,1,0,5,1
174491,6,6,1,0,5,1
174491,5,3,3,0,0,3
174491,4,1,1,0,0,1
255293,9,7,4,0,3,4
255293,8,5,2,0,3,2
255293,5,4,1,0,3,1
255293,4,1,1,0,0,1
255293,1,1,1,0,0,1
166977,10,6,3,0,3,3
166977,8,12,4,0,8,4
166977,7,4,1,0,3,1
166977,4,4,1,0,3,1
166977,3,1,1,0,0,1
54604,8,5,1,0,4,1
54604,6,12,2,0,10,2
54604,5,6,2,0,4,2
54604,4,2,1,0,1,1
54604,1,1,1,0,0,1
240142,10,6,6,0,0,6
240142,9,1,1,0,0,1
240142,2,2,1,0,1,1
240142,1,18,7,0,11,7
3829,7,9,1,0,8,1
3829,6,15,6,0,9,6
3829,5,6,1,0,5,1
3829,4,1,1,0,0,1
25448,8,2,1,0,1,1
25448,7,8,2,0,6,2
25448,6,15,7,0,8,7
25448,5,3,1,0,2,1
64438,8,1,1,0,0,1
64438,6,8,1,0,7,1
64438,5,11,3,0,8,3
64438,3,2,1,0,1,1
64438,2,4,2,0,2,2
4042,6,7,1,0,6,1
4042,5,8,4,0,4,4
4042,4,8,3,0,5,3
4042,3,1,1,0,0,1
148115,10,5,2,0,3,2
148115,9,3,1,0,2,1
148115,7,6,3,0,3,3
148115,5,1,1,0,0,1
148115,4,3,1,0,2,1
148115,3,4,2,0,2,2
225449,9,4,2,0,2,2
225449,8,6,1,0,5,1
225449,7,9,2,0,7,2
225449,6,9,1,0,8,1
225449,5,4,1,0,3,1
182276,7,12,3,0,9,3
182276,5,1,1,0,0,1
208093,10,5,2,0,3,2
208093,9,3,2,0,1,2
208093,8,11,3,0,8,3
208093,7,7,1,0,6,1
208093,6,5,1,0,4,1
181083,10,2,1,0,1,1
181083,8,8,1,0,7,1
181083,7,9,3,0,6,3
181083,6,6,1,0,5,1
2889,10,2,1,0,1,1
2889,8,7,3,0,4,3
2889,7,7,5,0,2,5
2889,6,10,2,0,8,2
2889,5,5,1,0,4,1
182634,8,1,1,0,0,1
182634,7,5,1,0,4,1
182634,6,8,1,0,7,1
182634,5,8,2,0,6,2
182634,4,5,2,0,3,2
182634,3,1,1,0,0,1
182634,2,1,1,0,0,1
31508,10,3,3,0,0,3
31508,8,2,1,0,1,1
31508,7,3,2,0,1,2
31508,6,4,1,0,3,1
31508,5,5,1,0,4,1
31508,4,6,3,0,3,3
31508,3,2,1,0,1,1
31508,2,6,5,0,1,5
159410,10,1,1,0,0,1
159410,9,3,2,1,1,1
159410,8,3,1,0,2,1
159410,7,5,2,0,3,2
159410,6,13,5,0,8,5
159410,5,4,1,0,3,1
203215,9,2,1,0,1,1
203215,8,9,3,0,6,3
203215,7,6,1,0,5,1
203215,6,12,5,0,7,5
203215,5,2,1,0,1,1
168900,9,2,1,0,1,1
168900,8,5,1,0,4,1
168900,7,3,1,0,2,1
168900,6,18,1,0,17,1
1093,6,16,4,0,12,4
1093,3,3,3,0,0,3
1093,2,1,1,0,0,1
6630,6,9,6,0,3,6
6630,5,9,6,0,3,6
6630,2,1,1,0,0,1
235249,10,3,2,0,1,2
235249,9,6,3,0,3,3
235249,3,2,1,0,1,1
10394,10,4,2,0,2,2
10394,9,2,1,0,1,1
10394,8,8,2,0,6,2
10394,7,10,3,0,7,3
6453,9,1,1,0,0,1
6453,7,5,2,0,3,2
6453,6,12,6,0,6,6
6453,5,11,7,0,4,7
6453,4,3,1,0,2,1
4586,8,4,1,0,3,1
4586,7,5,2,0,3,2
4586,6,4,1,0,3,1
4586,5,9,2,0,7,2
4586,4,6,2,0,4,2
8533,10,4,2,0,2,2
8533,9,1,1,0,0,1
8533,8,11,4,0,7,4
8533,7,6,4,0,2,4
8533,6,7,4,0,3,4
8533,5,3,2,0,1,2
101872,10,9,7,0,2,7
101872,9,9,6,0,3,6
101872,8,5,4,0,1,4
101872,7,3,1,0,2,1
101872,6,1,1,0,0,1
101872,4,1,1,0,0,1
34655,7,1,1,0,0,1
34655,6,11,4,0,7,4
34655,5,6,1,0,5,1
34655,4,5,1,0,4,1
34655,3,3,2,0,1,2
34655,2,3,3,0,0,3
34655,1,1,1,0,0,1
5224,10,2,1,0,1,1
5224,7,8,3,0,5,3
5224,6,14,2,0,12,2
5224,5,6,1,0,5,1
215389,9,1,1,0,0,1
215389,8,10,5,0,5,5
215389,7,7,1,0,6,1
215389,6,4,1,0,3,1
215389,4,2,1,0,1,1
183400,8,8,3,0,5,3
183400,7,10,3,0,7,3
183400,6,5,2,0,3,2
183400,5,2,1,0,1,1
183400,4,4,2,0,2,2
20533,7,6,2,0,4,2
20533,6,13,4,0,9,4
20533,5,2,1,0,1,1
20533,3,2,1,0,1,1
20533,1,1,1,0,0,1
17738,7,7,6,0,1,6
17738,6,12,6,0,6,6
17738,5,6,3,0,3,3
17738,3,2,1,0,1,1
11027,8,3,2,0,1,2
11027,7,9,2,0,7,2
11027,6,11,3,0,8,3
11027,5,7,4,0,3,4
1935,6,14,6,0,8,6
1935,5,7,1,0,6,1
1935,4,4,2,0,2,2
1935,3,3,2,0,1,2
10917,9,1,1,0,0,1
10917,7,7,2,0,5,2
10917,6,8,5,0,3,5
10917,5,6,1,0,5,1
10917,4,6,1,0,5,1
234104,10,14,3,0,11,3
234104,7,3,1,0,2,1
234104,1,2,1,0,1,1
225909,9,8,3,0,5,3
225909,8,13,4,0,9,4
225909,7,7,2,0,5,2
225909,6,3,1,0,2,1
10584,9,2,1,0,1,1
10584,8,7,3,0,4,3
10584,7,9,6,0,3,6
10584,6,5,3,0,2,3
10584,5,3,1,0,2,1
10584,3,3,2,0,1,2
3951,8,2,1,0,1,1
3951,7,1,1,0,0,1
3951,6,15,5,0,10,5
3951,5,6,2,0,4,2
3951,4,4,2,0,2,2
3951,3,2,1,0,1,1
237585,10,4,2,0,2,2
237585,9,3,2,1,1,1
237585,8,4,1,0,3,1
237585,7,4,1,0,3,1
237585,1,6,2,1,4,1
154728,7,4,1,0,3,1
154728,6,9,4,0,5,4
154728,5,8,1,0,7,1
154728,4,3,1,0,2,1
9110,10,2,1,0,1,1
9110,6,9,4,0,5,4
9110,5,12,5,0,7,5
9110,3,2,1,0,1,1
16457,8,16,7,0,9,7
16457,7,9,1,0,8,1
16457,4,1,1,0,0,1
8526,8,3,2,0,1,2
8526,7,6,4,0,2,4
8526,6,12,2,0,10,2
8526,5,5,2,0,3,2
8526,4,3,1,0,2,1
8526,3,2,1,0,1,1
160545,10,2,1,0,1,1
160545,9,4,2,0,2,2
160545,8,4,2,0,2,2
160545,6,7,2,0,5,2
7186,10,2,1,0,1,1
7186,8,2,1,0,1,1
7186,6,7,2,0,5,2
7186,5,7,4,0,3,4
7186,4,5,2,0,3,2
12218,9,2,1,0,1,1
12218,8,10,4,0,6,4
12218,7,8,2,0,6,2
12218,4,2,1,0,1,1
92879,8,3,1,0,2,1
92879,7,5,2,0,3,2
92879,6,9,1,0,8,1
92879,5,8,3,0,5,3
92879,4,3,2,0,1,2
189427,10,3,1,0,2,1
189427,9,6,2,0,4,2
189427,8,15,1,0,14,1
189427,7,2,1,0,1,1
189427,3,1,1,0,0,1
5215,10,1,1,0,0,1
5215,8,4,2,0,2,2
5215,7,3,2,0,1,2
5215,6,14,7,0,7,7
5215,5,4,3,0,1,3
5215,4,3,2,0,1,2
5215,3,2,1,0,1,1
106969,10,2,1,0,1,1
106969,8,10,6,0,4,6
106969,7,5,1,0,4,1
106969,6,6,1,0,5,1
106969,4,2,1,0,1,1
41955,9,1,1,0,0,1
41955,7,4,1,0,3,1
41955,6,10,1,0,9,1
41955,4,5,2,0,3,2
235940,7,8,1,0,7,1
235940,5,6,1,0,5,1
235940,3,1,1,0,0,1
11071,8,2,1,0,1,1
11071,7,11,3,0,8,3
11071,6,5,1,0,4,1
11071,5,5,2,0,3,2
11071,4,5,4,0,1,4
11071,3,1,1,0,0,1
11071,2,1,1,0,0,1
11071,1,1,1,0,0,1
189123,10,9,3,0,6,3
189123,9,9,5,0,4,5
189123,8,6,1,0,5,1
189123,7,4,1,0,3,1
254585,10,3,1,0,2,1
254585,9,1,1,0,0,1
254585,8,3,1,0,2,1
254585,7,5,1,0,4,1
254585,6,10,1,0,9,1
254585,3,3,1,0,2,1
254585,2,4,1,0,3,1
19971,8,5,3,0,2,3
19971,7,5,1,0,4,1
19971,6,9,2,0,7,2
126159,8,6,3,0,3,3
126159,6,8,1,0,7,1
126159,5,4,1,0,3,1
126159,4,4,2,0,2,2
126159,3,4,1,0,3,1
220597,10,9,3,0,6,3
220597,9,5,1,0,4,1
220597,8,5,1,0,4,1
220597,1,2,1,0,1,1
16474,7,9,1,0,8,1
16474,6,12,4,0,8,4
16474,5,8,3,0,5,3
19696,6,10,1,0,9,1
19696,5,11,2,0,9,2
209320,10,3,1,0,2,1
209320,9,2,1,0,1,1
209320,8,12,2,1,10,1
209320,7,6,1,0,5,1
209320,6,3,2,0,1,2
53,8,5,2,0,3,2
53,6,11,2,0,9,2
53,5,6,1,0,5,1
14343,7,2,1,0,1,1
14343,6,15,3,0,12,3
14343,5,8,2,0,6,2
14343,4,2,1,0,1,1
180147,6,15,2,0,13,2
180147,5,7,1,0,6,1
180147,4,2,2,0,0,2
181889,9,6,1,0,5,1
181889,8,10,6,0,4,6
181889,6,6,2,0,4,2
181889,5,1,1,0,0,1
122711,8,3,1,0,2,1
122711,6,13,4,0,9,4
122711,5,8,5,0,3,5
122711,4,3,1,0,2,1
122711,2,2,2,0,0,2
136563,7,6,2,0,4,2
136563,6,11,3,0,8,3
136563,5,11,3,0,8,3
242818,10,2,2,0,0,2
242818,8,6,3,0,3,3
242818,7,8,2,0,6,2
242818,6,5,1,0,4,1
242818,5,2,1,0,1,1
242818,2,3,3,0,0,3
12129,10,3,1,0,2,1
12129,8,7,2,0,5,2
12129,7,6,2,0,4,2
12129,5,1,1,0,0,1
20774,10,2,1,0,1,1
20774,9,7,4,0,3,4
20774,8,7,3,0,4,3
20774,7,10,5,0,5,5
20774,5,1,1,0,0,1
9805,6,5,4,0,1,4
9805,5,6,1,0,5,1
9805,4,6,1,0,5,1
9805,3,4,2,0,2,2
9805,1,2,1,0,1,1
20989,6,11,2,0,9,2
20989,5,4,1,0,3,1
20989,4,5,2,0,3,2
20989,3,6,1,0,5,1
20989,2,2,1,0,1,1
218577,8,4,1,0,3,1
218577,6,12,3,0,9,3
218577,5,5,1,0,4,1
5210,8,7,3,0,4,3
5210,7,5,1,0,4,1
5210,6,10,4,0,6,4
5210,5,6,3,0,3,3
14077,10,1,1,0,0,1
14077,8,9,6,0,3,6
14077,7,7,5,0,2,5
14077,6,6,2,0,4,2
14077,5,3,2,0,1,2
14077,2,2,1,0,1,1
230130,9,2,1,0,1,1
230130,8,9,2,1,7,1
230130,4,3,2,0,1,2
230130,3,3,1,0,2,1
233951,10,13,2,0,11,2
233951,9,2,1,0,1,1
233951,8,6,2,0,4,2
233951,7,6,3,0,3,3
233951,6,4,1,0,3,1
35167,7,11,4,0,7,4
35167,5,6,2,0,4,2
35167,3,1,1,0,0,1
58396,6,9,1,0,8,1
58396,4,1,1,0,0,1
58396,3,6,3,0,3,3
58396,2,3,1,0,2,1
88872,10,1,1,0,0,1
88872,8,1,1,0,0,1
88872,6,7,2,0,5,2
88872,3,5,2,0,3,2
88872,2,3,2,0,1,2
68743,9,1,1,0,0,1
68743,8,4,2,0,2,2
68743,7,5,1,0,4,1
68743,6,14,3,0,11,3
68743,5,4,2,0,2,2
68743,4,3,1,0,2,1
5644,10,1,1,0,0,1
5644,6,6,1,0,5,1
5644,5,9,3,0,6,3
5644,3,6,3,0,3,3
5644,2,4,3,0,1,3
122809,10,2,1,0,1,1
122809,9,3,2,0,1,2
122809,8,17,7,0,10,7
127434,8,8,3,0,5,3
127434,7,2,2,0,0,2
127434,6,12,1,0,11,1
127434,4,3,1,0,2,1
127434,2,1,1,0,0,1
4285,8,2,1,0,1,1
4285,7,11,4,0,7,4
4285,6,12,2,0,10,2
4285,5,4,1,0,3,1
4285,3,1,1,0,0,1
1019,6,12,1,0,11,1
1019,3,2,1,0,1,1
143841,8,7,3,0,4,3
143841,7,4,3,0,1,3
143841,6,13,6,0,7,6
143841,5,3,1,0,2,1
143841,3,1,1,0,0,1
6625,9,2,1,0,1,1
6625,8,7,5,0,2,5
6625,7,9,3,0,6,3
6625,6,5,2,0,3,2
6625,4,4,1,0,3,1
6625,3,2,1,0,1,1
11561,7,3,1,0,2,1
11561,6,6,2,0,4,2
11561,5,11,2,0,9,2
11561,4,4,1,0,3,1
11561,3,1,1,0,0,1
11561,2,4,3,0,1,3
146765,9,3,2,0,1,2
146765,7,8,2,0,6,2
146765,6,7,3,0,4,3
146765,4,3,1,0,2,1
39431,8,1,1,0,0,1
39431,7,3,2,0,1,2
39431,5,8,2,0,6,2
39431,4,7,1,0,6,1
39431,3,2,1,0,1,1
8400,5,10,3,0,7,3
8400,4,8,4,0,4,4
8400,3,4,1,0,3,1
199247,6,6,1,0,5,1
199247,5,5,3,0,2,3
199247,4,4,1,0,3,1
2634,7,8,2,0,6,2
2634,6,10,3,0,7,3
2634,4,2,1,0,1,1
2634,2,1,1,0,0,1
16632,10,2,1,0,1,1
16632,7,4,2,0,2,2
16632,6,5,2,0,3,2
16632,5,5,1,0,4,1
16632,4,8,4,0,4,4
16632,3,2,2,0,0,2
16632,2,4,2,0,2,2
260786,10,5,1,0,4,1
260786,8,9,3,0,6,3
260786,7,5,1,0,4,1
4560,9,1,1,0,0,1
4560,7,1,1,0,0,1
4560,6,9,3,0,6,3
4560,5,7,3,0,4,3
4560,4,6,1,0,5,1
4560,3,5,1,0,4,1
4560,2,1,1,0,0,1
66245,6,11,1,0,10,1
66245,4,2,1,0,1,1
131126,7,7,3,0,4,3
131126,6,11,3,0,8,3
131126,5,6,4,0,2,4
179581,10,5,4,0,1,4
179581,9,5,1,0,4,1
179581,8,10,4,0,6,4
3096,9,1,1,0,0,1
3096,8,2,1,0,1,1
3096,7,7,2,0,5,2
3096,6,13,7,0,6,7
3096,5,4,2,0,2,2
3096,3,1,1,0,0,1
3096,1,1,1,0,0,1
4634,7,2,1,0,1,1
4634,6,8,1,0,7,1
4634,5,10,4,0,6,4
148049,7,9,1,0,8,1
148049,6,11,5,0,6,5
148049,5,6,2,0,4,2
148049,4,1,1,0,0,1
160494,9,3,3,0,0,3
160494,8,11,7,0,4,7
160494,7,11,3,0,8,3
160494,6,3,2,0,1,2
160494,5,2,1,0,1,1
617,7,6,2,0,4,2
617,6,10,1,0,9,1
617,5,5,2,0,3,2
617,3,1,1,0,0,1
617,2,3,1,0,2,1
37718,10,3,2,0,1,2
37718,9,2,1,0,1,1
37718,8,10,9,0,1,9
37718,7,8,4,0,4,4
37718,6,4,1,0,3,1
37718,2,1,1,0,0,1
17909,9,2,2,0,0,2
17909,7,8,1,0,7,1
17909,5,3,2,0,1,2
17909,3,1,1,0,0,1
43799,10,2,1,0,1,1
43799,7,5,2,0,3,2
43799,6,5,1,0,4,1
43799,5,5,3,0,2,3
43799,4,3,1,0,2,1
43799,3,3,3,0,0,3
43799,2,4,3,0,1,3
43799,1,1,1,0,0,1
260277,9,2,1,0,1,1
260277,7,11,1,0,10,1
260277,6,8,1,0,7,1
260277,4,3,1,0,2,1
19647,7,5,1,0,4,1
19647,5,10,4,0,6,4
11739,8,1,1,0,0,1
11739,5,3,1,0,2,1
11739,4,10,4,0,6,4
11739,3,5,4,0,1,4
11739,2,5,4,0,1,4
11739,1,2,2,0,0,2
184900,9,2,1,0,1,1
184900,7,8,3,0,5,3
184900,6,10,1,0,9,1
184900,5,5,1,0,4,1
27857,8,6,3,0,3,3
27857,7,4,1,0,3,1
27857,6,10,3,0,7,3
27857,5,7,2,0,5,2
27857,3,1,1,0,0,1
27857,2,1,1,0,0,1
8514,8,2,1,0,1,1
8514,6,10,2,0,8,2
8514,5,9,3,0,6,3
8514,4,3,1,0,2,1
8514,3,2,1,0,1,1
8514,1,2,1,0,1,1
19534,7,7,2,0,5,2
19534,6,11,5,0,6,5
19534,5,6,1,0,5,1
19534,4,3,3,0,0,3
19534,3,2,2,0,0,2
87280,8,1,1,0,0,1
87280,6,8,2,0,6,2
87280,5,11,4,0,7,4
26841,10,1,1,0,0,1
26841,6,6,2,0,4,2
26841,4,5,3,0,2,3
26841,3,3,1,0,2,1
26841,2,2,1,0,1,1
26841,1,4,3,0,1,3
14696,9,2,1,0,1,1
14696,7,5,1,0,4,1
14696,6,9,2,0,7,2
14696,5,3,2,0,1,2
14696,4,4,1,0,3,1
14696,3,3,2,0,1,2
14696,2,1,1,0,0,1
14696,1,3,2,0,1,2
1277,8,4,1,0,3,1
1277,7,11,4,0,7,4
1277,6,12,4,0,8,4
1277,5,2,1,0,1,1
204671,10,5,2,0,3,2
204671,9,1,1,0,0,1
204671,8,4,1,0,3,1
204671,7,6,3,0,3,3
204671,6,7,1,0,6,1
204671,2,3,2,0,1,2
7471,8,2,1,0,1,1
7471,7,3,1,0,2,1
7471,6,5,1,0,4,1
7471,5,8,4,0,4,4
7471,4,10,5,0,5,5
7471,2,1,1,0,0,1
186141,8,4,2,0,2,2
186141,6,13,1,0,12,1
186141,5,6,2,0,4,2
186141,4,1,1,0,0,1
151801,9,2,1,0,1,1
151801,8,4,1,0,3,1
151801,6,8,1,0,7,1
151801,4,2,1,0,1,1
151801,2,1,1,0,0,1
10270,7,2,2,0,0,2
10270,6,7,3,0,4,3
10270,5,5,2,0,3,2
10270,4,7,1,0,6,1
10270,3,2,1,0,1,1
10270,2,3,3,0,0,3
85076,8,10,7,0,3,7
85076,7,5,2,0,3,2
85076,6,10,4,0,6,4
85076,5,4,1,0,3,1
85076,3,1,1,0,0,1
9496,9,2,2,0,0,2
9496,7,4,1,0,3,1
9496,6,4,2,0,2,2
9496,5,5,2,0,3,2
186947,10,2,1,0,1,1
186947,9,1,1,1,0,0
186947,8,5,2,0,3,2
186947,7,6,1,0,5,1
186947,6,9,3,0,6,3
186947,4,4,1,0,3,1
209033,7,4,1,0,3,1
209033,5,3,1,0,2,1
209033,1,1,1,0,0,1
10090,8,1,1,0,0,1
10090,6,8,3,0,5,3
10090,4,12,1,0,11,1
12506,8,1,1,0,0,1
12506,7,10,2,0,8,2
12506,6,14,2,0,12,2
163688,8,4,1,0,3,1
163688,7,10,2,0,8,2
163688,6,10,5,0,5,5
163688,5,7,3,0,4,3
35482,7,1,1,0,0,1
35482,6,8,5,0,3,5
35482,5,6,4,0,2,4
35482,4,9,1,0,8,1
35482,3,5,1,0,4,1
226426,10,1,1,0,0,1
226426,9,2,2,0,0,2
226426,8,3,1,0,2,1
226426,7,7,1,0,6,1
226426,6,8,1,0,7,1
226426,4,3,1,0,2,1
226426,3,1,1,0,0,1
43486,8,5,3,0,2,3
43486,7,11,7,0,4,7
43486,6,9,4,0,5,4
43486,5,3,2,0,1,2
43486,4,2,1,0,1,1
10599,9,1,1,0,0,1
10599,8,1,1,0,0,1
10599,7,1,1,0,0,1
10599,6,8,4,0,4,4
10599,5,7,2,0,5,2
10599,4,7,4,0,3,4
10599,3,2,2,0,0,2
10599,2,4,3,0,1,3
11641,7,2,1,0,1,1
11641,6,5,1,0,4,1
11641,5,10,5,0,5,5
11641,4,9,3,0,6,3
11641,2,1,1,0,0,1
9320,8,1,1,0,0,1
9320,6,7,4,0,3,4
9320,5,7,3,0,4,3
9320,4,6,3,0,3,3
9320,3,3,2,0,1,2
9320,1,2,1,0,1,1
223330,9,3,1,0,2,1
223330,7,9,4,0,5,4
223330,6,9,2,0,7,2
223330,5,3,1,1,2,0
220367,10,6,2,0,4,2
220367,9,6,2,0,4,2
220367,8,8,3,0,5,3
220367,7,6,1,0,5,1
185383,10,1,1,0,0,1
185383,8,12,5,3,7,2
185383,7,10,4,1,6,3
185383,6,5,1,0,4,1
185383,5,1,1,0,0,1
185383,3,1,1,0,0,1
17576,6,11,4,0,7,4
17576,5,10,1,0,9,1
17576,4,4,1,0,3,1
17576,1,1,1,0,0,1
153807,8,6,1,0,5,1
153807,5,3,2,0,1,2
153807,4,4,1,0,3,1
153807,2,2,1,0,1,1
32224,9,2,2,0,0,2
32224,8,2,1,0,1,1
32224,7,3,1,0,2,1
32224,6,5,3,0,2,3
32224,4,9,4,0,5,4
32224,3,4,3,0,1,3
32224,2,3,2,0,1,2
32224,1,1,1,0,0,1
31235,6,5,1,0,4,1
31235,5,6,1,0,5,1
31235,4,5,2,0,3,2
31235,3,7,2,0,5,2
35658,6,9,5,0,4,5
35658,5,10,2,0,8,2
35658,4,7,5,0,2,5
35658,3,2,1,0,1,1
35658,2,2,1,0,1,1
136116,5,6,1,0,5,1
136116,4,6,1,0,5,1
663,10,2,2,0,0,2
663,6,8,3,0,5,3
663,4,7,2,0,5,2
663,3,4,2,0,2,2
663,1,1,1,0,0,1
2513,7,1,1,0,0,1
2513,6,7,3,0,4,3
2513,5,8,4,0,4,4
2513,3,2,1,0,1,1
2513,2,3,2,0,1,2
24042,7,10,2,0,8,2
24042,6,12,2,0,10,2
24042,5,2,1,0,1,1
24042,4,3,1,0,2,1
255633,10,4,1,0,3,1
255633,9,4,3,1,1,2
255633,8,12,4,0,8,4
255633,7,5,1,0,4,1
255633,5,1,1,0,0,1
225800,9,4,1,0,3,1
225800,8,12,4,0,8,4
225800,7,6,1,0,5,1
225800,6,3,1,0,2,1
225800,4,1,1,0,0,1
93493,9,4,4,0,0,4
93493,7,8,5,0,3,5
93493,6,7,4,0,3,4
93493,5,6,3,0,3,3
93493,2,1,1,0,0,1
217268,10,1,1,0,0,1
217268,8,6,2,0,4,2
217268,6,8,1,0,7,1
4585,8,4,3,0,1,3
4585,7,3,1,0,2,1
4585,6,13,5,0,8,5
4585,5,8,4,0,4,4
4585,4,1,1,0,0,1
4585,3,1,1,0,0,1
4585,2,1,1,0,0,1
190115,9,4,1,0,3,1
190115,8,11,2,0,9,2
190115,7,11,1,0,10,1
190115,6,2,1,0,1,1
19425,8,4,4,0,0,4
19425,6,4,1,0,3,1
19425,5,6,2,0,4,2
19425,4,4,1,0,3,1
19425,3,3,1,0,2,1
19425,1,4,2,0,2,2
6152,7,2,1,0,1,1
6152,6,6,2,0,4,2
6152,5,5,1,0,4,1
6152,4,6,3,0,3,3
6152,3,7,3,0,4,3
6152,2,4,3,0,1,3
2724,10,2,1,0,1,1
2724,6,11,2,0,9,2
2724,5,5,1,0,4,1
2724,4,7,3,0,4,3
2724,3,3,1,0,2,1
2724,2,2,2,0,0,2
17159,10,1,1,0,0,1
17159,8,2,1,0,1,1
17159,4,6,2,0,4,2
17159,2,2,1,0,1,1
17159,1,2,2,0,0,2
228419,3,2,1,0,1,1
6672,8,10,5,0,5,5
6672,7,10,2,0,8,2
6672,6,5,3,0,2,3
201144,9,2,1,0,1,1
201144,8,4,2,0,2,2
201144,7,12,4,0,8,4
201144,6,11,2,0,9,2
143745,10,3,1,0,2,1
143745,9,2,1,0,1,1
143745,8,8,3,0,5,3
143745,7,14,6,0,8,6
143745,5,2,1,0,1,1
196234,9,3,3,0,0,3
196234,8,5,3,1,2,2
196234,6,13,2,0,11,2
196234,5,3,1,0,2,1
196234,4,1,1,0,0,1
196234,3,2,1,0,1,1
13916,7,5,1,0,4,1
13916,6,8,4,0,4,4
13916,5,6,1,0,5,1
13916,4,3,1,0,2,1
13916,3,3,1,0,2,1
13916,2,4,3,0,1,3
193681,6,14,4,0,10,4
193681,5,7,1,0,6,1
193681,4,3,2,0,1,2
10432,9,2,1,0,1,1
10432,8,1,1,0,0,1
10432,6,7,4,0,3,4
10432,3,3,1,0,2,1
10432,2,3,2,0,1,2
2731,8,4,1,0,3,1
2731,7,10,3,0,7,3
2731,6,8,3,0,5,3
2731,5,7,3,0,4,3
4081,10,1,1,0,0,1
4081,7,3,1,0,2,1
4081,6,6,2,0,4,2
4081,5,10,3,0,7,3
4081,4,9,1,0,8,1
73360,10,1,1,0,0,1
73360,9,2,1,0,1,1
73360,6,14,5,0,9,5
73360,5,3,1,0,2,1
73360,3,2,2,0,0,2
257674,10,7,2,0,5,2
257674,8,5,3,0,2,3
257674,7,4,1,0,3,1
257674,6,5,1,0,4,1
257674,3,2,2,0,0,2
257674,1,3,1,1,2,0
3473,8,2,1,0,1,1
3473,7,3,1,0,2,1
3473,6,13,1,0,12,1
3473,5,7,2,0,5,2
3473,4,2,1,0,1,1
5936,7,3,1,0,2,1
5936,6,14,6,0,8,6
5936,5,11,2,0,9,2
5936,4,2,1,0,1,1
5936,1,1,1,0,0,1
201012,8,4,2,0,2,2
201012,7,6,2,0,4,2
201012,4,5,1,0,4,1
5605,8,3,1,0,2,1
5605,7,4,2,0,2,2
5605,6,10,1,0,9,1
5605,5,5,5,0,0,5
5605,4,5,1,0,4,1
5605,3,2,2,0,0,2
5605,2,2,1,0,1,1
30081,8,3,2,0,1,2
30081,7,9,5,0,4,5
30081,6,11,4,0,7,4
30081,5,4,2,0,2,2
30081,4,3,1,0,2,1
140859,10,3,2,0,1,2
140859,9,3,2,0,1,2
140859,7,3,1,0,2,1
140859,6,5,2,0,3,2
140859,3,3,1,0,2,1
147472,10,1,1,0,0,1
147472,8,1,1,0,0,1
147472,7,4,2,0,2,2
147472,6,14,1,0,13,1
147472,5,7,2,0,5,2
147472,3,2,1,0,1,1
11473,7,4,2,0,2,2
11473,6,14,7,0,7,7
11473,5,8,1,0,7,1
11473,4,3,1,0,2,1
65197,10,2,2,0,0,2
65197,6,8,1,0,7,1
65197,3,3,2,0,1,2
65197,1,2,1,0,1,1
57767,9,2,1,0,1,1
57767,7,7,1,0,6,1
57767,6,12,2,0,10,2
57767,5,3,1,0,2,1
57767,3,4,2,0,2,2
228687,7,4,1,0,3,1
228687,6,3,1,0,2,1
228687,4,10,3,0,7,3
228687,3,6,1,0,5,1
262341,9,3,1,0,2,1
262341,8,9,1,0,8,1
24109,10,13,8,0,5,8
24109,9,3,1,0,2,1
24109,8,1,1,0,0,1
24109,6,2,2,0,0,2
24109,2,2,2,0,0,2
24109,1,4,2,0,2,2
86040,8,1,1,0,0,1
86040,7,8,2,0,6,2
86040,6,7,3,0,4,3
86040,5,7,4,0,3,4
86040,4,5,2,0,3,2
86040,3,1,1,0,0,1
86040,2,1,1,0,0,1
136244,8,1,1,0,0,1
136244,6,9,1,0,8,1
136244,5,9,3,0,6,3
136244,4,6,1,0,5,1
173372,8,5,1,0,4,1
173372,3,1,1,0,0,1
40006,8,6,2,0,4,2
40006,7,11,5,0,6,5
40006,6,8,1,0,7,1
25302,9,3,1,0,2,1
25302,8,7,2,0,5,2
25302,7,10,2,0,8,2
25302,6,5,2,0,3,2
25302,5,4,1,0,3,1
25461,7,7,1,0,6,1
25461,6,10,1,0,9,1
25461,5,8,2,0,6,2
25461,4,3,2,0,1,2
177002,10,5,3,0,2,3
177002,9,3,3,0,0,3
177002,7,4,1,0,3,1
177002,6,6,1,0,5,1
177002,4,3,2,0,1,2
120770,8,9,2,0,7,2
120770,7,9,1,0,8,1
120770,6,8,5,1,3,4
120770,5,3,1,0,2,1
120770,3,2,1,0,1,1
18562,8,1,1,0,0,1
18562,7,3,2,0,1,2
18562,6,6,3,0,3,3
18562,5,6,4,0,2,4
18562,3,4,2,0,2,2
18562,2,5,1,0,4,1
124264,8,7,4,0,3,4
124264,6,12,5,0,7,5
124264,4,2,1,0,1,1
20409,8,4,1,0,3,1
20409,7,10,1,0,9,1
20409,6,7,1,0,6,1
20409,5,7,3,0,4,3
20409,4,1,1,0,0,1
20409,3,2,1,0,1,1
164975,10,6,1,0,5,1
164975,7,4,1,0,3,1
164975,6,8,3,0,5,3
164975,4,1,1,0,0,1
27944,10,3,1,0,2,1
27944,9,1,1,0,0,1
27944,8,17,7,0,10,7
27944,7,8,2,0,6,2
27944,6,1,1,0,0,1
27944,4,1,1,0,0,1
121813,8,7,1,0,6,1
121813,7,7,2,0,5,2
121813,6,7,1,0,6,1
121813,4,4,2,0,2,2
121813,3,1,1,0,0,1
121813,2,1,1,0,0,1
246508,10,4,2,0,2,2
246508,8,12,9,0,3,9
246508,7,4,1,0,3,1
246508,3,1,1,0,0,1
118537,10,11,4,0,7,4
118537,8,9,1,0,8,1
118537,7,4,2,0,2,2
118537,6,2,1,0,1,1
118537,5,2,1,0,1,1
77454,7,8,2,0,6,2
77454,6,7,1,0,6,1
77454,5,5,1,0,4,1
77454,4,3,1,0,2,1
77454,3,3,1,0,2,1
77454,2,2,1,0,1,1
205496,9,3,1,0,2,1
205496,7,8,5,0,3,5
205496,6,12,1,0,11,1
205496,5,4,1,0,3,1
233080,10,3,1,0,2,1
233080,9,1,1,0,0,1
233080,8,3,1,0,2,1
233080,7,13,4,2,9,2
233080,6,7,2,0,5,2
180340,8,4,3,0,1,3
180340,7,3,1,0,2,1
180340,6,14,1,0,13,1
180340,5,8,3,0,5,3
215796,8,1,1,0,0,1
215796,6,11,1,0,10,1
215796,5,4,1,0,3,1
215796,3,5,3,0,2,3
15483,8,1,1,0,0,1
15483,7,9,1,0,8,1
15483,6,10,4,0,6,4
15483,5,7,3,0,4,3
15483,3,2,1,0,1,1
81263,6,12,1,0,11,1
81263,4,2,1,0,1,1
81263,3,3,1,0,2,1
19916,8,4,1,0,3,1
19916,6,5,1,0,4,1
19916,5,13,4,0,9,4
19916,4,3,2,0,1,2
201048,10,4,2,0,2,2
201048,8,3,2,0,1,2
201048,7,5,3,0,2,3
201048,6,6,2,0,4,2
201048,4,5,2,0,3,2
201048,2,1,1,0,0,1
10354,8,5,3,0,2,3
10354,6,10,6,0,4,6
10354,4,4,2,0,2,2
10354,3,2,1,0,1,1
10354,2,2,2,0,0,2
10354,1,1,1,0,0,1
99166,8,2,1,0,1,1
99166,7,5,1,0,4,1
99166,6,13,3,0,10,3
99166,5,7,2,0,5,2
99166,4,2,1,0,1,1
99166,2,1,1,0,0,1
28068,7,6,1,0,5,1
28068,6,5,1,0,4,1
28068,5,6,1,0,5,1
28068,4,4,2,0,2,2
28068,2,2,1,0,1,1
134769,9,15,7,0,8,7
134769,8,11,2,0,9,2
134769,7,2,1,0,1,1
200959,10,4,2,0,2,2
200959,9,3,2,0,1,2
200959,8,10,2,0,8,2
200959,7,9,4,0,5,4
200959,6,3,1,0,2,1
154327,10,1,1,0,0,1
154327,8,3,2,1,1,1
154327,7,5,1,0,4,1
154327,6,10,6,0,4,6
154327,5,6,1,1,5,0
154327,4,2,1,0,1,1
154327,3,1,1,1,0,0
58861,7,10,3,0,7,3
58861,4,4,1,0,3,1
58861,3,3,1,0,2,1
236827,2,2,1,0,1,1
116735,8,5,3,0,2,3
116735,7,13,6,0,7,6
116735,6,10,4,0,6,4
116735,5,1,1,0,0,1
171742,10,3,2,0,1,2
171742,9,3,1,0,2,1
171742,8,11,5,0,6,5
171742,7,12,2,0,10,2
102698,10,8,4,0,4,4
102698,8,9,3,1,6,2
102698,6,5,1,0,4,1
11208,7,9,4,0,5,4
11208,6,5,3,0,2,3
11208,5,9,3,0,6,3
11208,4,5,1,0,4,1
11208,3,1,1,0,0,1
145587,7,7,2,0,5,2
145587,6,9,4,0,5,4
145587,5,6,3,0,3,3
145587,3,4,1,0,3,1
2033,5,7,1,0,6,1
2033,4,10,5,0,5,5
2033,3,8,2,0,6,2
196953,9,2,1,0,1,1
196953,7,4,1,0,3,1
196953,5,9,1,0,8,1
196953,4,4,2,0,2,2
196953,3,2,1,0,1,1
196953,1,1,1,0,0,1
116194,7,7,1,0,6,1
116194,6,15,3,0,12,3
210350,9,2,1,0,1,1
210350,8,7,2,0,5,2
210350,7,6,1,0,5,1
210350,6,8,1,0,7,1
210350,5,3,1,0,2,1
210350,1,2,2,0,0,2
10368,8,3,2,0,1,2
10368,7,1,1,0,0,1
10368,6,11,4,0,7,4
10368,5,8,2,0,6,2
10368,1,1,1,0,0,1
231215,10,2,1,0,1,1
231215,9,4,1,0,3,1
231215,8,9,5,0,4,5
231215,6,7,1,0,6,1
73244,9,1,1,0,0,1
73244,8,3,1,0,2,1
73244,7,14,3,0,11,3
73244,6,8,2,0,6,2
73244,5,4,2,0,2,2
73244,3,1,1,0,0,1
30456,5,8,2,0,6,2
30456,4,7,3,0,4,3
30456,2,5,2,0,3,2
30456,1,2,1,0,1,1
15676,9,2,1,0,1,1
15676,8,5,3,0,2,3
15676,7,10,1,0,9,1
15676,6,6,3,0,3,3
15676,5,5,1,0,4,1
15676,4,1,1,0,0,1
17821,10,11,10,0,1,10
17821,9,5,2,0,3,2
17821,8,12,8,0,4,8
36604,9,3,2,0,1,2
36604,8,5,4,0,1,4
36604,7,15,2,0,13,2
36604,6,3,1,0,2,1
36604,5,1,1,0,0,1
57239,8,1,1,0,0,1
57239,7,2,1,0,1,1
57239,6,10,3,0,7,3
57239,5,10,4,0,6,4
57239,4,4,2,0,2,2
57239,2,1,1,0,0,1
19633,9,1,1,0,0,1
19633,6,5,2,0,3,2
19633,5,4,1,0,3,1
19633,4,5,1,0,4,1
19633,3,10,4,0,6,4
19633,2,3,1,0,2,1
19633,1,2,1,0,1,1
222913,8,12,2,0,10,2
222913,7,10,2,0,8,2
161206,3,2,1,0,1,1
36538,7,4,1,0,3,1
36538,6,11,2,0,9,2
36538,5,7,2,0,5,2
36538,4,3,1,0,2,1
4508,9,2,1,0,1,1
4508,8,1,1,0,0,1
4508,6,8,4,0,4,4
4508,5,6,1,0,5,1
4508,4,9,6,0,3,6
158163,9,2,1,0,1,1
158163,6,7,2,0,5,2
254322,8,12,1,0,11,1
254322,6,5,1,0,4,1
254322,5,2,1,0,1,1
254322,3,1,1,0,0,1
254322,2,2,1,0,1,1
9018,10,2,1,0,1,1
9018,8,8,4,0,4,4
9018,7,8,5,0,3,5
9018,6,8,2,0,6,2
9018,5,1,1,0,0,1
9018,4,2,1,0,1,1
9018,2,1,1,0,0,1
231574,9,4,1,0,3,1
231574,8,17,5,0,12,5
131812,7,2,1,0,1,1
131812,5,3,1,0,2,1
131812,4,2,1,0,1,1
131812,2,4,2,0,2,2
231035,9,6,1,0,5,1
231035,8,13,5,0,8,5
231035,7,5,1,0,4,1
231035,5,3,1,0,2,1
209322,9,8,4,0,4,4
209322,8,3,1,0,2,1
209322,7,9,1,0,8,1
209322,5,1,1,0,0,1
160537,8,5,3,1,2,2
160537,7,5,1,1,4,0
160537,6,10,5,0,5,5
160537,5,3,1,0,2,1
160537,3,3,1,0,2,1
5819,10,2,2,0,0,2
5819,8,4,3,0,1,3
5819,7,6,2,0,4,2
5819,6,4,3,0,1,3
5819,5,6,1,0,5,1
5819,4,5,3,0,2,3
5819,3,3,3,0,0,3
55999,10,7,5,0,2,5
55999,8,6,2,0,4,2
55999,7,7,3,0,4,3
55999,6,7,1,0,6,1
55999,5,1,1,0,0,1
9076,7,5,3,0,2,3
9076,6,16,6,0,10,6
9076,5,3,1,0,2,1
9076,4,1,1,0,0,1
9076,3,1,1,0,0,1
42259,10,4,3,0,1,3
42259,9,1,1,0,0,1
42259,8,2,2,0,0,2
42259,7,1,1,0,0,1
42259,6,1,1,0,0,1
42259,3,3,1,0,2,1
42259,1,15,9,0,6,9
230976,6,6,1,0,5,1
230976,5,8,3,0,5,3
230976,4,5,1,0,4,1
230976,3,4,2,0,2,2
230976,2,4,1,0,3,1
28292,7,2,1,0,1,1
28292,6,10,2,0,8,2
28292,5,6,1,0,5,1
28292,4,5,1,0,4,1
28292,3,2,1,0,1,1
28292,2,1,1,0,0,1
4383,6,8,3,0,5,3
4383,5,10,2,0,8,2
73536,8,5,1,0,4,1
73536,6,8,1,0,7,1
6526,10,1,1,0,0,1
6526,7,10,2,0,8,2
6526,6,12,4,0,8,4
6526,5,4,1,0,3,1
15432,10,2,1,0,1,1
15432,8,5,1,0,4,1
15432,7,10,4,0,6,4
15432,6,7,1,0,6,1
975,7,6,2,0,4,2
975,6,13,4,0,9,4
975,5,6,1,0,5,1
37854,7,8,2,0,6,2
37854,4,3,1,0,2,1
37854,1,1,1,0,0,1
152985,8,14,1,0,13,1
152985,7,5,1,0,4,1
31846,10,4,2,0,2,2
31846,9,2,1,0,1,1
31846,8,12,3,0,9,3
31846,7,6,5,0,1,5
31846,6,3,3,0,0,3
31846,5,3,3,0,0,3
7060,10,2,1,0,1,1
7060,8,1,1,0,0,1
7060,7,4,1,0,3,1
7060,6,14,8,0,6,8
7060,5,5,5,0,0,5
7060,4,2,1,0,1,1
150422,10,1,1,0,0,1
150422,8,4,4,0,0,4
150422,7,9,4,0,5,4
150422,6,13,9,0,4,9
150422,4,1,1,0,0,1
150422,1,2,1,0,1,1
12281,7,7,3,0,4,3
12281,6,8,3,0,5,3
12281,4,4,2,0,2,2
191512,8,3,1,0,2,1
191512,7,6,2,0,4,2
191512,6,8,2,0,6,2
191512,3,4,1,0,3,1
10392,6,15,9,0,6,9
10392,3,2,1,0,1,1
90002,10,2,1,0,1,1
90002,9,2,1,0,1,1
90002,8,6,2,0,4,2
90002,7,10,3,0,7,3
90002,6,6,3,0,3,3
90002,4,1,1,0,0,1
90002,3,1,1,0,0,1
75445,7,3,1,0,2,1
75445,6,14,1,0,13,1
75445,5,5,1,0,4,1
170609,7,6,2,0,4,2
170609,6,9,3,1,6,2
170609,4,1,1,0,0,1
170609,1,1,1,0,0,1
85948,8,3,1,0,2,1
85948,7,13,2,0,11,2
85948,6,4,2,0,2,2
85948,4,2,1,0,1,1
27127,9,3,1,0,2,1
27127,8,8,5,0,3,5
27127,7,13,4,0,9,4
27127,6,2,1,0,1,1
27127,5,2,1,0,1,1
27127,4,1,1,0,0,1
157593,10,3,2,0,1,2
157593,8,5,2,1,3,1
157593,6,5,1,1,4,0
157593,4,7,3,0,4,3
157593,3,1,1,0,0,1
3335,8,3,1,0,2,1
3335,7,8,4,0,4,4
3335,6,8,3,0,5,3
36250,9,1,1,0,0,1
36250,8,2,1,0,1,1
36250,7,5,2,0,3,2
36250,6,11,3,0,8,3
36250,5,5,2,0,3,2
36250,4,1,1,0,0,1
36250,3,4,2,0,2,2
27460,7,7,1,0,6,1
27460,6,10,3,0,7,3
27460,5,4,1,0,3,1
27460,4,6,1,0,5,1
27460,3,1,1,0,0,1
164059,10,8,1,0,7,1
164059,8,15,4,0,11,4
164059,7,2,2,0,0,2
93164,9,1,1,0,0,1
93164,8,4,1,0,3,1
93164,7,3,2,0,1,2
93164,6,13,7,0,6,7
93164,5,3,1,0,2,1
93164,4,3,1,0,2,1
93164,3,3,3,0,0,3
6687,8,3,1,0,2,1
6687,7,9,4,0,5,4
6687,6,7,1,0,6,1
6687,5,5,2,0,3,2
6687,4,3,1,0,2,1
6687,3,1,1,0,0,1
51367,8,2,1,0,1,1
51367,6,13,3,0,10,3
51367,4,4,1,0,3,1
232385,10,2,1,0,1,1
232385,8,3,1,0,2,1
232385,7,9,2,0,7,2
232385,5,7,4,0,3,4
27876,8,2,1,0,1,1
27876,7,5,1,0,4,1
27876,5,8,2,0,6,2
234977,9,1,1,0,0,1
234977,8,3,2,0,1,2
234977,7,9,2,0,7,2
234977,6,8,1,0,7,1
12943,9,1,1,0,0,1
12943,8,6,1,0,5,1
12943,7,4,2,0,2,2
12943,6,7,2,0,5,2
12943,5,6,2,0,4,2
12943,4,3,1,0,2,1
140626,8,6,6,0,0,6
140626,7,15,3,0,12,3
140626,6,5,1,0,4,1
140626,4,1,1,0,0,1
259069,10,1,1,0,0,1
259069,9,2,1,0,1,1
177807,8,4,1,0,3,1
177807,6,5,3,0,2,3
177807,3,5,2,0,3,2
129465,6,7,1,0,6,1
129465,1,3,1,0,2,1
69815,9,3,1,0,2,1
69815,8,9,3,0,6,3
69815,7,9,3,0,6,3
69815,6,6,2,0,4,2
69815,3,1,1,0,0,1
8644,8,3,3,0,0,3
8644,7,6,2,0,4,2
8644,6,7,2,0,5,2
8644,5,8,1,0,7,1
8644,3,1,1,0,0,1
8644,2,1,1,0,0,1
775,7,4,2,0,2,2
775,6,16,6,0,10,6
775,4,3,2,0,1,2
40072,8,3,2,0,1,2
40072,6,10,3,0,7,3
40072,5,7,2,0,5,2
40072,3,1,1,0,0,1
88881,7,1,1,0,0,1
88881,5,7,1,0,6,1
88881,4,9,3,0,6,3
88881,3,5,1,0,4,1
88881,2,2,1,0,1,1
242589,10,3,3,0,0,3
242589,8,19,6,0,13,6
242589,7,3,1,0,2,1
38824,7,7,3,0,4,3
38824,6,11,5,0,6,5
38824,5,5,1,0,4,1
38824,3,1,1,0,0,1
38824,2,2,2,0,0,2
2991,10,1,1,0,0,1
2991,7,4,1,0,3,1
2991,6,7,2,0,5,2
2991,4,7,1,0,6,1
2991,3,5,3,0,2,3
2550,8,3,1,0,2,1
2550,5,8,2,0,6,2
2550,4,4,1,0,3,1
2550,2,3,3,0,0,3
2550,1,1,1,0,0,1
23212,9,5,2,0,3,2
23212,7,6,2,0,4,2
23212,6,7,1,0,6,1
23212,5,6,1,0,5,1
23212,4,3,1,0,2,1
15164,8,4,2,0,2,2
15164,7,10,4,0,6,4
15164,2,1,1,0,0,1
15164,1,2,1,0,1,1
84247,9,1,1,0,0,1
84247,8,3,1,0,2,1
84247,7,7,3,0,4,3
84247,6,11,2,0,9,2
84247,5,7,1,0,6,1
6981,6,1,1,0,0,1
6981,5,4,1,0,3,1
6981,4,12,3,0,9,3
6981,3,6,1,0,5,1
6981,2,4,2,0,2,2
3447,6,4,1,0,3,1
3447,4,8,4,0,4,4
3447,3,8,4,0,4,4
3447,1,2,2,0,0,2
262114,10,17,9,0,8,9
262114,9,5,3,0,2,3
262114,8,4,1,0,3,1
262114,6,1,1,0,0,1
18732,10,1,1,0,0,1
18732,7,4,2,0,2,2
18732,6,10,3,0,7,3
18732,5,2,1,0,1,1
18732,4,3,1,0,2,1
18732,3,3,2,0,1,2
197551,6,13,1,0,12,1
14146,6,3,1,0,2,1
14146,5,4,2,0,2,2
14146,4,7,2,0,5,2
14146,3,10,5,0,5,5
14146,2,2,2,0,0,2
587,8,7,1,0,6,1
587,7,6,2,0,4,2
587,6,7,3,0,4,3
587,4,3,2,0,1,2
587,3,1,1,0,0,1
16440,8,3,1,0,2,1
16440,7,2,1,0,1,1
16440,6,5,1,0,4,1
16440,5,6,1,0,5,1
16440,4,8,5,0,3,5
23596,9,1,1,0,0,1
23596,7,7,3,0,4,3
23596,6,10,3,0,7,3
23596,5,8,2,0,6,2
183511,10,9,1,0,8,1
183511,9,2,1,0,1,1
183511,7,6,1,0,5,1
183511,6,4,2,0,2,2
183511,2,3,2,0,1,2
39545,10,1,1,0,0,1
39545,9,3,2,0,1,2
39545,8,2,1,0,1,1
39545,6,7,1,0,6,1
39545,5,4,2,0,2,2
39545,4,1,1,0,0,1
39545,3,4,4,0,0,4
39545,1,1,1,0,0,1
40350,6,10,2,0,8,2
40350,4,4,2,0,2,2
40350,3,2,1,0,1,1
40350,2,6,1,0,5,1
40350,1,5,2,0,3,2
231273,7,8,2,0,6,2
231273,5,4,1,0,3,1
231273,4,2,1,0,1,1
195696,9,1,1,0,0,1
195696,8,4,3,1,1,2
195696,6,7,1,0,6,1
195696,5,7,1,0,6,1
195696,2,2,1,0,1,1
195696,1,3,1,0,2,1
90092,7,7,2,0,5,2
3423,10,4,2,0,2,2
3423,8,5,5,0,0,5
3423,7,8,5,0,3,5
3423,6,3,3,0,0,3
3423,5,7,1,0,6,1
3423,4,2,2,0,0,2
3423,3,1,1,0,0,1
225689,10,17,13,0,4,13
225689,9,4,3,0,1,3
225689,6,3,1,0,2,1
34825,8,3,2,0,1,2
34825,6,7,4,0,3,4
34825,5,8,2,0,6,2
34825,4,3,1,0,2,1
34825,3,3,1,0,2,1
34825,1,2,1,0,1,1
9759,10,2,1,0,1,1
9759,9,3,1,0,2,1
9759,8,5,2,0,3,2
9759,7,7,1,0,6,1
9759,6,7,1,0,6,1
9759,5,4,1,0,3,1
32789,5,5,1,0,4,1
32789,2,2,1,0,1,1
36232,7,1,1,0,0,1
36232,6,5,3,0,2,3
36232,5,4,2,0,2,2
36232,4,8,3,0,5,3
36232,3,5,1,0,4,1
36232,2,4,3,0,1,3
133423,9,1,1,0,0,1
133423,8,4,3,0,1,3
133423,5,5,1,0,4,1
133423,4,8,3,0,5,3
133423,3,4,2,0,2,2
175924,10,1,1,0,0,1
175924,9,2,2,0,0,2
175924,8,4,2,0,2,2
175924,7,7,2,0,5,2
175924,6,10,1,0,9,1
162070,9,3,1,0,2,1
162070,6,11,3,0,8,3
162070,3,1,1,0,0,1
208340,10,8,4,0,4,4
208340,9,6,1,0,5,1
208340,8,11,1,0,10,1
208340,7,4,1,0,3,1
251213,8,15,5,0,10,5
251213,7,10,3,0,7,3
251213,6,5,3,0,2,3
20647,6,2,1,0,1,1
20647,5,7,3,0,4,3
20647,4,5,1,0,4,1
20647,3,6,2,0,4,2
20647,2,5,2,0,3,2
20647,1,4,3,0,1,3
91664,8,1,1,0,0,1
91664,6,10,2,0,8,2
91664,5,10,1,0,9,1
91664,4,5,1,0,4,1
10275,10,2,1,0,1,1
10275,9,1,1,0,0,1
10275,6,5,2,0,3,2
10275,4,5,2,0,3,2
10275,2,3,1,0,2,1
10275,1,2,1,0,1,1
5411,8,4,1,0,3,1
5411,7,9,5,0,4,5
5411,6,7,1,0,6,1
5411,4,4,2,0,2,2
169077,10,2,1,0,1,1
169077,8,3,1,0,2,1
169077,5,1,1,0,0,1
169077,3,3,2,1,1,1
169077,2,3,3,0,0,3
169077,1,1,1,0,0,1
14116,8,1,1,0,0,1
14116,7,5,2,0,3,2
14116,6,6,2,0,4,2
14116,5,7,2,0,5,2
14116,4,9,4,0,5,4
250963,8,5,2,0,3,2
250963,7,11,4,0,7,4
250963,6,4,1,0,3,1
250963,4,1,1,0,0,1
250963,3,1,1,0,0,1
123399,10,4,2,0,2,2
123399,8,7,4,0,3,4
123399,7,6,1,0,5,1
123399,6,9,1,0,8,1
123399,5,1,1,0,0,1
233501,8,3,1,0,2,1
233501,7,7,3,0,4,3
233501,6,9,3,0,6,3
233501,5,4,2,0,2,2
233501,4,4,1,0,3,1
5282,8,4,1,0,3,1
5282,7,2,1,0,1,1
5282,6,6,2,0,4,2
5282,5,5,2,0,3,2
5282,4,6,2,0,4,2
5282,3,3,2,0,1,2
5282,2,2,2,0,0,2
10266,10,1,1,0,0,1
10266,9,3,1,0,2,1
10266,8,5,2,0,3,2
10266,6,8,2,0,6,2
10266,5,5,2,0,3,2
87871,8,2,2,0,0,2
87871,7,4,1,0,3,1
87871,5,6,1,0,5,1
137637,9,4,3,0,1,3
137637,8,4,2,0,2,2
137637,7,10,4,0,6,4
137637,6,11,5,0,6,5
175735,9,1,1,0,0,1
175735,8,5,3,0,2,3
175735,7,12,4,0,8,4
175735,5,3,1,0,2,1
144374,8,3,1,0,2,1
144374,6,6,2,0,4,2
144374,4,8,1,0,7,1
942,7,1,1,0,0,1
942,6,6,2,0,4,2
942,5,14,7,0,7,7
942,1,1,1,0,0,1
6892,7,7,1,0,6,1
6892,5,9,2,0,7,2
6892,4,3,1,0,2,1
6892,3,4,3,0,1,3
7194,8,1,1,0,0,1
7194,7,6,3,0,3,3
7194,6,10,6,0,4,6
7194,4,7,1,0,6,1
208419,10,1,1,0,0,1
208419,9,2,1,0,1,1
208419,7,10,1,0,9,1
208419,4,4,1,0,3,1
256999,1,4,2,1,2,1
162295,7,11,3,0,8,3
16973,6,3,1,0,2,1
16973,3,7,1,0,6,1
16973,2,4,1,0,3,1
16973,1,2,2,0,0,2
232351,9,3,2,0,1,2
232351,5,8,1,0,7,1
232351,4,4,2,0,2,2
232351,3,5,1,0,4,1
232351,2,1,1,0,0,1
28017,7,8,1,0,7,1
28017,6,9,5,0,4,5
28017,5,3,1,0,2,1
14196,9,1,1,0,0,1
14196,7,12,3,0,9,3
14196,5,7,3,0,4,3
6221,8,4,1,0,3,1
6221,7,6,2,0,4,2
6221,6,14,6,0,8,6
6221,5,3,1,0,2,1
6221,4,1,1,0,0,1
6221,3,1,1,0,0,1
4392,8,5,2,0,3,2
4392,6,8,3,0,5,3
4392,5,6,3,0,3,3
4392,4,3,2,0,1,2
187769,8,4,1,0,3,1
187769,7,7,3,0,4,3
187769,6,16,4,0,12,4
187769,5,2,1,0,1,1
8960,8,4,2,0,2,2
8960,7,6,1,0,5,1
8960,6,11,2,0,9,2
8960,3,1,1,0,0,1
17579,7,1,1,0,0,1
17579,6,7,5,0,2,5
17579,5,10,2,0,8,2
17579,4,6,3,0,3,3
17579,3,5,2,0,3,2
22801,6,6,1,0,5,1
22801,5,9,4,0,5,4
22801,4,9,2,0,7,2
22801,3,4,2,0,2,2
16389,8,3,2,0,1,2
16389,7,9,6,0,3,6
16389,6,12,8,0,4,8
16389,5,4,2,0,2,2
73238,8,5,2,0,3,2
73238,7,11,1,0,10,1
73238,4,2,2,0,0,2
73238,3,1,1,0,0,1
188930,5,5,1,0,4,1
193103,10,3,1,0,2,1
193103,9,4,2,0,2,2
193103,8,12,7,0,5,7
193103,7,6,1,0,5,1
193103,6,3,2,0,1,2
193103,5,1,1,0,0,1
23818,9,2,1,0,1,1
23818,8,12,5,0,7,5
23818,7,9,2,0,7,2
23818,4,3,1,0,2,1
43043,6,10,1,0,9,1
43043,5,7,1,0,6,1
43043,4,6,1,0,5,1
43043,1,1,1,0,0,1
9784,10,3,2,0,1,2
9784,9,2,1,0,1,1
9784,8,6,1,0,5,1
9784,7,2,2,0,0,2
9784,6,8,1,0,7,1
9784,4,2,1,0,1,1
9784,3,2,1,0,1,1
20708,9,2,1,0,1,1
20708,8,5,2,0,3,2
20708,7,10,2,0,8,2
20708,6,6,2,0,4,2
20708,5,4,2,0,2,2
20708,1,1,1,0,0,1
252315,10,16,6,1,10,5
252315,9,3,1,0,2,1
252315,8,5,2,0,3,2
252315,2,1,1,0,0,1
2549,7,2,1,0,1,1
2549,6,7,2,0,5,2
2549,5,5,1,0,4,1
2549,3,9,2,0,7,2
199497,10,3,1,0,2,1
199497,9,4,3,0,1,3
199497,8,4,1,0,3,1
199497,5,1,1,0,0,1
199497,1,2,1,0,1,1
211882,7,10,2,0,8,2
211882,6,9,1,0,8,1
211882,5,6,1,0,5,1
22289,7,3,2,0,1,2
22289,6,6,1,0,5,1
22289,5,6,1,0,5,1
22289,2,2,1,0,1,1
221208,10,1,1,0,0,1
221208,7,10,3,0,7,3
221208,6,10,4,0,6,4
221208,4,4,3,0,1,3
179628,6,11,1,0,10,1
179628,5,7,3,0,4,3
179628,3,4,3,0,1,3
16272,9,2,2,0,0,2
16272,8,4,3,0,1,3
16272,7,8,4,0,4,4
16272,6,8,3,0,5,3
16272,5,5,3,0,2,3
230864,6,5,2,0,3,2
230864,4,8,1,0,7,1
230864,3,8,3,0,5,3
21124,8,1,1,0,0,1
21124,6,9,2,0,7,2
21124,5,4,2,0,2,2
21124,4,5,2,0,3,2
21124,3,7,2,0,5,2
21124,1,2,1,0,1,1
199401,6,3,1,0,2,1
199401,4,6,1,0,5,1
199401,3,8,1,0,7,1
19000,5,10,1,0,9,1
19000,4,7,1,0,6,1
19000,3,3,2,0,1,2
15462,9,1,1,0,0,1
15462,8,2,1,0,1,1
15462,7,2,2,0,0,2
15462,6,5,2,0,3,2
15462,5,3,2,0,1,2
15462,4,12,3,0,9,3
15462,2,3,1,0,2,1
206202,10,1,1,0,0,1
206202,9,5,2,0,3,2
206202,8,9,3,0,6,3
206202,7,9,3,0,6,3
206202,6,2,1,0,1,1
1802,7,2,2,0,0,2
1802,6,4,2,0,2,2
1802,5,7,1,0,6,1
1802,4,9,4,0,5,4
99227,10,1,1,0,0,1
99227,8,5,2,0,3,2
99227,7,5,1,0,4,1
99227,6,12,6,0,6,6
107029,6,8,1,0,7,1
107029,5,9,2,0,7,2
107029,4,6,1,0,5,1
107029,3,3,1,0,2,1
107029,2,1,1,0,0,1
110434,8,2,1,0,1,1
110434,7,2,1,0,1,1
110434,5,5,1,0,4,1
110434,4,9,4,0,5,4
110434,3,2,2,0,0,2
6851,7,2,1,0,1,1
6851,5,5,1,0,4,1
6851,4,11,4,0,7,4
6851,3,4,2,0,2,2
24020,10,6,2,0,4,2
24020,9,5,1,0,4,1
24020,7,7,3,0,4,3
24020,6,5,2,0,3,2
29419,9,1,1,0,0,1
29419,8,2,1,0,1,1
29419,6,5,1,0,4,1
29419,5,6,2,0,4,2
29419,4,6,1,0,5,1
29419,2,8,2,0,6,2
29419,1,1,1,0,0,1
165470,10,1,1,0,0,1
165470,7,4,1,0,3,1
165470,6,7,1,0,6,1
165470,5,5,1,0,4,1
165470,3,3,1,0,2,1
240096,10,12,7,1,5,6
240096,9,7,5,0,2,5
240096,8,5,1,0,4,1
240096,7,3,1,0,2,1
8349,8,1,1,0,0,1
8349,7,3,2,0,1,2
8349,6,7,5,0,2,5
8349,5,6,1,0,5,1
8349,4,6,3,0,3,3
8349,3,3,2,0,1,2
8349,2,3,1,0,2,1
202516,10,3,1,0,2,1
202516,5,5,1,0,4,1
98350,7,2,1,1,1,0
98350,5,5,3,0,2,3
98350,4,6,5,0,1,5
98350,3,4,3,1,1,2
98350,2,6,2,0,4,2
98350,1,1,1,0,0,1
13132,6,3,2,0,1,2
13132,5,9,2,0,7,2
13132,4,7,3,0,4,3
13132,3,6,3,0,3,3
13132,2,3,1,0,2,1
201453,9,2,1,0,1,1
201453,8,3,1,0,2,1
201453,6,6,1,0,5,1
201453,5,6,3,0,3,3
201453,4,4,1,0,3,1
201453,3,7,2,0,5,2
201453,2,2,1,0,1,1
109070,9,9,3,0,6,3
109070,8,11,2,0,9,2
109070,7,3,2,0,1,2
33169,4,7,2,0,5,2
33169,3,4,2,0,2,2
33169,2,4,2,0,2,2
33169,1,1,1,0,0,1
12238,5,6,3,0,3,3
12238,4,8,3,0,5,3
12238,3,8,1,0,7,1
12238,2,2,2,0,0,2
88554,7,5,1,0,4,1
88554,5,7,2,0,5,2
88554,4,6,1,0,5,1
88554,3,4,2,0,2,2
88554,2,2,1,0,1,1
182400,10,3,1,0,2,1
182400,8,4,1,0,3,1
182400,7,7,1,0,6,1
182400,6,10,2,0,8,2
182400,1,3,1,0,2,1
136712,7,8,1,0,7,1
136712,6,11,2,0,9,2
136712,5,6,1,0,5,1
67112,8,5,2,0,3,2
67112,7,10,2,0,8,2
67112,5,4,1,0,3,1
67112,3,2,1,0,1,1
15998,7,7,1,0,6,1
15998,3,1,1,0,0,1
248385,9,4,1,0,3,1
2145,10,2,2,0,0,2
2145,9,1,1,0,0,1
2145,8,4,2,0,2,2
2145,7,5,2,0,3,2
2145,6,7,1,0,6,1
2145,5,8,2,0,6,2
2145,4,2,1,0,1,1
72566,4,5,1,0,4,1
72566,3,2,1,0,1,1
676,8,2,1,0,1,1
676,7,3,3,0,0,3
676,6,4,1,0,3,1
676,5,7,1,0,6,1
676,4,5,2,0,3,2
676,2,3,1,0,2,1
676,1,2,2,0,0,2
15175,7,1,1,0,0,1
15175,6,1,1,0,0,1
15175,5,5,2,0,3,2
15175,4,5,2,0,3,2
15175,3,10,7,0,3,7
15175,2,6,5,0,1,5
15175,1,1,1,0,0,1
8102,10,2,1,0,1,1
8102,8,2,1,0,1,1
8102,7,8,3,0,5,3
8102,6,8,4,0,4,4
8102,3,1,1,0,0,1
8102,2,2,2,0,0,2
90735,10,3,1,0,2,1
90735,6,6,2,0,4,2
90735,5,7,1,0,6,1
90735,4,6,1,0,5,1
241083,8,2,1,0,1,1
241083,7,6,1,0,5,1
241083,4,6,3,0,3,3
228328,10,7,1,0,6,1
228328,8,8,3,0,5,3
228328,7,9,1,0,8,1
228328,5,1,1,0,0,1
37127,6,10,2,0,8,2
37127,5,9,3,0,6,3
37127,4,4,1,0,3,1
143070,9,2,1,0,1,1
143070,8,5,2,0,3,2
143070,6,11,3,0,8,3
143070,5,3,1,0,2,1
143070,4,5,1,0,4,1
143070,2,2,2,0,0,2
34383,7,3,1,0,2,1
34383,6,10,3,0,7,3
34383,5,8,3,0,5,3
2097,8,2,2,0,0,2
2097,7,5,1,0,4,1
2097,6,9,5,0,4,5
2097,5,4,2,0,2,2
2097,4,5,1,0,4,1
2097,3,3,1,0,2,1
267314,8,6,2,0,4,2
267314,7,17,2,0,15,2
267314,5,4,1,0,3,1
168077,9,2,1,0,1,1
168077,8,12,3,0,9,3
168077,5,2,1,0,1,1
168077,4,2,1,0,1,1
5266,8,2,1,0,1,1
5266,7,5,2,0,3,2
5266,6,9,3,0,6,3
5266,5,5,1,0,4,1
5266,4,5,1,0,4,1
220827,10,14,8,2,6,6
220827,8,8,4,0,4,4
220827,5,2,1,0,1,1
5011,7,4,1,0,3,1
5011,6,12,2,0,10,2
5011,5,4,1,0,3,1
5011,4,8,4,0,4,4
5011,3,1,1,0,0,1
129969,9,2,1,0,1,1
129969,7,16,3,0,13,3
245904,8,6,2,0,4,2
245904,7,10,2,0,8,2
245904,6,7,3,1,4,2
245904,5,2,1,0,1,1
245904,4,1,1,0,0,1
2030,7,8,4,0,4,4
2030,6,9,5,0,4,5
2030,5,6,4,0,2,4
2030,4,1,1,0,0,1
2030,3,3,1,0,2,1
30010,10,4,1,0,3,1
30010,8,5,4,0,1,4
30010,7,3,1,0,2,1
30010,6,11,7,0,4,7
30010,5,4,1,0,3,1
30010,3,2,1,0,1,1
30010,2,1,1,0,0,1
135732,10,4,2,0,2,2
135732,9,6,3,0,3,3
135732,1,1,1,0,0,1
14422,6,4,1,0,3,1
14422,4,11,4,0,7,4
14422,3,5,4,0,1,4
14422,2,3,2,0,1,2
15877,7,4,1,0,3,1
15877,5,8,2,0,6,2
15877,4,3,3,0,0,3
15877,3,1,1,0,0,1
15877,2,1,1,0,0,1
253319,8,7,2,0,5,2
253319,7,11,5,0,6,5
253319,6,7,1,0,6,1
253319,5,3,1,0,2,1
253319,4,1,1,0,0,1
14013,8,8,1,0,7,1
14013,7,8,2,0,6,2
14013,6,8,2,0,6,2
14013,5,3,1,0,2,1
12662,8,7,4,0,3,4
12662,7,13,2,0,11,2
12662,6,5,4,0,1,4
12662,4,1,1,0,0,1
1546,8,2,1,0,1,1
1546,4,2,2,0,0,2
1546,3,3,1,0,2,1
1546,2,7,3,0,4,3
1546,1,11,7,0,4,7
16975,8,2,2,0,0,2
16975,6,7,1,0,6,1
16975,5,7,1,0,6,1
16975,4,5,4,0,1,4
16975,3,3,2,0,1,2
236577,9,3,2,0,1,2
236577,8,6,3,0,3,3
236577,6,9,1,0,8,1
236577,4,2,1,1,1,0
206074,10,6,2,0,4,2
206074,9,4,2,0,2,2
206074,7,7,2,0,5,2
218074,9,11,2,1,9,1
218074,8,5,2,0,3,2
218074,5,1,1,0,0,1
1752,7,4,1,0,3,1
1752,6,5,1,0,4,1
1752,5,7,3,0,4,3
1752,4,7,4,0,3,4
1752,2,2,2,0,0,2
1752,1,3,1,0,2,1
15828,7,7,1,0,6,1
15828,6,7,1,0,6,1
6809,7,5,3,0,2,3
6809,6,8,1,0,7,1
6809,5,9,3,0,6,3
6809,3,4,1,0,3,1
228742,10,1,1,0,0,1
228742,8,12,3,0,9,3
228742,6,7,2,0,5,2
228742,4,1,1,0,0,1
228742,2,1,1,0,0,1
152822,7,4,2,0,2,2
152822,6,13,1,0,12,1
152822,5,5,1,0,4,1
152822,4,4,2,0,2,2
153319,10,9,7,0,2,7
153319,8,4,1,0,3,1
153319,7,2,1,0,1,1
153319,6,5,1,0,4,1
153319,5,5,1,0,4,1
153319,4,2,1,0,1,1
8188,8,4,4,0,0,4
8188,7,5,1,0,4,1
8188,6,11,2,0,9,2
8188,4,4,1,0,3,1
164022,10,5,2,0,3,2
164022,9,5,2,0,3,2
164022,8,4,2,0,2,2
164022,7,6,2,0,4,2
164022,6,6,1,0,5,1
164022,5,3,2,0,1,2
151467,6,17,2,0,15,2
151467,4,3,1,0,2,1
59650,10,2,1,0,1,1
59650,9,5,1,0,4,1
59650,8,8,2,0,6,2
59650,7,4,2,0,2,2
59650,6,5,2,0,3,2
59650,4,1,1,0,0,1
59650,3,2,1,0,1,1
230246,8,9,3,0,6,3
230246,7,12,1,0,11,1
230246,6,6,1,0,5,1
130626,7,5,1,0,4,1
130626,6,13,3,0,10,3
130626,5,3,1,0,2,1
130626,4,6,2,0,4,2
11402,9,1,1,0,0,1
11402,7,3,2,0,1,2
11402,6,14,3,0,11,3
11402,5,4,1,0,3,1
11402,4,3,2,0,1,2
11402,2,1,1,0,0,1
11402,1,1,1,0,0,1
93867,8,1,1,0,0,1
93867,7,6,3,0,3,3
93867,6,12,5,0,7,5
93867,5,7,1,0,6,1
93867,3,1,1,0,0,1
93867,2,1,1,0,0,1
117558,10,10,7,1,3,6
117558,9,4,1,1,3,0
117558,8,7,1,0,6,1
117558,4,3,2,0,1,2
244502,9,3,1,0,2,1
244502,8,6,1,0,5,1
244502,7,6,2,0,4,2
244502,6,8,2,0,6,2
244502,2,1,1,0,0,1
243343,8,5,2,0,3,2
243343,7,7,2,0,5,2
243343,6,10,3,0,7,3
243343,4,5,1,0,4,1
195149,10,8,3,0,5,3
195149,9,2,1,0,1,1
195149,8,8,3,1,5,2
195149,7,4,1,0,3,1
195149,4,2,1,0,1,1
3788,7,5,1,0,4,1
3788,6,8,1,0,7,1
3788,5,10,2,0,8,2
3788,4,3,1,0,2,1
122820,7,8,1,0,7,1
122820,4,5,1,0,4,1
122820,2,1,1,0,0,1
96266,9,1,1,0,0,1
96266,8,7,3,0,4,3
96266,7,12,7,0,5,7
96266,6,6,3,0,3,3
96266,5,3,2,0,1,2
96266,4,1,1,0,0,1
4695,8,4,2,0,2,2
4695,7,7,1,0,6,1
4695,6,5,1,0,4,1
4695,5,6,2,0,4,2
4695,4,5,2,0,3,2
35813,9,1,1,0,0,1
35813,8,8,1,0,7,1
35813,7,8,3,0,5,3
35813,6,10,4,0,6,4
35813,5,1,1,0,0,1
237927,10,6,1,0,5,1
237927,9,3,1,0,2,1
237927,8,9,1,1,8,0
13024,7,8,1,0,7,1
13024,6,10,3,0,7,3
13024,5,7,1,0,6,1
13024,4,3,1,0,2,1
247643,8,6,1,0,5,1
247643,6,9,1,0,8,1
250396,10,4,2,0,2,2
250396,9,11,4,0,7,4
250396,8,10,3,0,7,3
250396,7,3,1,0,2,1
250396,5,1,1,0,0,1
220848,10,4,2,0,2,2
220848,9,6,1,0,5,1
220848,7,8,1,0,7,1
220848,6,6,2,0,4,2
21,7,6,4,0,2,4
21,6,10,4,0,6,4
21,5,3,1,0,2,1
21,4,3,2,0,1,2
21,3,4,2,0,2,2
21,1,1,1,0,0,1
171430,8,4,2,0,2,2
171430,7,7,5,0,2,5
171430,6,10,4,0,6,4
171430,5,6,3,0,3,3
171430,4,2,1,0,1,1
3039,7,6,2,0,4,2
3039,6,11,4,0,7,4
3039,5,5,2,0,3,2
3039,4,1,1,0,0,1
3039,2,2,2,0,0,2
12584,8,3,2,0,1,2
12584,7,5,2,0,3,2
12584,5,4,2,0,2,2
254634,9,5,1,0,4,1
254634,8,15,6,0,9,6
254634,7,5,3,0,2,3
254634,6,1,1,0,0,1
254634,4,1,1,0,0,1
4738,7,5,1,0,4,1
4738,6,7,1,0,6,1
4738,5,10,2,0,8,2
4738,3,3,2,0,1,2
4738,1,1,1,0,0,1
4999,10,2,1,0,1,1
4999,8,2,2,0,0,2
4999,6,6,4,0,2,4
4999,5,8,3,0,5,3
4999,4,6,2,0,4,2
4999,2,2,1,0,1,1
248641,10,6,2,0,4,2
248641,9,10,4,0,6,4
248641,8,8,2,0,6,2
248641,5,2,1,0,1,1
23724,8,9,4,0,5,4
23724,7,9,5,0,4,5
166215,9,1,1,0,0,1
166215,8,8,5,0,3,5
166215,7,7,3,0,4,3
166215,6,9,3,0,6,3
166215,5,3,1,0,2,1
2101,6,11,1,0,10,1
2101,4,5,1,0,4,1
2101,3,1,1,0,0,1
5926,7,4,1,0,3,1
5926,6,10,5,0,5,5
5926,5,7,1,0,6,1
5926,4,7,3,0,4,3
5926,3,1,1,0,0,1
14625,7,5,2,0,3,2
14625,6,8,4,0,4,4
14625,5,9,3,0,6,3
14625,1,1,1,0,0,1
3355,9,1,1,0,0,1
3355,8,4,2,0,2,2
3355,7,5,2,0,3,2
3355,6,8,2,0,6,2
3355,5,7,4,0,3,4
3355,4,5,3,0,2,3
145765,8,1,1,0,0,1
145765,7,8,1,0,7,1
145765,6,9,2,0,7,2
145765,5,6,1,0,5,1
145765,4,5,2,0,3,2
135794,8,1,1,0,0,1
135794,7,9,1,0,8,1
135794,6,13,5,0,8,5
135794,4,4,1,0,3,1
222291,10,10,5,0,5,5
222291,9,5,3,0,2,3
222291,8,8,4,0,4,4
222291,7,5,1,0,4,1
32450,8,1,1,0,0,1
32450,7,4,1,0,3,1
32450,6,12,5,0,7,5
32450,5,7,2,0,5,2
32450,2,2,1,0,1,1
109732,7,3,1,0,2,1
109732,6,12,2,0,10,2
109732,4,4,1,0,3,1
109732,3,4,2,0,2,2
2791,7,1,1,0,0,1
2791,6,3,1,0,2,1
2791,5,4,2,0,2,2
2791,4,6,3,0,3,3
2791,3,9,4,0,5,4
2791,2,5,1,0,4,1
2791,1,2,1,0,1,1
5540,5,11,3,0,8,3
5540,4,5,1,0,4,1
5540,3,3,1,0,2,1
5540,2,2,1,0,1,1
4972,7,3,2,0,1,2
4972,6,13,6,0,7,6
4972,5,6,2,0,4,2
4972,4,5,2,0,3,2
4972,3,1,1,0,0,1
12557,8,2,2,0,0,2
12557,6,5,2,0,3,2
12557,5,2,1,0,1,1
12557,3,6,3,0,3,3
12557,2,4,2,0,2,2
12557,1,8,6,0,2,6
12133,7,5,3,0,2,3
12133,6,12,3,0,9,3
12133,3,3,2,0,1,2
12133,1,1,1,0,0,1
5396,10,4,3,0,1,3
5396,9,1,1,0,0,1
5396,8,5,1,0,4,1
5396,7,8,3,0,5,3
5396,6,6,3,0,3,3
5396,5,6,5,0,1,5
1862,7,3,1,0,2,1
1862,6,9,1,0,8,1
1862,5,6,1,0,5,1
238506,8,9,1,0,8,1
238506,7,11,1,0,10,1
238506,6,3,1,0,2,1
238506,5,2,1,0,1,1
8043,8,5,1,0,4,1
8043,7,8,2,0,6,2
8043,6,10,2,0,8,2
8043,5,4,1,0,3,1
16826,9,1,1,0,0,1
16826,8,3,2,0,1,2
16826,7,4,1,0,3,1
16826,6,15,7,0,8,7
16826,5,5,1,0,4,1
16826,4,2,1,0,1,1
9156,6,13,3,0,10,3
9156,5,4,2,0,2,2
90930,8,3,1,0,2,1
90930,7,8,1,0,7,1
90930,6,8,1,0,7,1
256742,10,8,2,0,6,2
256742,9,6,2,0,4,2
192245,7,9,3,0,6,3
192245,6,11,1,0,10,1
192245,5,4,1,0,3,1
6146,8,9,1,0,8,1
6146,7,11,3,0,8,3
6146,6,3,2,0,1,2
6146,5,4,1,0,3,1
244039,10,1,1,1,0,0
244039,9,3,1,0,2,1
244039,8,10,2,0,8,2
244039,7,9,3,0,6,3
10459,7,2,1,0,1,1
10459,6,10,3,0,7,3
10459,5,13,5,0,8,5
10459,4,4,2,0,2,2
8950,7,6,1,0,5,1
8950,6,11,4,0,7,4
8950,5,8,4,0,4,4
8950,3,3,2,0,1,2
8950,2,1,1,0,0,1
108100,7,3,1,0,2,1
108100,6,13,3,0,10,3
108100,3,4,1,0,3,1
8654,7,1,1,0,0,1
8654,6,3,2,0,1,2
8654,5,7,3,0,4,3
8654,4,9,4,0,5,4
8654,3,3,1,0,2,1
8654,2,2,1,0,1,1
250822,10,6,5,0,1,5
250822,9,14,3,0,11,3
250822,8,10,3,0,7,3
12743,10,2,1,0,1,1
12743,7,8,3,0,5,3
12743,6,8,3,0,5,3
12743,5,4,2,0,2,2
12743,4,3,3,0,0,3
10611,9,1,1,0,0,1
10611,8,6,3,0,3,3
10611,7,10,4,0,6,4
10611,6,8,3,0,5,3
10611,5,1,1,0,0,1
10611,3,1,1,0,0,1
237834,7,13,2,0,11,2
237834,6,10,2,0,8,2
13316,8,7,5,0,2,5
13316,7,5,1,0,4,1
13316,6,9,1,0,8,1
13316,2,1,1,0,0,1
12718,10,4,3,0,1,3
12718,9,5,1,0,4,1
12718,8,6,1,0,5,1
12718,7,11,2,0,9,2
12718,6,2,1,0,1,1
3628,7,6,1,0,5,1
3628,6,7,5,0,2,5
3628,5,8,1,0,7,1
3628,2,2,2,0,0,2
8902,10,2,1,0,1,1
8902,7,4,1,0,3,1
8902,6,12,1,0,11,1
8902,5,3,1,0,2,1
11466,10,5,3,0,2,3
11466,9,3,3,0,0,3
11466,8,5,3,0,2,3
11466,6,5,3,0,2,3
11466,5,6,2,0,4,2
11466,3,2,1,0,1,1
153501,6,10,1,0,9,1
153501,5,7,1,0,6,1
153501,4,3,2,0,1,2
209667,7,3,2,0,1,2
209667,6,18,3,0,15,3
209667,5,3,1,0,2,1
209667,4,3,2,0,1,2
209667,3,1,1,0,0,1
55686,8,3,1,0,2,1
55686,6,14,3,0,11,3
55686,4,3,1,0,2,1
84017,8,9,3,0,6,3
84017,7,7,1,0,6,1
84017,6,10,4,0,6,4
84017,4,2,1,0,1,1
10809,8,2,2,0,0,2
10809,7,9,1,0,8,1
10809,6,10,5,0,5,5
10809,5,6,1,0,5,1
10809,3,1,1,0,0,1
10809,2,1,1,0,0,1
23257,8,2,1,0,1,1
23257,7,4,2,0,2,2
23257,6,6,3,0,3,3
23257,5,4,3,0,1,3
23257,4,5,4,0,1,4
23257,3,4,4,0,0,4
23257,2,5,4,0,1,4
9272,7,3,1,0,2,1
9272,6,8,1,0,7,1
9272,5,11,1,0,10,1
13392,10,2,1,0,1,1
13392,9,1,1,0,0,1
13392,7,5,2,0,3,2
13392,6,6,2,0,4,2
13392,4,3,2,0,1,2
13392,3,2,1,0,1,1
8256,7,3,2,0,1,2
8256,6,7,3,0,4,3
8256,4,8,4,0,4,4
8256,3,6,4,0,2,4
8256,2,3,2,0,1,2
822,10,4961,1015,0,3946,1015
822,9,9470,1599,0,7871,1599
822,8,28514,4723,0,23791,4723
822,7,23931,3608,0,20323,3608
822,6,12440,2181,0,10259,2181
822,5,3193,629,0,2564,629
822,4,1253,311,0,942,311
822,3,445,107,0,338,107
822,2,180,37,0,143,37
822,1,77,19,0,58,19
30549,10,5924,1064,1,4860,1063
30549,9,12746,1858,0,10888,1858
30549,8,31444,4394,0,27050,4394
30549,7,18969,2461,0,16508,2461
30549,6,9420,1457,0,7963,1457
30549,5,2473,452,0,2021,452
30549,4,1043,246,0,797,246
30549,3,458,129,0,329,129
30549,2,215,65,0,150,65
30549,1,124,37,0,87,37
1406,0,1,0,0,1,0
34219,1,14,0,0,14,0
198773,1,18,0,0,18,0
160477,1,5,0,0,5,0
42215,1,7,0,0,7,0
176396,1,3,0,0,3,0
170042,1,8,0,0,8,0
15363,1,11,0,0,11,0
5404,1,20,0,0,20,0
27708,1,17,0,0,17,0
27746,1,9,0,0,9,0
394,1,6,0,0,6,0
21882,1,5,0,0,5,0
97903,1,8,0,0,8,0
131366,1,7,0,0,7,0
219513,1,3,0,0,3,0
194607,1,11,0,0,11,0
171499,1,2,0,0,2,0
7854,2,17,0,0,17,0
7854,1,21,0,0,21,0
144344,1,8,0,0,8,0
169124,1,8,0,0,8,0
17329,1,3,0,0,3,0
158600,2,9,0,0,9,0
158600,1,3,0,0,3,0
192153,1,13,0,0,13,0
196340,2,2,0,0,2,0
177639,1,2,0,0,2,0
203993,1,5,0,0,5,0
236457,2,3,0,0,3,0
171273,1,8,0,0,8,0
224517,2,4,0,0,4,0
224517,1,12,0,0,12,0
13642,1,7,0,0,7,0
18833,1,12,0,0,12,0
217372,1,4,0,0,4,0
220877,2,1,0,0,1,0
220877,1,5,0,0,5,0
91872,1,11,0,0,11,0
554,1,9,0,0,9,0
58421,1,12,0,0,12,0
232043,1,5,0,0,5,0
162007,1,2,0,0,2,0
9440,1,10,0,0,10,0
225694,1,5,0,0,5,0
191977,1,8,0,0,8,0
66505,1,8,0,0,8,0
119,1,7,0,0,7,0
124,1,5,0,0,5,0
2955,1,4,0,0,4,0
166669,2,5,0,0,5,0
166669,1,5,0,0,5,0
42776,1,14,0,0,14,0
152162,1,3,0,0,3,0
182134,1,5,0,0,5,0
154246,1,2,0,0,2,0
182631,3,7,0,0,7,0
182631,1,8,0,0,8,0
161614,2,4,0,0,4,0
132,1,6,0,0,6,0
2338,1,10,0,0,10,0
2346,1,13,0,0,13,0
12902,1,15,0,0,15,0
94362,1,9,0,0,9,0
194880,1,3,0,0,3,0
41916,1,4,0,0,4,0
144592,2,5,0,0,5,0
19100,1,6,0,0,6,0
142326,2,4,0,0,4,0
121288,1,15,0,0,15,0
106217,1,9,0,0,9,0
143515,2,3,0,0,3,0
143515,1,3,0,0,3,0
179572,1,3,0,0,3,0
171669,1,1,0,0,1,0
206941,2,3,0,0,3,0
206941,1,3,0,0,3,0
200077,1,3,0,0,3,0
199792,2,3,0,0,3,0
35570,1,6,0,0,6,0
205398,2,3,0,0,3,0
205398,1,2,0,0,2,0
228341,1,5,0,0,5,0
528,1,3,0,0,3,0
132372,1,7,0,0,7,0
176734,2,4,0,0,4,0
192458,2,2,0,0,2,0
149155,1,1,0,0,1,0
150999,2,4,0,0,4,0
150999,1,5,0,0,5,0
986,1,5,0,0,5,0
4396,1,10,0,0,10,0
37196,1,8,0,0,8,0
193042,1,10,0,0,10,0
16747,1,8,0,0,8,0
153065,1,4,0,0,4,0
55600,1,5,0,0,5,0
154809,1,4,0,0,4,0
36235,2,1,0,0,1,0
6887,1,8,0,0,8,0
244228,1,3,0,0,3,0
193558,1,4,0,0,4,0
229220,2,2,0,0,2,0
189932,2,5,0,0,5,0
131325,2,4,0,0,4,0
45986,1,12,0,0,12,0
26566,2,4,0,0,4,0
180511,1,4,0,0,4,0
220520,2,3,0,0,3,0
220520,1,3,0,0,3,0
902,1,6,0,0,6,0
5432,0,1,0,0,1,0
191231,1,3,0,0,3,0
232219,2,5,0,0,5,0
130176,3,12,0,0,12,0
130176,1,4,0,0,4,0
145639,1,2,0,0,2,0
183880,2,10,0,0,10,0
242574,1,3,0,0,3,0
3737,10,10,0,0,10,0
492,1,5,0,0,5,0
134453,1,5,0,0,5,0
30381,1,6,0,0,6,0
95064,1,8,0,0,8,0
246192,2,1,0,0,1,0
246192,1,3,0,0,3,0
165722,1,4,0,0,4,0
151022,1,3,0,0,3,0
24827,1,5,0,0,5,0
141517,1,6,0,0,6,0
216459,1,1,0,0,1,0
142992,1,4,0,0,4,0
217,1,3,0,0,3,0
15511,1,4,0,0,4,0
38386,10,23,0,0,23,0
38386,1,2,0,0,2,0
177590,1,2,0,0,2,0
13780,1,9,0,0,9,0
11901,0,1,0,0,1,0
65901,1,9,0,0,9,0
31999,1,11,0,0,11,0
19841,1,4,0,0,4,0
1544,1,7,0,0,7,0
21550,2,5,0,0,5,0
527,1,7,0,0,7,0
105037,1,4,0,0,4,0
181687,1,1,0,0,1,0
242302,1,6,0,0,6,0
41010,1,3,0,0,3,0
29223,1,1,0,0,1,0
13551,1,5,0,0,5,0
67492,1,12,0,0,12,0
98229,1,4,0,0,4,0
147303,2,4,0,0,4,0
178336,1,2,0,0,2,0
125,1,2,0,0,2,0
168609,1,3,0,0,3,0
32116,1,6,0,0,6,0
160495,1,1,0,0,1,0
197443,2,2,0,0,2,0
23094,1,7,0,0,7,0
233247,1,3,0,0,3,0
50768,1,6,0,0,6,0
191051,2,6,0,0,6,0
176165,1,1,0,0,1,0
116954,2,3,0,0,3,0
116954,1,3,0,0,3,0
162,1,3,0,0,3,0
185589,1,5,0,0,5,0
72991,1,5,0,0,5,0
2569,1,5,0,0,5,0
92319,2,5,0,0,5,0
92319,1,6,0,0,6,0
40354,3,5,0,0,5,0
183562,4,19,0,0,19,0
183562,2,3,0,0,3,0
34194,1,7,0,0,7,0
181345,1,3,0,0,3,0
246784,1,2,0,0,2,0
23686,1,12,0,0,12,0
27356,2,6,0,0,6,0
27356,1,8,0,0,8,0
17053,1,1,0,0,1,0
38862,1,6,0,0,6,0
205597,1,1,0,0,1,0
192860,1,3,0,0,3,0
68182,1,4,0,0,4,0
118174,1,2,0,0,2,0
24773,2,3,0,0,3,0
70,1,4,0,0,4,0
1275,1,5,0,0,5,0
3228,1,5,0,0,5,0
60435,1,5,0,0,5,0
187377,2,3,0,0,3,0
6068,1,2,0,0,2,0
15510,1,4,0,0,4,0
195043,1,2,0,0,2,0
141423,1,4,0,0,4,0
437,1,2,0,0,2,0
180680,1,1,0,0,1,0
82420,3,8,0,0,8,0
4394,1,5,0,0,5,0
8190,1,1,0,0,1,0
32341,1,6,0,0,6,0
90040,1,4,0,0,4,0
156091,3,12,0,0,12,0
156091,2,6,0,0,6,0
156091,1,7,0,0,7,0
75449,1,4,0,0,4,0
632,1,4,0,0,4,0
234277,3,8,0,0,8,0
234277,1,3,0,0,3,0
27976,2,2,0,0,2,0
27976,1,9,0,0,9,0
67877,1,2,0,0,2,0
180040,3,9,0,0,9,0
180040,1,1,0,0,1,0
28089,1,5,0,0,5,0
9027,1,5,0,0,5,0
75358,1,4,0,0,4,0
191876,2,3,0,0,3,0
8129,1,2,0,0,2,0
16216,1,9,0,0,9,0
37400,1,2,0,0,2,0
164265,2,5,0,0,5,0
164265,1,2,0,0,2,0
37371,1,2,0,0,2,0
143405,2,3,0,0,3,0
143405,1,3,0,0,3,0
198525,1,1,0,0,1,0
172381,2,4,0,0,4,0
150145,1,2,0,0,2,0
103185,1,2,0,0,2,0
94246,2,4,0,0,4,0
3800,1,4,0,0,4,0
245654,2,2,0,0,2,0
245654,1,3,0,0,3,0
1608,1,4,0,0,4,0
40237,1,6,0,0,6,0
6795,1,3,0,0,3,0
218333,2,1,0,0,1,0
218333,1,1,0,0,1,0
38992,1,1,0,0,1,0
15290,1,4,0,0,4,0
158435,1,6,0,0,6,0
9441,2,4,0,0,4,0
144270,2,4,0,0,4,0
144270,1,2,0,0,2,0
111799,1,5,0,0,5,0
135219,1,7,0,0,7,0
30658,1,6,0,0,6,0
35761,1,4,0,0,4,0
224597,1,6,0,0,6,0
181524,1,2,0,0,2,0
191894,2,4,0,0,4,0
191894,1,2,0,0,2,0
167513,1,6,0,0,6,0
22198,1,1,0,0,1,0
193949,1,2,0,0,2,0
164338,1,1,0,0,1,0
235488,1,1,0,0,1,0
195162,2,1,0,0,1,0
1334,1,1,0,0,1,0
34599,1,7,0,0,7,0
18745,1,2,0,0,2,0
22484,3,8,0,0,8,0
22484,1,6,0,0,6,0
26997,1,8,0,0,8,0
67185,2,4,0,0,4,0
67185,1,4,0,0,4,0
36522,1,4,0,0,4,0
635,1,1,0,0,1,0
103092,2,4,0,0,4,0
103092,1,4,0,0,4,0
144041,1,3,0,0,3,0
31624,1,4,0,0,4,0
8095,1,9,0,0,9,0
117960,10,5,0,0,5,0
40769,1,1,0,0,1,0
37387,1,2,0,0,2,0
35435,1,1,0,0,1,0
701,2,6,0,0,6,0
72,1,6,0,0,6,0
247763,2,2,0,0,2,0
247763,1,5,0,0,5,0
154086,1,1,0,0,1,0
186751,1,8,0,0,8,0
38545,1,3,0,0,3,0
176544,3,2,0,0,2,0
176544,2,1,0,0,1,0
176544,1,1,0,0,1,0
5406,1,4,0,0,4,0
152237,1,1,0,0,1,0
180899,1,3,0,0,3,0
24703,1,7,0,0,7,0
172933,2,4,0,0,4,0
172933,1,2,0,0,2,0
111148,1,5,0,0,5,0
38863,2,2,0,0,2,0
38863,1,2,0,0,2,0
171879,2,1,0,0,1,0
171879,1,1,0,0,1,0
136280,2,4,0,0,4,0
136280,1,1,0,0,1,0
883,1,2,0,0,2,0
76674,1,3,0,0,3,0
12589,1,4,0,0,4,0
187617,1,5,0,0,5,0
144189,1,6,0,0,6,0
25224,1,3,0,0,3,0
206931,2,1,0,0,1,0
63759,2,1,0,0,1,0
75165,1,6,0,0,6,0
144826,1,9,0,0,9,0
147253,3,7,0,0,7,0
140863,10,14,0,0,14,0
140863,1,4,0,0,4,0
9341,2,1,0,0,1,0
9341,1,4,0,0,4,0
192074,1,3,0,0,3,0
175,2,3,0,0,3,0
691,1,5,0,0,5,0
146418,1,5,0,0,5,0
153016,3,3,0,0,3,0
153016,2,3,0,0,3,0
153016,1,4,0,0,4,0
181293,1,6,0,0,6,0
163413,1,1,0,0,1,0
123239,2,2,0,0,2,0
123239,1,4,0,0,4,0
103649,1,2,0,0,2,0
137330,1,2,0,0,2,0
2393,1,5,0,0,5,0
218530,1,1,0,0,1,0
37907,1,5,0,0,5,0
123219,2,1,0,0,1,0
134157,1,4,0,0,4,0
117942,1,2,0,0,2,0
181796,1,1,0,0,1,0
228504,2,1,0,0,1,0
153507,1,1,0,0,1,0
209418,3,6,0,0,6,0
209418,2,2,0,0,2,0
209418,1,5,0,0,5,0
85036,1,3,0,0,3,0
29839,1,4,0,0,4,0
655,10,4,0,0,4,0
73,1,2,0,0,2,0
66588,1,3,0,0,3,0
195528,2,1,0,0,1,0
195528,1,2,0,0,2,0
19,1,3,0,0,3,0
218417,3,5,0,0,5,0
218417,2,4,0,0,4,0
71906,1,3,0,0,3,0
36811,1,5,0,0,5,0
254640,3,1,0,0,1,0
254640,1,1,0,0,1,0
30367,2,5,0,0,5,0
30367,1,4,0,0,4,0
89409,1,6,0,0,6,0
144529,1,6,0,0,6,0
20022,2,7,0,0,7,0
1899,1,4,0,0,4,0
173442,2,1,0,0,1,0
165401,1,2,0,0,2,0
195137,1,2,0,0,2,0
168681,1,1,0,0,1,0
14,1,2,0,0,2,0
231581,2,3,0,0,3,0
231581,1,2,0,0,2,0
132028,4,12,0,0,12,0
132028,2,6,0,0,6,0
1822,1,5,0,0,5,0
63543,1,4,0,0,4,0
137095,1,4,0,0,4,0
172385,1,3,0,0,3,0
154182,1,1,0,0,1,0
71882,1,2,0,0,2,0
223040,2,4,0,0,4,0
157001,2,2,0,0,2,0
80006,2,4,0,0,4,0
38548,10,2,0,0,2,0
154825,1,3,0,0,3,0
2266,2,3,0,0,3,0
118695,1,3,0,0,3,0
163642,2,1,0,0,1,0
169,1,2,0,0,2,0
226501,1,1,0,0,1,0
43152,1,1,0,0,1,0
113636,10,17,0,0,17,0
113636,1,2,0,0,2,0
2639,2,3,0,0,3,0
7480,1,5,0,0,5,0
130960,1,3,0,0,3,0
22278,10,8,0,0,8,0
40770,10,7,0,0,7,0
40508,10,5,0,0,5,0
40508,9,9,0,0,9,0
140535,1,1,0,0,1,0
6263,1,2,0,0,2,0
142852,2,8,0,0,8,0
167270,2,1,0,0,1,0
179803,2,4,0,0,4,0
177249,2,5,0,0,5,0
145203,2,2,0,0,2,0
223855,1,1,0,0,1,0
131014,3,5,0,0,5,0
6779,1,4,0,0,4,0
197405,3,7,0,0,7,0
192934,1,3,0,0,3,0
36648,2,2,0,0,2,0
13301,1,3,0,0,3,0
104955,2,7,0,0,7,0
1155,1,3,0,0,3,0
15045,1,3,0,0,3,0
22278,1,3,0,0,3,0
91080,1,6,0,0,6,0
24037,2,5,0,0,5,0
24037,1,1,0,0,1,0
172552,1,4,0,0,4,0
260428,4,4,0,0,4,0
58110,2,3,0,0,3,0
58110,1,3,0,0,3,0
172220,1,3,0,0,3,0
41066,1,8,0,0,8,0
28723,1,2,0,0,2,0
31483,2,5,0,0,5,0
31483,1,3,0,0,3,0
169794,2,3,0,0,3,0
169794,1,1,0,0,1,0
92044,1,4,0,0,4,0
5072,1,7,0,0,7,0
168274,2,12,0,0,12,0
30241,1,1,0,0,1,0
160610,3,5,0,0,5,0
160610,2,6,0,0,6,0
38823,2,4,0,0,4,0
40832,2,5,0,0,5,0
40770,2,3,0,0,3,0
143404,2,4,0,0,4,0
143404,1,3,0,0,3,0
175307,1,4,0,0,4,0
91984,1,2,0,0,2,0
27463,1,3,0,0,3,0
1419,1,2,0,0,2,0
1768,1,2,0,0,2,0
73316,1,1,0,0,1,0
138431,1,4,0,0,4,0
117,2,1,0,0,1,0
4209,1,1,0,0,1,0
75476,1,2,0,0,2,0
205046,2,1,0,0,1,0
205046,1,3,0,0,3,0
135116,1,1,0,0,1,0
1484,1,2,0,0,2,0
158889,4,12,0,0,12,0
158889,3,5,0,0,5,0
158889,1,10,0,0,10,0
4864,10,8,0,0,8,0
129736,1,2,0,0,2,0
128554,1,1,0,0,1,0
136056,3,13,0,0,13,0
136056,1,1,0,0,1,0
191004,1,4,0,0,4,0
59,1,3,0,0,3,0
200,1,1,0,0,1,0
9,1,3,0,0,3,0
3236,1,1,0,0,1,0
833,1,3,0,0,3,0
19947,1,2,0,0,2,0
40831,1,1,0,0,1,0
118705,1,5,0,0,5,0
66510,3,12,0,0,12,0
203780,1,1,0,0,1,0
125311,2,4,0,0,4,0
76150,1,1,0,0,1,0
193739,1,3,0,0,3,0
9408,1,1,0,0,1,0
143175,1,1,0,0,1,0
2290,1,2,0,0,2,0
15953,3,10,0,0,10,0
15953,1,2,0,0,2,0
27385,10,5,0,0,5,0
66849,1,3,0,0,3,0
25234,10,4,0,0,4,0
15600,1,1,0,0,1,0
154301,1,2,0,0,2,0
348,1,4,0,0,4,0
2808,1,4,0,0,4,0
63706,1,5,0,0,5,0
202583,1,1,0,0,1,0
19427,1,3,0,0,3,0
38984,10,9,0,0,9,0
29603,1,11,0,0,11,0
176371,3,3,0,0,3,0
176371,1,1,0,0,1,0
37734,1,2,0,0,2,0
68264,2,4,0,0,4,0
121423,10,5,0,0,5,0
32165,10,9,0,0,9,0
32165,1,1,0,0,1,0
154003,1,5,0,0,5,0
65673,1,3,0,0,3,0
172931,2,2,0,0,2,0
172931,1,1,0,0,1,0
218311,10,14,0,0,14,0
218311,2,4,0,0,4,0
73863,10,6,0,0,6,0
73863,2,5,0,0,5,0
244654,1,2,0,0,2,0
3452,1,1,0,0,1,0
234671,1,5,0,0,5,0
153318,1,1,0,0,1,0
67180,1,8,0,0,8,0
46396,2,3,0,0,3,0
46396,1,5,0,0,5,0
156138,2,1,0,0,1,0
156138,1,1,0,0,1,0
187680,2,3,0,0,3,0
4610,10,2,0,0,2,0
4610,1,4,0,0,4,0
6281,10,6,0,0,6,0
300,1,2,0,0,2,0
126996,2,3,0,0,3,0
94104,1,2,0,0,2,0
86073,10,11,0,0,11,0
12205,10,1,0,0,1,0
229265,1,1,0,0,1,0
201248,1,2,0,0,2,0
22532,2,3,0,0,3,0
19989,10,2,0,0,2,0
19989,1,2,0,0,2,0
21287,1,3,0,0,3,0
96007,1,5,0,0,5,0
533,10,8,0,0,8,0
218293,1,1,0,0,1,0
3139,1,2,0,0,2,0
234477,2,2,0,0,2,0
433,1,2,0,0,2,0
128664,2,6,0,0,6,0
128664,1,1,0,0,1,0
212516,2,2,0,0,2,0
212516,1,1,0,0,1,0
932,1,3,0,0,3,0
19995,1,4,0,0,4,0
84159,1,4,0,0,4,0
262215,2,5,0,0,5,0
37836,1,3,0,0,3,0
218121,2,6,0,0,6,0
29456,1,5,0,0,5,0
22192,2,4,0,0,4,0
1265,1,1,0,0,1,0
146816,2,1,0,0,1,0
146816,1,1,0,0,1,0
31479,1,2,0,0,2,0
190082,3,3,0,0,3,0
190082,2,1,0,0,1,0
190082,1,1,0,0,1,0
231696,3,10,0,0,10,0
231696,2,3,0,0,3,0
124052,1,1,0,0,1,0
142961,1,6,0,0,6,0
158109,1,1,0,0,1,0
118000,1,2,0,0,2,0
8668,1,3,0,0,3,0
9202,10,1,0,0,1,0
109779,2,6,0,0,6,0
223049,1,1,0,0,1,0
7682,9,3,0,0,3,0
7682,8,4,0,0,4,0
143401,2,1,0,0,1,0
4492,9,11,0,0,11,0
251678,2,1,0,0,1,0
19419,1,2,0,0,2,0
19650,10,2,0,0,2,0
19650,1,1,0,0,1,0
181761,1,1,0,0,1,0
180198,1,1,0,0,1,0
10799,9,2,0,0,2,0
168998,4,15,0,0,15,0
168054,2,2,0,0,2,0
692,1,2,0,0,2,0
109125,3,4,0,0,4,0
31506,10,1,0,0,1,0
179460,2,1,0,0,1,0
179460,1,3,0,0,3,0
163370,1,2,0,0,2,0
244331,2,1,0,0,1,0
244331,1,1,0,0,1,0
199383,1,1,0,0,1,0
1442,1,5,0,0,5,0
1962,10,6,0,0,6,0
227515,3,1,0,0,1,0
1459,2,2,0,0,2,0
155173,1,1,0,0,1,0
242639,2,3,0,0,3,0
242639,1,1,0,0,1,0
158572,2,3,0,0,3,0
158572,1,1,0,0,1,0
144415,10,13,0,0,13,0
144415,2,1,0,0,1,0
239464,4,7,0,0,7,0
25584,2,5,0,0,5,0
25584,1,1,0,0,1,0
392,1,2,0,0,2,0
170624,3,2,0,0,2,0
170624,2,1,0,0,1,0
170624,1,2,0,0,2,0
296,1,3,0,0,3,0
1157,10,7,0,0,7,0
235375,3,7,0,0,7,0
34320,1,1,0,0,1,0
59753,2,3,0,0,3,0
35572,1,1,0,0,1,0
223215,2,3,0,0,3,0
223215,1,2,0,0,2,0
137,10,8,0,0,8,0
137,1,6,0,0,6,0
163920,10,10,0,0,10,0
163920,1,2,0,0,2,0
169318,1,1,0,0,1,0
244995,1,1,0,0,1,0
620,2,2,0,0,2,0
128063,2,9,0,0,9,0
102148,2,6,0,0,6,0
205045,10,8,0,0,8,0
129293,10,9,0,0,9,0
58798,10,5,0,0,5,0
1376,1,2,0,0,2,0
164949,2,1,0,0,1,0
247236,1,1,0,0,1,0
226522,3,4,0,0,4,0
226522,2,3,0,0,3,0
31552,3,9,0,0,9,0
31552,2,2,0,0,2,0
130899,1,1,0,0,1,0
8195,3,5,0,0,5,0
35248,10,14,0,0,14,0
230251,1,5,0,0,5,0
128721,2,2,0,0,2,0
22398,1,2,0,0,2,0
244916,1,2,0,0,2,0
101,2,1,0,0,1,0
101,1,1,0,0,1,0
119632,10,8,0,0,8,0
2081,1,4,0,0,4,0
58602,1,2,0,0,2,0
129904,10,4,0,0,4,0
76417,10,6,0,0,6,0
76417,1,5,0,0,5,0
2533,3,6,0,0,6,0
2533,2,2,0,0,2,0
2533,1,3,0,0,3,0
230383,3,6,0,0,6,0
230383,2,3,0,0,3,0
230383,1,3,0,0,3,0
88827,3,5,0,0,5,0
88827,2,1,0,0,1,0
88827,1,2,0,0,2,0
119407,9,8,0,0,8,0
798,2,2,0,0,2,0
798,1,2,0,0,2,0
223,1,2,0,0,2,0
15126,3,5,0,0,5,0
3234,2,3,0,0,3,0
3234,1,2,0,0,2,0
71655,1,1,0,0,1,0
125046,2,4,0,0,4,0
128931,3,8,0,0,8,0
128931,1,2,0,0,2,0
28396,1,2,0,0,2,0
149809,1,1,0,0,1,0
166857,3,3,0,0,3,0
166857,2,1,0,0,1,0
90870,1,1,0,0,1,0
250442,2,1,0,0,1,0
163154,1,5,0,0,5,0
1933,9,15,0,0,15,0
26859,10,17,0,0,17,0
154443,1,1,0,0,1,0
75212,2,2,0,0,2,0
173156,3,4,0,0,4,0
173156,2,1,0,0,1,0
173156,1,2,0,0,2,0
45748,2,4,0,0,4,0
223779,2,6,0,0,6,0
223779,1,1,0,0,1,0
93724,2,3,0,0,3,0
93724,1,1,0,0,1,0
217780,2,2,0,0,2,0
30932,10,4,0,0,4,0
30932,2,2,0,0,2,0
63740,1,1,0,0,1,0
626,1,2,0,0,2,0
172547,1,2,0,0,2,0
230267,2,3,0,0,3,0
230267,1,2,0,0,2,0
166571,1,2,0,0,2,0
75091,1,4,0,0,4,0
193840,1,4,0,0,4,0
37231,10,7,0,0,7,0
99120,10,9,0,0,9,0
206940,1,3,0,0,3,0
5795,2,2,0,0,2,0
5795,1,1,0,0,1,0
42244,10,5,0,0,5,0
247,1,2,0,0,2,0
29198,10,6,0,0,6,0
144388,1,3,0,0,3,0
511,1,4,0,0,4,0
23985,2,4,0,0,4,0
23985,1,1,0,0,1,0
5767,10,3,0,0,3,0
174476,1,3,0,0,3,0
100679,2,5,0,0,5,0
57660,4,11,0,0,11,0
57660,3,5,0,0,5,0
57660,2,5,0,0,5,0
57660,1,5,0,0,5,0
631,3,7,0,0,7,0
631,1,3,0,0,3,0
180771,2,2,0,0,2,0
116858,1,1,0,0,1,0
6546,10,1,0,0,1,0
6546,9,5,0,0,5,0
83667,1,1,0,0,1,0
248158,2,3,0,0,3,0
27389,10,5,0,0,5,0
97357,1,2,0,0,2,0
123955,1,4,0,0,4,0
20750,10,8,0,0,8,0
110524,1,2,0,0,2,0
16497,2,2,0,0,2,0
16497,1,4,0,0,4,0
161226,2,1,0,0,1,0
161226,1,1,0,0,1,0
34969,2,3,0,0,3,0
34969,1,3,0,0,3,0
1621,2,8,0,0,8,0
1621,1,2,0,0,2,0
184346,1,1,0,0,1,0
27532,1,2,0,0,2,0
202977,1,2,0,0,2,0
54361,1,4,0,0,4,0
155693,10,3,0,0,3,0
155693,9,7,0,0,7,0
42743,1,5,0,0,5,0
215312,3,4,0,0,4,0
22551,2,3,0,0,3,0
148601,1,2,0,0,2,0
142121,10,12,0,0,12,0
185196,2,5,0,0,5,0
185196,1,2,0,0,2,0
2932,1,5,0,0,5,0
117914,10,7,0,0,7,0
175549,1,1,0,0,1,0
66193,10,3,0,0,3,0
66193,1,2,0,0,2,0
132428,2,4,0,0,4,0
132428,1,3,0,0,3,0
234396,2,3,0,0,3,0
234396,1,2,0,0,2,0
181797,1,2,0,0,2,0
4370,1,3,0,0,3,0
2604,1,2,0,0,2,0
173047,1,2,0,0,2,0
169704,3,7,0,0,7,0
169704,1,1,0,0,1,0
40529,2,2,0,0,2,0
207207,4,12,0,0,12,0
90041,10,1,0,0,1,0
90041,1,1,0,0,1,0
229892,1,2,0,0,2,0
109451,10,4,0,0,4,0
109451,1,1,0,0,1,0
249259,3,5,0,0,5,0
249259,1,3,0,0,3,0
730,1,10,0,0,10,0
41636,1,1,0,0,1,0
1263,10,2,0,0,2,0
1116,1,1,0,0,1,0
153497,2,3,0,0,3,0
153497,1,1,0,0,1,0
38032,1,1,0,0,1,0
84,3,5,0,0,5,0
84,1,6,0,0,6,0
1213,1,1,0,0,1,0
233955,2,3,0,0,3,0
38872,1,1,0,0,1,0
128445,1,1,0,0,1,0
104994,1,2,0,0,2,0
146149,10,9,0,0,9,0
146149,9,19,0,0,19,0
146149,2,9,0,0,9,0
146149,1,2,0,0,2,0
216597,2,2,0,0,2,0
68247,10,8,0,0,8,0
68247,1,1,0,0,1,0
172503,2,3,0,0,3,0
172503,1,1,0,0,1,0
92643,1,1,0,0,1,0
193210,2,1,0,0,1,0
193210,1,1,0,0,1,0
24770,1,1,0,0,1,0
145371,2,1,0,0,1,0
244049,10,32,0,0,32,0
22497,1,3,0,0,3,0
155255,1,5,0,0,5,0
199966,1,2,0,0,2,0
29773,1,1,0,0,1,0
196202,2,6,0,0,6,0
196202,1,3,0,0,3,0
16,1,2,0,0,2,0
384,1,1,0,0,1,0
3128,1,1,0,0,1,0
150293,1,1,0,0,1,0
37141,3,7,0,0,7,0
37141,2,11,0,0,11,0
56933,2,3,0,0,3,0
56933,1,2,0,0,2,0
176565,3,2,0,0,2,0
176565,2,3,0,0,3,0
9342,1,1,0,0,1,0
178210,1,2,0,0,2,0
48979,1,9,0,0,9,0
215613,1,1,0,0,1,0
36888,1,4,0,0,4,0
188866,5,20,0,0,20,0
188866,3,3,0,0,3,0
188866,1,1,0,0,1,0
145633,2,3,0,0,3,0
145633,1,2,0,0,2,0
231280,3,5,0,0,5,0
157917,2,2,0,0,2,0
119781,1,2,0,0,2,0
2652,2,5,0,0,5,0
2652,1,1,0,0,1,0
4424,1,1,0,0,1,0
81640,2,2,0,0,2,0
54735,1,1,0,0,1,0
31056,1,2,0,0,2,0
404,10,1,0,0,1,0
404,1,3,0,0,3,0
3312,1,1,0,0,1,0
5588,10,1,0,0,1,0
150146,1,6,0,0,6,0
2578,9,4,0,0,4,0
120605,1,3,0,0,3,0
181960,2,1,0,0,1,0
181960,1,1,0,0,1,0
122891,2,3,0,0,3,0
1017,1,3,0,0,3,0
6539,1,3,0,0,3,0
200057,3,4,0,0,4,0
200057,2,2,0,0,2,0
200057,1,1,0,0,1,0
99392,1,4,0,0,4,0
168215,10,9,0,0,9,0
157026,2,1,0,0,1,0
157026,1,2,0,0,2,0
241831,2,1,0,0,1,0
195503,1,1,0,0,1,0
25823,1,1,0,0,1,0
21704,10,4,0,0,4,0
244271,2,2,0,0,2,0
244271,1,1,0,0,1,0
218920,10,6,0,0,6,0
122240,4,8,0,0,8,0
230498,10,7,0,0,7,0
189,2,4,0,0,4,0
189,1,6,0,0,6,0
1950,1,4,0,0,4,0
3208,2,2,0,0,2,0
180231,10,7,0,0,7,0
180231,2,3,0,0,3,0
180231,1,2,0,0,2,0
118410,1,3,0,0,3,0
4583,1,4,0,0,4,0
68228,1,1,0,0,1,0
31449,10,3,0,0,3,0
96792,2,3,0,0,3,0
96792,1,1,0,0,1,0
230253,1,1,0,0,1,0
33150,10,13,0,0,13,0
36708,2,3,0,0,3,0
36708,1,6,0,0,6,0
255692,2,1,0,0,1,0
255692,1,1,0,0,1,0
28829,1,3,0,0,3,0
1245,10,2,0,0,2,0
166158,10,14,0,0,14,0
41749,2,1,0,0,1,0
41749,1,2,0,0,2,0
109764,9,7,0,0,7,0
109764,1,1,0,0,1,0
172971,1,1,0,0,1,0
122588,3,1,0,0,1,0
122588,2,2,0,0,2,0
122588,1,2,0,0,2,0
98918,1,5,0,0,5,0
146,10,2,0,0,2,0
31745,9,16,0,0,16,0
56786,1,1,0,0,1,0
42111,1,2,0,0,2,0
154905,2,1,0,0,1,0
431,2,5,0,0,5,0
96152,1,4,0,0,4,0
102835,9,7,0,0,7,0
131111,1,9,0,0,9,0
191972,1,1,0,0,1,0
129976,1,2,0,0,2,0
200454,2,2,0,0,2,0
181494,10,7,0,0,7,0
181494,1,1,0,0,1,0
3348,2,1,0,0,1,0
3348,1,1,0,0,1,0
184424,1,7,0,0,7,0
114903,2,1,0,0,1,0
114903,1,1,0,0,1,0
9021,10,2,0,0,2,0
182704,2,2,0,0,2,0
182704,1,1,0,0,1,0
200853,3,3,0,0,3,0
200853,2,1,0,0,1,0
25277,2,4,0,0,4,0
190639,2,1,0,0,1,0
190639,1,1,0,0,1,0
39217,1,2,0,0,2,0
153425,10,4,0,0,4,0
2555,1,1,0,0,1,0
149853,2,1,0,0,1,0
149853,1,1,0,0,1,0
1420,10,1,0,0,1,0
140951,2,1,0,0,1,0
140951,1,4,0,0,4,0
210274,3,7,0,0,7,0
161546,2,3,0,0,3,0
161546,1,1,0,0,1,0
156496,2,4,0,0,4,0
147930,3,8,0,0,8,0
257759,1,1,0,0,1,0
191963,1,1,0,0,1,0
124965,2,2,0,0,2,0
124965,1,1,0,0,1,0
42939,1,1,0,0,1,0
36399,1,4,0,0,4,0
130792,3,7,0,0,7,0
1423,1,1,0,0,1,0
10814,1,1,0,0,1,0
135281,1,2,0,0,2,0
696,1,2,0,0,2,0
34004,2,2,0,0,2,0
18289,1,1,0,0,1,0
89415,1,4,0,0,4,0
254591,2,3,0,0,3,0
183896,1,2,0,0,2,0
198836,10,8,0,0,8,0
18500,2,2,0,0,2,0
18500,1,1,0,0,1,0
161547,4,14,0,0,14,0
161547,2,4,0,0,4,0
161547,1,1,0,0,1,0
169147,2,2,0,0,2,0
169147,1,2,0,0,2,0
5205,1,3,0,0,3,0
138317,10,4,0,0,4,0
279,1,1,0,0,1,0
177079,2,7,0,0,7,0
177079,1,2,0,0,2,0
31759,2,1,0,0,1,0
31759,1,1,0,0,1,0
245271,2,5,0,0,5,0
245271,1,3,0,0,3,0
4378,9,3,0,0,3,0
144728,1,1,0,0,1,0
102898,2,2,0,0,2,0
204184,2,2,0,0,2,0
57163,10,9,0,0,9,0
123576,10,31,0,0,31,0
123576,3,3,0,0,3,0
118402,10,2,0,0,2,0
181260,1,3,0,0,3,0
14035,1,5,0,0,5,0
124847,1,1,0,0,1,0
165662,3,3,0,0,3,0
165662,1,2,0,0,2,0
139033,1,1,0,0,1,0
144734,2,1,0,0,1,0
144734,1,2,0,0,2,0
41627,3,1,0,0,1,0
199793,2,1,0,0,1,0
200785,1,3,0,0,3,0
1992,1,2,0,0,2,0
32114,1,1,0,0,1,0
165,2,3,0,0,3,0
67254,2,3,0,0,3,0
164865,2,9,0,0,9,0
5314,8,8,0,0,8,0
194523,2,5,0,0,5,0
163474,4,6,0,0,6,0
163474,1,2,0,0,2,0
129556,2,2,0,0,2,0
176803,2,3,0,0,3,0
782,1,1,0,0,1,0
144864,3,4,0,0,4,0
144864,2,2,0,0,2,0
144864,1,1,0,0,1,0
55597,10,5,0,0,5,0
66081,1,4,0,0,4,0
321,2,1,0,0,1,0
218479,2,3,0,0,3,0
118497,1,1,0,0,1,0
17,1,2,0,0,2,0
143176,2,2,0,0,2,0
125315,10,6,0,0,6,0
125675,10,4,0,0,4,0
12166,2,6,0,0,6,0
12166,1,4,0,0,4,0
219708,10,12,0,0,12,0
5942,1,1,0,0,1,0
148205,1,1,0,0,1,0
508,2,3,0,0,3,0
508,1,2,0,0,2,0
1324,10,3,0,0,3,0
146910,1,1,0,0,1,0
231666,10,9,0,0,9,0
29410,1,3,0,0,3,0
260605,4,2,0,0,2,0
107190,1,4,0,0,4,0
152765,4,4,0,0,4,0
152765,3,2,0,0,2,0
152765,2,1,0,0,1,0
371,2,4,0,0,4,0
371,1,3,0,0,3,0
22457,1,5,0,0,5,0
35285,1,2,0,0,2,0
217398,1,2,0,0,2,0
125924,1,1,0,0,1,0
9139,10,1,0,0,1,0
115233,1,3,0,0,3,0
131118,1,1,0,0,1,0
106999,10,3,0,0,3,0
1212,1,3,0,0,3,0
464,2,4,0,0,4,0
103132,2,1,0,0,1,0
103132,1,1,0,0,1,0
42673,1,1,0,0,1,0
203828,1,1,0,0,1,0
101020,10,6,0,0,6,0
184459,1,2,0,0,2,0
17804,2,6,0,0,6,0
114387,1,1,0,0,1,0
135243,1,1,0,0,1,0
23053,1,1,0,0,1,0
207062,2,2,0,0,2,0
207062,1,1,0,0,1,0
539,10,4,0,0,4,0
364,10,3,0,0,3,0
127312,1,4,0,0,4,0
198190,2,2,0,0,2,0
166372,9,10,0,0,10,0
166372,1,2,0,0,2,0
376,10,5,0,0,5,0
63539,3,13,0,0,13,0
63539,2,10,0,0,10,0
38713,4,4,0,0,4,0
38713,3,4,0,0,4,0
38713,2,5,0,0,5,0
38713,1,2,0,0,2,0
151771,3,2,0,0,2,0
151771,2,2,0,0,2,0
151771,1,1,0,0,1,0
237087,1,1,0,0,1,0
1674,1,1,0,0,1,0
244608,4,5,0,0,5,0
2296,1,1,0,0,1,0
41835,1,4,0,0,4,0
40209,1,2,0,0,2,0
834,10,11,0,0,11,0
205867,1,1,0,0,1,0
206084,4,7,0,0,7,0
206084,2,1,0,0,1,0
206084,1,1,0,0,1,0
8790,10,13,0,0,13,0
2770,9,2,0,0,2,0
132497,1,1,0,0,1,0
64204,10,2,0,0,2,0
804,2,2,0,0,2,0
804,1,1,0,0,1,0
14992,10,2,0,0,2,0
125752,3,2,0,0,2,0
125752,2,1,0,0,1,0
125752,1,2,0,0,2,0
145928,1,1,0,0,1,0
171630,1,3,0,0,3,0
218804,2,4,0,0,4,0
109969,1,3,0,0,3,0
89953,9,4,0,0,4,0
160958,3,4,0,0,4,0
160958,2,3,0,0,3,0
160958,1,3,0,0,3,0
210900,2,1,0,0,1,0
210900,1,3,0,0,3,0
854,1,1,0,0,1,0
43264,10,2,0,0,2,0
43264,9,3,0,0,3,0
17855,1,2,0,0,2,0
63632,1,1,0,0,1,0
226322,10,2,0,0,2,0
102897,1,2,0,0,2,0
96188,10,3,0,0,3,0
162107,10,3,0,0,3,0
162107,1,3,0,0,3,0
179182,1,1,0,0,1,0
104377,1,2,0,0,2,0
214029,2,3,0,0,3,0
134711,1,1,0,0,1,0
140343,1,3,0,0,3,0
15474,10,7,0,0,7,0
15474,2,11,0,0,11,0
15474,1,3,0,0,3,0
2060,1,6,0,0,6,0
40235,10,2,0,0,2,0
74390,1,2,0,0,2,0
117663,1,4,0,0,4,0
21293,10,4,0,0,4,0
21293,9,6,0,0,6,0
5770,1,1,0,0,1,0
789,1,2,0,0,2,0
41052,2,4,0,0,4,0
545,3,7,0,0,7,0
179835,10,2,0,0,2,0
179835,2,1,0,0,1,0
192802,1,1,0,0,1,0
65564,3,4,0,0,4,0
65564,1,2,0,0,2,0
4035,10,2,0,0,2,0
4035,9,3,0,0,3,0
119337,2,5,0,0,5,0
146408,1,2,0,0,2,0
256570,3,1,0,0,1,0
256570,1,2,0,0,2,0
213266,2,1,0,0,1,0
84772,2,1,0,0,1,0
84772,1,1,0,0,1,0
186265,1,3,0,0,3,0
38718,3,3,0,0,3,0
38718,1,3,0,0,3,0
1036,1,1,0,0,1,0
204431,2,5,0,0,5,0
204431,1,3,0,0,3,0
13945,10,6,0,0,6,0
21133,2,1,0,0,1,0
21133,1,5,0,0,5,0
4953,10,8,0,0,8,0
4953,1,2,0,0,2,0
1770,1,1,0,0,1,0
142830,2,3,0,0,3,0
191055,3,2,0,0,2,0
176334,10,6,0,0,6,0
176334,2,4,0,0,4,0
4149,9,1,0,0,1,0
48,10,1,0,0,1,0
137290,10,14,0,0,14,0
137290,2,4,0,0,4,0
235802,2,1,0,0,1,0
235802,1,1,0,0,1,0
32014,1,3,0,0,3,0
2129,1,1,0,0,1,0
252929,1,1,0,0,1,0
26235,10,1,0,0,1,0
26235,2,2,0,0,2,0
41541,10,3,0,0,3,0
30356,2,2,0,0,2,0
177197,2,1,0,0,1,0
1545,1,4,0,0,4,0
187104,2,8,0,0,8,0
38309,1,2,0,0,2,0
198522,2,1,0,0,1,0
198522,1,1,0,0,1,0
88594,1,1,0,0,1,0
64826,2,3,0,0,3,0
64826,1,2,0,0,2,0
148291,3,5,0,0,5,0
35935,1,3,0,0,3,0
126239,1,3,0,0,3,0
135262,2,6,0,0,6,0
220517,3,1,0,0,1,0
220517,2,2,0,0,2,0
38391,10,1,0,0,1,0
38391,1,4,0,0,4,0
56885,3,12,0,0,12,0
214396,2,3,0,0,3,0
214396,1,1,0,0,1,0
6209,1,2,0,0,2,0
831,1,1,0,0,1,0
4475,10,5,0,0,5,0
4475,9,10,0,0,10,0
3190,1,1,0,0,1,0
13005,1,2,0,0,2,0
231999,2,3,0,0,3,0
154600,1,2,0,0,2,0
209325,10,3,0,0,3,0
209325,3,3,0,0,3,0
209325,2,1,0,0,1,0
174837,3,2,0,0,2,0
174837,1,1,0,0,1,0
130060,3,1,0,0,1,0
130060,2,1,0,0,1,0
12830,10,2,0,0,2,0
12830,1,1,0,0,1,0
28258,10,2,0,0,2,0
198138,2,3,0,0,3,0
216428,3,3,0,0,3,0
216428,2,2,0,0,2,0
106753,10,8,0,0,8,0
106753,9,17,0,0,17,0
106753,3,26,0,0,26,0
6481,2,1,0,0,1,0
6481,1,1,0,0,1,0
191538,2,3,0,0,3,0
15180,1,1,0,0,1,0
113819,9,11,0,0,11,0
23540,3,1,0,0,1,0
23540,2,2,0,0,2,0
34010,1,2,0,0,2,0
1206,2,1,0,0,1,0
759,2,1,0,0,1,0
759,1,1,0,0,1,0
29613,10,3,0,0,3,0
20,2,2,0,0,2,0
20,1,4,0,0,4,0
111173,10,1,0,0,1,0
152757,3,2,0,0,2,0
152757,2,1,0,0,1,0
152757,1,1,0,0,1,0
422,1,1,0,0,1,0
18748,1,1,0,0,1,0
38364,1,2,0,0,2,0
239840,1,2,0,0,2,0
7538,10,3,0,0,3,0
42444,2,4,0,0,4,0
42444,1,1,0,0,1,0
124827,3,2,0,0,2,0
124827,2,1,0,0,1,0
202,1,1,0,0,1,0
29096,10,1,0,0,1,0
130827,1,2,0,0,2,0
223770,10,9,0,0,9,0
227460,3,4,0,0,4,0
227460,2,3,0,0,3,0
227460,1,1,0,0,1,0
142271,1,1,0,0,1,0
33040,10,9,0,0,9,0
1099,10,2,0,0,2,0
182120,1,1,0,0,1,0
83734,2,3,0,0,3,0
83734,1,2,0,0,2,0
8730,1,2,0,0,2,0
147030,10,8,0,0,8,0
4556,1,1,0,0,1,0
61,10,1,0,0,1,0
98347,1,1,0,0,1,0
267,3,3,0,0,3,0
267,1,1,0,0,1,0
31291,2,3,0,0,3,0
31291,1,6,0,0,6,0
8829,2,6,0,0,6,0
67181,2,2,0,0,2,0
208024,2,1,0,0,1,0
77,1,6,0,0,6,0
124969,3,3,0,0,3,0
124969,2,1,0,0,1,0
124969,1,1,0,0,1,0
24843,10,4,0,0,4,0
24843,1,1,0,0,1,0
11057,2,1,0,0,1,0
11057,1,5,0,0,5,0
148532,3,3,0,0,3,0
15549,9,4,0,0,4,0
78733,1,4,0,0,4,0
41658,2,3,0,0,3,0
97273,10,2,0,0,2,0
97273,1,1,0,0,1,0
192120,2,3,0,0,3,0
192120,1,2,0,0,2,0
174524,1,1,0,0,1,0
182,10,1,0,0,1,0
182,2,3,0,0,3,0
25729,3,2,0,0,2,0
25729,1,6,0,0,6,0
54433,9,9,0,0,9,0
54433,1,2,0,0,2,0
20133,1,2,0,0,2,0
142197,1,3,0,0,3,0
206175,1,1,0,0,1,0
175495,10,6,0,0,6,0
175495,2,7,0,0,7,0
144036,10,3,0,0,3,0
258444,1,2,0,0,2,0
61487,5,3,0,0,3,0
142402,3,8,0,0,8,0
142402,1,4,0,0,4,0
85105,10,4,0,0,4,0
124968,3,1,0,0,1,0
124968,2,1,0,0,1,0
31545,1,1,0,0,1,0
154479,1,1,0,0,1,0
3041,2,1,0,0,1,0
3041,1,4,0,0,4,0
231819,2,2,0,0,2,0
201054,10,4,0,0,4,0
201054,2,3,0,0,3,0
201054,1,3,0,0,3,0
154173,1,2,0,0,2,0
38749,10,11,0,0,11,0
38749,1,2,0,0,2,0
23890,10,5,0,0,5,0
71973,10,1,0,0,1,0
71973,2,1,0,0,1,0
135654,3,3,0,0,3,0
135654,2,1,0,0,1,0
16373,10,2,0,0,2,0
163354,1,2,0,0,2,0
38821,3,8,0,0,8,0
156976,10,2,0,0,2,0
156976,1,3,0,0,3,0
139326,10,3,0,0,3,0
139326,3,11,0,0,11,0
246297,2,5,0,0,5,0
246297,1,5,0,0,5,0
43578,2,2,0,0,2,0
43578,1,1,0,0,1,0
33911,10,3,0,0,3,0
102435,2,1,0,0,1,0
102435,1,1,0,0,1,0
5620,3,5,0,0,5,0
5620,1,3,0,0,3,0
2819,10,7,0,0,7,0
136356,10,1,0,0,1,0
1717,1,1,0,0,1,0
329,1,3,0,0,3,0
299,1,3,0,0,3,0
191925,2,2,0,0,2,0
1645,2,1,0,0,1,0
1645,1,2,0,0,2,0
232520,3,1,0,0,1,0
232520,1,1,0,0,1,0
207753,3,7,0,0,7,0
207753,2,4,0,0,4,0
207753,1,3,0,0,3,0
130592,10,6,0,0,6,0
130592,9,9,0,0,9,0
130592,3,14,0,0,14,0
130592,1,5,0,0,5,0
144492,10,1,0,0,1,0
194100,10,5,0,0,5,0
194100,1,1,0,0,1,0
66085,3,2,0,0,2,0
66085,2,2,0,0,2,0
66085,1,2,0,0,2,0
1931,9,1,0,0,1,0
11265,1,2,0,0,2,0
3394,10,12,0,0,12,0
246200,2,1,0,0,1,0
246200,1,1,0,0,1,0
359,2,3,0,0,3,0
4616,2,2,0,0,2,0
4616,1,3,0,0,3,0
147299,10,5,0,0,5,0
128565,9,9,0,0,9,0
27117,10,1,0,0,1,0
27117,1,2,0,0,2,0
124390,10,2,0,0,2,0
167763,3,5,0,0,5,0
167763,2,5,0,0,5,0
232361,3,4,0,0,4,0
232361,1,1,0,0,1,0
96704,2,2,0,0,2,0
144568,1,1,0,0,1,0
70519,2,3,0,0,3,0
70519,1,1,0,0,1,0
224904,3,5,0,0,5,0
209001,3,9,0,0,9,0
209001,1,2,0,0,2,0
175095,3,1,0,0,1,0
175095,1,1,0,0,1,0
379,1,1,0,0,1,0
2922,10,6,0,0,6,0
2922,1,1,0,0,1,0
67593,10,2,0,0,2,0
67593,1,4,0,0,4,0
168839,2,7,0,0,7,0
129820,2,2,0,0,2,0
2541,1,2,0,0,2,0
11104,1,2,0,0,2,0
16320,2,2,0,0,2,0
16320,1,1,0,0,1,0
175695,10,3,0,0,3,0
155,1,1,0,0,1,0
147790,10,2,0,0,2,0
147790,1,1,0,0,1,0
16498,1,3,0,0,3,0
84465,1,1,0,0,1,0
21709,9,6,0,0,6,0
21709,1,1,0,0,1,0
130912,10,4,0,0,4,0
186701,4,12,0,0,12,0
186701,2,2,0,0,2,0
186701,1,1,0,0,1,0
245354,2,2,0,0,2,0
142687,2,7,0,0,7,0
142687,1,1,0,0,1,0
3341,1,3,0,0,3,0
55705,2,4,0,0,4,0
55705,1,1,0,0,1,0
27298,10,1,0,0,1,0
165657,10,3,0,0,3,0
165657,1,5,0,0,5,0
225244,4,1,0,0,1,0
3990,10,1,0,0,1,0
238656,4,4,0,0,4,0
238656,2,2,0,0,2,0
88016,10,4,0,0,4,0
156786,10,7,0,0,7,0
182116,1,1,0,0,1,0
2612,1,4,0,0,4,0
43249,10,6,0,0,6,0
140795,1,1,0,0,1,0
3377,10,4,0,0,4,0
3071,10,9,0,0,9,0
3071,9,17,0,0,17,0
25114,3,3,0,0,3,0
25114,1,1,0,0,1,0
11415,10,2,0,0,2,0
151151,1,1,0,0,1,0
9735,1,1,0,0,1,0
10908,10,1,0,0,1,0
22938,9,3,0,0,3,0
24920,1,4,0,0,4,0
31971,10,2,0,0,2,0
2247,1,1,0,0,1,0
123609,3,2,0,0,2,0
123609,1,4,0,0,4,0
497,10,1,0,0,1,0
162388,4,8,0,0,8,0
162388,3,1,0,0,1,0
162388,1,1,0,0,1,0
253684,2,3,0,0,3,0
253684,1,2,0,0,2,0
224316,10,11,0,0,11,0
224316,1,2,0,0,2,0
211940,10,8,0,0,8,0
102181,10,4,0,0,4,0
102181,2,3,0,0,3,0
102181,1,4,0,0,4,0
254386,1,3,0,0,3,0
8069,2,6,0,0,6,0
213370,2,2,0,0,2,0
8690,10,2,0,0,2,0
8690,9,11,0,0,11,0
8690,1,1,0,0,1,0
252328,4,1,0,0,1,0
1338,10,2,0,0,2,0
55834,1,1,0,0,1,0
8126,1,1,0,0,1,0
91189,1,1,0,0,1,0
147431,2,1,0,0,1,0
90190,10,5,0,0,5,0
90190,1,1,0,0,1,0
104573,10,1,0,0,1,0
104573,2,1,0,0,1,0
104573,1,3,0,0,3,0
21239,10,1,0,0,1,0
170604,2,2,0,0,2,0
170604,1,2,0,0,2,0
43307,1,3,0,0,3,0
171479,3,2,0,0,2,0
171479,2,3,0,0,3,0
171479,1,2,0,0,2,0
1430,2,2,0,0,2,0
1982,1,3,0,0,3,0
38931,1,1,0,0,1,0
173319,3,1,0,0,1,0
1333,9,3,0,0,3,0
231733,3,3,0,0,3,0
163641,10,3,0,0,3,0
163641,3,4,0,0,4,0
9364,1,2,0,0,2,0
174744,10,6,0,0,6,0
174744,2,1,0,0,1,0
3202,2,2,0,0,2,0
3202,1,4,0,0,4,0
172881,1,1,0,0,1,0
233571,5,7,0,0,7,0
87821,3,1,0,0,1,0
87821,2,2,0,0,2,0
169649,1,1,0,0,1,0
192735,9,13,0,0,13,0
192735,1,2,0,0,2,0
90,1,2,0,0,2,0
35289,10,1,0,0,1,0
35289,1,3,0,0,3,0
200934,1,1,0,0,1,0
160784,2,3,0,0,3,0
160784,1,1,0,0,1,0
19646,10,1,0,0,1,0
4173,2,2,0,0,2,0
684,10,6,0,0,6,0
8017,1,1,0,0,1,0
67453,10,4,0,0,4,0
67453,2,7,0,0,7,0
231197,2,5,0,0,5,0
231197,1,1,0,0,1,0
19184,2,2,0,0,2,0
19184,1,3,0,0,3,0
159868,2,2,0,0,2,0
1070,1,1,0,0,1,0
31621,10,1,0,0,1,0
193483,3,12,0,0,12,0
28037,10,2,0,0,2,0
28037,9,2,0,0,2,0
1830,3,4,0,0,4,0
3383,10,2,0,0,2,0
3383,2,1,0,0,1,0
128698,10,5,0,0,5,0
128698,2,2,0,0,2,0
128698,1,1,0,0,1,0
192334,9,10,0,0,10,0
192334,1,2,0,0,2,0
761,10,4,0,0,4,0
167298,1,1,0,0,1,0
697,1,1,0,0,1,0
245045,1,2,0,0,2,0
126912,2,1,0,0,1,0
126912,1,1,0,0,1,0
4401,2,2,0,0,2,0
4401,1,1,0,0,1,0
208773,2,1,0,0,1,0
12538,10,1,0,0,1,0
12538,9,4,0,0,4,0
12538,1,3,0,0,3,0
9615,1,1,0,0,1,0
47046,10,4,0,0,4,0
245352,10,11,0,0,11,0
245352,2,3,0,0,3,0
245352,1,2,0,0,2,0
210290,3,4,0,0,4,0
210290,2,3,0,0,3,0
1708,1,1,0,0,1,0
3656,1,2,0,0,2,0
29355,3,9,0,0,9,0
29355,1,1,0,0,1,0
4562,10,3,0,0,3,0
4562,1,2,0,0,2,0
180199,5,6,0,0,6,0
54643,10,4,0,0,4,0
126008,2,1,0,0,1,0
145014,3,2,0,0,2,0
145014,1,1,0,0,1,0
37615,10,1,0,0,1,0
37615,9,3,0,0,3,0
136192,1,5,0,0,5,0
245353,2,8,0,0,8,0
11949,3,4,0,0,4,0
24416,10,4,0,0,4,0
24416,1,1,0,0,1,0
172737,3,1,0,0,1,0
256877,2,5,0,0,5,0
256877,1,1,0,0,1,0
164840,2,5,0,0,5,0
164840,1,6,0,0,6,0
56758,1,1,0,0,1,0
224272,1,4,0,0,4,0
8127,10,1,0,0,1,0
5050,10,1,0,0,1,0
5050,9,1,0,0,1,0
5050,8,8,0,0,8,0
20195,2,3,0,0,3,0
16144,9,3,0,0,3,0
179071,1,1,0,0,1,0
200058,4,3,0,0,3,0
182074,10,3,0,0,3,0
6117,10,1,0,0,1,0
18946,10,7,0,0,7,0
195867,10,7,0,0,7,0
195867,3,1,0,0,1,0
96,1,1,0,0,1,0
5622,2,1,0,0,1,0
22143,4,3,0,0,3,0
22143,3,2,0,0,2,0
22143,1,11,0,0,11,0
122690,10,18,0,0,18,0
137238,10,3,0,0,3,0
137238,1,3,0,0,3,0
139562,3,5,0,0,5,0
139562,2,2,0,0,2,0
257518,2,2,0,0,2,0
257518,1,1,0,0,1,0
84869,10,4,0,0,4,0
188314,4,4,0,0,4,0
188314,3,3,0,0,3,0
188314,2,1,0,0,1,0
5259,10,1,0,0,1,0
129614,2,4,0,0,4,0
63091,3,2,0,0,2,0
63091,2,2,0,0,2,0
233961,3,1,0,0,1,0
226520,4,6,0,0,6,0
226520,2,3,0,0,3,0
2339,1,2,0,0,2,0
182218,10,5,0,0,5,0
182218,2,4,0,0,4,0
156373,1,1,0,0,1,0
13883,3,1,0,0,1,0
13883,1,1,0,0,1,0
88513,1,1,0,0,1,0
6521,1,3,0,0,3,0
153422,10,6,0,0,6,0
17534,10,4,0,0,4,0
17534,1,1,0,0,1,0
193651,10,3,0,0,3,0
130605,1,3,0,0,3,0
11182,1,1,0,0,1,0
11159,10,6,0,0,6,0
11159,9,12,0,0,12,0
34227,10,8,0,0,8,0
34227,2,2,0,0,2,0
228133,2,1,0,0,1,0
228133,1,3,0,0,3,0
41429,3,1,0,0,1,0
41429,1,2,0,0,2,0
4792,8,2,0,0,2,0
145888,1,2,0,0,2,0
123228,10,5,0,0,5,0
123228,2,3,0,0,3,0
123228,1,1,0,0,1,0
92666,2,5,0,0,5,0
175755,1,2,0,0,2,0
6627,9,4,0,0,4,0
192240,1,1,0,0,1,0
4090,2,1,0,0,1,0
2,1,2,0,0,2,0
2001,1,4,0,0,4,0
20847,1,1,0,0,1,0
147305,1,1,0,0,1,0
134,2,1,0,0,1,0
184700,3,7,0,0,7,0
184700,1,2,0,0,2,0
252446,3,2,0,0,2,0
353,10,1,0,0,1,0
108344,2,2,0,0,2,0
108344,1,2,0,0,2,0
158534,2,4,0,0,4,0
870,2,1,0,0,1,0
182875,10,11,0,0,11,0
10164,2,3,0,0,3,0
10164,1,2,0,0,2,0
766,1,1,0,0,1,0
246663,2,1,0,0,1,0
246663,1,2,0,0,2,0
12750,3,1,0,0,1,0
12750,2,3,0,0,3,0
12750,1,4,0,0,4,0
124047,10,5,0,0,5,0
124047,1,2,0,0,2,0
2455,1,2,0,0,2,0
111502,2,8,0,0,8,0
40629,9,2,0,0,2,0
80642,1,1,0,0,1,0
11106,1,5,0,0,5,0
3706,1,1,0,0,1,0
177939,4,3,0,0,3,0
3661,3,3,0,0,3,0
64956,2,3,0,0,3,0
171226,2,1,0,0,1,0
12627,10,3,0,0,3,0
12627,1,3,0,0,3,0
169464,1,1,0,0,1,0
229218,2,1,0,0,1,0
166317,3,2,0,0,2,0
142555,10,14,0,0,14,0
142555,2,1,0,0,1,0
131904,1,1,0,0,1,0
175961,1,1,0,0,1,0
142432,10,7,0,0,7,0
142432,9,3,0,0,3,0
2316,1,2,0,0,2,0
160409,10,6,0,0,6,0
160409,3,4,0,0,4,0
160409,2,1,0,0,1,0
160409,1,1,0,0,1,0
245197,3,4,0,0,4,0
245197,1,1,0,0,1,0
139952,3,3,0,0,3,0
2956,8,8,0,0,8,0
12248,1,1,0,0,1,0
1448,10,3,0,0,3,0
177727,10,6,0,0,6,0
177727,2,2,0,0,2,0
10756,1,1,0,0,1,0
7967,1,2,0,0,2,0
118776,3,3,0,0,3,0
183797,10,7,0,0,7,0
183797,9,8,0,0,8,0
183797,1,2,0,0,2,0
257527,2,1,0,0,1,0
257527,1,1,0,0,1,0
177354,3,1,0,0,1,0
155689,3,4,0,0,4,0
155689,2,2,0,0,2,0
244114,4,3,0,0,3,0
244114,2,1,0,0,1,0
244114,1,1,0,0,1,0
145976,2,3,0,0,3,0
145976,1,1,0,0,1,0
26055,1,1,0,0,1,0
130486,2,1,0,0,1,0
748,1,1,0,0,1,0
840,10,2,0,0,2,0
840,1,1,0,0,1,0
15156,10,1,0,0,1,0
15156,9,6,0,0,6,0
29256,1,3,0,0,3,0
621,1,1,0,0,1,0
8096,10,6,0,0,6,0
1379,1,1,0,0,1,0
29030,1,4,0,0,4,0
12171,1,1,0,0,1,0
8192,10,5,0,0,5,0
1372,1,2,0,0,2,0
200171,2,2,0,0,2,0
212765,1,1,0,0,1,0
173441,3,2,0,0,2,0
173441,1,1,0,0,1,0
1218,9,1,0,0,1,0
1218,2,4,0,0,4,0
172584,1,2,0,0,2,0
173634,1,5,0,0,5,0
6778,3,4,0,0,4,0
5393,1,2,0,0,2,0
15167,10,1,0,0,1,0
15167,1,2,0,0,2,0
192297,2,2,0,0,2,0
30057,10,3,0,0,3,0
65262,10,2,0,0,2,0
65262,9,3,0,0,3,0
218050,1,1,0,0,1,0
206754,2,5,0,0,5,0
206754,1,1,0,0,1,0
13729,10,2,0,0,2,0
13729,9,6,0,0,6,0
199493,3,3,0,0,3,0
54507,10,1,0,0,1,0
54507,3,3,0,0,3,0
54507,2,2,0,0,2,0
54507,1,1,0,0,1,0
23964,9,3,0,0,3,0
2821,10,2,0,0,2,0
2234,9,10,0,0,10,0
3347,10,13,0,0,13,0
6352,10,1,0,0,1,0
6352,2,2,0,0,2,0
6352,1,1,0,0,1,0
2573,10,5,0,0,5,0
220774,10,5,0,0,5,0
165477,9,10,0,0,10,0
31722,1,1,0,0,1,0
3986,3,3,0,0,3,0
231567,2,1,0,0,1,0
191177,1,1,0,0,1,0
167292,10,2,0,0,2,0
167292,1,1,0,0,1,0
101930,9,4,0,0,4,0
63975,2,2,0,0,2,0
235512,10,8,0,0,8,0
235512,2,1,0,0,1,0
22465,9,9,0,0,9,0
22465,2,5,0,0,5,0
22465,1,1,0,0,1,0
12296,10,1,0,0,1,0
173092,10,3,0,0,3,0
137237,9,12,0,0,12,0
8671,10,3,0,0,3,0
131568,1,2,0,0,2,0
159632,2,2,0,0,2,0
196526,1,2,0,0,2,0
119637,4,5,0,0,5,0
935,1,1,0,0,1,0
2629,9,4,0,0,4,0
3048,10,2,0,0,2,0
140997,10,8,0,0,8,0
140997,9,8,0,0,8,0
23817,2,3,0,0,3,0
23817,1,4,0,0,4,0
2536,1,1,0,0,1,0
14535,9,5,0,0,5,0
217894,3,8,0,0,8,0
65568,3,5,0,0,5,0
165876,10,4,0,0,4,0
165876,1,1,0,0,1,0
228411,2,2,0,0,2,0
982,1,4,0,0,4,0
177702,10,7,0,0,7,0
177702,2,4,0,0,4,0
217949,1,1,0,0,1,0
218995,10,10,0,0,10,0
218995,2,1,0,0,1,0
161757,10,3,0,0,3,0
3593,1,2,0,0,2,0
244330,10,2,0,0,2,0
244330,3,1,0,0,1,0
244330,2,1,0,0,1,0
244330,1,1,0,0,1,0
124590,1,2,0,0,2,0
114438,2,2,0,0,2,0
114438,1,2,0,0,2,0
19074,1,1,0,0,1,0
71593,2,1,0,0,1,0
14083,1,5,0,0,5,0
219100,3,6,0,0,6,0
1152,3,2,0,0,2,0
1152,2,1,0,0,1,0
1152,1,1,0,0,1,0
72448,10,3,0,0,3,0
181617,10,8,0,0,8,0
181617,3,1,0,0,1,0
181617,2,1,0,0,1,0
180867,1,1,0,0,1,0
181329,4,10,0,0,10,0
162093,10,2,0,0,2,0
178892,3,4,0,0,4,0
178892,1,3,0,0,3,0
18296,10,2,0,0,2,0
128921,10,5,0,0,5,0
236217,10,15,0,0,15,0
236217,3,6,0,0,6,0
236217,2,6,0,0,6,0
253398,3,5,0,0,5,0
136955,1,2,0,0,2,0
182082,1,2,0,0,2,0
172062,10,15,0,0,15,0
172062,2,3,0,0,3,0
66120,3,2,0,0,2,0
258308,2,1,0,0,1,0
258308,1,1,0,0,1,0
164698,10,5,0,0,5,0
11161,10,7,0,0,7,0
11161,3,7,0,0,7,0
11161,2,2,0,0,2,0
11161,1,1,0,0,1,0
66190,3,4,0,0,4,0
221769,2,2,0,0,2,0
20295,2,1,0,0,1,0
142239,2,3,0,0,3,0
201509,1,1,0,0,1,0
66982,10,5,0,0,5,0
118023,10,1,0,0,1,0
118023,2,2,0,0,2,0
118023,1,1,0,0,1,0
5478,1,1,0,0,1,0
147021,10,4,0,0,4,0
216658,4,6,0,0,6,0
216658,3,1,0,0,1,0
205057,1,1,0,0,1,0
41762,3,3,0,0,3,0
41762,2,4,0,0,4,0
41762,1,1,0,0,1,0
434,10,2,0,0,2,0
434,9,6,0,0,6,0
163377,2,3,0,0,3,0
206150,1,2,0,0,2,0
218161,2,2,0,0,2,0
218161,1,1,0,0,1,0
4001,1,2,0,0,2,0
162009,1,1,0,0,1,0
41259,10,1,0,0,1,0
41259,8,9,0,0,9,0
41259,1,4,0,0,4,0
173115,2,2,0,0,2,0
103091,3,6,0,0,6,0
103091,1,2,0,0,2,0
30662,4,4,0,0,4,0
131449,3,6,0,0,6,0
131449,2,1,0,0,1,0
86128,9,5,0,0,5,0
86128,1,1,0,0,1,0
746,1,1,0,0,1,0
67436,1,2,0,0,2,0
322,3,6,0,0,6,0
322,2,2,0,0,2,0
53317,9,2,0,0,2,0
53317,8,11,0,0,11,0
179820,2,1,0,0,1,0
179820,1,1,0,0,1,0
3548,1,1,0,0,1,0
41490,3,3,0,0,3,0
68,2,2,0,0,2,0
68,1,2,0,0,2,0
9439,1,1,0,0,1,0
225729,3,4,0,0,4,0
225729,1,1,0,0,1,0
3137,3,3,0,0,3,0
3137,2,3,0,0,3,0
194230,1,2,0,0,2,0
33088,9,7,0,0,7,0
33088,3,9,0,0,9,0
8450,1,2,0,0,2,0
37301,2,1,0,0,1,0
179259,1,2,0,0,2,0
23935,1,1,0,0,1,0
24410,1,2,0,0,2,0
240465,1,1,0,0,1,0
177490,10,1,0,0,1,0
177490,2,1,0,0,1,0
177490,1,2,0,0,2,0
1413,2,6,0,0,6,0
174155,2,1,0,0,1,0
174155,1,1,0,0,1,0
12826,9,4,0,0,4,0
12826,1,1,0,0,1,0
234931,4,10,0,0,10,0
234931,1,1,0,0,1,0
97875,2,3,0,0,3,0
19679,2,1,0,0,1,0
19679,1,2,0,0,2,0
208480,4,4,0,0,4,0
208480,3,2,0,0,2,0
146818,10,3,0,0,3,0
197065,4,4,0,0,4,0
197065,3,1,0,0,1,0
2043,2,7,0,0,7,0
58099,3,5,0,0,5,0
16362,1,3,0,0,3,0
217776,2,1,0,0,1,0
70916,10,2,0,0,2,0
70916,9,6,0,0,6,0
70916,1,3,0,0,3,0
20782,3,3,0,0,3,0
20782,2,3,0,0,3,0
20782,1,2,0,0,2,0
229741,4,7,0,0,7,0
229741,3,2,0,0,2,0
163027,10,1,0,0,1,0
139245,4,5,0,0,5,0
153709,9,3,0,0,3,0
94733,2,2,0,0,2,0
3463,3,3,0,0,3,0
3463,2,1,0,0,1,0
248900,10,9,0,0,9,0
248900,3,2,0,0,2,0
205885,10,4,0,0,4,0
184824,3,1,0,0,1,0
184824,1,1,0,0,1,0
201920,10,6,0,0,6,0
201920,9,5,0,0,5,0
7514,1,2,0,0,2,0
194553,2,6,0,0,6,0
178209,10,16,0,0,16,0
33581,9,3,0,0,3,0
33581,1,2,0,0,2,0
21613,10,1,0,0,1,0
21613,1,3,0,0,3,0
202755,4,6,0,0,6,0
202755,3,2,0,0,2,0
202755,2,1,0,0,1,0
861,1,2,0,0,2,0
4604,10,2,0,0,2,0
248005,2,1,0,0,1,0
248005,1,2,0,0,2,0
189294,10,2,0,0,2,0
177659,4,3,0,0,3,0
1125,1,1,0,0,1,0
39188,3,2,0,0,2,0
39188,1,2,0,0,2,0
7104,2,1,0,0,1,0
7104,1,1,0,0,1,0
38786,2,2,0,0,2,0
38786,1,2,0,0,2,0
123370,10,3,0,0,3,0
123370,1,2,0,0,2,0
8392,10,3,0,0,3,0
207338,2,1,0,0,1,0
66608,10,1,0,0,1,0
27961,10,3,0,0,3,0
27961,9,2,0,0,2,0
93185,9,5,0,0,5,0
187289,3,11,0,0,11,0
146784,2,4,0,0,4,0
181440,2,2,0,0,2,0
514,1,5,0,0,5,0
19878,10,2,0,0,2,0
19878,2,5,0,0,5,0
3573,2,1,0,0,1,0
261114,3,4,0,0,4,0
261114,2,3,0,0,3,0
1308,10,1,0,0,1,0
1308,9,5,0,0,5,0
2318,9,1,0,0,1,0
58329,10,3,0,0,3,0
170199,3,2,0,0,2,0
103651,3,4,0,0,4,0
103651,2,2,0,0,2,0
38402,10,2,0,0,2,0
155702,10,17,0,0,17,0
155702,2,2,0,0,2,0
155702,1,1,0,0,1,0
210052,4,16,0,0,16,0
1493,2,3,0,0,3,0
222514,2,1,0,0,1,0
222514,1,6,0,0,6,0
13507,3,7,0,0,7,0
13507,2,4,0,0,4,0
13507,1,1,0,0,1,0
25677,10,1,0,0,1,0
206206,1,1,0,0,1,0
234948,3,3,0,0,3,0
4984,2,2,0,0,2,0
39088,10,5,0,0,5,0
176262,3,3,0,0,3,0
29663,1,1,0,0,1,0
79068,1,1,0,0,1,0
17988,3,5,0,0,5,0
172600,9,5,0,0,5,0
172600,1,1,0,0,1,0
248117,10,9,0,0,9,0
248117,3,3,0,0,3,0
248117,2,1,0,0,1,0
248117,1,1,0,0,1,0
10502,9,2,0,0,2,0
160567,3,4,0,0,4,0
160567,1,2,0,0,2,0
15738,10,3,0,0,3,0
15738,1,6,0,0,6,0
213953,1,1,0,0,1,0
173294,4,7,0,0,7,0
173294,3,2,0,0,2,0
137811,10,4,0,0,4,0
207208,10,3,0,0,3,0
112598,1,2,0,0,2,0
170146,10,2,0,0,2,0
170146,1,1,0,0,1,0
179933,2,1,0,0,1,0
64220,2,3,0,0,3,0
64220,1,1,0,0,1,0
177147,3,1,0,0,1,0
186864,2,2,0,0,2,0
186864,1,1,0,0,1,0
68858,4,4,0,0,4,0
68858,3,1,0,0,1,0
68858,1,2,0,0,2,0
93541,10,8,0,0,8,0
93541,2,5,0,0,5,0
196496,2,3,0,0,3,0
196496,1,3,0,0,3,0
99808,10,2,0,0,2,0
99808,1,2,0,0,2,0
101786,1,3,0,0,3,0
154875,4,3,0,0,3,0
154875,1,2,0,0,2,0
217475,9,12,0,0,12,0
217475,3,8,0,0,8,0
1713,9,3,0,0,3,0
39332,1,1,0,0,1,0
165877,2,4,0,0,4,0
165877,1,1,0,0,1,0
244918,3,3,0,0,3,0
244918,1,1,0,0,1,0
149787,1,1,0,0,1,0
133285,2,2,0,0,2,0
3422,10,2,0,0,2,0
55863,2,1,0,0,1,0
55863,1,2,0,0,2,0
110870,9,8,0,0,8,0
110870,1,1,0,0,1,0
32901,4,20,0,0,20,0
32901,3,7,0,0,7,0
256916,5,3,0,0,3,0
256916,3,1,0,0,1,0
3730,2,1,0,0,1,0
4985,1,7,0,0,7,0
5668,9,8,0,0,8,0
5668,1,1,0,0,1,0
43691,2,1,0,0,1,0
203204,2,1,0,0,1,0
203204,1,1,0,0,1,0
3562,9,2,0,0,2,0
144525,10,10,0,0,10,0
205907,3,3,0,0,3,0
245422,2,1,0,0,1,0
186323,3,4,0,0,4,0
186323,2,5,0,0,5,0
199904,2,1,0,0,1,0
199904,1,3,0,0,3,0
38275,1,1,0,0,1,0
13972,9,2,0,0,2,0
13972,1,1,0,0,1,0
35634,10,1,0,0,1,0
35634,1,1,0,0,1,0
271,1,1,0,0,1,0
145501,2,1,0,0,1,0
179350,2,2,0,0,2,0
2150,2,3,0,0,3,0
73313,1,1,0,0,1,0
37739,1,2,0,0,2,0
159143,10,5,0,0,5,0
159143,3,2,0,0,2,0
159143,2,2,0,0,2,0
140271,10,3,0,0,3,0
140271,2,4,0,0,4,0
988,10,2,0,0,2,0
988,2,4,0,0,4,0
988,1,1,0,0,1,0
3893,1,2,0,0,2,0
94734,1,1,0,0,1,0
159209,10,1,0,0,1,0
130390,2,2,0,0,2,0
1439,1,2,0,0,2,0
148271,10,11,0,0,11,0
148271,3,2,0,0,2,0
162152,10,1,0,0,1,0
162152,3,15,0,0,15,0
162152,1,1,0,0,1,0
72766,10,1,0,0,1,0
72766,9,2,0,0,2,0
24224,9,1,0,0,1,0
6508,10,1,0,0,1,0
6508,1,2,0,0,2,0
2608,1,1,0,0,1,0
217362,10,4,0,0,4,0
1678,3,7,0,0,7,0
1678,1,1,0,0,1,0
719,2,1,0,0,1,0
218208,3,1,0,0,1,0
166202,10,4,0,0,4,0
166202,2,4,0,0,4,0
166202,1,1,0,0,1,0
12875,1,2,0,0,2,0
24771,9,2,0,0,2,0
24771,2,2,0,0,2,0
195237,1,1,0,0,1,0
13123,3,3,0,0,3,0
13123,1,3,0,0,3,0
139629,10,1,0,0,1,0
1498,1,1,0,0,1,0
19187,1,2,0,0,2,0
25242,1,2,0,0,2,0
105199,10,3,0,0,3,0
105199,9,5,0,0,5,0
105199,2,1,0,0,1,0
145601,2,1,0,0,1,0
145601,1,2,0,0,2,0
34871,10,8,0,0,8,0
34871,1,2,0,0,2,0
119866,1,2,0,0,2,0
4845,10,3,0,0,3,0
90474,10,3,0,0,3,0
90474,2,2,0,0,2,0
172662,2,3,0,0,3,0
118337,10,2,0,0,2,0
118337,9,5,0,0,5,0
118337,1,1,0,0,1,0
180591,10,2,0,0,2,0
180591,4,10,0,0,10,0
180591,2,1,0,0,1,0
201186,1,3,0,0,3,0
40234,10,1,0,0,1,0
40234,2,2,0,0,2,0
156719,2,1,0,0,1,0
169274,2,1,0,0,1,0
3605,4,2,0,0,2,0
3605,3,2,0,0,2,0
154892,1,1,0,0,1,0
135888,1,1,0,0,1,0
27766,2,4,0,0,4,0
27766,1,1,0,0,1,0
82955,10,3,0,0,3,0
82955,9,14,0,0,14,0
2087,10,1,0,0,1,0
2087,1,2,0,0,2,0
181404,10,3,0,0,3,0
8039,9,2,0,0,2,0
160814,3,11,0,0,11,0
160814,1,2,0,0,2,0
150484,1,1,0,0,1,0
83040,2,1,0,0,1,0
208766,10,2,0,0,2,0
208766,4,6,0,0,6,0
131682,1,2,0,0,2,0
147451,10,3,0,0,3,0
147451,1,1,0,0,1,0
3567,1,1,0,0,1,0
193668,1,3,0,0,3,0
127493,2,1,0,0,1,0
127493,1,1,0,0,1,0
27658,2,6,0,0,6,0
210,2,1,0,0,1,0
1416,1,2,0,0,2,0
143994,3,3,0,0,3,0
230889,4,4,0,0,4,0
230889,3,1,0,0,1,0
230889,1,1,0,0,1,0
6554,10,2,0,0,2,0
6554,1,2,0,0,2,0
1669,1,1,0,0,1,0
216199,3,3,0,0,3,0
216199,1,2,0,0,2,0
181161,3,7,0,0,7,0
706,2,1,0,0,1,0
20609,1,3,0,0,3,0
1509,1,1,0,0,1,0
145186,9,9,0,0,9,0
2197,9,7,0,0,7,0
1533,1,1,0,0,1,0
146158,10,3,0,0,3,0
150298,2,3,0,0,3,0
150298,1,1,0,0,1,0
15410,1,1,0,0,1,0
52328,2,3,0,0,3,0
52328,1,2,0,0,2,0
6613,1,2,0,0,2,0
72482,10,3,0,0,3,0
161530,10,4,0,0,4,0
161530,2,2,0,0,2,0
1520,1,2,0,0,2,0
56835,1,2,0,0,2,0
189062,10,12,0,0,12,0
3040,1,1,0,0,1,0
1668,2,3,0,0,3,0
1668,1,1,0,0,1,0
14379,9,3,0,0,3,0
4907,9,2,0,0,2,0
173536,4,4,0,0,4,0
173536,2,1,0,0,1,0
138166,2,2,0,0,2,0
6866,3,1,0,0,1,0
6866,1,5,0,0,5,0
171492,10,3,0,0,3,0
171492,1,1,0,0,1,0
28609,9,5,0,0,5,0
162580,2,5,0,0,5,0
162580,1,5,0,0,5,0
63,2,2,0,0,2,0
63,1,1,0,0,1,0
22861,10,4,0,0,4,0
330,1,2,0,0,2,0
13166,10,1,0,0,1,0
5306,2,1,0,0,1,0
5306,1,4,0,0,4,0
11096,1,1,0,0,1,0
4688,3,1,0,0,1,0
145842,10,4,0,0,4,0
9616,9,6,0,0,6,0
204505,1,1,0,0,1,0
99459,10,13,0,0,13,0
99459,3,5,0,0,5,0
99459,1,1,0,0,1,0
146579,9,5,0,0,5,0
146579,1,1,0,0,1,0
724,10,2,0,0,2,0
724,1,2,0,0,2,0
3404,10,3,0,0,3,0
227893,3,2,0,0,2,0
33003,1,2,0,0,2,0
172032,10,1,0,0,1,0
172032,9,1,0,0,1,0
84838,2,2,0,0,2,0
84838,1,5,0,0,5,0
1408,1,3,0,0,3,0
58886,10,1,0,0,1,0
58886,2,3,0,0,3,0
5546,10,2,0,0,2,0
5546,1,8,0,0,8,0
84464,3,3,0,0,3,0
197178,2,2,0,0,2,0
197178,1,1,0,0,1,0
178044,2,1,0,0,1,0
166109,1,2,0,0,2,0
24070,1,1,0,0,1,0
130999,10,2,0,0,2,0
129395,10,3,0,0,3,0
137651,1,2,0,0,2,0
8232,10,1,0,0,1,0
8232,2,1,0,0,1,0
200834,10,4,0,0,4,0
200834,2,1,0,0,1,0
200834,1,1,0,0,1,0
33196,10,3,0,0,3,0
33196,1,1,0,0,1,0
149130,10,7,0,0,7,0
256320,1,2,0,0,2,0
182619,1,1,0,0,1,0
37738,10,3,0,0,3,0
201455,1,2,0,0,2,0
28739,10,7,0,0,7,0
28739,1,1,0,0,1,0
2387,10,3,0,0,3,0
42050,9,8,0,0,8,0
42050,1,15,0,0,15,0
3093,4,14,0,0,14,0
3093,3,4,0,0,4,0
3093,1,1,0,0,1,0
1695,2,4,0,0,4,0
1695,1,2,0,0,2,0
128475,10,6,0,0,6,0
89962,9,1,0,0,1,0
2166,10,8,0,0,8,0
2166,9,3,0,0,3,0
125943,1,1,0,0,1,0
1518,10,4,0,0,4,0
190400,3,1,0,0,1,0
181254,2,3,0,0,3,0
67178,3,2,0,0,2,0
67178,2,1,0,0,1,0
170202,10,4,0,0,4,0
170202,1,1,0,0,1,0
66437,3,4,0,0,4,0
66437,1,2,0,0,2,0
366,1,1,0,0,1,0
121409,9,12,0,0,12,0
2598,9,1,0,0,1,0
184919,9,11,0,0,11,0
184919,2,4,0,0,4,0
184919,1,1,0,0,1,0
161761,10,3,0,0,3,0
161761,9,4,0,0,4,0
161761,2,1,0,0,1,0
161761,1,1,0,0,1,0
164158,10,4,0,0,4,0
166633,1,2,0,0,2,0
201846,4,8,0,0,8,0
234691,10,5,0,0,5,0
234691,1,1,0,0,1,0
132817,2,1,0,0,1,0
146559,10,7,0,0,7,0
146559,1,1,0,0,1,0
172507,10,6,0,0,6,0
2179,10,1,0,0,1,0
2179,9,4,0,0,4,0
2179,2,1,0,0,1,0
110868,10,1,0,0,1,0
110868,9,5,0,0,5,0
189222,1,3,0,0,3,0
131246,4,12,0,0,12,0
131246,1,1,0,0,1,0
191877,9,11,0,0,11,0
191877,2,1,0,0,1,0
3385,1,2,0,0,2,0
170318,2,1,0,0,1,0
22479,1,2,0,0,2,0
57,2,1,0,0,1,0
57,1,1,0,0,1,0
177875,2,2,0,0,2,0
132620,3,4,0,0,4,0
132620,1,2,0,0,2,0
1942,1,1,0,0,1,0
81250,4,12,0,0,12,0
97094,10,3,0,0,3,0
97094,9,5,0,0,5,0
97094,2,3,0,0,3,0
264198,5,7,0,0,7,0
264198,3,1,0,0,1,0
40483,1,1,0,0,1,0
46158,4,6,0,0,6,0
46158,3,4,0,0,4,0
46158,2,2,0,0,2,0
46158,1,1,0,0,1,0
912,10,9,0,0,9,0
912,1,1,0,0,1,0
157912,10,2,0,0,2,0
157912,1,1,0,0,1,0
723,9,6,0,0,6,0
1190,10,3,0,0,3,0
25623,1,1,0,0,1,0
15369,4,5,0,0,5,0
15369,2,1,0,0,1,0
15369,1,5,0,0,5,0
173096,3,7,0,0,7,0
173096,1,1,0,0,1,0
157088,3,4,0,0,4,0
157088,2,1,0,0,1,0
13084,3,6,0,0,6,0
13084,1,1,0,0,1,0
164159,1,1,0,0,1,0
66798,3,7,0,0,7,0
66798,2,1,0,0,1,0
1644,1,2,0,0,2,0
147537,2,1,0,0,1,0
147537,1,2,0,0,2,0
113927,3,4,0,0,4,0
113927,2,3,0,0,3,0
113927,1,1,0,0,1,0
31822,1,5,0,0,5,0
253756,1,1,0,0,1,0
204817,4,9,0,0,9,0
129710,10,3,0,0,3,0
129710,9,2,0,0,2,0
129710,1,1,0,0,1,0
93971,3,5,0,0,5,0
93971,1,1,0,0,1,0
3702,10,2,0,0,2,0
109,1,1,0,0,1,0
2086,10,4,0,0,4,0
5014,2,4,0,0,4,0
5014,1,4,0,0,4,0
242667,2,3,0,0,3,0
217321,3,5,0,0,5,0
83197,10,1,0,0,1,0
83197,1,2,0,0,2,0
161943,2,3,0,0,3,0
1210,10,2,0,0,2,0
35614,1,3,0,0,3,0
40935,10,2,0,0,2,0
40935,3,3,0,0,3,0
795,10,1,0,0,1,0
169215,1,1,0,0,1,0
11416,9,2,0,0,2,0
66613,2,1,0,0,1,0
755,1,1,0,0,1,0
225167,5,12,0,0,12,0
170415,10,4,0,0,4,0
170415,2,4,0,0,4,0
170415,1,2,0,0,2,0
3406,1,2,0,0,2,0
29805,5,23,0,0,23,0
29805,1,1,0,0,1,0
102610,10,5,0,0,5,0
8243,9,3,0,0,3,0
7349,3,1,0,0,1,0
7349,1,2,0,0,2,0
195518,10,4,0,0,4,0
195518,1,3,0,0,3,0
88126,4,8,0,0,8,0
88126,3,3,0,0,3,0
88126,2,1,0,0,1,0
216439,3,2,0,0,2,0
2368,2,2,0,0,2,0
7976,10,1,0,0,1,0
7976,1,1,0,0,1,0
1370,1,1,0,0,1,0
143981,2,1,0,0,1,0
39336,5,7,0,0,7,0
39336,4,3,0,0,3,0
39336,3,1,0,0,1,0
39336,2,2,0,0,2,0
39336,1,4,0,0,4,0
35035,3,3,0,0,3,0
35035,2,1,0,0,1,0
35035,1,5,0,0,5,0
2294,10,1,0,0,1,0
3114,9,6,0,0,6,0
4991,10,2,0,0,2,0
36745,10,3,0,0,3,0
64675,10,1,0,0,1,0
64675,9,1,0,0,1,0
33159,10,1,0,0,1,0
36887,1,1,0,0,1,0
14134,1,1,0,0,1,0
163277,3,9,0,0,9,0
163277,2,3,0,0,3,0
89668,10,1,0,0,1,0
89668,2,2,0,0,2,0
158991,3,4,0,0,4,0
158991,2,3,0,0,3,0
158991,1,3,0,0,3,0
148531,2,2,0,0,2,0
710,1,1,0,0,1,0
31612,10,4,0,0,4,0
31612,1,1,0,0,1,0
216578,1,1,0,0,1,0
1666,4,2,0,0,2,0
1666,1,1,0,0,1,0
9149,10,3,0,0,3,0
9149,2,1,0,0,1,0
108831,2,1,0,0,1,0
13464,9,3,0,0,3,0
4854,2,1,0,0,1,0
2972,10,2,0,0,2,0
2972,9,1,0,0,1,0
206844,3,6,0,0,6,0
206844,2,2,0,0,2,0
88922,10,3,0,0,3,0
88922,1,3,0,0,3,0
11385,10,5,0,0,5,0
11385,9,3,0,0,3,0
11385,2,1,0,0,1,0
11385,1,4,0,0,4,0
67919,2,1,0,0,1,0
67919,1,2,0,0,2,0
20101,2,1,0,0,1,0
3934,9,3,0,0,3,0
172073,10,3,0,0,3,0
172073,2,2,0,0,2,0
172073,1,2,0,0,2,0
27380,1,1,0,0,1,0
151,2,1,0,0,1,0
3133,10,1,0,0,1,0
5312,10,1,0,0,1,0
46422,9,8,0,0,8,0
460,1,1,0,0,1,0
22664,10,3,0,0,3,0
22664,1,2,0,0,2,0
233976,10,6,0,0,6,0
233976,1,1,0,0,1,0
117854,1,1,0,0,1,0
128733,2,1,0,0,1,0
41019,9,3,0,0,3,0
19358,2,1,0,0,1,0
19358,1,1,0,0,1,0
41239,3,1,0,0,1,0
41239,2,1,0,0,1,0
1877,10,4,0,0,4,0
225163,10,5,0,0,5,0
225163,2,2,0,0,2,0
225163,1,1,0,0,1,0
57052,10,6,0,0,6,0
57052,2,11,0,0,11,0
26054,10,5,0,0,5,0
200456,1,1,0,0,1,0
171110,4,1,0,0,1,0
171110,1,1,0,0,1,0
235465,10,4,0,0,4,0
235465,2,2,0,0,2,0
168700,10,3,0,0,3,0
168700,3,8,0,0,8,0
168700,1,1,0,0,1,0
256066,4,5,0,0,5,0
256066,3,1,0,0,1,0
256066,1,1,0,0,1,0
27800,9,1,0,0,1,0
257726,10,2,0,0,2,0
257726,2,1,0,0,1,0
185374,2,2,0,0,2,0
154910,4,3,0,0,3,0
154910,1,1,0,0,1,0
5711,2,5,0,0,5,0
5711,1,1,0,0,1,0
204599,3,4,0,0,4,0
31954,3,2,0,0,2,0
13337,1,1,0,0,1,0
61470,10,4,0,0,4,0
541,2,1,0,0,1,0
541,1,2,0,0,2,0
159141,2,3,0,0,3,0
159141,1,1,0,0,1,0
3855,3,4,0,0,4,0
149869,3,9,0,0,9,0
149869,2,2,0,0,2,0
149869,1,3,0,0,3,0
245961,2,1,0,0,1,0
253214,3,1,0,0,1,0
253214,2,1,0,0,1,0
253214,1,2,0,0,2,0
3749,2,5,0,0,5,0
103235,10,1,0,0,1,0
185538,5,3,0,0,3,0
185538,2,1,0,0,1,0
132758,4,6,0,0,6,0
132758,3,1,0,0,1,0
132758,2,1,0,0,1,0
160744,3,6,0,0,6,0
2607,3,9,0,0,9,0
230089,1,1,0,0,1,0
83068,9,7,0,0,7,0
104575,2,7,0,0,7,0
124490,9,6,0,0,6,0
17526,1,1,0,0,1,0
163056,4,3,0,0,3,0
165563,10,2,0,0,2,0
165563,2,1,0,0,1,0
197707,10,3,0,0,3,0
197707,2,2,0,0,2,0
246201,2,1,0,0,1,0
246201,1,1,0,0,1,0
4637,3,8,0,0,8,0
61269,9,14,0,0,14,0
61269,1,1,0,0,1,0
40871,10,5,0,0,5,0
87904,1,1,0,0,1,0
2537,9,1,0,0,1,0
142084,2,2,0,0,2,0
154560,1,1,0,0,1,0
816,3,2,0,0,2,0
816,1,1,0,0,1,0
85243,10,3,0,0,3,0
85243,1,2,0,0,2,0
4327,10,2,0,0,2,0
4327,1,2,0,0,2,0
5941,10,1,0,0,1,0
5941,2,3,0,0,3,0
206448,10,2,0,0,2,0
206448,1,1,0,0,1,0
231223,10,6,0,0,6,0
1702,2,1,0,0,1,0
74102,9,3,0,0,3,0
261594,2,1,0,0,1,0
27155,10,1,0,0,1,0
5425,9,4,0,0,4,0
37612,10,5,0,0,5,0
37612,2,4,0,0,4,0
206490,1,1,0,0,1,0
7989,2,3,0,0,3,0
177210,10,3,0,0,3,0
177210,1,1,0,0,1,0
4789,9,2,0,0,2,0
4789,1,1,0,0,1,0
192401,2,2,0,0,2,0
192401,1,1,0,0,1,0
3563,1,5,0,0,5,0
180325,4,2,0,0,2,0
180325,3,2,0,0,2,0
180325,1,1,0,0,1,0
259374,10,8,0,0,8,0
238393,4,4,0,0,4,0
238393,3,1,0,0,1,0
238393,2,2,0,0,2,0
238393,1,1,0,0,1,0
4318,10,1,0,0,1,0
198287,2,1,0,0,1,0
198287,1,2,0,0,2,0
72667,1,1,0,0,1,0
172613,2,1,0,0,1,0
187353,4,4,0,0,4,0
104805,10,1,0,0,1,0
104805,2,1,0,0,1,0
187687,2,1,0,0,1,0
187687,1,2,0,0,2,0
75448,5,11,0,0,11,0
75448,3,2,0,0,2,0
75448,1,2,0,0,2,0
32405,10,2,0,0,2,0
32405,2,2,0,0,2,0
32405,1,1,0,0,1,0
35669,3,1,0,0,1,0
1679,2,2,0,0,2,0
9108,1,1,0,0,1,0
944,1,4,0,0,4,0
2936,1,1,0,0,1,0
1525,2,1,0,0,1,0
42206,2,4,0,0,4,0
42206,1,2,0,0,2,0
183572,1,2,0,0,2,0
85769,1,3,0,0,3,0
21854,10,2,0,0,2,0
55911,10,3,0,0,3,0
55911,2,2,0,0,2,0
55911,1,2,0,0,2,0
141735,10,1,0,0,1,0
141735,2,2,0,0,2,0
141735,1,2,0,0,2,0
175222,2,1,0,0,1,0
175222,1,1,0,0,1,0
765,10,3,0,0,3,0
765,2,3,0,0,3,0
224133,4,4,0,0,4,0
224133,2,1,0,0,1,0
159575,1,2,0,0,2,0
161965,10,3,0,0,3,0
161965,3,8,0,0,8,0
2350,1,1,0,0,1,0
3263,3,1,0,0,1,0
3263,1,1,0,0,1,0
243430,3,1,0,0,1,0
243430,2,1,0,0,1,0
243430,1,1,0,0,1,0
3553,2,2,0,0,2,0
3413,3,2,0,0,2,0
134150,10,4,0,0,4,0
134150,2,1,0,0,1,0
33155,10,1,0,0,1,0
126613,4,14,0,0,14,0
6542,2,4,0,0,4,0
6542,1,1,0,0,1,0
156457,2,1,0,0,1,0
156457,1,1,0,0,1,0
263,9,1,0,0,1,0
263,3,5,0,0,5,0
164237,10,4,0,0,4,0
164237,3,2,0,0,2,0
164237,2,4,0,0,4,0
152510,10,12,0,0,12,0
152510,2,2,0,0,2,0
18127,10,2,0,0,2,0
104655,2,3,0,0,3,0
147194,10,8,0,0,8,0
147194,9,8,0,0,8,0
147194,1,1,0,0,1,0
24568,2,1,0,0,1,0
121993,10,2,0,0,2,0
121993,2,3,0,0,3,0
162378,10,4,0,0,4,0
162378,1,1,0,0,1,0
38858,10,2,0,0,2,0
38858,2,3,0,0,3,0
38858,1,2,0,0,2,0
232079,3,5,0,0,5,0
232079,1,1,0,0,1,0
18975,1,1,0,0,1,0
199780,1,1,0,0,1,0
134520,5,6,0,0,6,0
134520,4,4,0,0,4,0
134520,1,1,0,0,1,0
33172,9,3,0,0,3,0
72644,3,2,0,0,2,0
72644,2,1,0,0,1,0
30804,3,2,0,0,2,0
30804,1,1,0,0,1,0
1701,9,2,0,0,2,0
137900,10,3,0,0,3,0
137900,2,2,0,0,2,0
228668,4,1,0,0,1,0
13328,10,4,0,0,4,0
13328,9,2,0,0,2,0
13328,2,7,0,0,7,0
162041,3,4,0,0,4,0
162041,2,4,0,0,4,0
163841,5,4,0,0,4,0
163841,2,1,0,0,1,0
163841,1,1,0,0,1,0
14403,2,2,0,0,2,0
14403,1,9,0,0,9,0
34583,10,2,0,0,2,0
235627,3,4,0,0,4,0
235627,1,1,0,0,1,0
175846,10,2,0,0,2,0
175846,9,3,0,0,3,0
15047,1,3,0,0,3,0
125977,1,1,0,0,1,0
128537,9,7,0,0,7,0
19624,10,3,0,0,3,0
19624,3,5,0,0,5,0
10869,1,1,0,0,1,0
28805,3,1,0,0,1,0
28805,2,3,0,0,3,0
28805,1,5,0,0,5,0
27451,5,44,0,0,44,0
27451,1,4,0,0,4,0
2611,1,3,0,0,3,0
148729,2,4,0,0,4,0
148729,1,2,0,0,2,0
161681,2,2,0,0,2,0
34829,1,2,0,0,2,0
56342,9,5,0,0,5,0
226255,2,2,0,0,2,0
230852,2,3,0,0,3,0
230852,1,1,0,0,1,0
161138,9,7,0,0,7,0
161138,2,3,0,0,3,0
161138,1,1,0,0,1,0
170300,1,1,0,0,1,0
173460,3,3,0,0,3,0
173460,1,2,0,0,2,0
6923,2,1,0,0,1,0
120426,10,2,0,0,2,0
229956,1,1,0,0,1,0
30024,3,4,0,0,4,0
150014,2,3,0,0,3,0
150014,1,1,0,0,1,0
140612,1,3,0,0,3,0
108157,10,3,0,0,3,0
108157,9,3,0,0,3,0
227273,4,5,0,0,5,0
227273,3,1,0,0,1,0
227273,2,1,0,0,1,0
132326,2,1,0,0,1,0
4910,10,1,0,0,1,0
4910,9,3,0,0,3,0
38387,3,1,0,0,1,0
38387,2,1,0,0,1,0
234429,1,2,0,0,2,0
16500,10,1,0,0,1,0
16500,9,4,0,0,4,0
16500,1,1,0,0,1,0
245357,1,2,0,0,2,0
4282,10,2,0,0,2,0
304,1,3,0,0,3,0
178007,2,5,0,0,5,0
25605,9,3,0,0,3,0
25605,2,1,0,0,1,0
25605,1,2,0,0,2,0
3484,10,2,0,0,2,0
205185,1,1,0,0,1,0
181811,1,1,0,0,1,0
232829,2,1,0,0,1,0
224894,3,3,0,0,3,0
224894,2,2,0,0,2,0
27306,2,1,0,0,1,0
198110,2,3,0,0,3,0
141653,3,2,0,0,2,0
141653,2,1,0,0,1,0
206327,4,1,0,0,1,0
206327,3,1,0,0,1,0
206327,1,1,0,0,1,0
2242,10,2,0,0,2,0
42306,4,5,0,0,5,0
42306,3,4,0,0,4,0
42306,1,1,0,0,1,0
161297,1,1,0,0,1,0
1387,9,2,0,0,2,0
1387,2,2,0,0,2,0
154602,1,3,0,0,3,0
145,10,4,0,0,4,0
639,1,1,0,0,1,0
239942,2,1,0,0,1,0
236461,2,2,0,0,2,0
103877,10,1,0,0,1,0
55679,1,3,0,0,3,0
172560,10,3,0,0,3,0
172560,2,3,0,0,3,0
84889,1,1,0,0,1,0
301,10,2,0,0,2,0
229632,3,2,0,0,2,0
229632,2,1,0,0,1,0
15880,10,1,0,0,1,0
94915,10,14,0,0,14,0
94915,9,9,0,0,9,0
164354,10,1,0,0,1,0
164354,3,6,0,0,6,0
164354,1,2,0,0,2,0
18750,10,1,0,0,1,0
4211,3,1,0,0,1,0
4211,2,2,0,0,2,0
4211,1,1,0,0,1,0
2771,9,1,0,0,1,0
1806,1,2,0,0,2,0
1558,10,4,0,0,4,0
66076,10,2,0,0,2,0
66076,9,9,0,0,9,0
66076,1,1,0,0,1,0
2077,3,1,0,0,1,0
76883,10,2,0,0,2,0
76883,2,3,0,0,3,0
125854,10,1,0,0,1,0
118385,2,2,0,0,2,0
118385,1,1,0,0,1,0
39383,1,1,0,0,1,0
229543,10,4,0,0,4,0
229543,9,9,0,0,9,0
244212,2,1,0,0,1,0
244212,1,1,0,0,1,0
2947,9,3,0,0,3,0
1251,10,3,0,0,3,0
55835,2,2,0,0,2,0
222219,1,1,0,0,1,0
135215,2,4,0,0,4,0
147624,2,3,0,0,3,0
214484,3,1,0,0,1,0
214484,2,1,0,0,1,0
203740,2,3,0,0,3,0
37376,9,4,0,0,4,0
162591,10,4,0,0,4,0
162591,3,12,0,0,12,0
162591,2,7,0,0,7,0
162591,1,3,0,0,3,0
17075,9,2,0,0,2,0
3845,10,2,0,0,2,0
3845,1,2,0,0,2,0
1101,10,1,0,0,1,0
1101,9,2,0,0,2,0
1101,2,3,0,0,3,0
244513,4,4,0,0,4,0
244513,3,1,0,0,1,0
251053,1,2,0,0,2,0
66126,10,3,0,0,3,0
27826,9,2,0,0,2,0
112991,1,1,0,0,1,0
234469,10,1,0,0,1,0
234469,3,5,0,0,5,0
12545,9,2,0,0,2,0
204675,10,4,0,0,4,0
204675,4,11,0,0,11,0
231218,4,2,0,0,2,0
231218,1,1,0,0,1,0
195296,1,2,0,0,2,0
15046,10,3,0,0,3,0
15046,9,6,0,0,6,0
15046,1,6,0,0,6,0
122943,10,1,0,0,1,0
122943,9,5,0,0,5,0
41493,10,6,0,0,6,0
41493,1,2,0,0,2,0
147707,10,2,0,0,2,0
147707,2,1,0,0,1,0
147707,1,1,0,0,1,0
176524,1,2,0,0,2,0
18265,2,3,0,0,3,0
18265,1,1,0,0,1,0
147568,1,2,0,0,2,0
17394,2,2,0,0,2,0
131261,2,2,0,0,2,0
193670,4,1,0,0,1,0
193670,3,1,0,0,1,0
193670,1,1,0,0,1,0
67631,9,2,0,0,2,0
204592,1,3,0,0,3,0
160418,1,1,0,0,1,0
3710,1,1,0,0,1,0
154902,10,1,0,0,1,0
154902,9,8,0,0,8,0
4212,3,1,0,0,1,0
4212,2,2,0,0,2,0
4212,1,1,0,0,1,0
234248,10,1,0,0,1,0
234248,3,1,0,0,1,0
232045,10,3,0,0,3,0
232045,9,6,0,0,6,0
232045,3,7,0,0,7,0
232045,2,5,0,0,5,0
216864,10,3,0,0,3,0
183959,3,3,0,0,3,0
224031,10,4,0,0,4,0
224031,1,1,0,0,1,0
17162,3,5,0,0,5,0
17162,1,1,0,0,1,0
22266,10,1,0,0,1,0
206939,2,3,0,0,3,0
668,10,1,0,0,1,0
668,1,1,0,0,1,0
30324,10,7,0,0,7,0
30324,3,8,0,0,8,0
90009,4,7,0,0,7,0
90009,1,2,0,0,2,0
101737,9,1,0,0,1,0
24067,10,3,0,0,3,0
24067,9,2,0,0,2,0
4258,1,3,0,0,3,0
183264,3,8,0,0,8,0
183264,1,1,0,0,1,0
63395,10,1,0,0,1,0
205831,2,6,0,0,6,0
205831,1,1,0,0,1,0
192701,10,2,0,0,2,0
192701,2,5,0,0,5,0
5709,9,5,0,0,5,0
110286,2,3,0,0,3,0
110286,1,1,0,0,1,0
14039,3,5,0,0,5,0
14039,2,3,0,0,3,0
176589,10,2,0,0,2,0
176589,9,2,0,0,2,0
176589,1,2,0,0,2,0
233149,10,6,0,0,6,0
68076,5,5,0,0,5,0
68076,4,1,0,0,1,0
68076,1,2,0,0,2,0
182770,5,10,0,0,10,0
193485,1,1,0,0,1,0
7263,1,1,0,0,1,0
89918,10,2,0,0,2,0
89918,9,6,0,0,6,0
182605,9,3,0,0,3,0
207729,5,4,0,0,4,0
207729,4,4,0,0,4,0
135877,2,2,0,0,2,0
135877,1,1,0,0,1,0
680,10,5,0,0,5,0
680,1,2,0,0,2,0
147240,3,2,0,0,2,0
211533,9,10,0,0,10,0
211533,2,4,0,0,4,0
204886,1,3,0,0,3,0
171136,10,3,0,0,3,0
171136,2,1,0,0,1,0
171136,1,3,0,0,3,0
17997,2,2,0,0,2,0
17997,1,1,0,0,1,0
295,10,2,0,0,2,0
2130,10,3,0,0,3,0
155827,9,25,0,0,25,0
155827,2,4,0,0,4,0
193164,10,1,0,0,1,0
193164,2,2,0,0,2,0
193164,1,4,0,0,4,0
226254,10,2,0,0,2,0
226254,2,1,0,0,1,0
2672,10,1,0,0,1,0
34819,10,1,0,0,1,0
34819,1,1,0,0,1,0
50849,9,3,0,0,3,0
17923,9,14,0,0,14,0
17923,3,1,0,0,1,0
17923,2,3,0,0,3,0
62,9,4,0,0,4,0
255615,10,11,0,0,11,0
255615,5,11,0,0,11,0
5684,2,1,0,0,1,0
5684,1,3,0,0,3,0
127188,9,1,0,0,1,0
127188,2,1,0,0,1,0
4746,1,2,0,0,2,0
144526,10,4,0,0,4,0
144526,9,9,0,0,9,0
144526,2,1,0,0,1,0
144526,1,1,0,0,1,0
69582,10,2,0,0,2,0
69582,1,3,0,0,3,0
23779,1,1,0,0,1,0
123844,3,7,0,0,7,0
123844,1,1,0,0,1,0
191624,1,2,0,0,2,0
49276,10,8,0,0,8,0
49276,3,1,0,0,1,0
49276,1,1,0,0,1,0
115288,4,5,0,0,5,0
115288,2,2,0,0,2,0
189453,10,6,0,0,6,0
189453,4,4,0,0,4,0
123536,3,3,0,0,3,0
7308,8,6,0,0,6,0
2342,2,2,0,0,2,0
94483,3,2,0,0,2,0
94483,1,1,0,0,1,0
163929,3,3,0,0,3,0
163929,2,3,0,0,3,0
235922,3,1,0,0,1,0
235922,2,1,0,0,1,0
160419,2,2,0,0,2,0
72131,1,2,0,0,2,0
195194,2,3,0,0,3,0
8138,3,2,0,0,2,0
13976,10,1,0,0,1,0
193265,2,1,0,0,1,0
193265,1,1,0,0,1,0
191986,10,2,0,0,2,0
8515,1,1,0,0,1,0
23848,10,2,0,0,2,0
130295,10,5,0,0,5,0
6531,10,1,0,0,1,0
53804,1,3,0,0,3,0
3707,1,2,0,0,2,0
171541,3,6,0,0,6,0
171541,2,3,0,0,3,0
171541,1,1,0,0,1,0
10707,10,5,0,0,5,0
14188,1,3,0,0,3,0
1380,10,1,0,0,1,0
1380,2,1,0,0,1,0
1380,1,1,0,0,1,0
853,10,2,0,0,2,0
853,2,1,0,0,1,0
5035,2,1,0,0,1,0
335,3,5,0,0,5,0
12633,9,2,0,0,2,0
129122,3,1,0,0,1,0
129122,2,1,0,0,1,0
129122,1,2,0,0,2,0
42328,10,9,0,0,9,0
42328,3,1,0,0,1,0
205079,2,3,0,0,3,0
205079,1,1,0,0,1,0
142063,4,7,0,0,7,0
142063,1,2,0,0,2,0
1585,3,1,0,0,1,0
1585,2,1,0,0,1,0
1585,1,1,0,0,1,0
16226,9,3,0,0,3,0
2962,10,1,0,0,1,0
2962,9,1,0,0,1,0
2962,1,1,0,0,1,0
31697,1,1,0,0,1,0
165556,3,2,0,0,2,0
165556,2,1,0,0,1,0
165556,1,2,0,0,2,0
13354,1,1,0,0,1,0
198707,5,1,0,0,1,0
198707,4,1,0,0,1,0
198707,1,1,0,0,1,0
214491,9,7,0,0,7,0
214491,2,1,0,0,1,0
214491,1,2,0,0,2,0
2268,3,6,0,0,6,0
104555,10,1,0,0,1,0
104555,9,3,0,0,3,0
104555,1,1,0,0,1,0
129380,1,1,0,0,1,0
169530,1,1,0,0,1,0
219232,3,3,0,0,3,0
193953,3,2,0,0,2,0
180179,10,2,0,0,2,0
180179,2,1,0,0,1,0
180179,1,2,0,0,2,0
243696,10,7,0,0,7,0
243696,2,1,0,0,1,0
3679,10,2,0,0,2,0
736,9,2,0,0,2,0
5015,10,1,0,0,1,0
5015,9,1,0,0,1,0
200551,2,1,0,0,1,0
200551,1,1,0,0,1,0
153238,2,2,0,0,2,0
232473,2,4,0,0,4,0
6090,8,6,0,0,6,0
6090,1,7,0,0,7,0
3378,9,5,0,0,5,0
107638,1,1,0,0,1,0
230591,1,1,0,0,1,0
234877,10,4,0,0,4,0
234877,2,1,0,0,1,0
21022,3,5,0,0,5,0
21022,2,4,0,0,4,0
21022,1,1,0,0,1,0
19591,10,3,0,0,3,0
19591,1,3,0,0,3,0
47218,10,1,0,0,1,0
47218,1,1,0,0,1,0
173074,9,6,0,0,6,0
5445,3,4,0,0,4,0
305,10,2,0,0,2,0
6584,10,5,0,0,5,0
186302,1,1,0,0,1,0
204135,10,2,0,0,2,0
204135,3,5,0,0,5,0
204135,1,1,0,0,1,0
4980,10,1,0,0,1,0
218580,2,1,0,0,1,0
218580,1,1,0,0,1,0
155460,10,11,0,0,11,0
36482,5,10,0,0,10,0
36482,3,2,0,0,2,0
36482,2,1,0,0,1,0
36482,1,1,0,0,1,0
22826,10,8,0,0,8,0
22826,2,4,0,0,4,0
22826,1,1,0,0,1,0
38504,10,1,0,0,1,0
38504,9,1,0,0,1,0
20675,1,3,0,0,3,0
32838,1,3,0,0,3,0
4958,3,3,0,0,3,0
4958,2,1,0,0,1,0
128938,2,1,0,0,1,0
246228,4,15,0,0,15,0
246228,2,1,0,0,1,0
204543,9,1,0,0,1,0
257067,1,2,0,0,2,0
33495,5,17,0,0,17,0
33495,3,4,0,0,4,0
33495,2,2,0,0,2,0
33495,1,1,0,0,1,0
136245,2,2,0,0,2,0
127134,3,6,0,0,6,0
127134,2,1,0,0,1,0
25409,9,3,0,0,3,0
6566,10,2,0,0,2,0
6566,9,2,0,0,2,0
6566,1,2,0,0,2,0
189192,2,3,0,0,3,0
189192,1,3,0,0,3,0
203270,2,2,0,0,2,0
6646,1,2,0,0,2,0
4376,10,1,0,0,1,0
4376,9,3,0,0,3,0
4376,1,1,0,0,1,0
101796,1,2,0,0,2,0
222643,1,1,0,0,1,0
173649,1,1,0,0,1,0
181176,2,1,0,0,1,0
181176,1,1,0,0,1,0
1920,2,2,0,0,2,0
213549,4,6,0,0,6,0
46362,2,3,0,0,3,0
94365,9,7,0,0,7,0
94365,3,2,0,0,2,0
94365,2,4,0,0,4,0
13542,10,3,0,0,3,0
13542,1,1,0,0,1,0
3059,10,2,0,0,2,0
608,1,1,0,0,1,0
175458,9,3,0,0,3,0
175458,1,2,0,0,2,0
10682,10,2,0,0,2,0
10682,2,1,0,0,1,0
172596,10,1,0,0,1,0
172596,9,5,0,0,5,0
172596,1,1,0,0,1,0
39232,1,1,0,0,1,0
55763,4,19,0,0,19,0
55763,3,5,0,0,5,0
17517,10,4,0,0,4,0
17517,9,5,0,0,5,0
17517,1,1,0,0,1,0
233974,3,1,0,0,1,0
140279,10,5,0,0,5,0
140279,3,9,0,0,9,0
140279,1,2,0,0,2,0
8196,1,1,0,0,1,0
161527,3,1,0,0,1,0
1817,10,3,0,0,3,0
171964,1,1,0,0,1,0
27680,4,4,0,0,4,0
27680,3,2,0,0,2,0
27680,2,2,0,0,2,0
16804,2,1,0,0,1,0
34745,10,1,0,0,1,0
34745,9,1,0,0,1,0
1867,10,2,0,0,2,0
155802,10,4,0,0,4,0
155802,2,1,0,0,1,0
10527,1,1,0,0,1,0
1551,10,1,0,0,1,0
574,2,2,0,0,2,0
188188,10,6,0,0,6,0
188188,2,1,0,0,1,0
5472,9,1,0,0,1,0
145654,3,2,0,0,2,0
145654,2,2,0,0,2,0
1835,1,2,0,0,2,0
841,10,3,0,0,3,0
13285,9,1,0,0,1,0
17651,3,1,0,0,1,0
17651,2,1,0,0,1,0
143882,4,6,0,0,6,0
153728,2,2,0,0,2,0
153728,1,1,0,0,1,0
4106,10,1,0,0,1,0
96345,10,2,0,0,2,0
96345,2,3,0,0,3,0
213661,10,3,0,0,3,0
213661,4,8,0,0,8,0
213661,3,3,0,0,3,0
170041,4,14,0,0,14,0
170041,2,3,0,0,3,0
150580,3,6,0,0,6,0
150580,2,1,0,0,1,0
158544,2,1,0,0,1,0
82397,10,3,0,0,3,0
82397,1,2,0,0,2,0
2843,10,1,0,0,1,0
24318,10,3,0,0,3,0
24318,9,1,0,0,1,0
24318,1,4,0,0,4,0
2478,10,1,0,0,1,0
2478,9,7,0,0,7,0
3061,4,9,0,0,9,0
3061,3,2,0,0,2,0
209664,10,5,0,0,5,0
209664,3,2,0,0,2,0
209664,1,2,0,0,2,0
79312,9,2,0,0,2,0
36783,10,1,0,0,1,0
170381,9,2,0,0,2,0
22544,1,2,0,0,2,0
145103,4,6,0,0,6,0
145103,3,5,0,0,5,0
130552,2,4,0,0,4,0
130552,1,3,0,0,3,0
108783,10,1,0,0,1,0
108783,9,4,0,0,4,0
172362,3,2,0,0,2,0
165959,9,6,0,0,6,0
165959,2,2,0,0,2,0
165959,1,1,0,0,1,0
215437,2,1,0,0,1,0
215437,1,3,0,0,3,0
246684,10,14,0,0,14,0
246684,4,4,0,0,4,0
246684,1,1,0,0,1,0
140857,1,1,0,0,1,0
1832,9,2,0,0,2,0
20228,9,4,0,0,4,0
20228,2,1,0,0,1,0
2297,10,1,0,0,1,0
2297,9,2,0,0,2,0
125996,3,2,0,0,2,0
125996,2,2,0,0,2,0
125996,1,1,0,0,1,0
223602,10,3,0,0,3,0
144468,1,2,0,0,2,0
82272,10,1,0,0,1,0
25900,4,1,0,0,1,0
476,3,6,0,0,6,0
40213,2,5,0,0,5,0
40213,1,2,0,0,2,0
41474,2,5,0,0,5,0
97655,10,2,0,0,2,0
97655,9,3,0,0,3,0
97655,1,1,0,0,1,0
241491,4,15,0,0,15,0
1633,10,8,0,0,8,0
1633,1,1,0,0,1,0
1910,1,3,0,0,3,0
4920,4,3,0,0,3,0
3887,1,1,0,0,1,0
181290,2,1,0,0,1,0
181290,1,1,0,0,1,0
201308,3,1,0,0,1,0
13121,10,1,0,0,1,0
13121,9,4,0,0,4,0
175334,1,1,0,0,1,0
10174,3,3,0,0,3,0
10174,2,1,0,0,1,0
10174,1,3,0,0,3,0
247160,9,13,0,0,13,0
247160,2,2,0,0,2,0
192656,2,1,0,0,1,0
159566,2,4,0,0,4,0
168537,5,7,0,0,7,0
168537,1,3,0,0,3,0
236709,2,1,0,0,1,0
236709,1,1,0,0,1,0
207572,5,3,0,0,3,0
252526,4,3,0,0,3,0
252526,3,3,0,0,3,0
252526,2,1,0,0,1,0
101865,5,6,0,0,6,0
101865,2,1,0,0,1,0
101865,1,1,0,0,1,0
146275,9,5,0,0,5,0
18400,10,1,0,0,1,0
18400,2,2,0,0,2,0
18400,1,1,0,0,1,0
25727,4,2,0,0,2,0
6927,3,1,0,0,1,0
6927,2,1,0,0,1,0
6927,1,1,0,0,1,0
147614,2,1,0,0,1,0
147614,1,2,0,0,2,0
196305,3,1,0,0,1,0
3095,1,1,0,0,1,0
149361,3,2,0,0,2,0
149361,2,1,0,0,1,0
149361,1,1,0,0,1,0
23631,10,2,0,0,2,0
4206,4,1,0,0,1,0
4206,3,2,0,0,2,0
4206,1,2,0,0,2,0
1578,10,1,0,0,1,0
8139,2,1,0,0,1,0
186767,3,5,0,0,5,0
186767,1,1,0,0,1,0
133405,3,2,0,0,2,0
255455,2,2,0,0,2,0
138704,3,1,0,0,1,0
152567,10,2,0,0,2,0
152567,3,5,0,0,5,0
160434,9,1,0,0,1,0
160434,1,1,0,0,1,0
138105,1,2,0,0,2,0
39564,9,6,0,0,6,0
24933,10,3,0,0,3,0
24933,9,3,0,0,3,0
24933,2,4,0,0,4,0
285,10,4,0,0,4,0
33427,1,2,0,0,2,0
126207,10,4,0,0,4,0
173804,2,1,0,0,1,0
158915,10,2,0,0,2,0
13089,3,2,0,0,2,0
13089,2,2,0,0,2,0
171542,10,1,0,0,1,0
171542,1,2,0,0,2,0
44614,10,5,0,0,5,0
44614,1,2,0,0,2,0
128412,9,10,0,0,10,0
220778,3,5,0,0,5,0
220778,2,2,0,0,2,0
220778,1,2,0,0,2,0
1319,10,1,0,0,1,0
1319,3,2,0,0,2,0
1319,1,1,0,0,1,0
61028,1,1,0,0,1,0
4214,2,1,0,0,1,0
169062,2,5,0,0,5,0
169062,1,3,0,0,3,0
195547,2,9,0,0,9,0
11706,10,1,0,0,1,0
11706,1,2,0,0,2,0
152851,10,4,0,0,4,0
22420,2,1,0,0,1,0
178550,4,6,0,0,6,0
178550,2,1,0,0,1,0
230791,3,1,0,0,1,0
230791,2,4,0,0,4,0
144557,10,3,0,0,3,0
144557,9,2,0,0,2,0
99479,10,4,0,0,4,0
95893,10,1,0,0,1,0
95893,8,12,0,0,12,0
95893,1,2,0,0,2,0
711,2,1,0,0,1,0
711,1,1,0,0,1,0
2115,10,2,0,0,2,0
2115,9,3,0,0,3,0
2115,1,3,0,0,3,0
65825,2,1,0,0,1,0
65825,1,1,0,0,1,0
1681,2,1,0,0,1,0
965,10,1,0,0,1,0
965,9,1,0,0,1,0
965,1,2,0,0,2,0
42713,1,3,0,0,3,0
26162,10,1,0,0,1,0
26162,1,1,0,0,1,0
34701,3,3,0,0,3,0
34701,1,2,0,0,2,0
142557,2,1,0,0,1,0
142557,1,1,0,0,1,0
188614,2,5,0,0,5,0
188614,1,1,0,0,1,0
3097,2,1,0,0,1,0
3097,1,1,0,0,1,0
1300,10,1,0,0,1,0
111172,2,5,0,0,5,0
42105,10,8,0,0,8,0
42105,2,4,0,0,4,0
24959,10,1,0,0,1,0
24959,8,5,0,0,5,0
147887,3,1,0,0,1,0
147887,1,1,0,0,1,0
3285,10,1,0,0,1,0
219512,2,3,0,0,3,0
219512,1,2,0,0,2,0
42142,5,6,0,0,6,0
42142,3,2,0,0,2,0
42142,2,1,0,0,1,0
42142,1,2,0,0,2,0
181370,3,8,0,0,8,0
349,9,1,0,0,1,0
349,2,8,0,0,8,0
67309,10,2,0,0,2,0
67309,2,2,0,0,2,0
67309,1,1,0,0,1,0
189869,10,4,0,0,4,0
189869,4,5,0,0,5,0
189869,3,1,0,0,1,0
29285,1,3,0,0,3,0
9963,3,1,0,0,1,0
9963,1,2,0,0,2,0
176816,4,21,0,0,21,0
176816,1,2,0,0,2,0
27938,10,1,0,0,1,0
27938,2,4,0,0,4,0
6283,10,3,0,0,3,0
242653,4,3,0,0,3,0
242653,3,1,0,0,1,0
1586,10,4,0,0,4,0
220203,1,1,0,0,1,0
220988,10,2,0,0,2,0
4974,1,1,0,0,1,0
67600,5,4,0,0,4,0
67600,1,1,0,0,1,0
85108,10,9,0,0,9,0
85108,2,2,0,0,2,0
12157,3,3,0,0,3,0
118025,10,1,0,0,1,0
118025,1,1,0,0,1,0
31897,3,2,0,0,2,0
174611,10,5,0,0,5,0
408,9,2,0,0,2,0
408,3,1,0,0,1,0
153724,9,3,0,0,3,0
440,3,2,0,0,2,0
440,2,1,0,0,1,0
6544,2,1,0,0,1,0
6544,1,1,0,0,1,0
13933,10,1,0,0,1,0
13933,9,4,0,0,4,0
149097,3,2,0,0,2,0
126000,10,3,0,0,3,0
3177,10,3,0,0,3,0
3177,3,2,0,0,2,0
3177,1,2,0,0,2,0
56294,1,4,0,0,4,0
172207,10,4,0,0,4,0
172207,9,5,0,0,5,0
172207,3,6,0,0,6,0
8993,3,3,0,0,3,0
21798,10,2,0,0,2,0
217553,2,1,0,0,1,0
63170,5,3,0,0,3,0
63170,4,2,0,0,2,0
63170,3,1,0,0,1,0
177697,10,4,0,0,4,0
177697,4,7,0,0,7,0
177697,2,1,0,0,1,0
177697,1,1,0,0,1,0
12896,5,4,0,0,4,0
2224,1,1,0,0,1,0
5367,10,1,0,0,1,0
6980,10,1,0,0,1,0
66590,10,1,0,0,1,0
367,10,1,0,0,1,0
7103,4,3,0,0,3,0
56880,9,3,0,0,3,0
124960,9,3,0,0,3,0
4375,10,1,0,0,1,0
4375,2,4,0,0,4,0
152241,5,22,0,0,22,0
2123,2,2,0,0,2,0
164589,10,1,0,0,1,0
164589,1,1,0,0,1,0
223518,10,6,0,0,6,0
36325,1,1,0,0,1,0
172866,2,3,0,0,3,0
360,10,1,0,0,1,0
360,9,2,0,0,2,0
38154,9,3,0,0,3,0
38154,2,6,0,0,6,0
38154,1,5,0,0,5,0
153939,10,3,0,0,3,0
153939,2,5,0,0,5,0
34001,9,5,0,0,5,0
45319,10,3,0,0,3,0
45319,9,2,0,0,2,0
23329,9,3,0,0,3,0
104627,3,5,0,0,5,0
104627,2,3,0,0,3,0
12963,10,1,0,0,1,0
12963,1,1,0,0,1,0
5833,2,1,0,0,1,0
164874,3,6,0,0,6,0
164874,2,1,0,0,1,0
164874,1,2,0,0,2,0
39635,2,1,0,0,1,0
39635,1,2,0,0,2,0
129946,2,1,0,0,1,0
85394,1,8,0,0,8,0
32743,10,4,0,0,4,0
32743,9,3,0,0,3,0
32743,8,17,0,0,17,0
218421,3,1,0,0,1,0
218421,2,1,0,0,1,0
155042,2,3,0,0,3,0
37983,1,1,0,0,1,0
7553,10,2,0,0,2,0
10989,1,2,0,0,2,0
92852,10,1,0,0,1,0
92852,2,1,0,0,1,0
92852,1,2,0,0,2,0
19796,10,1,0,0,1,0
19796,9,3,0,0,3,0
19796,1,2,0,0,2,0
67693,10,1,0,0,1,0
2895,10,2,0,0,2,0
237251,4,4,0,0,4,0
237251,2,2,0,0,2,0
94724,10,1,0,0,1,0
94724,9,7,0,0,7,0
40491,10,1,0,0,1,0
40491,9,4,0,0,4,0
40491,5,24,0,0,24,0
40491,3,2,0,0,2,0
40491,2,1,0,0,1,0
40491,1,1,0,0,1,0
8630,1,4,0,0,4,0
68603,3,3,0,0,3,0
65516,10,3,0,0,3,0
194723,4,7,0,0,7,0
224079,3,4,0,0,4,0
156737,2,3,0,0,3,0
197072,1,2,0,0,2,0
176435,3,3,0,0,3,0
192312,1,1,0,0,1,0
15209,10,5,0,0,5,0
15209,3,1,0,0,1,0
937,1,2,0,0,2,0
369,2,1,0,0,1,0
1627,9,4,0,0,4,0
12234,4,6,0,0,6,0
12234,2,1,0,0,1,0
12234,1,5,0,0,5,0
148231,10,4,0,0,4,0
148231,2,2,0,0,2,0
233956,3,2,0,0,2,0
233956,2,1,0,0,1,0
1436,10,2,0,0,2,0
139572,10,4,0,0,4,0
139572,9,10,0,0,10,0
6581,2,1,0,0,1,0
6581,1,5,0,0,5,0
606,10,3,0,0,3,0
15832,10,2,0,0,2,0
207330,9,8,0,0,8,0
207330,4,4,0,0,4,0
207330,3,3,0,0,3,0
35122,10,2,0,0,2,0
183447,3,9,0,0,9,0
183447,2,2,0,0,2,0
183447,1,1,0,0,1,0
178835,2,6,0,0,6,0
102107,10,8,0,0,8,0
192830,3,4,0,0,4,0
26156,10,2,0,0,2,0
26156,9,4,0,0,4,0
26156,4,6,0,0,6,0
7843,10,8,0,0,8,0
7843,3,2,0,0,2,0
207898,3,2,0,0,2,0
207898,1,1,0,0,1,0
125609,10,5,0,0,5,0
125609,9,4,0,0,4,0
125609,1,1,0,0,1,0
2997,3,4,0,0,4,0
2997,1,2,0,0,2,0
207910,3,1,0,0,1,0
207910,1,1,0,0,1,0
1249,10,1,0,0,1,0
1249,1,2,0,0,2,0
2891,3,1,0,0,1,0
2891,1,1,0,0,1,0
34375,3,7,0,0,7,0
260757,3,1,0,0,1,0
147999,4,4,0,0,4,0
147999,3,2,0,0,2,0
223931,5,2,0,0,2,0
223931,4,1,0,0,1,0
1434,2,2,0,0,2,0
1434,1,2,0,0,2,0
1961,10,2,0,0,2,0
203405,2,1,0,0,1,0
203405,1,2,0,0,2,0
389,2,3,0,0,3,0
1031,10,2,0,0,2,0
4921,4,4,0,0,4,0
31790,5,2,0,0,2,0
31790,1,1,0,0,1,0
1187,1,1,0,0,1,0
1663,10,3,0,0,3,0
2638,10,5,0,0,5,0
2638,2,1,0,0,1,0
3507,3,2,0,0,2,0
3507,2,1,0,0,1,0
2444,9,6,0,0,6,0
10156,1,1,0,0,1,0
40843,1,1,0,0,1,0
19665,2,1,0,0,1,0
218310,2,3,0,0,3,0
218310,1,1,0,0,1,0
35293,10,2,0,0,2,0
108377,10,3,0,0,3,0
108377,1,1,0,0,1,0
174192,10,1,0,0,1,0
28302,2,2,0,0,2,0
174893,10,3,0,0,3,0
174893,9,5,0,0,5,0
120305,9,4,0,0,4,0
120305,1,1,0,0,1,0
169427,2,1,0,0,1,0
30706,2,2,0,0,2,0
119265,1,1,0,0,1,0
1607,10,4,0,0,4,0
1607,1,2,0,0,2,0
188076,4,1,0,0,1,0
188076,1,2,0,0,2,0
2773,10,3,0,0,3,0
21463,10,1,0,0,1,0
160432,10,2,0,0,2,0
5750,10,2,0,0,2,0
5750,9,3,0,0,3,0
6583,10,2,0,0,2,0
59223,1,1,0,0,1,0
196306,4,4,0,0,4,0
196306,3,1,0,0,1,0
196306,2,1,0,0,1,0
2562,9,5,0,0,5,0
246150,9,10,0,0,10,0
246150,3,3,0,0,3,0
62225,5,8,0,0,8,0
184371,3,6,0,0,6,0
184371,1,1,0,0,1,0
10712,9,2,0,0,2,0
10712,7,12,0,0,12,0
128137,2,3,0,0,3,0
128137,1,2,0,0,2,0
136416,10,1,0,0,1,0
136416,9,1,0,0,1,0
136416,3,8,0,0,8,0
12747,9,5,0,0,5,0
12747,2,1,0,0,1,0
232830,3,2,0,0,2,0
232830,2,2,0,0,2,0
232830,1,2,0,0,2,0
192508,1,1,0,0,1,0
69601,5,1,0,0,1,0
69601,2,1,0,0,1,0
69601,1,1,0,0,1,0
39699,9,2,0,0,2,0
39699,1,1,0,0,1,0
5071,2,2,0,0,2,0
24376,10,1,0,0,1,0
24376,8,13,0,0,13,0
24376,1,6,0,0,6,0
57368,10,4,0,0,4,0
175989,1,1,0,0,1,0
172358,10,1,0,0,1,0
172358,3,3,0,0,3,0
191071,10,7,0,0,7,0
7086,10,3,0,0,3,0
63027,2,3,0,0,3,0
7718,10,1,0,0,1,0
7718,9,2,0,0,2,0
268,3,3,0,0,3,0
268,1,1,0,0,1,0
155081,10,2,0,0,2,0
155081,1,4,0,0,4,0
8487,9,1,0,0,1,0
67910,1,1,0,0,1,0
40347,10,2,0,0,2,0
139032,3,6,0,0,6,0
13532,1,3,0,0,3,0
165404,10,6,0,0,6,0
165404,1,2,0,0,2,0
10431,1,5,0,0,5,0
145393,3,2,0,0,2,0
55492,10,3,0,0,3,0
133637,10,1,0,0,1,0
133637,3,9,0,0,9,0
133637,2,3,0,0,3,0
118339,1,4,0,0,4,0
4453,1,2,0,0,2,0
6368,8,14,0,0,14,0
209166,10,1,0,0,1,0
201046,2,2,0,0,2,0
80933,10,4,0,0,4,0
80933,9,11,0,0,11,0
80933,1,3,0,0,3,0
9386,2,1,0,0,1,0
260332,2,1,0,0,1,0
260332,1,1,0,0,1,0
193693,10,1,0,0,1,0
193693,4,4,0,0,4,0
193693,2,1,0,0,1,0
5251,2,2,0,0,2,0
37988,10,3,0,0,3,0
37988,9,5,0,0,5,0
414,10,3,0,0,3,0
160396,10,1,0,0,1,0
160396,1,1,0,0,1,0
225482,4,8,0,0,8,0
225482,2,1,0,0,1,0
142558,2,1,0,0,1,0
142558,1,1,0,0,1,0
129382,10,2,0,0,2,0
129382,9,4,0,0,4,0
129382,3,2,0,0,2,0
3408,3,1,0,0,1,0
24082,1,1,0,0,1,0
216381,3,1,0,0,1,0
110160,9,1,0,0,1,0
110160,1,2,0,0,2,0
27802,9,6,0,0,6,0
27802,3,6,0,0,6,0
187787,1,2,0,0,2,0
40370,9,3,0,0,3,0
40370,1,1,0,0,1,0
204493,3,1,0,0,1,0
204493,2,1,0,0,1,0
247360,4,2,0,0,2,0
129945,4,7,0,0,7,0
129945,3,5,0,0,5,0
67038,9,5,0,0,5,0
67038,2,2,0,0,2,0
76810,2,2,0,0,2,0
58601,5,1,0,0,1,0
58601,1,1,0,0,1,0
161108,2,1,0,0,1,0
161108,1,2,0,0,2,0
27837,1,1,0,0,1,0
57998,4,2,0,0,2,0
57998,3,1,0,0,1,0
57998,2,2,0,0,2,0
111081,4,3,0,0,3,0
111081,3,1,0,0,1,0
82702,9,4,0,0,4,0
470,1,2,0,0,2,0
1965,10,2,0,0,2,0
184842,1,1,0,0,1,0
3466,1,2,0,0,2,0
3138,10,1,0,0,1,0
3427,10,1,0,0,1,0
228766,4,8,0,0,8,0
2884,10,2,0,0,2,0
2884,3,5,0,0,5,0
2884,1,1,0,0,1,0
191612,3,1,0,0,1,0
191612,1,1,0,0,1,0
4323,2,3,0,0,3,0
4323,1,1,0,0,1,0
199242,3,1,0,0,1,0
199242,2,1,0,0,1,0
65134,10,1,0,0,1,0
65134,1,3,0,0,3,0
9556,10,6,0,0,6,0
9556,1,1,0,0,1,0
191038,2,1,0,0,1,0
193213,2,1,0,0,1,0
193213,1,1,0,0,1,0
311,3,3,0,0,3,0
162367,1,3,0,0,3,0
173486,1,3,0,0,3,0
18297,2,2,0,0,2,0
18297,1,1,0,0,1,0
164031,3,4,0,0,4,0
232895,10,1,0,0,1,0
181265,3,2,0,0,2,0
181265,2,3,0,0,3,0
181265,1,1,0,0,1,0
3279,3,3,0,0,3,0
3279,2,3,0,0,3,0
3279,1,2,0,0,2,0
32226,10,1,0,0,1,0
28705,1,2,0,0,2,0
250780,5,16,0,0,16,0
249821,10,11,0,0,11,0
249821,3,1,0,0,1,0
6979,2,2,0,0,2,0
6979,1,1,0,0,1,0
4123,10,1,0,0,1,0
4123,9,5,0,0,5,0
4123,1,2,0,0,2,0
57073,3,2,0,0,2,0
205127,3,2,0,0,2,0
243358,5,8,0,0,8,0
194062,3,3,0,0,3,0
194062,2,2,0,0,2,0
194062,1,1,0,0,1,0
63743,10,4,0,0,4,0
1958,9,1,0,0,1,0
242343,4,6,0,0,6,0
242343,3,4,0,0,4,0
242343,2,1,0,0,1,0
242343,1,3,0,0,3,0
2146,1,1,0,0,1,0
98122,10,3,0,0,3,0
98122,3,5,0,0,5,0
98122,1,3,0,0,3,0
91050,9,4,0,0,4,0
11760,10,2,0,0,2,0
158973,1,1,0,0,1,0
104,3,1,0,0,1,0
5332,2,1,0,0,1,0
161537,3,2,0,0,2,0
107148,4,4,0,0,4,0
107148,3,3,0,0,3,0
495,9,2,0,0,2,0
495,1,1,0,0,1,0
1970,10,4,0,0,4,0
1970,3,5,0,0,5,0
24002,1,2,0,0,2,0
147363,10,14,0,0,14,0
147363,3,4,0,0,4,0
147363,1,2,0,0,2,0
244505,10,7,0,0,7,0
244505,3,3,0,0,3,0
244505,2,2,0,0,2,0
244505,1,1,0,0,1,0
10715,10,1,0,0,1,0
10715,9,1,0,0,1,0
10715,8,4,0,0,4,0
223740,2,1,0,0,1,0
4328,2,2,0,0,2,0
4328,1,1,0,0,1,0
2579,3,2,0,0,2,0
137931,10,2,0,0,2,0
137931,2,1,0,0,1,0
144382,3,7,0,0,7,0
204466,10,5,0,0,5,0
209530,10,18,0,0,18,0
209530,2,3,0,0,3,0
14634,1,1,0,0,1,0
19876,1,1,0,0,1,0
191364,10,1,0,0,1,0
191364,1,3,0,0,3,0
29078,10,3,0,0,3,0
29078,1,1,0,0,1,0
12829,10,1,0,0,1,0
12829,9,1,0,0,1,0
12829,1,1,0,0,1,0
101718,10,2,0,0,2,0
81542,9,7,0,0,7,0
81542,2,2,0,0,2,0
81542,1,1,0,0,1,0
66116,10,2,0,0,2,0
4023,10,2,0,0,2,0
4023,9,2,0,0,2,0
4023,1,1,0,0,1,0
44558,10,1,0,0,1,0
44558,9,2,0,0,2,0
103814,10,1,0,0,1,0
103814,3,2,0,0,2,0
103814,2,3,0,0,3,0
178940,4,1,0,0,1,0
178940,3,2,0,0,2,0
895,3,3,0,0,3,0
895,1,1,0,0,1,0
219430,9,10,0,0,10,0
219430,1,2,0,0,2,0
181819,2,2,0,0,2,0
181819,1,1,0,0,1,0
160853,1,1,0,0,1,0
213149,4,4,0,0,4,0
213149,3,1,0,0,1,0
213149,2,2,0,0,2,0
224125,3,2,0,0,2,0
155157,9,11,0,0,11,0
35599,10,2,0,0,2,0
35599,1,2,0,0,2,0
4769,2,1,0,0,1,0
230358,10,5,0,0,5,0
230358,1,2,0,0,2,0
37794,2,1,0,0,1,0
235344,3,1,0,0,1,0
235344,2,2,0,0,2,0
235344,1,1,0,0,1,0
171356,2,2,0,0,2,0
6817,3,4,0,0,4,0
6817,1,1,0,0,1,0
218,9,2,0,0,2,0
203624,2,1,0,0,1,0
38918,9,1,0,0,1,0
38918,2,2,0,0,2,0
490,2,5,0,0,5,0
40941,1,2,0,0,2,0
24000,10,3,0,0,3,0
24000,9,3,0,0,3,0
24000,8,5,0,0,5,0
160044,3,4,0,0,4,0
160044,2,2,0,0,2,0
9200,10,3,0,0,3,0
174093,2,1,0,0,1,0
11865,2,1,0,0,1,0
11865,1,1,0,0,1,0
2980,10,1,0,0,1,0
2980,9,3,0,0,3,0
2980,1,5,0,0,5,0
66837,3,1,0,0,1,0
66837,2,1,0,0,1,0
66837,1,1,0,0,1,0
1821,4,2,0,0,2,0
1821,3,1,0,0,1,0
1821,1,1,0,0,1,0
145086,9,6,0,0,6,0
116948,1,1,0,0,1,0
41875,3,2,0,0,2,0
41875,2,1,0,0,1,0
21469,10,1,0,0,1,0
22303,2,3,0,0,3,0
22303,1,2,0,0,2,0
205308,3,1,0,0,1,0
66855,5,5,0,0,5,0
66855,1,1,0,0,1,0
1094,10,3,0,0,3,0
1094,9,1,0,0,1,0
1094,8,3,0,0,3,0
175763,3,5,0,0,5,0
175763,1,1,0,0,1,0
8983,10,1,0,0,1,0
175088,3,2,0,0,2,0
158130,4,2,0,0,2,0
158130,1,1,0,0,1,0
6250,10,4,0,0,4,0
6250,9,4,0,0,4,0
6250,2,4,0,0,4,0
179280,9,5,0,0,5,0
179280,2,4,0,0,4,0
234120,10,3,0,0,3,0
15311,9,1,0,0,1,0
15311,2,5,0,0,5,0
15311,1,3,0,0,3,0
920,2,2,0,0,2,0
242569,4,9,0,0,9,0
242569,3,2,0,0,2,0
242569,1,1,0,0,1,0
33071,9,5,0,0,5,0
3658,1,1,0,0,1,0
1628,9,6,0,0,6,0
1628,2,3,0,0,3,0
4279,10,3,0,0,3,0
4279,9,3,0,0,3,0
19048,10,1,0,0,1,0
19048,9,1,0,0,1,0
33665,1,2,0,0,2,0
158918,8,6,0,0,6,0
158918,1,2,0,0,2,0
99770,9,6,0,0,6,0
99770,3,4,0,0,4,0
99770,1,1,0,0,1,0
3313,10,1,0,0,1,0
3313,2,2,0,0,2,0
198611,10,3,0,0,3,0
198611,9,7,0,0,7,0
198611,2,1,0,0,1,0
1794,2,5,0,0,5,0
218314,2,4,0,0,4,0
3119,4,11,0,0,11,0
3119,3,5,0,0,5,0
3119,2,1,0,0,1,0
23656,10,3,0,0,3,0
23656,1,2,0,0,2,0
37000,8,18,0,0,18,0
200359,10,4,0,0,4,0
200359,1,1,0,0,1,0
216482,2,2,0,0,2,0
2800,2,1,0,0,1,0
180816,4,8,0,0,8,0
180816,3,3,0,0,3,0
180816,1,2,0,0,2,0
161383,10,3,0,0,3,0
161383,2,3,0,0,3,0
141035,10,1,0,0,1,0
85800,3,1,0,0,1,0
1522,10,3,0,0,3,0
1522,8,7,0,0,7,0
6982,10,1,0,0,1,0
6982,9,1,0,0,1,0
2833,10,2,0,0,2,0
1407,10,1,0,0,1,0
203655,10,2,0,0,2,0
203655,9,10,0,0,10,0
203655,7,79,0,0,79,0
203655,4,3,0,0,3,0
203655,3,2,0,0,2,0
203655,1,1,0,0,1,0
191073,10,6,0,0,6,0
191073,1,1,0,0,1,0
226519,3,1,0,0,1,0
226519,2,1,0,0,1,0
8521,1,3,0,0,3,0
32,10,2,0,0,2,0
32,1,1,0,0,1,0
148036,9,3,0,0,3,0
148036,1,1,0,0,1,0
180785,10,3,0,0,3,0
180785,9,1,0,0,1,0
180785,2,1,0,0,1,0
180785,1,1,0,0,1,0
199357,1,1,0,0,1,0
2995,1,1,0,0,1,0
244994,9,7,0,0,7,0
244994,2,2,0,0,2,0
207310,9,4,0,0,4,0
2154,3,1,0,0,1,0
158837,3,3,0,0,3,0
158837,2,1,0,0,1,0
66125,4,11,0,0,11,0
66125,1,1,0,0,1,0
142364,10,1,0,0,1,0
194298,2,2,0,0,2,0
194298,1,1,0,0,1,0
5369,2,2,0,0,2,0
14054,1,1,0,0,1,0
203759,2,1,0,0,1,0
36241,10,2,0,0,2,0
1916,9,1,0,0,1,0
46530,1,3,0,0,3,0
182626,2,3,0,0,3,0
142556,2,1,0,0,1,0
142556,1,1,0,0,1,0
753,4,9,0,0,9,0
6614,10,2,0,0,2,0
6614,9,7,0,0,7,0
41123,3,5,0,0,5,0
473,10,2,0,0,2,0
473,3,3,0,0,3,0
109252,10,3,0,0,3,0
182077,10,2,0,0,2,0
182077,9,1,0,0,1,0
182077,1,3,0,0,3,0
6460,9,2,0,0,2,0
118293,10,4,0,0,4,0
247342,1,2,0,0,2,0
1352,10,1,0,0,1,0
1352,3,3,0,0,3,0
170225,10,3,0,0,3,0
170225,1,1,0,0,1,0
258041,1,1,0,0,1,0
161762,10,1,0,0,1,0
161762,9,3,0,0,3,0
30952,10,4,0,0,4,0
30952,9,2,0,0,2,0
30952,8,13,0,0,13,0
30952,2,6,0,0,6,0
144743,1,1,0,0,1,0
224907,4,5,0,0,5,0
224907,1,2,0,0,2,0
6994,9,3,0,0,3,0
129091,10,4,0,0,4,0
129091,4,13,0,0,13,0
129091,3,4,0,0,4,0
129091,2,3,0,0,3,0
129091,1,1,0,0,1,0
127561,9,24,0,0,24,0
1072,10,3,0,0,3,0
1072,1,1,0,0,1,0
63758,4,2,0,0,2,0
3725,9,2,0,0,2,0
145475,10,5,0,0,5,0
145475,4,6,0,0,6,0
101929,3,1,0,0,1,0
101929,1,1,0,0,1,0
73650,10,1,0,0,1,0
73650,9,3,0,0,3,0
73650,2,1,0,0,1,0
30287,10,1,0,0,1,0
30287,2,3,0,0,3,0
222887,3,2,0,0,2,0
222887,1,1,0,0,1,0
197439,4,5,0,0,5,0
234711,4,2,0,0,2,0
8160,10,1,0,0,1,0
8160,9,5,0,0,5,0
8160,1,5,0,0,5,0
57759,1,1,0,0,1,0
150605,10,1,0,0,1,0
150605,9,4,0,0,4,0
150605,1,1,0,0,1,0
4962,1,1,0,0,1,0
150930,9,2,0,0,2,0
150930,2,1,0,0,1,0
2667,2,1,0,0,1,0
4062,10,2,0,0,2,0
4062,8,10,0,0,10,0
4062,0,1,0,0,1,0
244141,5,7,0,0,7,0
170437,2,1,0,0,1,0
170437,1,1,0,0,1,0
144567,2,1,0,0,1,0
11883,10,1,0,0,1,0
11883,9,5,0,0,5,0
11883,8,12,0,0,12,0
11883,1,2,0,0,2,0
803,9,4,0,0,4,0
41054,10,2,0,0,2,0
41054,3,6,0,0,6,0
102940,2,5,0,0,5,0
229453,10,4,0,0,4,0
229453,1,1,0,0,1,0
29140,10,1,0,0,1,0
29140,2,1,0,0,1,0
29140,1,1,0,0,1,0
180975,9,4,0,0,4,0
229598,10,6,0,0,6,0
229598,2,3,0,0,3,0
229598,1,1,0,0,1,0
94891,10,2,0,0,2,0
94891,9,1,0,0,1,0
459,3,2,0,0,2,0
26047,10,3,0,0,3,0
139131,5,6,0,0,6,0
139131,4,1,0,0,1,0
139131,2,1,0,0,1,0
139131,1,1,0,0,1,0
867,3,2,0,0,2,0
174260,2,5,0,0,5,0
85204,4,2,0,0,2,0
103339,5,4,0,0,4,0
103339,4,1,0,0,1,0
103339,1,1,0,0,1,0
13597,1,2,0,0,2,0
232303,10,1,0,0,1,0
232303,4,4,0,0,4,0
232303,2,1,0,0,1,0
232303,1,1,0,0,1,0
165346,3,2,0,0,2,0
165346,2,2,0,0,2,0
165004,3,2,0,0,2,0
165004,1,1,0,0,1,0
166776,4,4,0,0,4,0
166776,2,1,0,0,1,0
166776,1,2,0,0,2,0
245710,3,12,0,0,12,0
245710,1,1,0,0,1,0
4004,10,2,0,0,2,0
4329,9,1,0,0,1,0
4329,1,2,0,0,2,0
14441,9,8,0,0,8,0
14441,1,1,0,0,1,0
2881,1,1,0,0,1,0
206859,1,1,0,0,1,0
39045,2,3,0,0,3,0
68260,2,1,0,0,1,0
172896,10,12,0,0,12,0
172896,1,1,0,0,1,0
38287,10,1,0,0,1,0
38287,1,1,0,0,1,0
12168,9,2,0,0,2,0
185021,3,1,0,0,1,0
185021,1,2,0,0,2,0
42980,1,2,0,0,2,0
3676,10,3,0,0,3,0
204615,9,3,0,0,3,0
92644,10,6,0,0,6,0
92644,3,3,0,0,3,0
92644,2,2,0,0,2,0
6203,2,2,0,0,2,0
54372,10,3,0,0,3,0
54372,2,1,0,0,1,0
54372,1,2,0,0,2,0
162351,5,13,0,0,13,0
41291,9,7,0,0,7,0
176980,5,12,0,0,12,0
176980,3,1,0,0,1,0
1314,2,5,0,0,5,0
192827,10,3,0,0,3,0
27609,10,1,0,0,1,0
27609,1,1,0,0,1,0
198,10,1,0,0,1,0
198,2,1,0,0,1,0
37362,10,3,0,0,3,0
37362,9,4,0,0,4,0
37362,2,1,0,0,1,0
32989,1,1,0,0,1,0
215471,10,5,0,0,5,0
215471,5,9,0,0,9,0
215471,4,4,0,0,4,0
1837,10,1,0,0,1,0
1837,9,2,0,0,2,0
112210,2,6,0,0,6,0
112210,1,4,0,0,4,0
87893,10,1,0,0,1,0
87893,9,4,0,0,4,0
87893,1,1,0,0,1,0
155495,3,2,0,0,2,0
155495,2,3,0,0,3,0
129368,10,4,0,0,4,0
2901,9,2,0,0,2,0
112192,4,1,0,0,1,0
112192,2,1,0,0,1,0
112192,1,1,0,0,1,0
577,2,2,0,0,2,0
122313,10,1,0,0,1,0
85245,10,3,0,0,3,0
85245,9,4,0,0,4,0
164775,10,2,0,0,2,0
19484,9,3,0,0,3,0
73472,10,3,0,0,3,0
257058,3,2,0,0,2,0
32969,10,1,0,0,1,0
181867,3,2,0,0,2,0
191579,5,9,0,0,9,0
32409,10,4,0,0,4,0
32409,9,5,0,0,5,0
188181,2,2,0,0,2,0
188181,1,1,0,0,1,0
39872,10,2,0,0,2,0
39872,1,1,0,0,1,0
38904,3,2,0,0,2,0
38904,2,1,0,0,1,0
6711,7,6,0,0,6,0
179217,3,4,0,0,4,0
179217,2,2,0,0,2,0
158882,2,1,0,0,1,0
205078,10,7,0,0,7,0
77076,10,2,0,0,2,0
124622,4,1,0,0,1,0
27789,10,2,0,0,2,0
27789,9,7,0,0,7,0
27789,2,3,0,0,3,0
256874,5,4,0,0,4,0
256874,3,1,0,0,1,0
256874,2,2,0,0,2,0
166532,9,4,0,0,4,0
32260,10,1,0,0,1,0
32260,9,3,0,0,3,0
256065,5,14,0,0,14,0
256065,3,1,0,0,1,0
18485,2,2,0,0,2,0
3294,10,2,0,0,2,0
3294,9,2,0,0,2,0
3294,1,1,0,0,1,0
56320,3,1,0,0,1,0
56320,1,1,0,0,1,0
181325,10,3,0,0,3,0
226588,2,1,0,0,1,0
2447,2,2,0,0,2,0
2447,1,1,0,0,1,0
88406,10,1,0,0,1,0
88406,4,1,0,0,1,0
194923,1,1,0,0,1,0
3625,3,3,0,0,3,0
1205,9,1,0,0,1,0
1205,2,1,0,0,1,0
77034,10,1,0,0,1,0
77034,1,2,0,0,2,0
142889,3,2,0,0,2,0
184372,5,20,0,0,20,0
184372,3,3,0,0,3,0
184372,2,2,0,0,2,0
102144,4,3,0,0,3,0
2409,10,3,0,0,3,0
173291,9,3,0,0,3,0
173291,2,1,0,0,1,0
4839,4,6,0,0,6,0
4839,2,2,0,0,2,0
39914,10,2,0,0,2,0
39914,1,6,0,0,6,0
184704,3,5,0,0,5,0
27490,10,1,0,0,1,0
27490,1,1,0,0,1,0
1738,10,4,0,0,4,0
104063,2,3,0,0,3,0
3851,2,1,0,0,1,0
209538,2,5,0,0,5,0
98529,10,3,0,0,3,0
98529,1,1,0,0,1,0
10183,5,11,0,0,11,0
10183,4,3,0,0,3,0
10183,3,3,0,0,3,0
39324,10,3,0,0,3,0
39324,9,6,0,0,6,0
153905,3,1,0,0,1,0
119899,10,1,0,0,1,0
119899,3,2,0,0,2,0
119899,2,1,0,0,1,0
87120,3,3,0,0,3,0
257380,4,5,0,0,5,0
257380,3,1,0,0,1,0
257380,1,1,0,0,1,0
43365,10,2,0,0,2,0
43365,2,3,0,0,3,0
2817,10,1,0,0,1,0
2817,8,3,0,0,3,0
2817,1,4,0,0,4,0
68083,1,1,0,0,1,0
3183,10,1,0,0,1,0
220926,10,1,0,0,1,0
85652,1,1,0,0,1,0
186475,2,1,0,0,1,0
181122,3,2,0,0,2,0
181122,2,1,0,0,1,0
235365,3,2,0,0,2,0
1326,10,1,0,0,1,0
1326,1,2,0,0,2,0
257966,10,2,0,0,2,0
130729,10,1,0,0,1,0
130729,9,6,0,0,6,0
130729,3,8,0,0,8,0
14042,10,1,0,0,1,0
14042,3,1,0,0,1,0
14042,2,1,0,0,1,0
220155,3,1,0,0,1,0
6187,10,4,0,0,4,0
6187,1,2,0,0,2,0
221643,10,2,0,0,2,0
221643,9,3,0,0,3,0
221643,2,3,0,0,3,0
82216,10,2,0,0,2,0
82216,1,2,0,0,2,0
81850,10,2,0,0,2,0
81850,4,14,0,0,14,0
232979,3,2,0,0,2,0
9354,3,4,0,0,4,0
34639,3,1,0,0,1,0
20790,10,2,0,0,2,0
20790,1,1,0,0,1,0
247104,4,1,0,0,1,0
39328,3,2,0,0,2,0
39328,2,2,0,0,2,0
39328,1,2,0,0,2,0
179448,4,1,0,0,1,0
179448,1,1,0,0,1,0
5585,9,3,0,0,3,0
168882,10,6,0,0,6,0
168882,2,4,0,0,4,0
83092,3,4,0,0,4,0
5447,9,1,0,0,1,0
5447,1,1,0,0,1,0
190333,4,2,0,0,2,0
190333,3,2,0,0,2,0
190333,2,1,0,0,1,0
190333,1,2,0,0,2,0
220700,1,2,0,0,2,0
40638,2,3,0,0,3,0
2957,10,1,0,0,1,0
2957,9,3,0,0,3,0
30239,10,1,0,0,1,0
30239,1,1,0,0,1,0
193083,10,3,0,0,3,0
193083,9,5,0,0,5,0
193083,3,1,0,0,1,0
193083,2,2,0,0,2,0
227422,2,5,0,0,5,0
153625,10,5,0,0,5,0
168232,2,3,0,0,3,0
197061,10,1,0,0,1,0
197061,2,3,0,0,3,0
446,1,1,0,0,1,0
1304,1,2,0,0,2,0
2792,9,2,0,0,2,0
166081,10,4,0,0,4,0
166081,9,3,0,0,3,0
133747,3,5,0,0,5,0
133747,1,1,0,0,1,0
6800,9,1,0,0,1,0
137744,10,4,0,0,4,0
3966,10,3,0,0,3,0
1844,3,1,0,0,1,0
1844,2,1,0,0,1,0
154633,10,2,0,0,2,0
154633,9,8,0,0,8,0
154633,8,18,0,0,18,0
154633,2,2,0,0,2,0
154633,1,1,0,0,1,0
558,10,4,0,0,4,0
558,1,2,0,0,2,0
96026,4,1,0,0,1,0
96026,2,2,0,0,2,0
96026,1,1,0,0,1,0
230315,9,9,0,0,9,0
230315,3,4,0,0,4,0
536,3,3,0,0,3,0
258451,9,7,0,0,7,0
258451,4,7,0,0,7,0
258451,2,2,0,0,2,0
258451,1,2,0,0,2,0
3090,1,1,0,0,1,0
4724,8,1,0,0,1,0
416,2,2,0,0,2,0
147104,10,3,0,0,3,0
147104,4,2,0,0,2,0
147104,2,1,0,0,1,0
147104,1,1,0,0,1,0
264220,6,4,0,0,4,0
264220,4,1,0,0,1,0
264220,3,2,0,0,2,0
178153,2,1,0,0,1,0
220784,10,4,0,0,4,0
220784,3,3,0,0,3,0
220784,1,1,0,0,1,0
308,2,1,0,0,1,0
165586,9,3,0,0,3,0
189056,10,5,0,0,5,0
189056,9,7,0,0,7,0
189056,2,1,0,0,1,0
134626,10,2,0,0,2,0
134626,3,3,0,0,3,0
134626,2,1,0,0,1,0
134626,1,1,0,0,1,0
23311,3,3,0,0,3,0
23311,1,1,0,0,1,0
144988,2,2,0,0,2,0
144988,1,1,0,0,1,0
137872,2,1,0,0,1,0
87200,2,1,0,0,1,0
2003,9,4,0,0,4,0
163175,10,9,0,0,9,0
162865,3,3,0,0,3,0
112381,2,1,0,0,1,0
112381,1,1,0,0,1,0
5511,3,2,0,0,2,0
5511,1,2,0,0,2,0
31145,10,1,0,0,1,0
26946,4,5,0,0,5,0
26946,2,2,0,0,2,0
229427,1,1,0,0,1,0
10196,10,1,0,0,1,0
10196,1,1,0,0,1,0
4255,3,2,0,0,2,0
2979,10,1,0,0,1,0
15548,10,1,0,0,1,0
15548,9,8,0,0,8,0
15548,1,2,0,0,2,0
2740,10,1,0,0,1,0
216856,10,4,0,0,4,0
216856,4,4,0,0,4,0
216856,3,1,0,0,1,0
257668,10,3,0,0,3,0
257668,3,1,0,0,1,0
214989,2,2,0,0,2,0
160608,10,1,0,0,1,0
7576,3,3,0,0,3,0
40550,4,12,0,0,12,0
40550,2,1,0,0,1,0
30741,9,1,0,0,1,0
221366,5,10,0,0,10,0
221366,3,7,0,0,7,0
221366,2,3,0,0,3,0
8497,10,3,0,0,3,0
8497,1,1,0,0,1,0
7307,10,1,0,0,1,0
7307,1,1,0,0,1,0
23181,10,2,0,0,2,0
136284,10,1,0,0,1,0
136284,9,6,0,0,6,0
136284,3,4,0,0,4,0
41612,1,1,0,0,1,0
158356,10,3,0,0,3,0
158356,1,1,0,0,1,0
24998,10,2,0,0,2,0
24998,9,2,0,0,2,0
2353,10,1,0,0,1,0
2353,2,1,0,0,1,0
4421,10,1,0,0,1,0
4421,1,1,0,0,1,0
256390,10,4,0,0,4,0
20090,9,1,0,0,1,0
20090,1,1,0,0,1,0
188164,4,3,0,0,3,0
188164,1,1,0,0,1,0
223950,2,3,0,0,3,0
122327,9,2,0,0,2,0
122327,1,1,0,0,1,0
65582,10,1,0,0,1,0
65582,9,5,0,0,5,0
211,10,4,0,0,4,0
211,1,1,0,0,1,0
172235,10,5,0,0,5,0
172235,2,2,0,0,2,0
49435,9,2,0,0,2,0
39210,2,1,0,0,1,0
172994,5,12,0,0,12,0
172994,2,1,0,0,1,0
172994,1,1,0,0,1,0
42688,10,6,0,0,6,0
42688,2,1,0,0,1,0
129615,10,1,0,0,1,0
129615,1,1,0,0,1,0
67285,10,3,0,0,3,0
67285,9,2,0,0,2,0
67285,3,2,0,0,2,0
46745,10,1,0,0,1,0
46745,9,2,0,0,2,0
46745,1,1,0,0,1,0
199223,5,6,0,0,6,0
199223,2,3,0,0,3,0
199223,1,1,0,0,1,0
257733,4,4,0,0,4,0
257733,2,2,0,0,2,0
257733,1,1,0,0,1,0
3945,9,1,0,0,1,0
3945,3,8,0,0,8,0
222821,1,1,0,0,1,0
25182,3,2,0,0,2,0
214988,3,1,0,0,1,0
214988,2,1,0,0,1,0
13676,10,3,0,0,3,0
41095,10,1,0,0,1,0
41095,9,4,0,0,4,0
170430,9,1,0,0,1,0
178688,5,12,0,0,12,0
178688,4,4,0,0,4,0
5699,4,6,0,0,6,0
5699,2,2,0,0,2,0
53103,10,1,0,0,1,0
53103,2,1,0,0,1,0
13493,10,3,0,0,3,0
13493,1,2,0,0,2,0
1823,1,1,0,0,1,0
5357,2,1,0,0,1,0
159910,4,2,0,0,2,0
159910,2,3,0,0,3,0
19508,10,2,0,0,2,0
55315,10,1,0,0,1,0
55315,2,2,0,0,2,0
5468,9,1,0,0,1,0
206471,10,2,0,0,2,0
206471,4,8,0,0,8,0
241025,10,4,0,0,4,0
241025,9,5,0,0,5,0
241025,2,1,0,0,1,0
241025,1,1,0,0,1,0
429,10,2,0,0,2,0
429,9,5,0,0,5,0
38227,10,4,0,0,4,0
38227,9,2,0,0,2,0
38227,1,4,0,0,4,0
8860,9,5,0,0,5,0
8860,1,2,0,0,2,0
3248,2,3,0,0,3,0
132019,5,7,0,0,7,0
132019,1,2,0,0,2,0
28436,9,1,0,0,1,0
28436,1,1,0,0,1,0
144499,10,1,0,0,1,0
144499,2,1,0,0,1,0
144499,1,1,0,0,1,0
1833,1,1,0,0,1,0
12956,1,1,0,0,1,0
17859,10,3,0,0,3,0
17859,1,2,0,0,2,0
195373,10,3,0,0,3,0
195373,9,1,0,0,1,0
195373,1,2,0,0,2,0
17382,1,1,0,0,1,0
234468,10,1,0,0,1,0
234468,9,3,0,0,3,0
234468,3,1,0,0,1,0
102681,1,1,0,0,1,0
2970,9,3,0,0,3,0
20077,1,1,0,0,1,0
2857,3,7,0,0,7,0
2857,2,3,0,0,3,0
5677,3,1,0,0,1,0
2812,10,4,0,0,4,0
181393,3,3,0,0,3,0
181393,2,1,0,0,1,0
181393,1,1,0,0,1,0
155822,9,3,0,0,3,0
155822,2,1,0,0,1,0
820,3,4,0,0,4,0
42617,10,2,0,0,2,0
17533,4,7,0,0,7,0
17533,3,3,0,0,3,0
17533,1,1,0,0,1,0
215616,4,3,0,0,3,0
215616,3,1,0,0,1,0
702,1,1,0,0,1,0
3705,10,1,0,0,1,0
3705,1,1,0,0,1,0
142401,9,8,0,0,8,0
142401,2,1,0,0,1,0
66088,9,3,0,0,3,0
66088,2,2,0,0,2,0
119622,9,2,0,0,2,0
166280,4,2,0,0,2,0
166280,2,1,0,0,1,0
166280,1,1,0,0,1,0
2521,3,1,0,0,1,0
148759,10,5,0,0,5,0
165595,4,3,0,0,3,0
165595,2,1,0,0,1,0
28018,10,1,0,0,1,0
212346,7,10,0,0,10,0
212346,5,3,0,0,3,0
212346,2,1,0,0,1,0
256067,3,1,0,0,1,0
256067,1,1,0,0,1,0
116981,2,1,0,0,1,0
116981,1,2,0,0,2,0
169743,2,4,0,0,4,0
127129,10,2,0,0,2,0
127129,9,2,0,0,2,0
127129,1,1,0,0,1,0
428,1,1,0,0,1,0
33759,3,3,0,0,3,0
40759,3,3,0,0,3,0
40759,2,1,0,0,1,0
8816,9,1,0,0,1,0
122913,5,9,0,0,9,0
219101,1,1,0,0,1,0
199047,1,1,0,0,1,0
2766,1,3,0,0,3,0
1235,9,1,0,0,1,0
1773,2,2,0,0,2,0
22604,10,4,0,0,4,0
5607,10,2,0,0,2,0
5607,2,1,0,0,1,0
1447,2,1,0,0,1,0
158100,5,10,0,0,10,0
158100,3,3,0,0,3,0
158978,9,5,0,0,5,0
144865,10,1,0,0,1,0
137140,10,1,0,0,1,0
137140,9,1,0,0,1,0
137140,2,2,0,0,2,0
137140,1,1,0,0,1,0
180543,4,2,0,0,2,0
180543,1,2,0,0,2,0
118703,1,1,0,0,1,0
152952,2,1,0,0,1,0
152952,1,1,0,0,1,0
230430,2,6,0,0,6,0
197451,10,5,0,0,5,0
40667,2,1,0,0,1,0
40667,1,1,0,0,1,0
2693,1,2,0,0,2,0
109801,10,2,0,0,2,0
109801,9,11,0,0,11,0
109801,2,3,0,0,3,0
109801,1,1,0,0,1,0
207117,1,1,0,0,1,0
2738,10,1,0,0,1,0
2738,1,1,0,0,1,0
17922,10,1,0,0,1,0
17922,9,9,0,0,9,0
17922,2,1,0,0,1,0
17922,1,1,0,0,1,0
7182,10,3,0,0,3,0
7182,9,2,0,0,2,0
202982,4,5,0,0,5,0
3352,9,1,0,0,1,0
3352,1,1,0,0,1,0
4587,9,1,0,0,1,0
209136,4,2,0,0,2,0
209136,3,1,0,0,1,0
23049,10,1,0,0,1,0
23049,1,2,0,0,2,0
34659,2,3,0,0,3,0
256669,3,2,0,0,2,0
67148,2,5,0,0,5,0
7601,9,1,0,0,1,0
7601,7,4,0,0,4,0
50862,10,1,0,0,1,0
50862,9,3,0,0,3,0
50862,2,3,0,0,3,0
50862,1,1,0,0,1,0
1378,9,1,0,0,1,0
1378,2,1,0,0,1,0
1378,1,1,0,0,1,0
159003,9,7,0,0,7,0
159003,3,10,0,0,10,0
20040,9,1,0,0,1,0
185104,9,2,0,0,2,0
93563,9,3,0,0,3,0
169275,4,2,0,0,2,0
169275,3,1,0,0,1,0
169475,3,4,0,0,4,0
169475,2,1,0,0,1,0
69318,10,1,0,0,1,0
182260,3,1,0,0,1,0
140172,2,1,0,0,1,0
540,9,3,0,0,3,0
540,1,1,0,0,1,0
223674,4,14,0,0,14,0
223674,2,7,0,0,7,0
141725,10,2,0,0,2,0
213882,4,3,0,0,3,0
4367,9,1,0,0,1,0
136249,10,1,0,0,1,0
136249,9,3,0,0,3,0
1543,10,5,0,0,5,0
166569,2,2,0,0,2,0
166569,1,1,0,0,1,0
23995,4,1,0,0,1,0
23995,2,1,0,0,1,0
993,2,1,0,0,1,0
104234,1,1,0,0,1,0
1460,10,1,0,0,1,0
1460,2,2,0,0,2,0
98960,9,8,0,0,8,0
195456,10,2,0,0,2,0
195456,9,1,0,0,1,0
195456,3,2,0,0,2,0
195456,1,3,0,0,3,0
26147,10,1,0,0,1,0
26147,9,8,0,0,8,0
26147,2,2,0,0,2,0
74233,10,2,0,0,2,0
74233,1,1,0,0,1,0
167828,9,10,0,0,10,0
38355,10,3,0,0,3,0
158883,1,1,0,0,1,0
107464,10,5,0,0,5,0
107464,9,1,0,0,1,0
107464,2,4,0,0,4,0
107464,1,3,0,0,3,0
11274,2,1,0,0,1,0
3758,1,2,0,0,2,0
204602,4,3,0,0,3,0
1470,9,3,0,0,3,0
22721,10,1,0,0,1,0
22721,9,1,0,0,1,0
445,3,4,0,0,4,0
445,2,3,0,0,3,0
177698,10,1,0,0,1,0
28574,10,11,0,0,11,0
28574,9,6,0,0,6,0
28574,2,1,0,0,1,0
34152,10,9,0,0,9,0
34152,3,7,0,0,7,0
34152,2,2,0,0,2,0
34152,1,2,0,0,2,0
4086,3,2,0,0,2,0
38897,9,1,0,0,1,0
38897,2,4,0,0,4,0
20881,10,1,0,0,1,0
20881,1,1,0,0,1,0
206266,1,1,0,0,1,0
23521,10,1,0,0,1,0
23521,9,3,0,0,3,0
120580,10,4,0,0,4,0
1161,10,2,0,0,2,0
1161,2,2,0,0,2,0
1161,1,1,0,0,1,0
173800,10,3,0,0,3,0
173800,9,1,0,0,1,0
173800,1,2,0,0,2,0
173875,9,8,0,0,8,0
173875,2,7,0,0,7,0
747,1,1,0,0,1,0
2937,9,2,0,0,2,0
40949,2,1,0,0,1,0
40949,1,2,0,0,2,0
195484,10,4,0,0,4,0
1796,3,1,0,0,1,0
254110,3,2,0,0,2,0
254110,1,2,0,0,2,0
59161,10,3,0,0,3,0
59161,9,4,0,0,4,0
59161,3,6,0,0,6,0
59161,2,2,0,0,2,0
59161,1,1,0,0,1,0
2307,10,1,0,0,1,0
203719,2,1,0,0,1,0
266083,10,2,0,0,2,0
266083,3,3,0,0,3,0
22359,4,1,0,0,1,0
225885,4,3,0,0,3,0
149910,3,1,0,0,1,0
698,10,2,0,0,2,0
698,9,1,0,0,1,0
698,1,4,0,0,4,0
510,10,1,0,0,1,0
510,9,1,0,0,1,0
510,2,2,0,0,2,0
229240,10,2,0,0,2,0
229240,3,1,0,0,1,0
67486,9,3,0,0,3,0
101682,4,1,0,0,1,0
101682,1,1,0,0,1,0
6226,4,4,0,0,4,0
6226,2,1,0,0,1,0
6226,1,2,0,0,2,0
39994,2,2,0,0,2,0
257769,10,9,0,0,9,0
257769,4,1,0,0,1,0
9794,9,1,0,0,1,0
256623,10,7,0,0,7,0
256623,4,6,0,0,6,0
256623,2,2,0,0,2,0
107173,1,4,0,0,4,0
246759,10,5,0,0,5,0
246759,1,4,0,0,4,0
2581,10,2,0,0,2,0
2581,9,2,0,0,2,0
37184,10,8,0,0,8,0
37184,3,5,0,0,5,0
37184,2,1,0,0,1,0
143782,2,1,0,0,1,0
196379,9,2,0,0,2,0
4643,2,1,0,0,1,0
2192,2,1,0,0,1,0
69105,9,2,0,0,2,0
69105,2,3,0,0,3,0
69105,1,1,0,0,1,0
150690,1,4,0,0,4,0
1356,10,3,0,0,3,0
1356,3,5,0,0,5,0
399,9,1,0,0,1,0
1709,2,1,0,0,1,0
223726,10,2,0,0,2,0
223726,3,1,0,0,1,0
223726,1,1,0,0,1,0
146035,3,1,0,0,1,0
1145,2,1,0,0,1,0
193193,2,3,0,0,3,0
129951,2,3,0,0,3,0
172007,10,2,0,0,2,0
172007,9,6,0,0,6,0
69356,9,1,0,0,1,0
144789,10,3,0,0,3,0
144789,9,6,0,0,6,0
144789,3,1,0,0,1,0
144789,2,2,0,0,2,0
16184,10,1,0,0,1,0
16184,8,6,0,0,6,0
16184,2,1,0,0,1,0
47462,10,2,0,0,2,0
158812,10,4,0,0,4,0
158812,3,3,0,0,3,0
148494,1,2,0,0,2,0
9804,2,1,0,0,1,0
128114,9,4,0,0,4,0
140524,2,2,0,0,2,0
187515,10,3,0,0,3,0
187515,1,1,0,0,1,0
193512,6,11,0,0,11,0
193512,4,2,0,0,2,0
193512,3,3,0,0,3,0
193512,2,1,0,0,1,0
193512,1,3,0,0,3,0
4671,10,4,0,0,4,0
4671,1,1,0,0,1,0
20761,10,1,0,0,1,0
20761,4,2,0,0,2,0
86415,10,1,0,0,1,0
86415,3,2,0,0,2,0
86415,2,2,0,0,2,0
28238,10,4,0,0,4,0
66797,9,1,0,0,1,0
66797,2,3,0,0,3,0
66797,1,2,0,0,2,0
13271,9,1,0,0,1,0
21947,5,6,0,0,6,0
220628,10,5,0,0,5,0
220628,9,12,0,0,12,0
220628,3,1,0,0,1,0
220628,2,1,0,0,1,0
220628,1,1,0,0,1,0
2446,9,2,0,0,2,0
2211,1,1,0,0,1,0
104633,9,4,0,0,4,0
258466,3,1,0,0,1,0
258466,1,1,0,0,1,0
172969,5,7,0,0,7,0
172969,2,1,0,0,1,0
210342,10,3,0,0,3,0
210342,9,3,0,0,3,0
210342,2,1,0,0,1,0
34255,10,3,0,0,3,0
34255,9,3,0,0,3,0
34255,3,1,0,0,1,0
34255,2,2,0,0,2,0
248861,10,5,0,0,5,0
248861,4,2,0,0,2,0
248861,3,2,0,0,2,0
303,10,2,0,0,2,0
303,2,1,0,0,1,0
7290,3,1,0,0,1,0
7290,1,3,0,0,3,0
20634,10,1,0,0,1,0
93001,9,8,0,0,8,0
155496,5,1,0,0,1,0
155496,4,1,0,0,1,0
155496,3,1,0,0,1,0
155496,2,1,0,0,1,0
155496,1,1,0,0,1,0
2580,4,2,0,0,2,0
2580,3,2,0,0,2,0
2580,1,1,0,0,1,0
17521,10,2,0,0,2,0
17521,9,3,0,0,3,0
137336,10,2,0,0,2,0
137336,9,2,0,0,2,0
194019,3,2,0,0,2,0
194019,1,1,0,0,1,0
26516,1,2,0,0,2,0
2061,1,1,0,0,1,0
1873,1,1,0,0,1,0
1912,9,6,0,0,6,0
46586,9,1,0,0,1,0
4281,10,1,0,0,1,0
141829,10,2,0,0,2,0
141829,1,2,0,0,2,0
673,10,1,0,0,1,0
177857,10,7,0,0,7,0
177857,3,4,0,0,4,0
128011,10,1,0,0,1,0
128011,2,2,0,0,2,0
74408,1,4,0,0,4,0
145578,9,1,0,0,1,0
145578,3,6,0,0,6,0
145578,2,2,0,0,2,0
145578,1,2,0,0,2,0
154904,9,1,0,0,1,0
154904,3,2,0,0,2,0
154904,2,3,0,0,3,0
154904,1,2,0,0,2,0
188021,2,3,0,0,3,0
979,3,2,0,0,2,0
12237,10,1,0,0,1,0
12237,2,5,0,0,5,0
12237,1,2,0,0,2,0
36634,9,3,0,0,3,0
36634,1,2,0,0,2,0
69130,1,1,0,0,1,0
4207,10,4,0,0,4,0
1237,10,2,0,0,2,0
1237,9,4,0,0,4,0
20952,9,1,0,0,1,0
20952,3,5,0,0,5,0
20952,2,3,0,0,3,0
20952,1,1,0,0,1,0
948,10,2,0,0,2,0
948,9,3,0,0,3,0
9214,10,1,0,0,1,0
10662,2,1,0,0,1,0
23928,10,1,0,0,1,0
23928,3,1,0,0,1,0
16153,10,1,0,0,1,0
16153,3,14,0,0,14,0
16153,2,3,0,0,3,0
16153,1,1,0,0,1,0
127,9,2,0,0,2,0
34905,10,4,0,0,4,0
34905,9,3,0,0,3,0
49261,10,2,0,0,2,0
49261,9,3,0,0,3,0
130240,10,1,0,0,1,0
65272,2,1,0,0,1,0
65272,1,1,0,0,1,0
153225,10,2,0,0,2,0
153225,9,6,0,0,6,0
153225,3,1,0,0,1,0
153225,2,2,0,0,2,0
207919,1,1,0,0,1,0
671,9,6,0,0,6,0
129029,2,2,0,0,2,0
129029,1,1,0,0,1,0
17450,2,1,0,0,1,0
17450,1,1,0,0,1,0
41090,3,1,0,0,1,0
130499,2,2,0,0,2,0
130499,1,1,0,0,1,0
162660,10,3,0,0,3,0
162660,9,5,0,0,5,0
3405,9,2,0,0,2,0
3405,2,1,0,0,1,0
246639,10,2,0,0,2,0
178,10,1,0,0,1,0
178,3,4,0,0,4,0
158970,4,7,0,0,7,0
2252,3,3,0,0,3,0
169697,3,1,0,0,1,0
169697,2,1,0,0,1,0
169697,1,1,0,0,1,0
213503,4,6,0,0,6,0
32968,9,3,0,0,3,0
32968,8,8,0,0,8,0
32968,2,3,0,0,3,0
32968,1,2,0,0,2,0
3226,3,2,0,0,2,0
30393,10,3,0,0,3,0
39710,9,3,0,0,3,0
39710,1,1,0,0,1,0
99630,2,1,0,0,1,0
158548,3,2,0,0,2,0
85340,10,1,0,0,1,0
85340,2,2,0,0,2,0
171620,10,1,0,0,1,0
171620,2,2,0,0,2,0
54395,10,4,0,0,4,0
54395,8,7,0,0,7,0
54395,2,6,0,0,6,0
54395,1,3,0,0,3,0
4922,10,1,0,0,1,0
1217,8,8,0,0,8,0
8996,10,1,0,0,1,0
8996,2,4,0,0,4,0
8996,1,1,0,0,1,0
8833,10,4,0,0,4,0
176564,10,4,0,0,4,0
69587,9,2,0,0,2,0
69587,2,2,0,0,2,0
192619,10,7,0,0,7,0
192619,1,2,0,0,2,0
151251,3,4,0,0,4,0
151251,2,3,0,0,3,0
1178,8,1,0,0,1,0
1178,2,2,0,0,2,0
1178,1,1,0,0,1,0
150533,10,1,0,0,1,0
150533,2,1,0,0,1,0
4831,1,1,0,0,1,0
209886,10,1,0,0,1,0
209886,9,2,0,0,2,0
70324,1,1,0,0,1,0
252688,4,1,0,0,1,0
252688,3,1,0,0,1,0
129974,9,27,0,0,27,0
129974,3,1,0,0,1,0
129974,1,3,0,0,3,0
215469,10,1,0,0,1,0
215469,2,3,0,0,3,0
22733,10,5,0,0,5,0
22733,1,1,0,0,1,0
174182,3,1,0,0,1,0
174182,2,4,0,0,4,0
24795,9,1,0,0,1,0
37345,2,2,0,0,2,0
108018,1,1,0,0,1,0
3163,9,3,0,0,3,0
3163,2,1,0,0,1,0
3163,1,1,0,0,1,0
19803,10,2,0,0,2,0
29020,10,2,0,0,2,0
29020,9,1,0,0,1,0
29020,3,6,0,0,6,0
29020,1,3,0,0,3,0
34284,3,2,0,0,2,0
34284,2,3,0,0,3,0
19877,10,3,0,0,3,0
26148,2,2,0,0,2,0
132799,2,1,0,0,1,0
132799,1,2,0,0,2,0
8179,9,1,0,0,1,0
2194,2,3,0,0,3,0
679,1,1,0,0,1,0
241987,5,2,0,0,2,0
241987,3,1,0,0,1,0
241987,1,1,0,0,1,0
214204,4,4,0,0,4,0
33767,3,1,0,0,1,0
33767,1,1,0,0,1,0
1001,10,2,0,0,2,0
1001,9,1,0,0,1,0
1001,1,3,0,0,3,0
4386,4,6,0,0,6,0
4386,1,1,0,0,1,0
233015,3,4,0,0,4,0
233015,2,2,0,0,2,0
26952,1,2,0,0,2,0
332,10,2,0,0,2,0
186279,5,10,0,0,10,0
186279,4,1,0,0,1,0
186279,3,1,0,0,1,0
2229,10,2,0,0,2,0
220738,9,14,0,0,14,0
220738,4,11,0,0,11,0
220738,2,1,0,0,1,0
197101,1,1,0,0,1,0
1556,10,1,0,0,1,0
1556,9,2,0,0,2,0
193867,4,1,0,0,1,0
193867,2,1,0,0,1,0
193867,1,1,0,0,1,0
173759,3,3,0,0,3,0
4076,10,2,0,0,2,0
11670,10,2,0,0,2,0
11670,2,1,0,0,1,0
43136,10,5,0,0,5,0
43136,2,1,0,0,1,0
134618,9,1,0,0,1,0
134618,1,1,0,0,1,0
215614,1,2,0,0,2,0
170951,4,4,0,0,4,0
29875,4,2,0,0,2,0
19651,3,4,0,0,4,0
62972,1,2,0,0,2,0
191932,9,4,0,0,4,0
191932,2,1,0,0,1,0
223538,10,5,0,0,5,0
223538,3,4,0,0,4,0
223538,2,1,0,0,1,0
104640,2,2,0,0,2,0
22169,10,1,0,0,1,0
93819,10,10,0,0,10,0
93819,2,1,0,0,1,0
93819,1,1,0,0,1,0
148381,10,2,0,0,2,0
148381,3,2,0,0,2,0
148381,2,4,0,0,4,0
148381,1,1,0,0,1,0
178450,10,3,0,0,3,0
178450,2,1,0,0,1,0
209289,10,8,0,0,8,0
209289,5,8,0,0,8,0
209289,4,2,0,0,2,0
209289,3,1,0,0,1,0
209289,2,1,0,0,1,0
169675,10,3,0,0,3,0
169675,2,4,0,0,4,0
169675,1,1,0,0,1,0
2199,10,4,0,0,4,0
200783,10,1,0,0,1,0
200783,9,1,0,0,1,0
200783,8,13,0,0,13,0
200783,1,2,0,0,2,0
127436,10,1,0,0,1,0
22244,10,1,0,0,1,0
22244,1,2,0,0,2,0
133534,2,1,0,0,1,0
163685,10,1,0,0,1,0
163685,2,5,0,0,5,0
37349,10,1,0,0,1,0
27719,10,1,0,0,1,0
27719,9,4,0,0,4,0
27719,2,3,0,0,3,0
280,1,1,0,0,1,0
52825,9,6,0,0,6,0
52825,3,3,0,0,3,0
207487,3,3,0,0,3,0
207487,2,1,0,0,1,0
11028,10,1,0,0,1,0
11028,7,6,0,0,6,0
3585,1,1,0,0,1,0
12764,3,1,0,0,1,0
197760,10,7,0,0,7,0
197760,3,1,0,0,1,0
197760,1,1,0,0,1,0
121806,10,1,0,0,1,0
121806,2,1,0,0,1,0
121806,1,1,0,0,1,0
190,9,1,0,0,1,0
240822,10,1,0,0,1,0
240822,3,1,0,0,1,0
240822,1,1,0,0,1,0
165347,5,9,0,0,9,0
165347,3,1,0,0,1,0
216640,4,1,0,0,1,0
216640,1,1,0,0,1,0
117555,9,1,0,0,1,0
117555,8,10,0,0,10,0
117555,2,3,0,0,3,0
117555,1,1,0,0,1,0
42651,2,1,0,0,1,0
42651,1,1,0,0,1,0
24085,1,3,0,0,3,0
204801,10,6,0,0,6,0
204801,4,1,0,0,1,0
204801,3,1,0,0,1,0
204801,2,1,0,0,1,0
20074,10,2,0,0,2,0
4287,1,1,0,0,1,0
269207,5,2,0,0,2,0
165967,5,2,0,0,2,0
165967,4,2,0,0,2,0
165967,2,1,0,0,1,0
165967,1,1,0,0,1,0
11628,10,1,0,0,1,0
3806,2,2,0,0,2,0
3806,1,1,0,0,1,0
200610,9,4,0,0,4,0
200610,7,25,0,0,25,0
6235,10,1,0,0,1,0
17857,10,4,0,0,4,0
17857,2,1,0,0,1,0
98739,1,2,0,0,2,0
909,2,1,0,0,1,0
964,1,1,0,0,1,0
147206,3,3,0,0,3,0
12188,10,1,0,0,1,0
8,9,2,0,0,2,0
8,3,2,0,0,2,0
131241,4,1,0,0,1,0
232041,5,5,0,0,5,0
232041,2,2,0,0,2,0
203042,10,2,0,0,2,0
203042,2,2,0,0,2,0
336,2,4,0,0,4,0
183643,4,6,0,0,6,0
2253,1,1,0,0,1,0
99655,2,1,0,0,1,0
1404,9,2,0,0,2,0
12367,2,1,0,0,1,0
126443,10,1,0,0,1,0
126443,2,6,0,0,6,0
182064,4,10,0,0,10,0
182064,3,5,0,0,5,0
182064,2,2,0,0,2,0
8711,10,6,0,0,6,0
8711,3,3,0,0,3,0
157815,10,1,0,0,1,0
157815,3,5,0,0,5,0
157815,2,3,0,0,3,0
121015,10,1,0,0,1,0
121015,9,1,0,0,1,0
121015,2,1,0,0,1,0
121015,1,1,0,0,1,0
55279,10,3,0,0,3,0
137933,10,1,0,0,1,0
137933,2,1,0,0,1,0
184085,2,1,0,0,1,0
191049,10,1,0,0,1,0
240892,10,5,0,0,5,0
240892,5,10,0,0,10,0
240892,2,3,0,0,3,0
15271,10,1,0,0,1,0
15271,9,2,0,0,2,0
15271,8,15,0,0,15,0
15271,2,1,0,0,1,0
15271,1,3,0,0,3,0
5503,2,2,0,0,2,0
19081,10,2,0,0,2,0
19081,3,1,0,0,1,0
144479,9,36,0,0,36,0
144479,3,3,0,0,3,0
240843,2,2,0,0,2,0
158916,10,2,0,0,2,0
158916,3,2,0,0,2,0
158916,2,1,0,0,1,0
137480,10,1,0,0,1,0
137480,4,6,0,0,6,0
137480,2,1,0,0,1,0
156175,3,4,0,0,4,0
156175,2,1,0,0,1,0
156175,1,1,0,0,1,0
4668,10,3,0,0,3,0
215918,10,1,0,0,1,0
215918,2,2,0,0,2,0
215918,1,2,0,0,2,0
80942,9,3,0,0,3,0
80942,1,1,0,0,1,0
169558,10,1,0,0,1,0
169558,9,3,0,0,3,0
169558,1,4,0,0,4,0
219638,1,1,0,0,1,0
218126,10,4,0,0,4,0
218126,3,1,0,0,1,0
19409,10,1,0,0,1,0
248002,10,4,0,0,4,0
248002,3,2,0,0,2,0
248002,1,3,0,0,3,0
17820,9,2,0,0,2,0
17820,1,5,0,0,5,0
32048,10,1,0,0,1,0
208808,3,6,0,0,6,0
29582,9,2,0,0,2,0
192286,10,2,0,0,2,0
192286,5,18,0,0,18,0
183521,8,5,0,0,5,0
178051,9,7,0,0,7,0
178051,2,3,0,0,3,0
176215,3,5,0,0,5,0
176215,1,1,0,0,1,0
69851,4,1,0,0,1,0
180921,10,1,0,0,1,0
180921,9,5,0,0,5,0
180921,3,4,0,0,4,0
180921,2,1,0,0,1,0
204728,6,8,0,0,8,0
204728,5,5,0,0,5,0
204728,1,1,0,0,1,0
35472,10,4,0,0,4,0
35472,2,2,0,0,2,0
21389,10,4,0,0,4,0
147505,9,11,0,0,11,0
147505,3,2,0,0,2,0
147505,2,2,0,0,2,0
63385,10,6,0,0,6,0
63385,3,2,0,0,2,0
63385,2,1,0,0,1,0
154804,3,1,0,0,1,0
154804,2,1,0,0,1,0
204175,10,2,0,0,2,0
204175,3,1,0,0,1,0
204175,2,1,0,0,1,0
218179,3,1,0,0,1,0
218179,2,1,0,0,1,0
218179,1,1,0,0,1,0
221372,9,6,0,0,6,0
221372,1,2,0,0,2,0
189890,10,3,0,0,3,0
189890,2,2,0,0,2,0
189890,1,2,0,0,2,0
175634,9,4,0,0,4,0
175634,3,2,0,0,2,0
182194,2,2,0,0,2,0
182194,1,1,0,0,1,0
196712,6,10,0,0,10,0
196712,5,4,0,0,4,0
196712,1,1,0,0,1,0
38195,10,2,0,0,2,0
38195,3,2,0,0,2,0
182638,2,1,0,0,1,0
182638,1,1,0,0,1,0
9824,1,1,0,0,1,0
22950,10,3,0,0,3,0
18794,4,6,0,0,6,0
18794,2,1,0,0,1,0
5900,2,2,0,0,2,0
154343,9,3,0,0,3,0
154343,8,7,0,0,7,0
154343,2,9,0,0,9,0
103191,10,2,0,0,2,0
103191,9,1,0,0,1,0
236304,10,8,0,0,8,0
236304,2,1,0,0,1,0
9092,10,1,0,0,1,0
158917,10,1,0,0,1,0
158917,9,1,0,0,1,0
18905,10,1,0,0,1,0
265736,6,15,0,0,15,0
4975,3,1,0,0,1,0
4975,1,1,0,0,1,0
32688,10,1,0,0,1,0
32688,3,7,0,0,7,0
212662,6,8,0,0,8,0
212662,5,7,0,0,7,0
212662,4,2,0,0,2,0
212662,3,1,0,0,1,0
212662,2,3,0,0,3,0
212662,1,3,0,0,3,0
148764,9,5,0,0,5,0
148764,2,1,0,0,1,0
323,9,2,0,0,2,0
14701,10,4,0,0,4,0
230667,2,2,0,0,2,0
177541,2,3,0,0,3,0
18266,9,1,0,0,1,0
18266,1,1,0,0,1,0
82948,10,3,0,0,3,0
246816,3,2,0,0,2,0
246816,1,1,0,0,1,0
2728,2,1,0,0,1,0
2728,1,1,0,0,1,0
121787,10,1,0,0,1,0
121787,9,2,0,0,2,0
24985,8,5,0,0,5,0
255037,1,1,0,0,1,0
192824,10,3,0,0,3,0
192824,9,4,0,0,4,0
94837,10,1,0,0,1,0
94837,8,18,0,0,18,0
141419,10,1,0,0,1,0
141419,5,10,0,0,10,0
141419,3,3,0,0,3,0
141419,2,1,0,0,1,0
46957,2,2,0,0,2,0
234450,2,1,0,0,1,0
234450,1,1,0,0,1,0
461,9,4,0,0,4,0
93537,10,3,0,0,3,0
93537,3,4,0,0,4,0
93537,1,1,0,0,1,0
2366,2,2,0,0,2,0
2366,1,1,0,0,1,0
2763,2,2,0,0,2,0
1170,8,2,0,0,2,0
72269,3,2,0,0,2,0
72269,2,2,0,0,2,0
172162,10,3,0,0,3,0
172162,9,1,0,0,1,0
172162,4,5,0,0,5,0
172162,2,1,0,0,1,0
50912,9,3,0,0,3,0
50912,1,1,0,0,1,0
6387,10,1,0,0,1,0
78,2,1,0,0,1,0
15721,10,2,0,0,2,0
15721,9,2,0,0,2,0
15721,1,1,0,0,1,0
161995,3,4,0,0,4,0
161995,2,2,0,0,2,0
172158,10,1,0,0,1,0
98046,1,2,0,0,2,0
206169,3,1,0,0,1,0
236484,10,2,0,0,2,0
236484,1,1,0,0,1,0
217099,6,14,0,0,14,0
217099,3,4,0,0,4,0
8320,1,1,0,0,1,0
212376,3,2,0,0,2,0
220193,10,4,0,0,4,0
220193,9,4,0,0,4,0
220193,3,5,0,0,5,0
187976,2,3,0,0,3,0
187976,1,2,0,0,2,0
5243,1,1,0,0,1,0
172206,9,5,0,0,5,0
172206,3,2,0,0,2,0
172206,2,1,0,0,1,0
118215,10,2,0,0,2,0
118215,3,4,0,0,4,0
158851,10,4,0,0,4,0
172837,2,5,0,0,5,0
172837,1,1,0,0,1,0
829,10,2,0,0,2,0
2688,10,2,0,0,2,0
258389,9,4,0,0,4,0
314,10,1,0,0,1,0
314,9,4,0,0,4,0
31575,1,1,0,0,1,0
88691,1,4,0,0,4,0
256313,10,5,0,0,5,0
256313,9,11,0,0,11,0
256313,3,1,0,0,1,0
256313,2,2,0,0,2,0
150996,4,6,0,0,6,0
150996,2,2,0,0,2,0
24225,2,3,0,0,3,0
24225,1,4,0,0,4,0
4346,1,1,0,0,1,0
19046,9,1,0,0,1,0
19046,1,1,0,0,1,0
42691,10,3,0,0,3,0
202207,4,5,0,0,5,0
202207,3,2,0,0,2,0
202207,2,1,0,0,1,0
202207,1,1,0,0,1,0
2583,3,2,0,0,2,0
2583,2,1,0,0,1,0
2583,1,1,0,0,1,0
8250,3,2,0,0,2,0
8250,2,1,0,0,1,0
8250,1,1,0,0,1,0
1697,2,1,0,0,1,0
7176,4,3,0,0,3,0
7176,3,3,0,0,3,0
7176,1,1,0,0,1,0
256801,10,2,0,0,2,0
256801,9,4,0,0,4,0
145424,9,7,0,0,7,0
83325,5,4,0,0,4,0
83325,4,1,0,0,1,0
83325,1,1,0,0,1,0
103469,3,1,0,0,1,0
103469,2,1,0,0,1,0
32129,3,1,0,0,1,0
32129,1,2,0,0,2,0
149863,10,1,0,0,1,0
149863,9,6,0,0,6,0
149863,3,1,0,0,1,0
149863,2,1,0,0,1,0
149863,1,1,0,0,1,0
16000,3,2,0,0,2,0
38944,10,1,0,0,1,0
38944,3,2,0,0,2,0
19028,10,1,0,0,1,0
19028,9,1,0,0,1,0
8328,10,1,0,0,1,0
8328,3,2,0,0,2,0
38950,9,2,0,0,2,0
13714,10,1,0,0,1,0
93540,3,3,0,0,3,0
4205,4,1,0,0,1,0
315,10,1,0,0,1,0
315,9,2,0,0,2,0
315,1,1,0,0,1,0
195981,5,13,0,0,13,0
195981,4,5,0,0,5,0
195981,3,2,0,0,2,0
195981,1,1,0,0,1,0
108705,10,3,0,0,3,0
108705,4,6,0,0,6,0
108705,3,2,0,0,2,0
108705,2,1,0,0,1,0
159470,10,3,0,0,3,0
159470,1,1,0,0,1,0
112445,10,2,0,0,2,0
1336,9,1,0,0,1,0
1336,1,1,0,0,1,0
7935,5,2,0,0,2,0
7935,4,1,0,0,1,0
7935,2,2,0,0,2,0
7935,1,1,0,0,1,0
142584,10,3,0,0,3,0
6284,10,1,0,0,1,0
6284,1,2,0,0,2,0
181495,4,1,0,0,1,0
182385,3,3,0,0,3,0
40962,9,3,0,0,3,0
40962,4,7,0,0,7,0
232318,4,4,0,0,4,0
232318,3,4,0,0,4,0
145975,2,1,0,0,1,0
16191,10,4,0,0,4,0
16191,9,4,0,0,4,0
181120,2,1,0,0,1,0
27674,9,2,0,0,2,0
27674,1,1,0,0,1,0
232420,10,1,0,0,1,0
9801,10,1,0,0,1,0
9801,2,3,0,0,3,0
29351,1,2,0,0,2,0
204879,10,2,0,0,2,0
204879,4,5,0,0,5,0
174518,9,21,0,0,21,0
174518,5,5,0,0,5,0
174518,4,3,0,0,3,0
61902,10,3,0,0,3,0
61902,1,1,0,0,1,0
9473,3,7,0,0,7,0
9473,1,2,0,0,2,0
180193,4,4,0,0,4,0
2942,10,5,0,0,5,0
2942,9,3,0,0,3,0
148975,10,1,0,0,1,0
148975,4,3,0,0,3,0
113853,2,1,0,0,1,0
113853,1,1,0,0,1,0
1524,10,1,0,0,1,0
99358,3,1,0,0,1,0
99358,1,1,0,0,1,0
168512,10,4,0,0,4,0
168512,2,1,0,0,1,0
169795,1,1,0,0,1,0
132148,3,1,0,0,1,0
1924,10,1,0,0,1,0
1924,9,3,0,0,3,0
35812,10,2,0,0,2,0
145599,3,1,0,0,1,0
13359,10,2,0,0,2,0
13359,2,1,0,0,1,0
43168,9,2,0,0,2,0
65313,1,1,0,0,1,0
22684,2,1,0,0,1,0
22684,1,1,0,0,1,0
2372,1,1,0,0,1,0
30370,9,3,0,0,3,0
147889,10,1,0,0,1,0
147889,9,4,0,0,4,0
147889,4,16,0,0,16,0
147889,2,1,0,0,1,0
147889,1,1,0,0,1,0
15121,1,1,0,0,1,0
128218,3,6,0,0,6,0
7483,10,1,0,0,1,0
158268,10,3,0,0,3,0
154125,4,2,0,0,2,0
154125,3,1,0,0,1,0
154125,2,1,0,0,1,0
189160,1,1,0,0,1,0
19399,1,2,0,0,2,0
244099,4,1,0,0,1,0
244099,1,1,0,0,1,0
188991,4,3,0,0,3,0
17250,10,2,0,0,2,0
17250,9,1,0,0,1,0
83157,3,1,0,0,1,0
13224,10,2,0,0,2,0
5856,9,2,0,0,2,0
190247,4,5,0,0,5,0
21829,2,1,0,0,1,0
21829,1,1,0,0,1,0
83919,9,5,0,0,5,0
83919,2,3,0,0,3,0
198408,2,2,0,0,2,0
245645,9,7,0,0,7,0
245645,4,2,0,0,2,0
245645,3,1,0,0,1,0
245645,1,1,0,0,1,0
71886,4,6,0,0,6,0
71886,3,1,0,0,1,0
75828,2,2,0,0,2,0
2090,4,3,0,0,3,0
2090,2,1,0,0,1,0
162738,10,2,0,0,2,0
162738,3,4,0,0,4,0
162738,1,1,0,0,1,0
164205,10,4,0,0,4,0
6837,10,5,0,0,5,0
6837,2,3,0,0,3,0
127438,2,1,0,0,1,0
127438,1,2,0,0,2,0
201037,10,2,0,0,2,0
201037,9,2,0,0,2,0
201037,4,4,0,0,4,0
201037,2,1,0,0,1,0
42702,10,8,0,0,8,0
42702,9,4,0,0,4,0
39095,9,2,0,0,2,0
65936,1,1,0,0,1,0
195179,10,1,0,0,1,0
195179,9,3,0,0,3,0
195179,4,10,0,0,10,0
195179,3,3,0,0,3,0
195179,2,2,0,0,2,0
183150,10,1,0,0,1,0
183150,4,6,0,0,6,0
183150,3,1,0,0,1,0
214996,4,1,0,0,1,0
2919,4,4,0,0,4,0
42132,9,1,0,0,1,0
307,10,1,0,0,1,0
569,9,1,0,0,1,0
569,1,1,0,0,1,0
119804,3,3,0,0,3,0
1997,4,8,0,0,8,0
5082,10,3,0,0,3,0
5082,9,2,0,0,2,0
5082,4,13,0,0,13,0
5082,2,1,0,0,1,0
15509,10,1,0,0,1,0
224271,3,9,0,0,9,0
145943,1,1,0,0,1,0
1177,9,1,0,0,1,0
1177,2,1,0,0,1,0
2887,9,1,0,0,1,0
2887,8,1,0,0,1,0
2887,1,1,0,0,1,0
36659,9,1,0,0,1,0
121657,5,8,0,0,8,0
177515,4,1,0,0,1,0
177515,2,2,0,0,2,0
14342,10,2,0,0,2,0
14342,9,2,0,0,2,0
162315,3,1,0,0,1,0
187679,4,2,0,0,2,0
171544,9,10,0,0,10,0
171544,5,9,0,0,9,0
33434,5,1,0,0,1,0
33434,3,1,0,0,1,0
33434,1,2,0,0,2,0
206928,9,4,0,0,4,0
206928,3,4,0,0,4,0
206928,2,1,0,0,1,0
147523,10,3,0,0,3,0
147523,2,4,0,0,4,0
147523,1,1,0,0,1,0
4096,2,4,0,0,4,0
83196,3,1,0,0,1,0
230050,5,3,0,0,3,0
230050,3,1,0,0,1,0
230050,2,1,0,0,1,0
115976,10,1,0,0,1,0
115976,3,8,0,0,8,0
115976,2,1,0,0,1,0
115976,1,2,0,0,2,0
116877,4,7,0,0,7,0
170344,10,1,0,0,1,0
170344,9,2,0,0,2,0
170344,3,4,0,0,4,0
170344,2,2,0,0,2,0
170344,1,1,0,0,1,0
362,2,1,0,0,1,0
181385,3,1,0,0,1,0
181385,2,2,0,0,2,0
181385,1,2,0,0,2,0
159446,3,2,0,0,2,0
159446,2,1,0,0,1,0
159446,1,1,0,0,1,0
205420,10,4,0,0,4,0
205420,2,1,0,0,1,0
64583,10,1,0,0,1,0
64583,2,1,0,0,1,0
21342,10,1,0,0,1,0
21342,9,2,0,0,2,0
106631,10,1,0,0,1,0
106631,1,1,0,0,1,0
40830,9,2,0,0,2,0
40830,2,1,0,0,1,0
40830,1,1,0,0,1,0
2759,4,4,0,0,4,0
2759,3,2,0,0,2,0
16177,10,1,0,0,1,0
16177,3,2,0,0,2,0
4427,9,3,0,0,3,0
166436,9,3,0,0,3,0
1694,10,3,0,0,3,0
1694,3,2,0,0,2,0
1694,2,1,0,0,1,0
1694,1,1,0,0,1,0
2376,2,1,0,0,1,0
31159,10,1,0,0,1,0
31159,1,1,0,0,1,0
166418,1,1,0,0,1,0
104376,10,1,0,0,1,0
104376,9,2,0,0,2,0
104376,2,3,0,0,3,0
29352,8,10,0,0,10,0
29352,1,3,0,0,3,0
6748,10,2,0,0,2,0
2401,1,2,0,0,2,0
76203,10,1,0,0,1,0
76203,4,4,0,0,4,0
76203,3,1,0,0,1,0
76203,1,1,0,0,1,0
13266,3,1,0,0,1,0
134631,10,5,0,0,5,0
134631,9,2,0,0,2,0
134631,1,1,0,0,1,0
206802,10,4,0,0,4,0
206802,3,5,0,0,5,0
206802,2,3,0,0,3,0
206802,1,1,0,0,1,0
69234,2,1,0,0,1,0
8916,10,2,0,0,2,0
146963,4,4,0,0,4,0
146963,3,2,0,0,2,0
146963,1,1,0,0,1,0
148740,10,2,0,0,2,0
148740,9,5,0,0,5,0
148740,3,1,0,0,1,0
30179,10,2,0,0,2,0
30179,3,1,0,0,1,0
217423,10,2,0,0,2,0
146943,2,3,0,0,3,0
8915,10,2,0,0,2,0
8915,9,2,0,0,2,0
5960,9,2,0,0,2,0
241245,2,7,0,0,7,0
241245,1,1,0,0,1,0
87632,2,2,0,0,2,0
3836,3,1,0,0,1,0
535,10,2,0,0,2,0
35395,3,1,0,0,1,0
256802,10,5,0,0,5,0
256802,9,8,0,0,8,0
256802,3,1,0,0,1,0
76684,1,1,0,0,1,0
128185,1,4,0,0,4,0
27266,4,3,0,0,3,0
27266,2,1,0,0,1,0
3262,2,1,0,0,1,0
228390,3,6,0,0,6,0
8325,4,2,0,0,2,0
241225,4,2,0,0,2,0
218957,4,9,0,0,9,0
218957,2,1,0,0,1,0
20543,9,1,0,0,1,0
4244,1,1,0,0,1,0
2206,10,1,0,0,1,0
29626,3,6,0,0,6,0
199309,2,1,0,0,1,0
124044,9,2,0,0,2,0
4642,2,1,0,0,1,0
1428,9,1,0,0,1,0
1428,1,2,0,0,2,0
11002,9,2,0,0,2,0
11002,4,6,0,0,6,0
11002,2,1,0,0,1,0
11002,1,1,0,0,1,0
91668,9,2,0,0,2,0
91668,2,1,0,0,1,0
194081,3,1,0,0,1,0
343,10,2,0,0,2,0
343,9,2,0,0,2,0
343,4,5,0,0,5,0
343,3,4,0,0,4,0
343,1,1,0,0,1,0
2190,9,3,0,0,3,0
72285,3,1,0,0,1,0
19732,9,4,0,0,4,0
122701,10,1,0,0,1,0
122701,1,1,0,0,1,0
36649,10,2,0,0,2,0
40773,10,1,0,0,1,0
40773,8,20,0,0,20,0
40773,1,1,0,0,1,0
39802,2,1,0,0,1,0
127839,4,6,0,0,6,0
127839,3,3,0,0,3,0
127839,1,1,0,0,1,0
88960,10,1,0,0,1,0
35247,8,11,0,0,11,0
35247,1,1,0,0,1,0
6787,10,1,0,0,1,0
6787,9,1,0,0,1,0
6787,8,3,0,0,3,0
3251,2,1,0,0,1,0
2610,10,1,0,0,1,0
186,9,4,0,0,4,0
186,2,1,0,0,1,0
4228,1,1,0,0,1,0
246938,2,1,0,0,1,0
16142,10,3,0,0,3,0
11886,2,1,0,0,1,0
32678,9,2,0,0,2,0
6810,9,2,0,0,2,0
6810,1,2,0,0,2,0
2072,1,1,0,0,1,0
181956,10,2,0,0,2,0
89976,9,1,0,0,1,0
89976,1,4,0,0,4,0
246701,10,2,0,0,2,0
19329,10,3,0,0,3,0
182352,4,2,0,0,2,0
182352,3,1,0,0,1,0
182352,1,1,0,0,1,0
5953,9,4,0,0,4,0
124290,10,1,0,0,1,0
124290,9,2,0,0,2,0
124290,3,3,0,0,3,0
124290,2,2,0,0,2,0
124290,1,1,0,0,1,0
1329,3,2,0,0,2,0
1329,2,1,0,0,1,0
4780,9,2,0,0,2,0
4780,3,12,0,0,12,0
254976,1,1,0,0,1,0
7109,4,4,0,0,4,0
7109,3,4,0,0,4,0
8784,10,1,0,0,1,0
8784,8,2,0,0,2,0
202254,10,1,0,0,1,0
23375,10,4,0,0,4,0
23550,2,1,0,0,1,0
252693,5,5,0,0,5,0
155633,3,3,0,0,3,0
155633,1,1,0,0,1,0
127275,3,3,0,0,3,0
127275,2,1,0,0,1,0
132188,10,3,0,0,3,0
132188,9,5,0,0,5,0
132188,1,1,0,0,1,0
181236,10,2,0,0,2,0
181236,2,1,0,0,1,0
24387,1,2,0,0,2,0
10226,4,2,0,0,2,0
2216,10,3,0,0,3,0
182050,5,11,0,0,11,0
145205,10,2,0,0,2,0
145205,1,1,0,0,1,0
41032,9,3,0,0,3,0
41032,1,1,0,0,1,0
18057,10,3,0,0,3,0
18057,9,8,0,0,8,0
18057,2,1,0,0,1,0
86167,5,10,0,0,10,0
232417,10,2,0,0,2,0
232417,3,2,0,0,2,0
232417,2,1,0,0,1,0
12355,4,1,0,0,1,0
42112,2,1,0,0,1,0
57037,10,6,0,0,6,0
57037,8,19,0,0,19,0
154778,10,2,0,0,2,0
154778,2,3,0,0,3,0
154778,1,3,0,0,3,0
46410,1,1,0,0,1,0
126274,5,18,0,0,18,0
126274,2,2,0,0,2,0
19115,10,1,0,0,1,0
69602,10,3,0,0,3,0
69602,2,6,0,0,6,0
69602,1,2,0,0,2,0
145027,9,1,0,0,1,0
15911,10,1,0,0,1,0
67601,3,1,0,0,1,0
67601,1,1,0,0,1,0
88464,10,3,0,0,3,0
88464,2,1,0,0,1,0
32164,9,2,0,0,2,0
32164,2,3,0,0,3,0
32164,1,1,0,0,1,0
249670,3,1,0,0,1,0
197285,10,2,0,0,2,0
46747,8,2,0,0,2,0
46747,7,2,0,0,2,0
134637,3,5,0,0,5,0
134637,2,2,0,0,2,0
134637,1,1,0,0,1,0
2538,3,6,0,0,6,0
5736,9,4,0,0,4,0
152767,10,1,0,0,1,0
152767,2,4,0,0,4,0
256918,1,1,0,0,1,0
4402,1,1,0,0,1,0
179385,9,5,0,0,5,0
179385,4,13,0,0,13,0
179385,2,2,0,0,2,0
3663,1,1,0,0,1,0
3600,4,3,0,0,3,0
3600,2,1,0,0,1,0
3600,1,1,0,0,1,0
6824,9,3,0,0,3,0
159452,9,4,0,0,4,0
250754,10,7,0,0,7,0
46744,10,1,0,0,1,0
46744,8,1,0,0,1,0
5966,3,9,0,0,9,0
31410,9,3,0,0,3,0
138338,2,2,0,0,2,0
18824,4,4,0,0,4,0
18824,1,2,0,0,2,0
182487,3,6,0,0,6,0
20096,1,2,0,0,2,0
31547,9,6,0,0,6,0
31547,3,6,0,0,6,0
31547,2,2,0,0,2,0
219276,4,3,0,0,3,0
219276,3,2,0,0,2,0
2388,10,2,0,0,2,0
2388,9,6,0,0,6,0
218025,10,4,0,0,4,0
218025,4,1,0,0,1,0
218025,3,2,0,0,2,0
20821,3,2,0,0,2,0
209696,6,5,0,0,5,0
209696,1,2,0,0,2,0
8374,10,8,0,0,8,0
8374,1,3,0,0,3,0
253344,2,4,0,0,4,0
262388,9,5,0,0,5,0
262388,4,5,0,0,5,0
262388,2,1,0,0,1,0
38694,10,1,0,0,1,0
4852,10,1,0,0,1,0
5482,4,1,0,0,1,0
92363,3,1,0,0,1,0
131616,10,1,0,0,1,0
131616,3,2,0,0,2,0
164110,10,2,0,0,2,0
164110,9,10,0,0,10,0
164110,4,4,0,0,4,0
23878,3,4,0,0,4,0
23878,2,1,0,0,1,0
65521,10,1,0,0,1,0
65521,1,1,0,0,1,0
82449,9,1,0,0,1,0
82449,2,5,0,0,5,0
248949,6,2,0,0,2,0
26205,10,1,0,0,1,0
26205,9,1,0,0,1,0
26205,8,4,0,0,4,0
26205,1,3,0,0,3,0
91430,10,1,0,0,1,0
91430,2,2,0,0,2,0
183578,5,2,0,0,2,0
183578,1,1,0,0,1,0
140779,5,14,0,0,14,0
140779,2,2,0,0,2,0
38981,2,3,0,0,3,0
147685,10,1,0,0,1,0
147685,2,1,0,0,1,0
147685,1,1,0,0,1,0
169146,3,1,0,0,1,0
169146,1,1,0,0,1,0
27101,4,2,0,0,2,0
27101,2,1,0,0,1,0
210271,10,21,0,0,21,0
210271,5,9,0,0,9,0
210271,4,2,0,0,2,0
17026,1,1,0,0,1,0
256788,5,8,0,0,8,0
266966,3,1,0,0,1,0
25233,10,2,0,0,2,0
25233,9,1,0,0,1,0
1402,9,2,0,0,2,0
1402,1,1,0,0,1,0
181959,10,3,0,0,3,0
181959,9,3,0,0,3,0
181959,2,1,0,0,1,0
120906,10,3,0,0,3,0
223151,10,1,0,0,1,0
223151,3,2,0,0,2,0
223151,1,1,0,0,1,0
21779,3,2,0,0,2,0
21779,1,2,0,0,2,0
192829,10,1,0,0,1,0
192829,9,2,0,0,2,0
192829,8,13,0,0,13,0
192829,3,1,0,0,1,0
192829,2,1,0,0,1,0
3936,10,1,0,0,1,0
3936,1,1,0,0,1,0
176963,10,3,0,0,3,0
176963,5,10,0,0,10,0
12304,10,1,0,0,1,0
12304,9,5,0,0,5,0
12304,1,2,0,0,2,0
2311,10,1,0,0,1,0
2311,2,3,0,0,3,0
32424,4,1,0,0,1,0
32424,2,1,0,0,1,0
161928,10,1,0,0,1,0
161928,3,11,0,0,11,0
131232,10,2,0,0,2,0
131232,2,1,0,0,1,0
507,4,3,0,0,3,0
507,3,1,0,0,1,0
42997,1,1,0,0,1,0
205226,10,2,0,0,2,0
205226,9,2,0,0,2,0
258412,5,13,0,0,13,0
258412,3,3,0,0,3,0
12372,9,4,0,0,4,0
12372,1,2,0,0,2,0
125605,9,4,0,0,4,0
125605,1,2,0,0,2,0
253719,10,2,0,0,2,0
253719,3,1,0,0,1,0
2427,9,3,0,0,3,0
2427,1,2,0,0,2,0
5382,9,2,0,0,2,0
5382,1,1,0,0,1,0
593,10,2,0,0,2,0
156420,10,4,0,0,4,0
156420,9,5,0,0,5,0
247980,10,2,0,0,2,0
247980,4,8,0,0,8,0
247980,1,1,0,0,1,0
37906,4,2,0,0,2,0
37906,3,1,0,0,1,0
37906,1,1,0,0,1,0
5178,10,1,0,0,1,0
5178,3,1,0,0,1,0
4368,10,4,0,0,4,0
168582,10,6,0,0,6,0
24321,10,1,0,0,1,0
199723,4,2,0,0,2,0
199723,1,1,0,0,1,0
191387,3,2,0,0,2,0
3065,10,1,0,0,1,0
3065,4,15,0,0,15,0
143869,10,1,0,0,1,0
143869,9,2,0,0,2,0
5452,4,1,0,0,1,0
5452,3,1,0,0,1,0
5452,1,1,0,0,1,0
202737,3,3,0,0,3,0
76436,3,1,0,0,1,0
29638,9,4,0,0,4,0
29638,3,2,0,0,2,0
29638,2,1,0,0,1,0
230275,1,1,0,0,1,0
39941,3,1,0,0,1,0
2574,3,1,0,0,1,0
2574,1,3,0,0,3,0
33112,1,3,0,0,3,0
181192,3,2,0,0,2,0
181192,1,1,0,0,1,0
910,10,1,0,0,1,0
291,9,4,0,0,4,0
291,2,6,0,0,6,0
192668,9,5,0,0,5,0
192668,3,3,0,0,3,0
192668,2,5,0,0,5,0
232090,4,6,0,0,6,0
232090,3,3,0,0,3,0
12055,3,1,0,0,1,0
12055,1,1,0,0,1,0
131581,3,2,0,0,2,0
131581,2,1,0,0,1,0
131581,1,1,0,0,1,0
46748,10,1,0,0,1,0
88140,10,1,0,0,1,0
3416,4,2,0,0,2,0
3416,1,1,0,0,1,0
24168,10,1,0,0,1,0
38558,10,5,0,0,5,0
38558,7,5,0,0,5,0
12897,3,1,0,0,1,0
150925,10,1,0,0,1,0
150925,9,1,0,0,1,0
150925,8,8,0,0,8,0
150925,1,1,0,0,1,0
177725,3,1,0,0,1,0
177725,2,1,0,0,1,0
177725,1,1,0,0,1,0
20233,9,1,0,0,1,0
20233,3,2,0,0,2,0
20233,2,2,0,0,2,0
184460,1,1,0,0,1,0
19957,10,2,0,0,2,0
99308,10,3,0,0,3,0
99308,9,4,0,0,4,0
99308,8,14,0,0,14,0
99308,1,1,0,0,1,0
178839,10,1,0,0,1,0
178839,3,3,0,0,3,0
1932,9,1,0,0,1,0
123406,4,9,0,0,9,0
123406,2,1,0,0,1,0
202771,9,2,0,0,2,0
202771,1,9,0,0,9,0
156878,10,5,0,0,5,0
156878,3,2,0,0,2,0
223360,10,1,0,0,1,0
223360,9,7,0,0,7,0
223360,1,2,0,0,2,0
2860,2,1,0,0,1,0
8324,10,1,0,0,1,0
8324,9,1,0,0,1,0
8324,1,1,0,0,1,0
24116,2,7,0,0,7,0
15999,3,1,0,0,1,0
15999,2,1,0,0,1,0
19040,3,7,0,0,7,0
87907,3,1,0,0,1,0
145259,9,2,0,0,2,0
145259,8,5,0,0,5,0
145259,7,7,0,0,7,0
27613,10,1,0,0,1,0
27613,9,1,0,0,1,0
452,10,1,0,0,1,0
11084,9,3,0,0,3,0
11084,2,2,0,0,2,0
38949,1,1,0,0,1,0
198455,10,4,0,0,4,0
255659,10,4,0,0,4,0
255659,5,2,0,0,2,0
6898,9,1,0,0,1,0
21506,10,1,0,0,1,0
21506,9,1,0,0,1,0
21506,8,9,0,0,9,0
10962,1,1,0,0,1,0
6767,1,2,0,0,2,0
209280,1,1,0,0,1,0
2897,10,1,0,0,1,0
2897,9,1,0,0,1,0
2897,1,1,0,0,1,0
4278,1,1,0,0,1,0
35173,10,1,0,0,1,0
35173,9,1,0,0,1,0
253399,3,1,0,0,1,0
64897,6,35,0,0,35,0
64897,5,7,0,0,7,0
64897,4,2,0,0,2,0
64897,2,1,0,0,1,0
1582,4,2,0,0,2,0
170799,2,1,0,0,1,0
6953,10,1,0,0,1,0
1243,3,4,0,0,4,0
1243,2,1,0,0,1,0
2965,10,1,0,0,1,0
2965,9,1,0,0,1,0
2965,2,2,0,0,2,0
2965,1,1,0,0,1,0
23828,9,1,0,0,1,0
23828,3,6,0,0,6,0
224483,5,2,0,0,2,0
224483,4,2,0,0,2,0
224483,1,1,0,0,1,0
2485,9,3,0,0,3,0
754,3,3,0,0,3,0
754,2,1,0,0,1,0
5228,10,2,0,0,2,0
27608,3,2,0,0,2,0
27608,2,4,0,0,4,0
27608,1,1,0,0,1,0
37441,10,1,0,0,1,0
37441,3,2,0,0,2,0
245928,4,1,0,0,1,0
185276,10,1,0,0,1,0
185276,3,2,0,0,2,0
226860,9,3,0,0,3,0
226860,3,1,0,0,1,0
232824,4,1,0,0,1,0
232824,2,1,0,0,1,0
22161,5,1,0,0,1,0
22161,2,1,0,0,1,0
22161,1,1,0,0,1,0
17030,10,1,0,0,1,0
17030,9,7,0,0,7,0
17030,5,11,0,0,11,0
17030,4,2,0,0,2,0
17030,2,2,0,0,2,0
228183,4,4,0,0,4,0
228183,3,3,0,0,3,0
212580,1,1,0,0,1,0
219621,10,3,0,0,3,0
219621,8,24,0,0,24,0
172598,9,5,0,0,5,0
172598,1,1,0,0,1,0
219,10,3,0,0,3,0
219,9,3,0,0,3,0
199908,1,1,0,0,1,0
9782,3,3,0,0,3,0
18902,9,1,0,0,1,0
93400,10,1,0,0,1,0
2343,9,5,0,0,5,0
188601,9,3,0,0,3,0
188601,8,10,0,0,10,0
188601,3,6,0,0,6,0
188601,2,4,0,0,4,0
206805,10,1,0,0,1,0
26745,1,1,0,0,1,0
41585,9,1,0,0,1,0
1719,9,2,0,0,2,0
1719,2,2,0,0,2,0
254213,10,1,0,0,1,0
36599,10,3,0,0,3,0
36599,9,2,0,0,2,0
36599,5,17,0,0,17,0
212551,10,1,0,0,1,0
212551,5,10,0,0,10,0
212551,3,1,0,0,1,0
212551,2,1,0,0,1,0
622,10,1,0,0,1,0
622,1,1,0,0,1,0
250779,10,11,0,0,11,0
250779,9,13,0,0,13,0
250779,1,1,0,0,1,0
124706,10,3,0,0,3,0
124706,2,2,0,0,2,0
126076,10,2,0,0,2,0
23694,10,3,0,0,3,0
23694,9,1,0,0,1,0
23694,8,6,0,0,6,0
222853,4,6,0,0,6,0
222853,2,2,0,0,2,0
4470,10,1,0,0,1,0
4470,9,2,0,0,2,0
4470,8,5,0,0,5,0
95607,10,6,0,0,6,0
95607,9,7,0,0,7,0
95607,4,14,0,0,14,0
95607,1,2,0,0,2,0
5939,10,6,0,0,6,0
5939,9,3,0,0,3,0
146597,9,4,0,0,4,0
191998,10,5,0,0,5,0
7251,5,6,0,0,6,0
7251,2,2,0,0,2,0
38334,1,1,0,0,1,0
1216,1,2,0,0,2,0
1007,9,1,0,0,1,0
2990,10,1,0,0,1,0
218824,10,2,0,0,2,0
218824,9,4,0,0,4,0
218824,2,4,0,0,4,0
595,10,1,0,0,1,0
3309,9,2,0,0,2,0
3309,3,4,0,0,4,0
3309,2,1,0,0,1,0
84730,9,1,0,0,1,0
177815,10,1,0,0,1,0
177815,3,2,0,0,2,0
31294,10,3,0,0,3,0
31294,1,5,0,0,5,0
3370,3,3,0,0,3,0
23258,2,2,0,0,2,0
4881,2,3,0,0,3,0
4881,1,1,0,0,1,0
1723,1,1,0,0,1,0
255683,4,5,0,0,5,0
255683,3,1,0,0,1,0
255683,1,1,0,0,1,0
150013,1,1,0,0,1,0
243538,5,1,0,0,1,0
243538,1,1,0,0,1,0
178361,10,2,0,0,2,0
178361,1,1,0,0,1,0
36314,4,1,0,0,1,0
36314,2,1,0,0,1,0
36314,1,1,0,0,1,0
156482,5,4,0,0,4,0
156482,4,2,0,0,2,0
156482,1,1,0,0,1,0
154895,2,3,0,0,3,0
126703,10,4,0,0,4,0
126703,9,6,0,0,6,0
126703,2,5,0,0,5,0
126703,1,2,0,0,2,0
141087,9,2,0,0,2,0
3662,2,3,0,0,3,0
23829,9,1,0,0,1,0
159355,10,2,0,0,2,0
2779,10,2,0,0,2,0
2779,9,1,0,0,1,0
2779,2,1,0,0,1,0
2779,1,1,0,0,1,0
128927,10,3,0,0,3,0
128927,9,1,0,0,1,0
128927,2,2,0,0,2,0
192623,4,6,0,0,6,0
192623,3,8,0,0,8,0
192623,1,2,0,0,2,0
71668,3,2,0,0,2,0
71668,1,1,0,0,1,0
97824,10,2,0,0,2,0
97824,1,1,0,0,1,0
20589,9,2,0,0,2,0
2215,3,4,0,0,4,0
3015,9,4,0,0,4,0
3015,2,1,0,0,1,0
236272,10,1,0,0,1,0
236272,4,5,0,0,5,0
148282,9,7,0,0,7,0
148282,2,3,0,0,3,0
229006,3,1,0,0,1,0
224134,5,14,0,0,14,0
224134,1,2,0,0,2,0
10623,4,3,0,0,3,0
10623,3,1,0,0,1,0
10623,2,1,0,0,1,0
202819,5,3,0,0,3,0
202819,1,2,0,0,2,0
175512,8,1,0,0,1,0
175512,7,2,0,0,2,0
193328,10,5,0,0,5,0
193328,9,4,0,0,4,0
193328,8,14,0,0,14,0
193328,5,27,0,0,27,0
193328,3,10,0,0,10,0
1514,9,1,0,0,1,0
178397,10,3,0,0,3,0
64875,10,3,0,0,3,0
64875,8,7,0,0,7,0
29676,10,2,0,0,2,0
29676,9,2,0,0,2,0
29676,1,2,0,0,2,0
207783,9,4,0,0,4,0
207783,4,7,0,0,7,0
207783,1,1,0,0,1,0
226445,4,1,0,0,1,0
178494,10,13,0,0,13,0
178494,4,4,0,0,4,0
178494,1,1,0,0,1,0
178939,3,6,0,0,6,0
178939,2,1,0,0,1,0
188196,10,1,0,0,1,0
188196,4,10,0,0,10,0
188196,3,4,0,0,4,0
188196,2,1,0,0,1,0
188196,1,1,0,0,1,0
5559,2,1,0,0,1,0
1321,10,1,0,0,1,0
1321,2,1,0,0,1,0
1373,10,1,0,0,1,0
1373,9,2,0,0,2,0
1373,4,1,0,0,1,0
189829,9,10,0,0,10,0
189829,4,3,0,0,3,0
189829,3,1,0,0,1,0
189829,1,1,0,0,1,0
36231,9,2,0,0,2,0
36231,1,2,0,0,2,0
605,8,3,0,0,3,0
605,1,1,0,0,1,0
126025,1,1,0,0,1,0
65889,9,1,0,0,1,0
65889,1,3,0,0,3,0
40416,9,3,0,0,3,0
9296,3,1,0,0,1,0
9296,1,1,0,0,1,0
227171,9,5,0,0,5,0
227171,1,1,0,0,1,0
232980,10,2,0,0,2,0
232980,6,28,0,0,28,0
232980,4,3,0,0,3,0
232980,3,1,0,0,1,0
12131,1,1,0,0,1,0
256568,10,5,0,0,5,0
256568,9,12,0,0,12,0
135019,10,1,0,0,1,0
135019,9,3,0,0,3,0
27830,9,3,0,0,3,0
9912,10,1,0,0,1,0
212958,2,1,0,0,1,0
20422,9,1,0,0,1,0
20422,8,2,0,0,2,0
257321,10,9,0,0,9,0
927,10,1,0,0,1,0
131493,9,4,0,0,4,0
131493,4,2,0,0,2,0
124881,4,9,0,0,9,0
102792,10,1,0,0,1,0
102792,9,3,0,0,3,0
27028,10,8,0,0,8,0
27028,2,1,0,0,1,0
62226,9,5,0,0,5,0
62226,3,1,0,0,1,0
26124,10,1,0,0,1,0
5779,9,2,0,0,2,0
32047,10,1,0,0,1,0
32047,1,2,0,0,2,0
94902,2,1,0,0,1,0
6240,9,2,0,0,2,0
172008,1,1,0,0,1,0
70097,3,2,0,0,2,0
70097,2,2,0,0,2,0
17530,9,5,0,0,5,0
17530,1,1,0,0,1,0
10534,9,3,0,0,3,0
10534,3,1,0,0,1,0
10534,2,1,0,0,1,0
10534,1,1,0,0,1,0
23598,1,2,0,0,2,0
3668,10,1,0,0,1,0
221599,5,3,0,0,3,0
143323,3,4,0,0,4,0
143323,2,2,0,0,2,0
143323,1,1,0,0,1,0
4113,2,1,0,0,1,0
2310,1,1,0,0,1,0
22377,10,2,0,0,2,0
86882,10,3,0,0,3,0
163172,5,1,0,0,1,0
163172,2,1,0,0,1,0
163172,1,1,0,0,1,0
151310,9,1,0,0,1,0
126789,3,4,0,0,4,0
126789,2,2,0,0,2,0
261529,10,1,0,0,1,0
138973,2,1,0,0,1,0
138973,1,1,0,0,1,0
12263,2,2,0,0,2,0
26118,3,1,0,0,1,0
5829,4,4,0,0,4,0
5829,3,1,0,0,1,0
21666,1,3,0,0,3,0
127798,9,3,0,0,3,0
127798,8,15,0,0,15,0
6388,10,2,0,0,2,0
6388,9,1,0,0,1,0
6388,8,4,0,0,4,0
6388,2,3,0,0,3,0
6388,1,2,0,0,2,0
3924,10,1,0,0,1,0
3924,9,2,0,0,2,0
3924,3,9,0,0,9,0
3924,2,1,0,0,1,0
120316,3,2,0,0,2,0
258413,10,2,0,0,2,0
258413,9,11,0,0,11,0
31069,9,4,0,0,4,0
180937,10,6,0,0,6,0
180937,3,3,0,0,3,0
230361,3,1,0,0,1,0
42969,10,1,0,0,1,0
42969,1,1,0,0,1,0
7641,10,1,0,0,1,0
7641,2,1,0,0,1,0
5430,10,2,0,0,2,0
91666,5,12,0,0,12,0
91666,3,1,0,0,1,0
130004,9,1,0,0,1,0
130004,2,3,0,0,3,0
130004,1,1,0,0,1,0
157323,3,1,0,0,1,0
157323,1,1,0,0,1,0
13886,10,5,0,0,5,0
13886,8,2,0,0,2,0
58253,10,1,0,0,1,0
58253,9,1,0,0,1,0
268201,6,9,0,0,9,0
268201,5,2,0,0,2,0
268201,2,1,0,0,1,0
38805,2,1,0,0,1,0
38805,1,1,0,0,1,0
1160,9,7,0,0,7,0
24932,9,1,0,0,1,0
24932,2,1,0,0,1,0
24932,1,1,0,0,1,0
89912,9,2,0,0,2,0
89912,3,2,0,0,2,0
62809,9,3,0,0,3,0
40800,9,5,0,0,5,0
40800,3,3,0,0,3,0
40800,1,1,0,0,1,0
217466,9,13,0,0,13,0
217466,1,1,0,0,1,0
1348,10,1,0,0,1,0
1348,9,3,0,0,3,0
1348,1,1,0,0,1,0
3155,10,1,0,0,1,0
3155,9,1,0,0,1,0
3155,2,3,0,0,3,0
258437,4,3,0,0,3,0
258437,3,1,0,0,1,0
62814,5,9,0,0,9,0
62814,4,1,0,0,1,0
62814,2,1,0,0,1,0
3419,10,1,0,0,1,0
215213,4,5,0,0,5,0
215213,3,7,0,0,7,0
228570,3,1,0,0,1,0
2517,2,3,0,0,3,0
2517,1,1,0,0,1,0
35763,10,1,0,0,1,0
35763,2,3,0,0,3,0
35763,1,2,0,0,2,0
7451,4,3,0,0,3,0
8636,10,4,0,0,4,0
8636,9,1,0,0,1,0
41334,10,1,0,0,1,0
41334,9,1,0,0,1,0
41334,1,3,0,0,3,0
182635,10,5,0,0,5,0
182635,3,5,0,0,5,0
37683,10,2,0,0,2,0
37683,2,2,0,0,2,0
109456,10,1,0,0,1,0
109456,9,1,0,0,1,0
1803,3,1,0,0,1,0
1803,1,1,0,0,1,0
180650,9,7,0,0,7,0
180650,1,1,0,0,1,0
355,2,2,0,0,2,0
224403,3,1,0,0,1,0
7464,10,1,0,0,1,0
10925,8,5,0,0,5,0
1528,10,2,0,0,2,0
195709,6,11,0,0,11,0
195709,1,1,0,0,1,0
149639,3,5,0,0,5,0
103666,3,3,0,0,3,0
2040,9,1,0,0,1,0
2040,2,4,0,0,4,0
115793,8,6,0,0,6,0
161719,1,1,0,0,1,0
1744,9,1,0,0,1,0
50719,10,3,0,0,3,0
50719,9,7,0,0,7,0
50719,3,4,0,0,4,0
5635,2,1,0,0,1,0
63900,10,1,0,0,1,0
63900,2,2,0,0,2,0
1691,9,1,0,0,1,0
1691,1,1,0,0,1,0
3724,9,4,0,0,4,0
3724,2,1,0,0,1,0
3724,1,1,0,0,1,0
4235,10,2,0,0,2,0
4235,1,2,0,0,2,0
2794,1,1,0,0,1,0
205826,4,5,0,0,5,0
2844,10,2,0,0,2,0
2844,3,2,0,0,2,0
225981,10,4,0,0,4,0
225981,9,8,0,0,8,0
38499,8,11,0,0,11,0
38499,4,8,0,0,8,0
38499,3,4,0,0,4,0
38499,2,1,0,0,1,0
54201,1,1,0,0,1,0
12325,10,2,0,0,2,0
179930,2,2,0,0,2,0
183949,10,5,0,0,5,0
183949,4,7,0,0,7,0
183949,3,1,0,0,1,0
183949,2,1,0,0,1,0
4162,9,2,0,0,2,0
8285,10,5,0,0,5,0
8285,3,2,0,0,2,0
8285,1,1,0,0,1,0
149296,10,4,0,0,4,0
149296,3,1,0,0,1,0
149296,2,2,0,0,2,0
5837,10,1,0,0,1,0
5837,9,1,0,0,1,0
174584,3,2,0,0,2,0
223449,2,1,0,0,1,0
13703,10,1,0,0,1,0
13703,9,2,0,0,2,0
13703,8,4,0,0,4,0
13703,2,5,0,0,5,0
243435,10,1,0,0,1,0
243435,2,5,0,0,5,0
243435,1,1,0,0,1,0
1866,2,3,0,0,3,0
2082,9,6,0,0,6,0
122271,10,2,0,0,2,0
122271,2,3,0,0,3,0
20953,9,3,0,0,3,0
88253,5,3,0,0,3,0
88253,4,1,0,0,1,0
65590,3,7,0,0,7,0
126426,1,2,0,0,2,0
170431,10,1,0,0,1,0
170431,4,13,0,0,13,0
2149,10,1,0,0,1,0
2149,2,3,0,0,3,0
184917,2,1,0,0,1,0
184917,1,1,0,0,1,0
8071,10,1,0,0,1,0
8071,3,1,0,0,1,0
171663,2,1,0,0,1,0
3369,3,2,0,0,2,0
3369,2,1,0,0,1,0
3369,1,1,0,0,1,0
215392,10,5,0,0,5,0
215392,9,1,0,0,1,0
215392,3,3,0,0,3,0
6698,1,1,0,0,1,0
91425,10,2,0,0,2,0
91425,3,3,0,0,3,0
91425,2,1,0,0,1,0
91425,1,1,0,0,1,0
240759,10,1,0,0,1,0
240759,9,12,0,0,12,0
240759,3,1,0,0,1,0
89695,9,7,0,0,7,0
89695,4,1,0,0,1,0
154857,4,6,0,0,6,0
1588,9,1,0,0,1,0
217554,10,1,0,0,1,0
217554,3,2,0,0,2,0
158267,10,2,0,0,2,0
158267,8,9,0,0,9,0
158267,4,10,0,0,10,0
158267,3,1,0,0,1,0
158267,1,2,0,0,2,0
2725,10,1,0,0,1,0
2725,1,3,0,0,3,0
4892,2,3,0,0,3,0
4892,1,2,0,0,2,0
1869,10,3,0,0,3,0
1869,9,6,0,0,6,0
156062,9,1,0,0,1,0
156062,3,6,0,0,6,0
156062,2,5,0,0,5,0
156062,1,1,0,0,1,0
147171,3,4,0,0,4,0
147171,1,1,0,0,1,0
15386,4,5,0,0,5,0
15386,3,2,0,0,2,0
15386,2,3,0,0,3,0
23917,2,1,0,0,1,0
180920,10,2,0,0,2,0
180920,1,1,0,0,1,0
113301,10,1,0,0,1,0
113301,1,1,0,0,1,0
68250,3,1,0,0,1,0
181464,1,1,0,0,1,0
33967,9,2,0,0,2,0
33967,8,2,0,0,2,0
136554,10,1,0,0,1,0
136554,9,2,0,0,2,0
31216,9,3,0,0,3,0
5235,9,1,0,0,1,0
241796,2,2,0,0,2,0
241796,1,1,0,0,1,0
28508,9,5,0,0,5,0
28508,1,1,0,0,1,0
5992,10,3,0,0,3,0
5992,1,1,0,0,1,0
58624,5,2,0,0,2,0
17125,10,1,0,0,1,0
17125,3,2,0,0,2,0
167,9,5,0,0,5,0
160908,10,10,0,0,10,0
160908,5,4,0,0,4,0
160908,3,1,0,0,1,0
5232,10,1,0,0,1,0
1375,10,3,0,0,3,0
1375,3,1,0,0,1,0
1375,1,1,0,0,1,0
18686,9,1,0,0,1,0
18686,8,4,0,0,4,0
175023,10,2,0,0,2,0
175023,2,3,0,0,3,0
32495,1,3,0,0,3,0
18481,1,1,0,0,1,0
172309,9,2,0,0,2,0
20031,9,1,0,0,1,0
20031,1,1,0,0,1,0
72808,3,1,0,0,1,0
72808,2,3,0,0,3,0
197269,10,2,0,0,2,0
197269,5,5,0,0,5,0
197269,3,2,0,0,2,0
89951,10,3,0,0,3,0
89951,9,4,0,0,4,0
89951,4,8,0,0,8,0
2929,9,2,0,0,2,0
2929,8,3,0,0,3,0
188390,1,1,0,0,1,0
8104,10,1,0,0,1,0
8104,9,1,0,0,1,0
4275,3,2,0,0,2,0
4275,1,1,0,0,1,0
5171,4,3,0,0,3,0
128028,9,3,0,0,3,0
41311,10,1,0,0,1,0
41311,8,17,0,0,17,0
41311,5,21,0,0,21,0
18212,9,5,0,0,5,0
18212,1,1,0,0,1,0
150761,4,3,0,0,3,0
150761,1,1,0,0,1,0
93287,4,4,0,0,4,0
93287,1,1,0,0,1,0
7753,10,3,0,0,3,0
7753,2,1,0,0,1,0
141067,5,1,0,0,1,0
130908,9,5,0,0,5,0
130908,5,13,0,0,13,0
130908,1,1,0,0,1,0
245487,10,2,0,0,2,0
20645,10,1,0,0,1,0
20645,9,1,0,0,1,0
20645,3,3,0,0,3,0
20645,2,2,0,0,2,0
6282,9,1,0,0,1,0
6282,3,1,0,0,1,0
6282,1,1,0,0,1,0
147009,1,2,0,0,2,0
218933,5,2,0,0,2,0
218933,4,1,0,0,1,0
218933,3,2,0,0,2,0
254088,10,1,0,0,1,0
254088,2,1,0,0,1,0
260201,10,3,0,0,3,0
100169,4,1,0,0,1,0
44338,2,1,0,0,1,0
76447,1,4,0,0,4,0
128204,2,1,0,0,1,0
128204,1,1,0,0,1,0
25453,10,1,0,0,1,0
25453,3,4,0,0,4,0
27870,10,1,0,0,1,0
27870,1,1,0,0,1,0
6383,10,3,0,0,3,0
6383,4,16,0,0,16,0
21358,4,4,0,0,4,0
21358,3,1,0,0,1,0
21358,1,1,0,0,1,0
241334,2,1,0,0,1,0
612,10,1,0,0,1,0
612,2,2,0,0,2,0
140386,2,2,0,0,2,0
243994,3,2,0,0,2,0
236248,5,6,0,0,6,0
236248,4,2,0,0,2,0
236248,3,1,0,0,1,0
836,3,2,0,0,2,0
836,2,1,0,0,1,0
137789,9,1,0,0,1,0
137789,1,1,0,0,1,0
130229,10,1,0,0,1,0
130229,9,1,0,0,1,0
130229,5,12,0,0,12,0
166026,10,2,0,0,2,0
166026,1,1,0,0,1,0
195231,5,14,0,0,14,0
195231,4,6,0,0,6,0
195231,2,2,0,0,2,0
195231,1,1,0,0,1,0
5700,10,2,0,0,2,0
5700,9,3,0,0,3,0
5700,3,2,0,0,2,0
224013,10,1,0,0,1,0
224013,9,1,0,0,1,0
224013,1,2,0,0,2,0
687,9,1,0,0,1,0
249039,10,1,0,0,1,0
249039,1,1,0,0,1,0
14036,10,2,0,0,2,0
14036,2,2,0,0,2,0
170669,1,1,0,0,1,0
10642,6,9,0,0,9,0
10642,1,1,0,0,1,0
173784,10,4,0,0,4,0
173784,1,1,0,0,1,0
8316,1,1,0,0,1,0
5491,10,1,0,0,1,0
35179,4,5,0,0,5,0
35179,3,2,0,0,2,0
172033,10,3,0,0,3,0
172033,3,1,0,0,1,0
230765,10,7,0,0,7,0
230765,5,7,0,0,7,0
230765,3,4,0,0,4,0
230765,2,1,0,0,1,0
230765,1,1,0,0,1,0
12964,10,1,0,0,1,0
12964,9,2,0,0,2,0
12964,2,1,0,0,1,0
12964,1,3,0,0,3,0
229599,4,5,0,0,5,0
18399,10,1,0,0,1,0
18399,9,2,0,0,2,0
18399,2,2,0,0,2,0
207242,10,2,0,0,2,0
207242,3,1,0,0,1,0
207242,2,1,0,0,1,0
130907,4,12,0,0,12,0
130907,3,6,0,0,6,0
130907,1,1,0,0,1,0
219475,3,1,0,0,1,0
5042,3,1,0,0,1,0
2426,1,2,0,0,2,0
118315,10,3,0,0,3,0
41890,1,2,0,0,2,0
1288,9,3,0,0,3,0
1288,8,9,0,0,9,0
227605,10,4,0,0,4,0
8326,10,2,0,0,2,0
20081,2,1,0,0,1,0
176458,10,2,0,0,2,0
176458,9,2,0,0,2,0
12898,4,1,0,0,1,0
12898,1,1,0,0,1,0
117784,10,2,0,0,2,0
117784,9,1,0,0,1,0
117784,8,5,0,0,5,0
191191,3,1,0,0,1,0
35652,1,1,0,0,1,0
23761,9,2,0,0,2,0
38187,10,1,0,0,1,0
38187,2,2,0,0,2,0
152846,2,1,0,0,1,0
11542,10,2,0,0,2,0
11542,3,1,0,0,1,0
11542,2,2,0,0,2,0
7975,10,4,0,0,4,0
118452,9,1,0,0,1,0
118452,2,2,0,0,2,0
118452,1,1,0,0,1,0
130725,9,2,0,0,2,0
130725,1,2,0,0,2,0
38924,10,1,0,0,1,0
38924,3,4,0,0,4,0
38924,2,1,0,0,1,0
13648,10,1,0,0,1,0
13648,8,12,0,0,12,0
13648,2,5,0,0,5,0
13648,1,4,0,0,4,0
1816,9,3,0,0,3,0
1816,3,6,0,0,6,0
857,2,3,0,0,3,0
188347,10,3,0,0,3,0
188347,9,8,0,0,8,0
188347,3,6,0,0,6,0
188347,2,4,0,0,4,0
188347,1,5,0,0,5,0
3594,10,1,0,0,1,0
3594,3,2,0,0,2,0
3594,1,2,0,0,2,0
794,2,2,0,0,2,0
794,1,1,0,0,1,0
2214,2,1,0,0,1,0
133633,1,1,0,0,1,0
4125,10,1,0,0,1,0
4125,9,1,0,0,1,0
154519,5,5,0,0,5,0
154519,1,1,0,0,1,0
38986,2,1,0,0,1,0
2431,9,1,0,0,1,0
2431,8,9,0,0,9,0
22863,1,1,0,0,1,0
4978,4,3,0,0,3,0
147474,1,1,0,0,1,0
192906,4,2,0,0,2,0
218028,10,2,0,0,2,0
218028,5,17,0,0,17,0
218028,3,2,0,0,2,0
149620,5,1,0,0,1,0
149620,4,1,0,0,1,0
149620,3,1,0,0,1,0
149620,1,1,0,0,1,0
87141,2,3,0,0,3,0
180471,2,3,0,0,3,0
174802,3,2,0,0,2,0
174802,1,1,0,0,1,0
148639,2,1,0,0,1,0
25775,5,2,0,0,2,0
25775,4,2,0,0,2,0
197408,10,4,0,0,4,0
197408,2,1,0,0,1,0
2049,10,1,0,0,1,0
14940,9,6,0,0,6,0
14940,4,3,0,0,3,0
1940,3,2,0,0,2,0
156474,2,1,0,0,1,0
148507,3,1,0,0,1,0
184525,10,2,0,0,2,0
184525,3,3,0,0,3,0
184525,2,2,0,0,2,0
184525,1,3,0,0,3,0
31935,9,3,0,0,3,0
31935,2,1,0,0,1,0
15731,9,1,0,0,1,0
15731,2,4,0,0,4,0
15731,1,1,0,0,1,0
3637,3,2,0,0,2,0
3637,2,1,0,0,1,0
60311,9,1,0,0,1,0
60311,1,2,0,0,2,0
238889,4,1,0,0,1,0
171978,10,2,0,0,2,0
171978,9,4,0,0,4,0
171978,3,5,0,0,5,0
171978,1,2,0,0,2,0
165522,4,5,0,0,5,0
47130,10,2,0,0,2,0
47130,9,2,0,0,2,0
47130,1,1,0,0,1,0
42207,3,2,0,0,2,0
42207,1,1,0,0,1,0
160125,9,6,0,0,6,0
160125,2,1,0,0,1,0
160125,1,1,0,0,1,0
4200,4,1,0,0,1,0
4200,2,1,0,0,1,0
160067,8,15,0,0,15,0
21436,2,1,0,0,1,0
100172,10,6,0,0,6,0
100172,3,2,0,0,2,0
100172,2,1,0,0,1,0
231962,6,16,0,0,16,0
214910,3,4,0,0,4,0
214910,2,3,0,0,3,0
67609,2,2,0,0,2,0
136240,3,1,0,0,1,0
136240,2,3,0,0,3,0
1256,9,1,0,0,1,0
191070,10,1,0,0,1,0
191070,9,2,0,0,2,0
191070,3,1,0,0,1,0
401,3,3,0,0,3,0
177542,4,8,0,0,8,0
177542,3,3,0,0,3,0
195454,10,1,0,0,1,0
195454,1,2,0,0,2,0
23055,3,2,0,0,2,0
42360,1,1,0,0,1,0
292,9,2,0,0,2,0
130764,9,3,0,0,3,0
130764,3,7,0,0,7,0
130764,2,4,0,0,4,0
3640,10,1,0,0,1,0
7467,9,1,0,0,1,0
170395,9,1,0,0,1,0
170395,1,2,0,0,2,0
5383,10,4,0,0,4,0
5383,9,2,0,0,2,0
5383,3,3,0,0,3,0
135557,10,1,0,0,1,0
135557,9,1,0,0,1,0
135557,1,2,0,0,2,0
1346,9,1,0,0,1,0
60245,9,4,0,0,4,0
60245,3,1,0,0,1,0
122691,10,9,0,0,9,0
122691,4,2,0,0,2,0
3157,1,1,0,0,1,0
11983,9,3,0,0,3,0
2698,3,3,0,0,3,0
198791,5,11,0,0,11,0
198791,3,1,0,0,1,0
198791,2,1,0,0,1,0
198791,1,2,0,0,2,0
57349,10,3,0,0,3,0
57349,9,4,0,0,4,0
57349,3,1,0,0,1,0
57349,2,1,0,0,1,0
57349,1,1,0,0,1,0
131788,10,3,0,0,3,0
247313,9,5,0,0,5,0
247313,4,3,0,0,3,0
247313,3,1,0,0,1,0
247313,2,1,0,0,1,0
247313,1,2,0,0,2,0
170922,10,2,0,0,2,0
170922,4,4,0,0,4,0
170922,1,1,0,0,1,0
151446,9,10,0,0,10,0
151446,4,4,0,0,4,0
151446,3,1,0,0,1,0
151446,2,1,0,0,1,0
151446,1,1,0,0,1,0
10467,10,2,0,0,2,0
217531,10,1,0,0,1,0
4781,9,1,0,0,1,0
4781,1,2,0,0,2,0
5217,3,2,0,0,2,0
206540,9,5,0,0,5,0
206540,2,2,0,0,2,0
56995,4,1,0,0,1,0
56995,3,1,0,0,1,0
253106,4,1,0,0,1,0
253106,1,1,0,0,1,0
43526,10,5,0,0,5,0
126021,6,18,0,0,18,0
126021,5,7,0,0,7,0
126021,4,3,0,0,3,0
126021,3,1,0,0,1,0
84732,10,3,0,0,3,0
84732,9,4,0,0,4,0
172480,9,1,0,0,1,0
172480,2,3,0,0,3,0
172480,1,1,0,0,1,0
8486,10,1,0,0,1,0
8486,1,6,0,0,6,0
40421,8,6,0,0,6,0
3820,9,2,0,0,2,0
786,9,1,0,0,1,0
231939,10,1,0,0,1,0
231939,8,3,0,0,3,0
183441,3,3,0,0,3,0
2217,2,1,0,0,1,0
166726,6,37,0,0,37,0
166726,4,1,0,0,1,0
166726,3,1,0,0,1,0
3581,10,1,0,0,1,0
3581,1,1,0,0,1,0
5142,3,2,0,0,2,0
5142,1,1,0,0,1,0
31380,9,2,0,0,2,0
193551,5,10,0,0,10,0
193551,3,1,0,0,1,0
37,9,3,0,0,3,0
37,1,1,0,0,1,0
5012,10,2,0,0,2,0
2946,10,1,0,0,1,0
2946,3,7,0,0,7,0
2946,2,2,0,0,2,0
2946,1,1,0,0,1,0
15505,10,1,0,0,1,0
232831,9,4,0,0,4,0
16355,9,2,0,0,2,0
16355,2,4,0,0,4,0
11122,3,1,0,0,1,0
11122,2,1,0,0,1,0
250561,5,6,0,0,6,0
250561,3,2,0,0,2,0
250561,2,1,0,0,1,0
272,9,1,0,0,1,0
4208,10,1,0,0,1,0
4201,4,3,0,0,3,0
4201,2,1,0,0,1,0
188018,3,2,0,0,2,0
188018,1,1,0,0,1,0
255639,1,1,0,0,1,0
430,9,1,0,0,1,0
430,3,3,0,0,3,0
430,2,2,0,0,2,0
63778,10,2,0,0,2,0
63778,4,2,0,0,2,0
63778,3,1,0,0,1,0
2597,10,3,0,0,3,0
2597,2,2,0,0,2,0
34185,9,1,0,0,1,0
20781,1,1,0,0,1,0
32107,1,1,0,0,1,0
23658,9,3,0,0,3,0
28246,9,2,0,0,2,0
66851,10,1,0,0,1,0
66851,2,3,0,0,3,0
118553,9,6,0,0,6,0
118553,4,3,0,0,3,0
118553,3,2,0,0,2,0
118553,2,1,0,0,1,0
118553,1,1,0,0,1,0
15000,8,14,0,0,14,0
15000,3,3,0,0,3,0
15000,2,1,0,0,1,0
198961,8,1,0,0,1,0
198961,2,4,0,0,4,0
198961,1,1,0,0,1,0
129204,3,2,0,0,2,0
129204,1,2,0,0,2,0
22392,9,5,0,0,5,0
22392,1,1,0,0,1,0
5957,1,2,0,0,2,0
221155,10,4,0,0,4,0
221155,4,1,0,0,1,0
221155,3,4,0,0,4,0
21705,10,5,0,0,5,0
21705,9,4,0,0,4,0
21705,6,34,0,0,34,0
134615,1,4,0,0,4,0
158093,1,1,0,0,1,0
34444,10,5,0,0,5,0
34444,2,1,0,0,1,0
40651,10,1,0,0,1,0
40651,9,4,0,0,4,0
2494,5,16,0,0,16,0
2494,2,2,0,0,2,0
3249,2,1,0,0,1,0
255618,10,2,0,0,2,0
255990,3,2,0,0,2,0
255990,2,2,0,0,2,0
255990,1,1,0,0,1,0
138201,9,1,0,0,1,0
193500,10,2,0,0,2,0
193500,9,10,0,0,10,0
204755,10,4,0,0,4,0
204755,9,2,0,0,2,0
4037,8,5,0,0,5,0
4037,2,3,0,0,3,0
210295,4,2,0,0,2,0
8945,10,1,0,0,1,0
8945,9,1,0,0,1,0
184117,10,4,0,0,4,0
184117,4,5,0,0,5,0
184117,1,2,0,0,2,0
73543,3,1,0,0,1,0
73543,2,1,0,0,1,0
73543,1,1,0,0,1,0
10986,10,3,0,0,3,0
10986,9,2,0,0,2,0
14076,8,3,0,0,3,0
142124,10,10,0,0,10,0
142124,4,2,0,0,2,0
142124,2,1,0,0,1,0
7420,3,2,0,0,2,0
7420,1,2,0,0,2,0
28828,3,2,0,0,2,0
194194,9,5,0,0,5,0
194194,5,15,0,0,15,0
194194,4,4,0,0,4,0
194194,1,1,0,0,1,0
76442,9,3,0,0,3,0
7064,3,1,0,0,1,0
7064,1,1,0,0,1,0
5272,10,1,0,0,1,0
130242,10,1,0,0,1,0
130242,9,5,0,0,5,0
130242,3,2,0,0,2,0
2362,10,2,0,0,2,0
940,2,1,0,0,1,0
129858,2,1,0,0,1,0
129858,1,1,0,0,1,0
68340,10,1,0,0,1,0
68340,9,1,0,0,1,0
68340,4,6,0,0,6,0
68340,2,4,0,0,4,0
68340,1,2,0,0,2,0
103670,5,5,0,0,5,0
7822,10,1,0,0,1,0
36523,10,1,0,0,1,0
228051,7,13,0,0,13,0
228051,6,4,0,0,4,0
2169,10,2,0,0,2,0
67823,10,7,0,0,7,0
67823,4,5,0,0,5,0
67823,3,2,0,0,2,0
67823,1,1,0,0,1,0
95710,9,2,0,0,2,0
95710,8,8,0,0,8,0
95710,1,7,0,0,7,0
144709,4,3,0,0,3,0
179929,9,2,0,0,2,0
179929,4,6,0,0,6,0
179929,3,1,0,0,1,0
19918,2,2,0,0,2,0
80869,1,3,0,0,3,0
211808,2,3,0,0,3,0
80908,9,3,0,0,3,0
80908,4,13,0,0,13,0
80908,2,3,0,0,3,0
80908,1,1,0,0,1,0
4317,10,1,0,0,1,0
4317,2,1,0,0,1,0
247935,4,1,0,0,1,0
5698,10,3,0,0,3,0
5698,3,2,0,0,2,0
135107,1,1,0,0,1,0
33624,10,1,0,0,1,0
33624,9,4,0,0,4,0
33624,8,11,0,0,11,0
33624,1,2,0,0,2,0
93577,10,1,0,0,1,0
93577,8,3,0,0,3,0
6121,9,3,0,0,3,0
141418,1,2,0,0,2,0
192777,9,7,0,0,7,0
192777,6,37,0,0,37,0
192777,4,4,0,0,4,0
192777,2,1,0,0,1,0
192777,1,1,0,0,1,0
89956,10,2,0,0,2,0
89956,9,3,0,0,3,0
89956,8,3,0,0,3,0
89956,1,1,0,0,1,0
174926,10,2,0,0,2,0
174926,4,2,0,0,2,0
201478,5,6,0,0,6,0
201478,4,3,0,0,3,0
201478,3,2,0,0,2,0
94255,1,1,0,0,1,0
99132,3,1,0,0,1,0
42920,1,1,0,0,1,0
8986,10,1,0,0,1,0
8986,1,1,0,0,1,0
130682,10,1,0,0,1,0
130682,9,3,0,0,3,0
130682,3,10,0,0,10,0
130682,2,2,0,0,2,0
109643,10,1,0,0,1,0
109643,1,1,0,0,1,0
2298,10,3,0,0,3,0
183831,9,3,0,0,3,0
183831,2,8,0,0,8,0
151410,3,7,0,0,7,0
1305,1,1,0,0,1,0
35477,9,12,0,0,12,0
35477,4,2,0,0,2,0
35477,1,1,0,0,1,0
189166,9,5,0,0,5,0
189166,2,4,0,0,4,0
156096,9,9,0,0,9,0
156096,3,1,0,0,1,0
197333,6,8,0,0,8,0
197333,1,2,0,0,2,0
207845,3,1,0,0,1,0
207845,2,1,0,0,1,0
36661,3,3,0,0,3,0
36661,2,1,0,0,1,0
221669,3,1,0,0,1,0
643,1,1,0,0,1,0
140840,7,12,0,0,12,0
211450,10,1,0,0,1,0
211450,9,1,0,0,1,0
204143,4,7,0,0,7,0
204143,3,2,0,0,2,0
156007,3,2,0,0,2,0
1014,10,6,0,0,6,0
1014,9,10,0,0,10,0
3091,9,3,0,0,3,0
3091,1,1,0,0,1,0
956,10,2,0,0,2,0
956,2,2,0,0,2,0
20528,10,1,0,0,1,0
141734,2,1,0,0,1,0
249833,2,1,0,0,1,0
8782,3,1,0,0,1,0
22080,9,1,0,0,1,0
22080,2,2,0,0,2,0
22080,1,1,0,0,1,0
5707,9,2,0,0,2,0
5707,1,2,0,0,2,0
188343,2,1,0,0,1,0
1354,1,1,0,0,1,0
179627,3,2,0,0,2,0
179627,2,4,0,0,4,0
15110,10,2,0,0,2,0
15110,9,4,0,0,4,0
15110,3,9,0,0,9,0
15110,1,2,0,0,2,0
168230,2,1,0,0,1,0
135796,4,1,0,0,1,0
135796,1,1,0,0,1,0
3914,9,7,0,0,7,0
2856,10,2,0,0,2,0
2856,1,1,0,0,1,0
5725,9,3,0,0,3,0
163432,9,9,0,0,9,0
53376,9,3,0,0,3,0
85424,6,5,0,0,5,0
85424,5,1,0,0,1,0
85424,1,1,0,0,1,0
202494,9,3,0,0,3,0
202494,2,1,0,0,1,0
212382,10,2,0,0,2,0
212382,5,16,0,0,16,0
212382,3,1,0,0,1,0
212382,2,2,0,0,2,0
54745,2,1,0,0,1,0
54745,1,2,0,0,2,0
425,10,1,0,0,1,0
425,9,1,0,0,1,0
425,3,1,0,0,1,0
425,2,1,0,0,1,0
7994,3,3,0,0,3,0
7994,2,1,0,0,1,0
13513,9,1,0,0,1,0
13513,1,1,0,0,1,0
233960,4,5,0,0,5,0
233960,1,1,0,0,1,0
117707,10,2,0,0,2,0
117707,9,2,0,0,2,0
117707,3,4,0,0,4,0
117707,2,1,0,0,1,0
1898,10,1,0,0,1,0
4598,9,2,0,0,2,0
4598,7,18,0,0,18,0
4598,2,4,0,0,4,0
5755,2,1,0,0,1,0
20044,10,10,0,0,10,0
20044,1,4,0,0,4,0
220368,10,4,0,0,4,0
220368,1,1,0,0,1,0
147241,10,3,0,0,3,0
9161,2,2,0,0,2,0
153116,10,1,0,0,1,0
153116,1,2,0,0,2,0
171447,10,1,0,0,1,0
171447,9,1,0,0,1,0
171447,8,4,0,0,4,0
22472,2,1,0,0,1,0
5996,10,1,0,0,1,0
89927,10,1,0,0,1,0
89927,8,4,0,0,4,0
195455,10,2,0,0,2,0
195455,9,2,0,0,2,0
253786,10,10,0,0,10,0
253786,4,2,0,0,2,0
9476,9,6,0,0,6,0
9476,4,4,0,0,4,0
117987,9,1,0,0,1,0
117987,8,6,0,0,6,0
117987,1,1,0,0,1,0
206299,5,4,0,0,4,0
256297,5,5,0,0,5,0
256297,3,1,0,0,1,0
17807,10,1,0,0,1,0
17807,2,2,0,0,2,0
177843,2,2,0,0,2,0
72799,10,2,0,0,2,0
72799,4,4,0,0,4,0
72799,2,1,0,0,1,0
200280,5,5,0,0,5,0
200280,3,1,0,0,1,0
200280,1,2,0,0,2,0
150138,3,3,0,0,3,0
153839,9,1,0,0,1,0
153839,3,3,0,0,3,0
20018,1,1,0,0,1,0
31821,10,5,0,0,5,0
31821,3,1,0,0,1,0
5575,1,1,0,0,1,0
127648,10,1,0,0,1,0
127648,8,11,0,0,11,0
127648,4,12,0,0,12,0
127648,3,4,0,0,4,0
127648,2,4,0,0,4,0
129225,2,1,0,0,1,0
162292,3,1,0,0,1,0
203191,5,4,0,0,4,0
203191,4,1,0,0,1,0
203191,3,2,0,0,2,0
203191,1,2,0,0,2,0
13782,7,10,0,0,10,0
173504,6,4,0,0,4,0
173504,5,3,0,0,3,0
173504,1,1,0,0,1,0
19735,1,1,0,0,1,0
39219,10,1,0,0,1,0
39219,9,1,0,0,1,0
200512,10,7,0,0,7,0
200512,4,2,0,0,2,0
200512,3,2,0,0,2,0
200512,1,1,0,0,1,0
2988,9,1,0,0,1,0
2988,2,1,0,0,1,0
1244,10,1,0,0,1,0
252,9,7,0,0,7,0
252,3,1,0,0,1,0
92094,10,1,0,0,1,0
92094,9,3,0,0,3,0
92094,1,3,0,0,3,0
136058,7,16,0,0,16,0
136058,3,12,0,0,12,0
136058,1,1,0,0,1,0
20182,10,5,0,0,5,0
20182,1,1,0,0,1,0
153815,10,2,0,0,2,0
153815,3,2,0,0,2,0
153815,2,1,0,0,1,0
32990,1,1,0,0,1,0
210418,2,2,0,0,2,0
233194,4,2,0,0,2,0
233194,2,1,0,0,1,0
7755,4,4,0,0,4,0
7755,2,1,0,0,1,0
7755,1,1,0,0,1,0
145478,9,2,0,0,2,0
145478,4,4,0,0,4,0
145478,3,2,0,0,2,0
145478,2,2,0,0,2,0
18835,9,2,0,0,2,0
18835,2,1,0,0,1,0
127096,3,3,0,0,3,0
127096,2,3,0,0,3,0
135431,9,5,0,0,5,0
135431,7,18,0,0,18,0
135431,2,1,0,0,1,0
135431,1,3,0,0,3,0
68186,10,2,0,0,2,0
68186,9,1,0,0,1,0
68186,2,1,0,0,1,0
197588,4,4,0,0,4,0
197588,3,2,0,0,2,0
197588,1,2,0,0,2,0
29952,4,2,0,0,2,0
11573,8,13,0,0,13,0
11573,1,1,0,0,1,0
203967,9,5,0,0,5,0
13403,5,1,0,0,1,0
13403,4,1,0,0,1,0
226176,3,1,0,0,1,0
216014,10,1,0,0,1,0
216014,9,10,0,0,10,0
216014,7,18,0,0,18,0
216014,3,12,0,0,12,0
125608,10,2,0,0,2,0
125608,9,10,0,0,10,0
125608,3,3,0,0,3,0
1383,3,5,0,0,5,0
138963,4,2,0,0,2,0
138963,2,1,0,0,1,0
10676,1,1,0,0,1,0
4558,9,3,0,0,3,0
4558,1,1,0,0,1,0
375,1,1,0,0,1,0
181390,9,1,0,0,1,0
147721,10,1,0,0,1,0
147721,1,2,0,0,2,0
205819,5,4,0,0,4,0
33156,10,1,0,0,1,0
33156,2,1,0,0,1,0
166859,4,2,0,0,2,0
73655,2,1,0,0,1,0
2091,4,4,0,0,4,0
89767,10,7,0,0,7,0
89767,9,9,0,0,9,0
89767,2,1,0,0,1,0
89767,1,1,0,0,1,0
179918,10,4,0,0,4,0
179918,9,6,0,0,6,0
179918,2,1,0,0,1,0
246742,5,2,0,0,2,0
63052,9,4,0,0,4,0
63052,2,2,0,0,2,0
3941,10,1,0,0,1,0
76065,9,1,0,0,1,0
124356,10,2,0,0,2,0
124356,9,4,0,0,4,0
124356,5,9,0,0,9,0
124356,3,1,0,0,1,0
124356,2,1,0,0,1,0
10998,9,1,0,0,1,0
10998,2,2,0,0,2,0
813,8,4,0,0,4,0
7067,10,1,0,0,1,0
7067,9,2,0,0,2,0
7067,2,1,0,0,1,0
7067,1,1,0,0,1,0
167237,10,1,0,0,1,0
167237,9,1,0,0,1,0
167237,5,5,0,0,5,0
167237,4,6,0,0,6,0
224119,1,1,0,0,1,0
208663,4,9,0,0,9,0
208663,2,2,0,0,2,0
116593,10,2,0,0,2,0
116593,9,1,0,0,1,0
116593,8,6,0,0,6,0
58565,10,1,0,0,1,0
58565,8,9,0,0,9,0
58565,2,3,0,0,3,0
35306,9,1,0,0,1,0
35306,3,3,0,0,3,0
35306,2,1,0,0,1,0
35306,1,1,0,0,1,0
207010,5,2,0,0,2,0
207010,4,3,0,0,3,0
7955,10,3,0,0,3,0
7955,3,2,0,0,2,0
119856,9,2,0,0,2,0
158237,4,2,0,0,2,0
25687,10,1,0,0,1,0
20120,9,1,0,0,1,0
20120,2,1,0,0,1,0
98472,1,1,0,0,1,0
15435,1,1,0,0,1,0
221644,10,1,0,0,1,0
221644,9,2,0,0,2,0
207991,3,2,0,0,2,0
207991,2,1,0,0,1,0
4141,10,2,0,0,2,0
206,9,1,0,0,1,0
206,2,1,0,0,1,0
210008,5,5,0,0,5,0
210008,3,1,0,0,1,0
210008,1,1,0,0,1,0
4150,10,1,0,0,1,0
4150,9,1,0,0,1,0
4150,8,3,0,0,3,0
3344,8,1,0,0,1,0
28060,9,2,0,0,2,0
28060,2,1,0,0,1,0
28060,1,1,0,0,1,0
181331,9,5,0,0,5,0
252197,10,2,0,0,2,0
94373,1,1,0,0,1,0
197067,4,5,0,0,5,0
197067,3,5,0,0,5,0
197067,2,1,0,0,1,0
206450,4,7,0,0,7,0
206450,3,4,0,0,4,0
206450,1,2,0,0,2,0
192274,10,1,0,0,1,0
192274,9,6,0,0,6,0
192274,3,1,0,0,1,0
192274,2,1,0,0,1,0
192274,1,1,0,0,1,0
172310,9,2,0,0,2,0
172310,2,4,0,0,4,0
172310,1,1,0,0,1,0
40851,10,2,0,0,2,0
4172,10,4,0,0,4,0
4172,9,2,0,0,2,0
4172,3,2,0,0,2,0
39565,10,1,0,0,1,0
39565,9,3,0,0,3,0
39565,3,1,0,0,1,0
116860,10,4,0,0,4,0
116860,9,3,0,0,3,0
116860,7,31,0,0,31,0
116860,5,11,0,0,11,0
41757,10,3,0,0,3,0
41757,2,5,0,0,5,0
41757,1,1,0,0,1,0
57139,2,2,0,0,2,0
57139,1,1,0,0,1,0
23946,10,1,0,0,1,0
23946,9,1,0,0,1,0
23946,1,2,0,0,2,0
32431,2,2,0,0,2,0
32431,1,1,0,0,1,0
144150,4,2,0,0,2,0
144150,3,1,0,0,1,0
284,10,2,0,0,2,0
284,1,1,0,0,1,0
3889,10,2,0,0,2,0
180345,9,5,0,0,5,0
180345,5,12,0,0,12,0
5260,10,3,0,0,3,0
5260,9,3,0,0,3,0
5260,1,6,0,0,6,0
32171,5,4,0,0,4,0
32171,4,2,0,0,2,0
32171,3,2,0,0,2,0
32171,1,1,0,0,1,0
27959,10,1,0,0,1,0
3998,10,1,0,0,1,0
3998,2,2,0,0,2,0
41496,2,2,0,0,2,0
162476,9,5,0,0,5,0
162476,4,2,0,0,2,0
162476,3,2,0,0,2,0
8939,9,9,0,0,9,0
8939,4,4,0,0,4,0
8939,3,2,0,0,2,0
101988,9,2,0,0,2,0
13767,10,2,0,0,2,0
13767,3,3,0,0,3,0
224675,4,4,0,0,4,0
224675,2,2,0,0,2,0
224675,1,2,0,0,2,0
8308,10,1,0,0,1,0
227002,4,1,0,0,1,0
227002,1,2,0,0,2,0
148443,10,5,0,0,5,0
148443,3,1,0,0,1,0
148443,2,1,0,0,1,0
104498,2,1,0,0,1,0
104498,1,1,0,0,1,0
400,10,1,0,0,1,0
400,1,1,0,0,1,0
176960,10,2,0,0,2,0
176960,1,1,0,0,1,0
124647,9,1,0,0,1,0
34943,3,1,0,0,1,0
34943,2,1,0,0,1,0
34943,1,1,0,0,1,0
259038,1,1,0,0,1,0
21809,10,1,0,0,1,0
21809,9,1,0,0,1,0
21809,1,3,0,0,3,0
11432,5,9,0,0,9,0
11432,4,1,0,0,1,0
11432,3,2,0,0,2,0
34744,10,2,0,0,2,0
34744,9,1,0,0,1,0
171234,10,4,0,0,4,0
171234,5,10,0,0,10,0
171234,3,3,0,0,3,0
171234,2,1,0,0,1,0
229315,10,6,0,0,6,0
229315,5,8,0,0,8,0
229315,4,3,0,0,3,0
229315,3,2,0,0,2,0
241106,2,3,0,0,3,0
241106,1,1,0,0,1,0
15407,1,1,0,0,1,0
178896,5,2,0,0,2,0
178896,3,2,0,0,2,0
178896,1,1,0,0,1,0
1240,8,2,0,0,2,0
1240,2,1,0,0,1,0
5687,3,1,0,0,1,0
9577,10,1,0,0,1,0
9577,1,2,0,0,2,0
140179,2,2,0,0,2,0
145304,1,1,0,0,1,0
174402,5,1,0,0,1,0
174402,1,1,0,0,1,0
108679,2,1,0,0,1,0
108679,1,1,0,0,1,0
8553,2,1,0,0,1,0
166976,9,8,0,0,8,0
166976,3,1,0,0,1,0
201861,2,1,0,0,1,0
201861,1,1,0,0,1,0
182047,3,1,0,0,1,0
182047,2,1,0,0,1,0
23777,10,4,0,0,4,0
23777,9,1,0,0,1,0
23777,3,6,0,0,6,0
174805,4,1,0,0,1,0
29026,4,2,0,0,2,0
29026,2,1,0,0,1,0
176502,9,5,0,0,5,0
176502,1,1,0,0,1,0
25537,2,2,0,0,2,0
271518,5,1,0,0,1,0
271518,3,1,0,0,1,0
271518,2,1,0,0,1,0
2710,9,3,0,0,3,0
154982,10,1,0,0,1,0
154982,9,1,0,0,1,0
154982,3,3,0,0,3,0
264055,10,2,0,0,2,0
264055,9,5,0,0,5,0
264055,5,4,0,0,4,0
113567,10,6,0,0,6,0
113567,5,5,0,0,5,0
113567,3,1,0,0,1,0
35423,3,2,0,0,2,0
35423,2,1,0,0,1,0
234337,10,4,0,0,4,0
234337,4,4,0,0,4,0
234337,3,1,0,0,1,0
234337,2,1,0,0,1,0
5060,10,3,0,0,3,0
5060,2,1,0,0,1,0
34342,8,11,0,0,11,0
3965,2,1,0,0,1,0
170969,4,3,0,0,3,0
170969,3,1,0,0,1,0
2335,10,2,0,0,2,0
2335,2,1,0,0,1,0
204498,9,4,0,0,4,0
204498,4,4,0,0,4,0
204498,3,5,0,0,5,0
204498,1,4,0,0,4,0
227693,10,1,0,0,1,0
227693,3,1,0,0,1,0
2088,8,10,0,0,10,0
2088,4,3,0,0,3,0
2088,3,2,0,0,2,0
153870,5,7,0,0,7,0
153870,4,2,0,0,2,0
153870,2,1,0,0,1,0
28717,1,1,0,0,1,0
785,9,1,0,0,1,0
146548,6,31,0,0,31,0
146548,4,3,0,0,3,0
95364,9,4,0,0,4,0
9685,1,1,0,0,1,0
2096,10,1,0,0,1,0
86270,8,5,0,0,5,0
86270,1,1,0,0,1,0
192296,2,1,0,0,1,0
192296,1,1,0,0,1,0
92499,9,1,0,0,1,0
92499,3,2,0,0,2,0
92499,2,4,0,0,4,0
92499,1,2,0,0,2,0
4442,9,1,0,0,1,0
17623,10,1,0,0,1,0
17623,4,8,0,0,8,0
32680,10,1,0,0,1,0
32680,9,1,0,0,1,0
32680,8,5,0,0,5,0
413,9,2,0,0,2,0
413,1,2,0,0,2,0
2989,10,1,0,0,1,0
2989,9,3,0,0,3,0
2989,2,2,0,0,2,0
2989,1,1,0,0,1,0
186793,5,7,0,0,7,0
186793,2,1,0,0,1,0
186793,1,2,0,0,2,0
188225,5,3,0,0,3,0
188225,4,1,0,0,1,0
188225,1,1,0,0,1,0
13223,10,1,0,0,1,0
13223,4,3,0,0,3,0
168752,10,2,0,0,2,0
168752,3,2,0,0,2,0
168752,2,2,0,0,2,0
5646,9,2,0,0,2,0
5646,8,7,0,0,7,0
5646,1,1,0,0,1,0
19544,8,16,0,0,16,0
19544,2,2,0,0,2,0
19544,1,1,0,0,1,0
10915,9,1,0,0,1,0
10915,2,2,0,0,2,0
66896,9,8,0,0,8,0
1313,10,3,0,0,3,0
1313,5,2,0,0,2,0
1313,2,1,0,0,1,0
1313,1,1,0,0,1,0
177482,10,5,0,0,5,0
177482,2,1,0,0,1,0
177482,1,1,0,0,1,0
150539,9,2,0,0,2,0
150539,2,3,0,0,3,0
1686,10,1,0,0,1,0
1686,9,1,0,0,1,0
8173,9,4,0,0,4,0
3549,8,2,0,0,2,0
26080,8,7,0,0,7,0
147144,3,4,0,0,4,0
147144,2,1,0,0,1,0
258411,10,6,0,0,6,0
210101,4,1,0,0,1,0
210101,2,1,0,0,1,0
210101,1,1,0,0,1,0
128855,9,3,0,0,3,0
128855,1,1,0,0,1,0
28102,10,1,0,0,1,0
203462,10,3,0,0,3,0
203462,2,1,0,0,1,0
203462,1,1,0,0,1,0
227162,2,4,0,0,4,0
227162,1,1,0,0,1,0
98197,9,5,0,0,5,0
98197,5,17,0,0,17,0
98197,3,9,0,0,9,0
56690,10,2,0,0,2,0
56690,9,2,0,0,2,0
56690,8,20,0,0,20,0
56690,3,2,0,0,2,0
56690,2,1,0,0,1,0
11038,5,10,0,0,10,0
11038,4,3,0,0,3,0
11038,2,1,0,0,1,0
11038,1,3,0,0,3,0
31968,7,37,0,0,37,0
31968,4,5,0,0,5,0
31968,3,1,0,0,1,0
31968,2,1,0,0,1,0
13115,9,4,0,0,4,0
13115,8,10,0,0,10,0
176914,3,3,0,0,3,0
176914,2,2,0,0,2,0
176914,1,1,0,0,1,0
38062,9,9,0,0,9,0
38062,3,4,0,0,4,0
38062,2,1,0,0,1,0
67034,2,4,0,0,4,0
8066,5,4,0,0,4,0
8066,4,3,0,0,3,0
8066,3,1,0,0,1,0
8066,1,1,0,0,1,0
5465,10,1,0,0,1,0
6559,10,3,0,0,3,0
92497,10,3,0,0,3,0
92497,7,10,0,0,10,0
145609,5,9,0,0,9,0
145609,4,3,0,0,3,0
145609,2,2,0,0,2,0
106174,9,1,0,0,1,0
151369,10,3,0,0,3,0
148,10,1,0,0,1,0
41934,5,1,0,0,1,0
41934,1,2,0,0,2,0
20832,9,2,0,0,2,0
20832,2,4,0,0,4,0
150599,10,1,0,0,1,0
150599,2,1,0,0,1,0
33024,10,1,0,0,1,0
33024,8,11,0,0,11,0
33024,3,7,0,0,7,0
33024,2,3,0,0,3,0
33024,1,3,0,0,3,0
199881,5,5,0,0,5,0
199881,3,1,0,0,1,0
199881,2,1,0,0,1,0
193248,10,2,0,0,2,0
193248,2,2,0,0,2,0
193248,1,1,0,0,1,0
149621,10,1,0,0,1,0
149621,9,8,0,0,8,0
163047,3,1,0,0,1,0
163047,1,1,0,0,1,0
245214,10,4,0,0,4,0
31853,5,1,0,0,1,0
31853,1,1,0,0,1,0
225316,10,3,0,0,3,0
10320,10,2,0,0,2,0
66825,10,1,0,0,1,0
66825,9,1,0,0,1,0
41646,10,1,0,0,1,0
41646,9,2,0,0,2,0
41646,2,6,0,0,6,0
41646,1,1,0,0,1,0
175626,3,1,0,0,1,0
3403,1,1,0,0,1,0
10323,4,3,0,0,3,0
10323,3,3,0,0,3,0
1784,3,2,0,0,2,0
16149,10,1,0,0,1,0
16149,4,3,0,0,3,0
16149,3,2,0,0,2,0
16149,2,1,0,0,1,0
93879,2,1,0,0,1,0
6431,4,1,0,0,1,0
254123,6,8,0,0,8,0
1291,1,1,0,0,1,0
170477,1,1,0,0,1,0
28224,9,4,0,0,4,0
107463,10,3,0,0,3,0
107463,9,2,0,0,2,0
107463,2,3,0,0,3,0
15163,10,2,0,0,2,0
15163,9,1,0,0,1,0
171489,2,1,0,0,1,0
171489,1,3,0,0,3,0
138616,3,6,0,0,6,0
138616,1,1,0,0,1,0
37680,10,1,0,0,1,0
37680,1,1,0,0,1,0
158815,6,4,0,0,4,0
158815,1,1,0,0,1,0
84671,9,2,0,0,2,0
84671,2,3,0,0,3,0
166276,10,1,0,0,1,0
166276,9,3,0,0,3,0
166276,3,2,0,0,2,0
269144,5,6,0,0,6,0
269144,1,1,0,0,1,0
538,1,1,0,0,1,0
214125,5,7,0,0,7,0
214125,3,1,0,0,1,0
1066,9,4,0,0,4,0
1066,1,1,0,0,1,0
4084,1,1,0,0,1,0
30958,1,1,0,0,1,0
7453,5,3,0,0,3,0
7453,2,1,0,0,1,0
2742,4,3,0,0,3,0
249763,5,3,0,0,3,0
249763,4,5,0,0,5,0
249763,2,1,0,0,1,0
249763,1,1,0,0,1,0
19466,10,1,0,0,1,0
23827,3,1,0,0,1,0
23827,2,1,0,0,1,0
40958,3,1,0,0,1,0
40958,2,3,0,0,3,0
229742,9,3,0,0,3,0
104617,10,1,0,0,1,0
104617,1,1,0,0,1,0
29382,10,2,0,0,2,0
29382,9,3,0,0,3,0
76681,10,1,0,0,1,0
76681,9,3,0,0,3,0
76681,3,2,0,0,2,0
76681,2,2,0,0,2,0
1174,8,3,0,0,3,0
1174,1,2,0,0,2,0
157135,3,3,0,0,3,0
252985,3,1,0,0,1,0
252985,2,5,0,0,5,0
1450,2,3,0,0,3,0
5041,4,1,0,0,1,0
5041,3,1,0,0,1,0
5041,2,1,0,0,1,0
5041,1,1,0,0,1,0
1804,3,3,0,0,3,0
1804,2,1,0,0,1,0
40561,4,6,0,0,6,0
40561,3,1,0,0,1,0
169102,4,9,0,0,9,0
3485,10,1,0,0,1,0
3485,4,15,0,0,15,0
3485,3,5,0,0,5,0
171775,10,2,0,0,2,0
171775,9,3,0,0,3,0
189506,2,2,0,0,2,0
223619,4,5,0,0,5,0
223619,3,1,0,0,1,0
198971,3,4,0,0,4,0
198971,1,1,0,0,1,0
249411,6,14,0,0,14,0
17395,4,2,0,0,2,0
17395,3,1,0,0,1,0
236245,10,2,0,0,2,0
236245,3,3,0,0,3,0
152174,1,1,0,0,1,0
177538,10,2,0,0,2,0
177538,9,4,0,0,4,0
177538,1,1,0,0,1,0
166,9,3,0,0,3,0
144223,3,1,0,0,1,0
142265,2,1,0,0,1,0
11730,9,1,0,0,1,0
11730,2,1,0,0,1,0
906,2,2,0,0,2,0
122867,10,1,0,0,1,0
122867,2,4,0,0,4,0
33984,10,2,0,0,2,0
33984,9,1,0,0,1,0
33984,4,6,0,0,6,0
33984,2,3,0,0,3,0
5351,3,1,0,0,1,0
121414,10,1,0,0,1,0
37755,10,2,0,0,2,0
37755,9,1,0,0,1,0
5186,3,2,0,0,2,0
20646,2,1,0,0,1,0
180,1,1,0,0,1,0
7215,4,2,0,0,2,0
7215,2,1,0,0,1,0
14525,9,3,0,0,3,0
14525,3,3,0,0,3,0
51195,1,1,0,0,1,0
154742,4,3,0,0,3,0
154742,3,2,0,0,2,0
154742,1,1,0,0,1,0
27736,4,4,0,0,4,0
27736,3,2,0,0,2,0
18058,10,1,0,0,1,0
18058,3,1,0,0,1,0
18058,2,1,0,0,1,0
118247,10,1,0,0,1,0
118247,3,2,0,0,2,0
118247,1,1,0,0,1,0
15235,1,2,0,0,2,0
4842,10,2,0,0,2,0
4842,2,1,0,0,1,0
4842,1,2,0,0,2,0
8031,10,1,0,0,1,0
24927,9,3,0,0,3,0
24927,3,4,0,0,4,0
24927,2,1,0,0,1,0
127432,3,1,0,0,1,0
7634,4,1,0,0,1,0
7634,3,1,0,0,1,0
161849,10,2,0,0,2,0
128425,7,18,0,0,18,0
128425,5,5,0,0,5,0
128425,4,1,0,0,1,0
128425,3,4,0,0,4,0
128425,2,1,0,0,1,0
128425,1,2,0,0,2,0
201305,9,1,0,0,1,0
201305,2,1,0,0,1,0
256952,4,1,0,0,1,0
256952,1,1,0,0,1,0
43927,9,1,0,0,1,0
43927,1,2,0,0,2,0
169658,2,1,0,0,1,0
169658,1,1,0,0,1,0
248125,2,1,0,0,1,0
88871,5,5,0,0,5,0
195742,4,8,0,0,8,0
195742,1,1,0,0,1,0
199269,3,1,0,0,1,0
90568,1,2,0,0,2,0
13508,9,1,0,0,1,0
7922,10,1,0,0,1,0
7922,3,2,0,0,2,0
7922,1,1,0,0,1,0
2780,1,2,0,0,2,0
66251,10,2,0,0,2,0
66251,2,8,0,0,8,0
191067,10,1,0,0,1,0
191067,4,7,0,0,7,0
191067,3,1,0,0,1,0
191067,2,1,0,0,1,0
13682,8,5,0,0,5,0
13682,7,14,0,0,14,0
13682,3,8,0,0,8,0
13682,1,1,0,0,1,0
60029,2,1,0,0,1,0
7927,10,1,0,0,1,0
7927,8,2,0,0,2,0
7927,1,2,0,0,2,0
209567,4,3,0,0,3,0
3515,7,4,0,0,4,0
217619,3,3,0,0,3,0
156458,10,1,0,0,1,0
156458,9,4,0,0,4,0
2760,9,1,0,0,1,0
172559,2,1,0,0,1,0
231027,4,2,0,0,2,0
39020,10,1,0,0,1,0
39020,3,1,0,0,1,0
234221,4,2,0,0,2,0
234221,3,1,0,0,1,0
234221,2,1,0,0,1,0
218863,10,2,0,0,2,0
218863,9,4,0,0,4,0
218863,4,3,0,0,3,0
109657,10,1,0,0,1,0
8930,1,1,0,0,1,0
204576,10,5,0,0,5,0
204576,4,6,0,0,6,0
204576,3,3,0,0,3,0
240744,5,3,0,0,3,0
240744,3,1,0,0,1,0
240744,1,1,0,0,1,0
23025,2,1,0,0,1,0
216985,10,3,0,0,3,0
216985,9,1,0,0,1,0
216985,3,1,0,0,1,0
198412,8,30,0,0,30,0
198412,5,7,0,0,7,0
198412,4,4,0,0,4,0
198412,3,3,0,0,3,0
11437,4,1,0,0,1,0
11437,3,3,0,0,3,0
193417,3,1,0,0,1,0
193417,1,1,0,0,1,0
4219,9,1,0,0,1,0
4219,1,1,0,0,1,0
100473,9,5,0,0,5,0
209945,9,3,0,0,3,0
209945,8,9,0,0,9,0
25470,3,4,0,0,4,0
172543,10,1,0,0,1,0
172543,3,2,0,0,2,0
130685,10,1,0,0,1,0
130685,9,1,0,0,1,0
130685,8,9,0,0,9,0
130685,4,10,0,0,10,0
130685,3,2,0,0,2,0
130685,1,1,0,0,1,0
26211,10,1,0,0,1,0
9392,10,1,0,0,1,0
9392,9,1,0,0,1,0
9392,8,4,0,0,4,0
25004,10,2,0,0,2,0
5831,10,1,0,0,1,0
5831,5,18,0,0,18,0
5831,1,1,0,0,1,0
1908,9,2,0,0,2,0
1908,1,2,0,0,2,0
2356,10,2,0,0,2,0
2356,8,2,0,0,2,0
2356,7,7,0,0,7,0
184648,10,4,0,0,4,0
184648,1,1,0,0,1,0
75360,10,1,0,0,1,0
1721,3,2,0,0,2,0
7338,3,1,0,0,1,0
96765,2,1,0,0,1,0
96765,1,1,0,0,1,0
33785,4,1,0,0,1,0
4288,2,1,0,0,1,0
42195,9,4,0,0,4,0
39180,9,1,0,0,1,0
2717,9,1,0,0,1,0
2717,2,9,0,0,9,0
6718,1,2,0,0,2,0
138966,3,1,0,0,1,0
5554,2,1,0,0,1,0
40440,10,3,0,0,3,0
39415,10,1,0,0,1,0
39415,9,2,0,0,2,0
1953,3,2,0,0,2,0
1953,2,1,0,0,1,0
183626,10,1,0,0,1,0
206091,1,1,0,0,1,0
209222,3,4,0,0,4,0
4979,10,2,0,0,2,0
4979,3,4,0,0,4,0
59335,3,3,0,0,3,0
59335,2,4,0,0,4,0
59335,1,1,0,0,1,0
504,10,2,0,0,2,0
504,9,1,0,0,1,0
66213,10,1,0,0,1,0
66213,1,3,0,0,3,0
151456,10,5,0,0,5,0
151456,9,15,0,0,15,0
151456,5,6,0,0,6,0
151456,4,1,0,0,1,0
151456,3,1,0,0,1,0
159087,9,1,0,0,1,0
17962,10,1,0,0,1,0
17962,9,1,0,0,1,0
17962,2,3,0,0,3,0
13460,9,1,0,0,1,0
13460,8,4,0,0,4,0
68943,3,1,0,0,1,0
68943,1,1,0,0,1,0
4485,3,1,0,0,1,0
4485,2,1,0,0,1,0
35207,9,1,0,0,1,0
84173,10,1,0,0,1,0
84173,8,8,0,0,8,0
84173,2,4,0,0,4,0
2994,5,6,0,0,6,0
235817,7,22,0,0,22,0
235817,5,3,0,0,3,0
235817,3,1,0,0,1,0
9288,2,2,0,0,2,0
1414,1,1,0,0,1,0
92876,3,3,0,0,3,0
92876,2,2,0,0,2,0
92876,1,1,0,0,1,0
25768,9,8,0,0,8,0
25768,1,1,0,0,1,0
38390,9,2,0,0,2,0
38390,2,4,0,0,4,0
40238,10,2,0,0,2,0
40238,2,1,0,0,1,0
32995,3,1,0,0,1,0
32995,2,2,0,0,2,0
191790,3,1,0,0,1,0
147883,5,8,0,0,8,0
40182,10,3,0,0,3,0
40182,2,1,0,0,1,0
148424,10,3,0,0,3,0
148424,7,20,0,0,20,0
161620,6,16,0,0,16,0
161620,5,8,0,0,8,0
161620,3,2,0,0,2,0
22947,9,8,0,0,8,0
22947,2,1,0,0,1,0
205080,9,2,0,0,2,0
205080,8,12,0,0,12,0
205080,2,2,0,0,2,0
205080,1,1,0,0,1,0
17577,8,5,0,0,5,0
17577,3,3,0,0,3,0
25190,4,3,0,0,3,0
25190,2,1,0,0,1,0
2148,10,2,0,0,2,0
2148,9,1,0,0,1,0
2148,2,4,0,0,4,0
6215,1,1,0,0,1,0
13805,9,1,0,0,1,0
223481,3,2,0,0,2,0
266965,5,2,0,0,2,0
120886,10,2,0,0,2,0
120886,1,1,0,0,1,0
189925,10,1,0,0,1,0
189925,9,1,0,0,1,0
189925,4,3,0,0,3,0
189925,3,3,0,0,3,0
189925,2,1,0,0,1,0
2331,1,2,0,0,2,0
2758,2,1,0,0,1,0
198700,10,2,0,0,2,0
198700,4,4,0,0,4,0
198700,3,2,0,0,2,0
198700,2,2,0,0,2,0
14032,3,5,0,0,5,0
14032,2,1,0,0,1,0
66665,10,7,0,0,7,0
66665,2,1,0,0,1,0
3159,3,3,0,0,3,0
3159,2,1,0,0,1,0
46746,10,1,0,0,1,0
46746,8,3,0,0,3,0
46746,7,13,0,0,13,0
155250,9,4,0,0,4,0
155250,7,2,0,0,2,0
155250,4,1,0,0,1,0
95449,10,1,0,0,1,0
95449,9,2,0,0,2,0
95449,4,11,0,0,11,0
95449,2,2,0,0,2,0
565,9,1,0,0,1,0
479,2,1,0,0,1,0
198701,10,2,0,0,2,0
198701,9,6,0,0,6,0
198701,4,4,0,0,4,0
198701,3,2,0,0,2,0
198701,2,3,0,0,3,0
46743,10,2,0,0,2,0
46743,2,4,0,0,4,0
120814,1,1,0,0,1,0
18246,10,1,0,0,1,0
162071,10,3,0,0,3,0
162071,9,5,0,0,5,0
162071,3,8,0,0,8,0
138728,4,5,0,0,5,0
138728,3,3,0,0,3,0
5956,8,2,0,0,2,0
23959,10,1,0,0,1,0
23959,1,1,0,0,1,0
2121,10,2,0,0,2,0
5239,10,2,0,0,2,0
5239,2,1,0,0,1,0
5239,1,1,0,0,1,0
221805,3,10,0,0,10,0
221805,2,1,0,0,1,0
63788,3,8,0,0,8,0
63788,2,4,0,0,4,0
63788,1,2,0,0,2,0
244171,10,4,0,0,4,0
244171,4,3,0,0,3,0
244171,2,1,0,0,1,0
2174,10,4,0,0,4,0
2174,3,2,0,0,2,0
2174,2,2,0,0,2,0
254894,10,2,0,0,2,0
254894,3,2,0,0,2,0
954,8,1,0,0,1,0
32682,1,1,0,0,1,0
144310,1,2,0,0,2,0
2559,9,1,0,0,1,0
126404,3,1,0,0,1,0
42685,10,1,0,0,1,0
42685,1,1,0,0,1,0
34221,1,1,0,0,1,0
7960,9,2,0,0,2,0
7960,5,26,0,0,26,0
7960,1,1,0,0,1,0
3127,9,5,0,0,5,0
198003,7,23,0,0,23,0
198003,5,8,0,0,8,0
198003,1,1,0,0,1,0
58696,10,1,0,0,1,0
187785,4,4,0,0,4,0
3696,1,5,0,0,5,0
153723,3,5,0,0,5,0
153723,2,2,0,0,2,0
31586,4,8,0,0,8,0
31586,2,1,0,0,1,0
27817,4,1,0,0,1,0
27817,1,2,0,0,2,0
21631,9,1,0,0,1,0
21631,8,3,0,0,3,0
21631,2,4,0,0,4,0
8319,10,1,0,0,1,0
213491,9,2,0,0,2,0
213491,5,13,0,0,13,0
213491,2,1,0,0,1,0
2280,1,2,0,0,2,0
3568,1,1,0,0,1,0
27624,9,3,0,0,3,0
27624,2,3,0,0,3,0
242149,10,3,0,0,3,0
242149,3,1,0,0,1,0
242149,1,1,0,0,1,0
18880,9,1,0,0,1,0
18880,2,2,0,0,2,0
70653,10,3,0,0,3,0
70653,9,2,0,0,2,0
70653,2,4,0,0,4,0
70653,1,4,0,0,4,0
3271,10,2,0,0,2,0
3271,9,1,0,0,1,0
26114,10,1,0,0,1,0
4165,8,1,0,0,1,0
57141,1,1,0,0,1,0
193327,10,1,0,0,1,0
193327,4,2,0,0,2,0
193327,2,2,0,0,2,0
158861,9,5,0,0,5,0
158861,5,10,0,0,10,0
158861,3,1,0,0,1,0
158861,2,1,0,0,1,0
17397,10,2,0,0,2,0
17397,4,3,0,0,3,0
32333,9,4,0,0,4,0
32333,2,1,0,0,1,0
32333,1,1,0,0,1,0
231327,4,1,0,0,1,0
20253,10,2,0,0,2,0
20253,2,1,0,0,1,0
36229,1,1,0,0,1,0
33801,10,1,0,0,1,0
33801,9,3,0,0,3,0
33801,3,1,0,0,1,0
33801,1,1,0,0,1,0
196392,10,1,0,0,1,0
196392,9,2,0,0,2,0
7941,2,1,0,0,1,0
158236,10,3,0,0,3,0
158236,9,2,0,0,2,0
158236,3,8,0,0,8,0
158236,2,1,0,0,1,0
158236,1,1,0,0,1,0
161966,9,2,0,0,2,0
161966,3,1,0,0,1,0
59061,10,2,0,0,2,0
59061,9,1,0,0,1,0
59061,8,8,0,0,8,0
59061,3,5,0,0,5,0
2200,9,3,0,0,3,0
3664,10,1,0,0,1,0
3664,9,3,0,0,3,0
999,2,1,0,0,1,0
193238,5,1,0,0,1,0
193238,1,1,0,0,1,0
6926,3,1,0,0,1,0
8707,3,1,0,0,1,0
247984,10,1,0,0,1,0
247984,3,3,0,0,3,0
247984,1,1,0,0,1,0
217544,5,1,0,0,1,0
71837,9,1,0,0,1,0
71837,8,5,0,0,5,0
71837,3,9,0,0,9,0
71837,1,4,0,0,4,0
103638,8,4,0,0,4,0
103638,1,1,0,0,1,0
41763,10,3,0,0,3,0
32679,10,2,0,0,2,0
32679,9,1,0,0,1,0
32679,2,6,0,0,6,0
128098,10,1,0,0,1,0
128098,2,1,0,0,1,0
5589,9,3,0,0,3,0
5589,2,3,0,0,3,0
5589,1,2,0,0,2,0
20266,2,1,0,0,1,0
130008,10,2,0,0,2,0
198059,10,1,0,0,1,0
198059,8,1,0,0,1,0
198059,1,1,0,0,1,0
3958,10,1,0,0,1,0
3958,2,2,0,0,2,0
13314,10,1,0,0,1,0
13314,3,1,0,0,1,0
13314,1,1,0,0,1,0
19653,10,2,0,0,2,0
19653,4,11,0,0,11,0
19653,2,1,0,0,1,0
162480,3,3,0,0,3,0
120781,9,2,0,0,2,0
120781,7,15,0,0,15,0
2974,10,1,0,0,1,0
175742,9,1,0,0,1,0
175742,2,1,0,0,1,0
175742,1,1,0,0,1,0
18765,10,1,0,0,1,0
18765,8,9,0,0,9,0
18765,3,1,0,0,1,0
19373,8,4,0,0,4,0
188465,10,2,0,0,2,0
23499,8,2,0,0,2,0
177823,6,6,0,0,6,0
177823,5,4,0,0,4,0
177823,4,1,0,0,1,0
25972,9,4,0,0,4,0
25972,2,2,0,0,2,0
193122,2,2,0,0,2,0
193122,1,3,0,0,3,0
256804,8,29,0,0,29,0
256804,3,1,0,0,1,0
2226,10,1,0,0,1,0
2226,4,2,0,0,2,0
174990,3,4,0,0,4,0
187488,1,1,0,0,1,0
146094,10,1,0,0,1,0
146094,2,3,0,0,3,0
230746,10,2,0,0,2,0
230746,4,3,0,0,3,0
230746,1,1,0,0,1,0
201307,4,5,0,0,5,0
20848,10,1,0,0,1,0
20848,9,1,0,0,1,0
20848,3,1,0,0,1,0
102881,4,1,0,0,1,0
102881,3,1,0,0,1,0
102881,2,1,0,0,1,0
246900,7,3,0,0,3,0
246900,6,4,0,0,4,0
246900,5,3,0,0,3,0
246900,4,2,0,0,2,0
85338,9,1,0,0,1,0
85338,3,2,0,0,2,0
85338,2,1,0,0,1,0
1998,10,2,0,0,2,0
1998,7,15,0,0,15,0
1998,4,14,0,0,14,0
183,4,5,0,0,5,0
183,3,1,0,0,1,0
149328,9,2,0,0,2,0
18891,9,1,0,0,1,0
27960,10,1,0,0,1,0
27960,9,1,0,0,1,0
60815,4,2,0,0,2,0
60815,2,1,0,0,1,0
60815,1,1,0,0,1,0
8331,9,2,0,0,2,0
42968,8,3,0,0,3,0
184663,10,4,0,0,4,0
184663,3,2,0,0,2,0
3247,10,1,0,0,1,0
3499,1,1,0,0,1,0
216710,5,1,0,0,1,0
216710,3,1,0,0,1,0
133713,10,2,0,0,2,0
133713,9,2,0,0,2,0
133713,2,2,0,0,2,0
85567,5,5,0,0,5,0
85567,3,3,0,0,3,0
85567,2,1,0,0,1,0
85567,1,1,0,0,1,0
155411,4,1,0,0,1,0
155411,3,1,0,0,1,0
62230,5,1,0,0,1,0
62230,1,1,0,0,1,0
72242,9,1,0,0,1,0
72242,2,1,0,0,1,0
15139,4,11,0,0,11,0
15139,2,2,0,0,2,0
15139,1,1,0,0,1,0
469,3,3,0,0,3,0
469,2,1,0,0,1,0
206943,9,3,0,0,3,0
206943,4,3,0,0,3,0
206943,3,2,0,0,2,0
206943,2,1,0,0,1,0
206943,1,3,0,0,3,0
191065,10,2,0,0,2,0
191065,9,3,0,0,3,0
191065,4,4,0,0,4,0
191065,2,1,0,0,1,0
109105,8,2,0,0,2,0
109105,2,2,0,0,2,0
109105,1,1,0,0,1,0
129971,10,1,0,0,1,0
129971,4,7,0,0,7,0
129971,3,3,0,0,3,0
129971,2,1,0,0,1,0
80934,10,4,0,0,4,0
80934,9,1,0,0,1,0
80934,1,1,0,0,1,0
933,10,1,0,0,1,0
933,4,6,0,0,6,0
41243,10,5,0,0,5,0
41243,1,1,0,0,1,0
6861,3,1,0,0,1,0
175739,10,1,0,0,1,0
175739,9,3,0,0,3,0
175739,3,4,0,0,4,0
3560,10,1,0,0,1,0
3560,4,7,0,0,7,0
477,9,5,0,0,5,0
165748,4,4,0,0,4,0
3677,2,3,0,0,3,0
3677,1,2,0,0,2,0
184145,5,9,0,0,9,0
184145,4,1,0,0,1,0
184145,1,3,0,0,3,0
130723,9,2,0,0,2,0
130723,2,1,0,0,1,0
144574,6,2,0,0,2,0
4909,10,2,0,0,2,0
4909,9,1,0,0,1,0
4909,2,1,0,0,1,0
2383,9,2,0,0,2,0
230266,10,2,0,0,2,0
230266,3,2,0,0,2,0
230266,2,2,0,0,2,0
3189,9,1,0,0,1,0
25749,9,1,0,0,1,0
25749,8,10,0,0,10,0
39345,10,4,0,0,4,0
228553,4,2,0,0,2,0
118330,10,1,0,0,1,0
118330,1,1,0,0,1,0
223201,10,1,0,0,1,0
223201,3,2,0,0,2,0
223201,2,1,0,0,1,0
3057,1,1,0,0,1,0
184267,6,4,0,0,4,0
184267,2,1,0,0,1,0
184267,1,3,0,0,3,0
55842,10,1,0,0,1,0
55842,9,4,0,0,4,0
24118,10,3,0,0,3,0
24118,9,3,0,0,3,0
24118,3,2,0,0,2,0
24118,2,1,0,0,1,0
214899,10,3,0,0,3,0
214899,8,3,0,0,3,0
214899,2,9,0,0,9,0
214899,1,1,0,0,1,0
151645,10,4,0,0,4,0
151645,2,2,0,0,2,0
5784,1,2,0,0,2,0
7821,2,3,0,0,3,0
19623,10,3,0,0,3,0
19623,1,1,0,0,1,0
119639,9,2,0,0,2,0
119639,2,1,0,0,1,0
119639,1,1,0,0,1,0
4359,10,1,0,0,1,0
5155,8,6,0,0,6,0
5155,3,1,0,0,1,0
9516,1,2,0,0,2,0
149169,4,1,0,0,1,0
149169,3,2,0,0,2,0
149169,2,1,0,0,1,0
3715,9,2,0,0,2,0
3576,10,4,0,0,4,0
3576,9,2,0,0,2,0
2668,10,1,0,0,1,0
2668,1,1,0,0,1,0
3531,3,1,0,0,1,0
3531,1,1,0,0,1,0
38923,3,1,0,0,1,0
193062,2,3,0,0,3,0
224751,10,3,0,0,3,0
175209,2,4,0,0,4,0
36611,9,2,0,0,2,0
36611,8,3,0,0,3,0
36611,1,5,0,0,5,0
67123,4,1,0,0,1,0
67123,1,1,0,0,1,0
236143,9,5,0,0,5,0
236143,4,5,0,0,5,0
236143,2,2,0,0,2,0
1672,9,1,0,0,1,0
7502,2,2,0,0,2,0
7502,1,1,0,0,1,0
114863,9,2,0,0,2,0
8101,10,4,0,0,4,0
8101,9,3,0,0,3,0
5591,8,1,0,0,1,0
137500,10,4,0,0,4,0
137500,5,3,0,0,3,0
126340,10,1,0,0,1,0
585,3,1,0,0,1,0
43041,10,1,0,0,1,0
43041,9,5,0,0,5,0
130763,3,3,0,0,3,0
130763,2,1,0,0,1,0
129280,3,2,0,0,2,0
7493,1,1,0,0,1,0
84834,10,3,0,0,3,0
84834,4,1,0,0,1,0
144579,3,9,0,0,9,0
144579,1,1,0,0,1,0
217176,5,7,0,0,7,0
217176,3,1,0,0,1,0
1028,9,1,0,0,1,0
1028,3,1,0,0,1,0
31057,10,2,0,0,2,0
31057,3,5,0,0,5,0
31057,2,4,0,0,4,0
31057,1,2,0,0,2,0
140468,9,3,0,0,3,0
140468,1,1,0,0,1,0
2502,8,1,0,0,1,0
2502,7,1,0,0,1,0
2502,6,3,0,0,3,0
249106,10,2,0,0,2,0
249106,3,1,0,0,1,0
73365,10,3,0,0,3,0
73365,2,1,0,0,1,0
73365,1,1,0,0,1,0
519,9,1,0,0,1,0
76546,9,2,0,0,2,0
76546,7,16,0,0,16,0
165633,10,5,0,0,5,0
165633,3,3,0,0,3,0
256159,5,6,0,0,6,0
256159,3,1,0,0,1,0
256159,1,1,0,0,1,0
169459,9,3,0,0,3,0
169459,8,6,0,0,6,0
169459,1,1,0,0,1,0
255034,10,6,0,0,6,0
255034,4,4,0,0,4,0
255034,3,3,0,0,3,0
255034,2,1,0,0,1,0
254193,10,6,0,0,6,0
254193,3,3,0,0,3,0
254193,1,1,0,0,1,0
129492,10,2,0,0,2,0
129492,5,11,0,0,11,0
129492,3,1,0,0,1,0
1207,10,1,0,0,1,0
1207,9,1,0,0,1,0
14452,10,2,0,0,2,0
14452,3,1,0,0,1,0
14452,2,1,0,0,1,0
14452,1,1,0,0,1,0
219509,1,1,0,0,1,0
159405,2,2,0,0,2,0
42731,1,1,0,0,1,0
182541,10,6,0,0,6,0
182541,9,1,0,0,1,0
182541,5,13,0,0,13,0
192116,1,6,0,0,6,0
209641,4,2,0,0,2,0
209641,3,1,0,0,1,0
209641,1,1,0,0,1,0
113312,10,4,0,0,4,0
113312,9,1,0,0,1,0
113312,1,1,0,0,1,0
7218,2,1,0,0,1,0
462,9,1,0,0,1,0
462,3,5,0,0,5,0
462,2,2,0,0,2,0
177927,10,10,0,0,10,0
177927,9,6,0,0,6,0
177927,3,4,0,0,4,0
177927,1,1,0,0,1,0
193695,4,12,0,0,12,0
2916,9,1,0,0,1,0
131060,10,3,0,0,3,0
131060,5,12,0,0,12,0
8329,1,1,0,0,1,0
244191,10,1,0,0,1,0
244191,3,6,0,0,6,0
255674,10,2,0,0,2,0
255674,9,7,0,0,7,0
18401,5,1,0,0,1,0
18401,4,1,0,0,1,0
3626,2,3,0,0,3,0
3626,1,1,0,0,1,0
176596,1,1,0,0,1,0
24845,10,1,0,0,1,0
24845,3,2,0,0,2,0
226089,10,3,0,0,3,0
226089,4,1,0,0,1,0
226089,3,1,0,0,1,0
226089,1,1,0,0,1,0
4516,9,1,0,0,1,0
4516,4,14,0,0,14,0
62922,1,1,0,0,1,0
2641,4,3,0,0,3,0
13503,10,1,0,0,1,0
7774,2,1,0,0,1,0
4799,10,1,0,0,1,0
4799,9,1,0,0,1,0
4799,2,2,0,0,2,0
20829,10,1,0,0,1,0
4914,10,1,0,0,1,0
4914,3,1,0,0,1,0
2566,10,1,0,0,1,0
2566,9,1,0,0,1,0
2566,1,1,0,0,1,0
2000,8,1,0,0,1,0
163119,1,1,0,0,1,0
232481,4,4,0,0,4,0
232481,3,1,0,0,1,0
2809,9,2,0,0,2,0
2809,3,1,0,0,1,0
2809,1,1,0,0,1,0
1622,1,1,0,0,1,0
209542,9,2,0,0,2,0
209542,3,6,0,0,6,0
209542,2,2,0,0,2,0
175177,10,1,0,0,1,0
175177,9,3,0,0,3,0
34173,10,4,0,0,4,0
34173,9,1,0,0,1,0
34173,8,5,0,0,5,0
200729,2,1,0,0,1,0
159375,9,4,0,0,4,0
159375,2,1,0,0,1,0
140682,10,2,0,0,2,0
140682,5,12,0,0,12,0
140682,2,1,0,0,1,0
255658,9,3,0,0,3,0
255658,1,1,0,0,1,0
181382,10,1,0,0,1,0
171419,3,2,0,0,2,0
171419,2,1,0,0,1,0
5183,10,1,0,0,1,0
5183,9,2,0,0,2,0
5183,3,4,0,0,4,0
5183,2,1,0,0,1,0
2645,10,2,0,0,2,0
2645,2,2,0,0,2,0
26458,4,1,0,0,1,0
26458,3,1,0,0,1,0
3053,3,2,0,0,2,0
230265,4,1,0,0,1,0
12544,10,3,0,0,3,0
12544,1,2,0,0,2,0
17536,6,4,0,0,4,0
17536,4,1,0,0,1,0
244082,9,1,0,0,1,0
244082,1,1,0,0,1,0
113931,5,4,0,0,4,0
113931,4,1,0,0,1,0
1504,3,5,0,0,5,0
1504,2,1,0,0,1,0
1504,1,1,0,0,1,0
5826,5,11,0,0,11,0
234292,1,1,0,0,1,0
214296,6,3,0,0,3,0
214296,4,1,0,0,1,0
13016,5,2,0,0,2,0
246761,10,1,0,0,1,0
246761,9,7,0,0,7,0
246761,5,2,0,0,2,0
246761,4,3,0,0,3,0
246761,3,1,0,0,1,0
25617,3,3,0,0,3,0
38328,2,6,0,0,6,0
1749,8,4,0,0,4,0
3162,3,1,0,0,1,0
6731,9,1,0,0,1,0
181955,10,1,0,0,1,0
181955,9,2,0,0,2,0
181955,4,5,0,0,5,0
181955,1,1,0,0,1,0
12134,2,1,0,0,1,0
12134,1,3,0,0,3,0
6916,9,3,0,0,3,0
6916,4,5,0,0,5,0
6916,3,1,0,0,1,0
6916,1,1,0,0,1,0
31336,3,1,0,0,1,0
31336,1,1,0,0,1,0
1437,8,2,0,0,2,0
11037,10,1,0,0,1,0
83199,8,9,0,0,9,0
83199,3,4,0,0,4,0
83199,2,1,0,0,1,0
8755,10,1,0,0,1,0
8755,9,3,0,0,3,0
148209,3,4,0,0,4,0
148209,1,1,0,0,1,0
8598,10,3,0,0,3,0
8598,9,1,0,0,1,0
8598,8,3,0,0,3,0
6928,10,6,0,0,6,0
6928,1,1,0,0,1,0
57458,10,1,0,0,1,0
57458,9,1,0,0,1,0
57458,2,2,0,0,2,0
212450,4,2,0,0,2,0
212450,1,3,0,0,3,0
8009,8,2,0,0,2,0
8009,1,2,0,0,2,0
3152,10,3,0,0,3,0
3152,1,2,0,0,2,0
181244,10,1,0,0,1,0
181244,9,1,0,0,1,0
148375,2,4,0,0,4,0
3476,10,1,0,0,1,0
3476,9,3,0,0,3,0
3476,2,4,0,0,4,0
3476,1,1,0,0,1,0
173337,10,2,0,0,2,0
173337,4,3,0,0,3,0
173337,3,1,0,0,1,0
12317,9,2,0,0,2,0
12317,2,2,0,0,2,0
180208,10,1,0,0,1,0
180208,9,1,0,0,1,0
207951,4,1,0,0,1,0
207951,2,1,0,0,1,0
207951,1,1,0,0,1,0
7138,4,1,0,0,1,0
171278,6,4,0,0,4,0
171278,1,1,0,0,1,0
5715,10,1,0,0,1,0
5715,1,1,0,0,1,0
1727,2,1,0,0,1,0
64610,1,4,0,0,4,0
3670,9,1,0,0,1,0
83278,9,2,0,0,2,0
83278,2,1,0,0,1,0
83278,1,1,0,0,1,0
6742,10,3,0,0,3,0
164147,2,2,0,0,2,0
164147,1,1,0,0,1,0
126728,2,4,0,0,4,0
39029,10,1,0,0,1,0
39029,9,1,0,0,1,0
39029,3,3,0,0,3,0
39029,2,2,0,0,2,0
39029,1,1,0,0,1,0
180211,2,2,0,0,2,0
178166,10,6,0,0,6,0
178166,4,5,0,0,5,0
178166,3,1,0,0,1,0
178166,1,1,0,0,1,0
152867,3,10,0,0,10,0
6046,2,1,0,0,1,0
185378,4,2,0,0,2,0
185378,1,1,0,0,1,0
1503,9,1,0,0,1,0
4107,2,2,0,0,2,0
253379,10,2,0,0,2,0
253379,1,1,0,0,1,0
4770,1,2,0,0,2,0
170756,4,2,0,0,2,0
77361,10,2,0,0,2,0
77361,5,9,0,0,9,0
77361,3,3,0,0,3,0
77361,2,1,0,0,1,0
232509,5,8,0,0,8,0
232509,3,4,0,0,4,0
94571,1,2,0,0,2,0
20907,1,1,0,0,1,0
7861,10,1,0,0,1,0
31335,10,1,0,0,1,0
31335,9,3,0,0,3,0
35865,3,1,0,0,1,0
15069,10,2,0,0,2,0
15069,9,3,0,0,3,0
245931,5,3,0,0,3,0
245931,4,2,0,0,2,0
245931,3,1,0,0,1,0
20499,9,3,0,0,3,0
2841,8,1,0,0,1,0
161782,9,4,0,0,4,0
161782,3,4,0,0,4,0
235544,10,8,0,0,8,0
235544,4,1,0,0,1,0
235544,3,1,0,0,1,0
235544,1,1,0,0,1,0
230273,10,6,0,0,6,0
4696,9,1,0,0,1,0
4696,8,1,0,0,1,0
146496,10,2,0,0,2,0
146496,9,3,0,0,3,0
146496,8,9,0,0,9,0
146496,3,4,0,0,4,0
146496,1,3,0,0,3,0
16538,4,1,0,0,1,0
16538,3,1,0,0,1,0
29118,10,1,0,0,1,0
136609,7,8,0,0,8,0
136609,1,1,0,0,1,0
5650,7,4,0,0,4,0
257164,10,4,0,0,4,0
257164,9,10,0,0,10,0
257164,3,1,0,0,1,0
117549,4,11,0,0,11,0
3357,10,1,0,0,1,0
3357,9,1,0,0,1,0
3357,2,2,0,0,2,0
29383,4,2,0,0,2,0
40853,7,13,0,0,13,0
40853,2,4,0,0,4,0
40853,1,2,0,0,2,0
2854,10,1,0,0,1,0
2854,9,1,0,0,1,0
2854,3,2,0,0,2,0
22085,10,1,0,0,1,0
22085,1,3,0,0,3,0
103883,3,2,0,0,2,0
103883,2,1,0,0,1,0
4242,10,1,0,0,1,0
4242,1,1,0,0,1,0
1390,3,5,0,0,5,0
1390,2,1,0,0,1,0
1390,1,1,0,0,1,0
2095,10,1,0,0,1,0
13436,3,2,0,0,2,0
91010,5,2,0,0,2,0
91010,4,1,0,0,1,0
11396,9,1,0,0,1,0
11396,8,10,0,0,10,0
11396,2,1,0,0,1,0
169436,10,2,0,0,2,0
169436,9,1,0,0,1,0
169436,4,6,0,0,6,0
228425,4,5,0,0,5,0
228425,2,2,0,0,2,0
191110,10,3,0,0,3,0
191110,9,4,0,0,4,0
191110,1,2,0,0,2,0
66695,9,2,0,0,2,0
66695,2,1,0,0,1,0
66695,1,1,0,0,1,0
5991,4,2,0,0,2,0
752,10,1,0,0,1,0
260298,3,4,0,0,4,0
260298,2,2,0,0,2,0
260298,1,1,0,0,1,0
202564,9,8,0,0,8,0
202564,5,7,0,0,7,0
202564,4,3,0,0,3,0
202564,3,1,0,0,1,0
202564,1,1,0,0,1,0
244320,3,2,0,0,2,0
42131,1,4,0,0,4,0
6516,10,4,0,0,4,0
6516,6,24,0,0,24,0
6516,4,4,0,0,4,0
6516,1,2,0,0,2,0
471,10,1,0,0,1,0
471,9,2,0,0,2,0
471,7,16,0,0,16,0
471,1,1,0,0,1,0
147445,5,15,0,0,15,0
147445,2,7,0,0,7,0
247724,10,8,0,0,8,0
247724,4,1,0,0,1,0
28004,10,2,0,0,2,0
3324,10,1,0,0,1,0
12071,4,3,0,0,3,0
12071,1,2,0,0,2,0
177877,4,1,0,0,1,0
177877,2,1,0,0,1,0
180906,10,6,0,0,6,0
180906,2,1,0,0,1,0
173452,10,1,0,0,1,0
173452,4,3,0,0,3,0
173452,3,2,0,0,2,0
4613,4,1,0,0,1,0
4613,2,1,0,0,1,0
4613,1,1,0,0,1,0
132532,1,2,0,0,2,0
4126,10,1,0,0,1,0
171548,4,11,0,0,11,0
141102,9,1,0,0,1,0
141102,3,1,0,0,1,0
141102,2,7,0,0,7,0
141102,1,1,0,0,1,0
30505,10,1,0,0,1,0
30505,3,1,0,0,1,0
30505,2,1,0,0,1,0
144587,2,1,0,0,1,0
95756,10,1,0,0,1,0
95756,4,8,0,0,8,0
95756,3,1,0,0,1,0
95756,2,2,0,0,2,0
6037,10,1,0,0,1,0
165521,4,3,0,0,3,0
102275,2,1,0,0,1,0
102275,1,1,0,0,1,0
46147,10,1,0,0,1,0
46147,2,2,0,0,2,0
7638,10,5,0,0,5,0
7638,9,2,0,0,2,0
7638,3,1,0,0,1,0
7106,9,1,0,0,1,0
7106,8,17,0,0,17,0
6918,1,1,0,0,1,0
297,8,4,0,0,4,0
297,1,1,0,0,1,0
136415,9,1,0,0,1,0
1322,2,4,0,0,4,0
2836,2,2,0,0,2,0
525,9,1,0,0,1,0
525,3,1,0,0,1,0
159507,10,1,0,0,1,0
159507,7,16,0,0,16,0
159507,1,3,0,0,3,0
35662,3,1,0,0,1,0
35662,1,1,0,0,1,0
187121,5,7,0,0,7,0
167283,3,1,0,0,1,0
10946,10,1,0,0,1,0
10946,3,2,0,0,2,0
26778,10,1,0,0,1,0
26778,9,1,0,0,1,0
26778,8,5,0,0,5,0
26778,2,5,0,0,5,0
3100,9,1,0,0,1,0
108012,9,2,0,0,2,0
108012,5,10,0,0,10,0
108012,3,2,0,0,2,0
108012,2,4,0,0,4,0
131457,10,2,0,0,2,0
131457,9,4,0,0,4,0
131457,3,2,0,0,2,0
69316,1,1,0,0,1,0
238090,10,4,0,0,4,0
238090,3,1,0,0,1,0
9049,10,3,0,0,3,0
9049,9,2,0,0,2,0
3147,9,1,0,0,1,0
3147,2,1,0,0,1,0
234105,10,1,0,0,1,0
234105,9,2,0,0,2,0
234105,2,1,0,0,1,0
13995,9,7,0,0,7,0
13512,5,9,0,0,9,0
13512,3,2,0,0,2,0
14137,10,1,0,0,1,0
4362,4,2,0,0,2,0
207911,8,11,0,0,11,0
207911,3,3,0,0,3,0
234093,4,4,0,0,4,0
2824,2,2,0,0,2,0
4794,10,3,0,0,3,0
9803,10,3,0,0,3,0
9803,9,2,0,0,2,0
9803,3,1,0,0,1,0
4289,2,1,0,0,1,0
93472,10,1,0,0,1,0
93472,9,1,0,0,1,0
93472,8,6,0,0,6,0
93472,3,7,0,0,7,0
2105,5,9,0,0,9,0
145381,10,1,0,0,1,0
145381,9,6,0,0,6,0
145381,5,10,0,0,10,0
145381,2,3,0,0,3,0
5827,10,6,0,0,6,0
5827,3,1,0,0,1,0
378,2,1,0,0,1,0
212027,9,1,0,0,1,0
93733,5,12,0,0,12,0
93733,1,2,0,0,2,0
16067,3,1,0,0,1,0
235511,10,1,0,0,1,0
235511,7,31,0,0,31,0
235511,4,4,0,0,4,0
235511,3,5,0,0,5,0
1267,2,2,0,0,2,0
178154,4,2,0,0,2,0
178154,1,2,0,0,2,0
6513,4,8,0,0,8,0
6513,2,2,0,0,2,0
6513,1,1,0,0,1,0
194964,5,6,0,0,6,0
194964,2,1,0,0,1,0
194964,1,2,0,0,2,0
264239,10,1,0,0,1,0
264239,9,6,0,0,6,0
264239,2,1,0,0,1,0
25772,9,1,0,0,1,0
6503,10,4,0,0,4,0
2707,9,1,0,0,1,0
2707,1,2,0,0,2,0
28121,10,1,0,0,1,0
4477,2,1,0,0,1,0
148586,2,1,0,0,1,0
148586,1,1,0,0,1,0
221977,5,2,0,0,2,0
5839,10,3,0,0,3,0
5839,2,4,0,0,4,0
40602,9,2,0,0,2,0
4110,8,5,0,0,5,0
6045,2,1,0,0,1,0
178515,10,3,0,0,3,0
178515,5,7,0,0,7,0
178515,1,1,0,0,1,0
232800,3,9,0,0,9,0
232800,1,2,0,0,2,0
221368,10,9,0,0,9,0
221368,5,1,0,0,1,0
180938,4,2,0,0,2,0
180938,3,4,0,0,4,0
18781,4,1,0,0,1,0
18781,3,1,0,0,1,0
185381,6,6,0,0,6,0
185381,4,1,0,0,1,0
185381,1,1,0,0,1,0
41783,9,1,0,0,1,0
41783,8,5,0,0,5,0
41783,3,1,0,0,1,0
41783,2,5,0,0,5,0
180459,10,1,0,0,1,0
180459,7,17,0,0,17,0
180459,5,20,0,0,20,0
180459,1,1,0,0,1,0
2531,2,1,0,0,1,0
2531,1,1,0,0,1,0
200351,1,1,0,0,1,0
143509,10,1,0,0,1,0
143509,3,4,0,0,4,0
143509,2,2,0,0,2,0
396,4,4,0,0,4,0
151367,2,6,0,0,6,0
2364,9,1,0,0,1,0
2364,2,4,0,0,4,0
214123,10,1,0,0,1,0
214123,3,1,0,0,1,0
21572,10,1,0,0,1,0
10829,10,1,0,0,1,0
234700,10,1,0,0,1,0
234700,9,6,0,0,6,0
139769,9,2,0,0,2,0
23387,4,4,0,0,4,0
23387,3,2,0,0,2,0
166298,3,4,0,0,4,0
204734,4,2,0,0,2,0
204734,2,1,0,0,1,0
9090,1,1,0,0,1,0
188908,4,2,0,0,2,0
257077,10,3,0,0,3,0
257077,5,3,0,0,3,0
257077,4,1,0,0,1,0
257077,1,1,0,0,1,0
6495,4,1,0,0,1,0
6495,2,1,0,0,1,0
6495,1,2,0,0,2,0
19392,1,2,0,0,2,0
40961,9,1,0,0,1,0
40961,3,2,0,0,2,0
40961,2,2,0,0,2,0
40961,1,1,0,0,1,0
13520,5,7,0,0,7,0
247143,10,1,0,0,1,0
247143,9,5,0,0,5,0
247143,2,1,0,0,1,0
34376,9,1,0,0,1,0
119109,2,1,0,0,1,0
5788,7,2,0,0,2,0
31926,10,1,0,0,1,0
31926,2,1,0,0,1,0
5264,10,2,0,0,2,0
5264,3,1,0,0,1,0
5264,2,1,0,0,1,0
65581,10,1,0,0,1,0
65581,8,7,0,0,7,0
65581,2,1,0,0,1,0
191077,10,2,0,0,2,0
191077,8,5,0,0,5,0
191077,7,17,0,0,17,0
191077,5,19,0,0,19,0
191077,4,14,0,0,14,0
191077,3,10,0,0,10,0
191077,2,5,0,0,5,0
170909,3,1,0,0,1,0
170909,1,1,0,0,1,0
227110,4,1,0,0,1,0
227110,3,1,0,0,1,0
227110,1,1,0,0,1,0
128662,10,2,0,0,2,0
128662,9,5,0,0,5,0
128662,2,1,0,0,1,0
178754,5,6,0,0,6,0
178754,4,4,0,0,4,0
178754,1,1,0,0,1,0
109077,3,4,0,0,4,0
109077,2,2,0,0,2,0
109077,1,1,0,0,1,0
130556,2,1,0,0,1,0
10999,8,1,0,0,1,0
10999,1,2,0,0,2,0
13254,3,1,0,0,1,0
5423,10,1,0,0,1,0
5423,9,1,0,0,1,0
5423,1,3,0,0,3,0
175121,10,6,0,0,6,0
175121,2,2,0,0,2,0
180256,10,3,0,0,3,0
180256,4,3,0,0,3,0
180256,3,1,0,0,1,0
180256,1,1,0,0,1,0
55706,10,3,0,0,3,0
54221,4,1,0,0,1,0
54221,1,1,0,0,1,0
144506,10,3,0,0,3,0
144506,9,5,0,0,5,0
144506,4,4,0,0,4,0
144506,3,1,0,0,1,0
208670,7,28,0,0,28,0
208670,4,1,0,0,1,0
73228,9,1,0,0,1,0
73228,8,10,0,0,10,0
73228,1,4,0,0,4,0
202589,2,4,0,0,4,0
153509,8,8,0,0,8,0
153509,3,9,0,0,9,0
153509,2,2,0,0,2,0
19811,10,1,0,0,1,0
19811,9,1,0,0,1,0
19811,1,2,0,0,2,0
155700,10,1,0,0,1,0
155700,5,12,0,0,12,0
112692,10,2,0,0,2,0
112692,8,4,0,0,4,0
112692,1,1,0,0,1,0
3194,9,1,0,0,1,0
5107,3,5,0,0,5,0
5107,1,1,0,0,1,0
2092,10,1,0,0,1,0
2092,2,1,0,0,1,0
7710,3,9,0,0,9,0
1517,1,1,0,0,1,0
9084,9,1,0,0,1,0
9084,3,3,0,0,3,0
9084,2,3,0,0,3,0
20801,10,4,0,0,4,0
20801,8,5,0,0,5,0
20801,7,3,0,0,3,0
20801,2,5,0,0,5,0
116978,10,3,0,0,3,0
116978,2,1,0,0,1,0
232437,10,1,0,0,1,0
232437,8,9,0,0,9,0
232437,3,4,0,0,4,0
19990,8,1,0,0,1,0
22268,8,4,0,0,4,0
3815,9,1,0,0,1,0
3815,2,2,0,0,2,0
1598,2,2,0,0,2,0
165041,10,2,0,0,2,0
165041,4,6,0,0,6,0
235360,10,3,0,0,3,0
235360,2,1,0,0,1,0
235360,1,1,0,0,1,0
41837,10,3,0,0,3,0
41837,5,3,0,0,3,0
41837,3,1,0,0,1,0
41837,1,1,0,0,1,0
144,2,1,0,0,1,0
3925,2,1,0,0,1,0
3925,1,2,0,0,2,0
114784,3,2,0,0,2,0
183405,5,9,0,0,9,0
2334,2,2,0,0,2,0
99698,4,1,0,0,1,0
11330,2,1,0,0,1,0
11330,1,1,0,0,1,0
1317,3,1,0,0,1,0
188325,1,2,0,0,2,0
43023,10,2,0,0,2,0
43023,4,6,0,0,6,0
198775,5,7,0,0,7,0
198775,1,1,0,0,1,0
43245,10,4,0,0,4,0
43245,1,2,0,0,2,0
205766,10,2,0,0,2,0
205766,9,5,0,0,5,0
205766,5,10,0,0,10,0
205766,4,1,0,0,1,0
2902,4,3,0,0,3,0
7771,10,6,0,0,6,0
144290,1,1,0,0,1,0
35311,10,1,0,0,1,0
35311,2,1,0,0,1,0
35311,1,1,0,0,1,0
196105,4,4,0,0,4,0
196105,3,1,0,0,1,0
163481,1,1,0,0,1,0
62143,10,3,0,0,3,0
142551,2,1,0,0,1,0
1960,9,1,0,0,1,0
32992,1,1,0,0,1,0
146922,5,1,0,0,1,0
146922,1,1,0,0,1,0
7662,4,2,0,0,2,0
7662,3,1,0,0,1,0
1757,4,1,0,0,1,0
1757,3,2,0,0,2,0
247106,4,2,0,0,2,0
247106,3,1,0,0,1,0
39084,9,1,0,0,1,0
3657,9,1,0,0,1,0
3657,3,3,0,0,3,0
7470,10,1,0,0,1,0
7470,9,1,0,0,1,0
7470,8,13,0,0,13,0
7470,4,6,0,0,6,0
89575,9,5,0,0,5,0
89575,3,3,0,0,3,0
163097,5,1,0,0,1,0
163097,1,1,0,0,1,0
111379,3,1,0,0,1,0
111299,10,1,0,0,1,0
111299,1,3,0,0,3,0
768,10,2,0,0,2,0
768,9,2,0,0,2,0
9227,10,2,0,0,2,0
9227,8,1,0,0,1,0
769,3,1,0,0,1,0
769,1,1,0,0,1,0
82572,3,3,0,0,3,0
20906,2,1,0,0,1,0
20906,1,1,0,0,1,0
41898,2,1,0,0,1,0
235982,4,2,0,0,2,0
235982,1,2,0,0,2,0
34958,10,1,0,0,1,0
34958,8,3,0,0,3,0
34958,2,4,0,0,4,0
164917,10,2,0,0,2,0
164917,3,1,0,0,1,0
164917,1,1,0,0,1,0
89222,10,1,0,0,1,0
89222,9,1,0,0,1,0
204577,3,3,0,0,3,0
204577,2,1,0,0,1,0
204887,10,1,0,0,1,0
204887,8,1,0,0,1,0
204887,7,3,0,0,3,0
204887,6,13,0,0,13,0
202204,10,2,0,0,2,0
202204,4,3,0,0,3,0
202204,1,1,0,0,1,0
34277,8,3,0,0,3,0
34277,3,2,0,0,2,0
34277,2,3,0,0,3,0
34277,1,1,0,0,1,0
131530,10,2,0,0,2,0
131530,9,1,0,0,1,0
131530,3,2,0,0,2,0
131530,1,1,0,0,1,0
161290,5,10,0,0,10,0
247314,10,4,0,0,4,0
247314,9,6,0,0,6,0
247314,1,1,0,0,1,0
70767,4,4,0,0,4,0
142653,10,1,0,0,1,0
142653,9,1,0,0,1,0
142653,3,3,0,0,3,0
142653,2,3,0,0,3,0
142653,1,1,0,0,1,0
235902,9,8,0,0,8,0
235902,5,5,0,0,5,0
185380,6,6,0,0,6,0
185380,4,1,0,0,1,0
185380,1,1,0,0,1,0
2496,8,2,0,0,2,0
2496,7,6,0,0,6,0
103937,2,1,0,0,1,0
107829,10,1,0,0,1,0
107829,9,1,0,0,1,0
107829,8,6,0,0,6,0
177160,3,1,0,0,1,0
155258,10,1,0,0,1,0
155258,9,4,0,0,4,0
155258,3,1,0,0,1,0
15274,4,1,0,0,1,0
15274,2,1,0,0,1,0
147145,9,4,0,0,4,0
147145,5,13,0,0,13,0
147145,3,6,0,0,6,0
147145,2,4,0,0,4,0
147145,1,1,0,0,1,0
4983,9,1,0,0,1,0
4983,2,1,0,0,1,0
196217,2,1,0,0,1,0
1140,9,1,0,0,1,0
1377,9,1,0,0,1,0
111387,10,4,0,0,4,0
7637,4,2,0,0,2,0
7637,3,1,0,0,1,0
8702,10,4,0,0,4,0
8702,1,1,0,0,1,0
70532,5,2,0,0,2,0
70532,1,1,0,0,1,0
18041,8,2,0,0,2,0
5308,2,2,0,0,2,0
213648,5,1,0,0,1,0
175867,9,1,0,0,1,0
175867,8,15,0,0,15,0
18085,10,2,0,0,2,0
18085,9,3,0,0,3,0
18085,4,1,0,0,1,0
18085,3,1,0,0,1,0
60574,3,2,0,0,2,0
60574,2,3,0,0,3,0
43393,3,1,0,0,1,0
93522,9,2,0,0,2,0
93522,8,2,0,0,2,0
185331,10,1,0,0,1,0
185331,9,1,0,0,1,0
185331,7,18,0,0,18,0
185331,3,6,0,0,6,0
185331,2,3,0,0,3,0
185331,1,1,0,0,1,0
269199,10,4,0,0,4,0
269199,9,4,0,0,4,0
269199,5,2,0,0,2,0
195275,9,5,0,0,5,0
38038,4,6,0,0,6,0
38038,2,1,0,0,1,0
184383,9,3,0,0,3,0
184383,8,2,0,0,2,0
184383,2,2,0,0,2,0
184383,1,1,0,0,1,0
653,10,1,0,0,1,0
653,9,1,0,0,1,0
30485,10,1,0,0,1,0
7259,10,2,0,0,2,0
7259,9,1,0,0,1,0
7259,8,6,0,0,6,0
28817,9,1,0,0,1,0
28817,2,1,0,0,1,0
127048,9,1,0,0,1,0
127048,1,1,0,0,1,0
29415,10,1,0,0,1,0
29415,9,3,0,0,3,0
29415,3,2,0,0,2,0
154642,9,2,0,0,2,0
154642,3,4,0,0,4,0
151972,10,1,0,0,1,0
151972,5,17,0,0,17,0
151972,2,1,0,0,1,0
151972,1,1,0,0,1,0
179723,10,1,0,0,1,0
179723,9,3,0,0,3,0
179723,2,1,0,0,1,0
179723,1,1,0,0,1,0
31274,10,1,0,0,1,0
31274,9,1,0,0,1,0
31274,3,2,0,0,2,0
31274,2,3,0,0,3,0
2002,9,1,0,0,1,0
230064,5,2,0,0,2,0
230064,4,6,0,0,6,0
132320,10,1,0,0,1,0
132320,9,2,0,0,2,0
132320,8,7,0,0,7,0
29599,9,2,0,0,2,0
165046,10,1,0,0,1,0
165046,4,3,0,0,3,0
165046,3,2,0,0,2,0
6610,10,1,0,0,1,0
6610,1,1,0,0,1,0
255708,2,1,0,0,1,0
1902,9,1,0,0,1,0
194228,10,2,0,0,2,0
56246,1,3,0,0,3,0
168544,10,1,0,0,1,0
168544,5,13,0,0,13,0
168544,3,4,0,0,4,0
900,8,4,0,0,4,0
900,1,1,0,0,1,0
19991,4,14,0,0,14,0
2699,5,10,0,0,10,0
171475,10,2,0,0,2,0
171475,9,3,0,0,3,0
171475,3,1,0,0,1,0
11195,2,1,0,0,1,0
18615,1,1,0,0,1,0
192346,10,4,0,0,4,0
192346,9,4,0,0,4,0
192346,7,31,0,0,31,0
192346,3,2,0,0,2,0
231032,10,1,0,0,1,0
231032,9,1,0,0,1,0
231032,3,1,0,0,1,0
231032,2,1,0,0,1,0
4202,10,1,0,0,1,0
246146,4,5,0,0,5,0
246146,3,1,0,0,1,0
246146,2,1,0,0,1,0
8037,10,1,0,0,1,0
8037,4,4,0,0,4,0
163399,5,2,0,0,2,0
163399,1,1,0,0,1,0
163482,7,12,0,0,12,0
4215,10,1,0,0,1,0
164236,5,8,0,0,8,0
164236,3,2,0,0,2,0
164236,1,1,0,0,1,0
152902,9,2,0,0,2,0
232403,5,4,0,0,4,0
232403,4,3,0,0,3,0
232403,2,1,0,0,1,0
198985,7,2,0,0,2,0
198985,1,3,0,0,3,0
35546,2,2,0,0,2,0
43231,1,3,0,0,3,0
21123,10,3,0,0,3,0
21123,9,2,0,0,2,0
21123,8,1,0,0,1,0
21123,7,5,0,0,5,0
142903,10,1,0,0,1,0
142903,9,1,0,0,1,0
164259,1,1,0,0,1,0
226592,3,2,0,0,2,0
143255,10,1,0,0,1,0
143255,4,3,0,0,3,0
143255,3,1,0,0,1,0
143255,1,1,0,0,1,0
3590,2,1,0,0,1,0
244144,5,10,0,0,10,0
6873,9,1,0,0,1,0
6873,8,3,0,0,3,0
6873,2,4,0,0,4,0
3766,6,13,0,0,13,0
252877,5,1,0,0,1,0
252877,4,1,0,0,1,0
2203,9,1,0,0,1,0
178212,3,1,0,0,1,0
178212,1,2,0,0,2,0
2510,3,2,0,0,2,0
2510,2,2,0,0,2,0
2510,1,1,0,0,1,0
18791,1,3,0,0,3,0
138016,9,2,0,0,2,0
138016,8,4,0,0,4,0
138016,3,3,0,0,3,0
138016,1,1,0,0,1,0
152172,4,1,0,0,1,0
267568,10,4,0,0,4,0
267568,4,3,0,0,3,0
42493,9,1,0,0,1,0
145209,10,1,0,0,1,0
96672,9,1,0,0,1,0
131183,1,1,0,0,1,0
159011,4,2,0,0,2,0
1530,2,1,0,0,1,0
33359,10,2,0,0,2,0
33359,3,1,0,0,1,0
1987,10,1,0,0,1,0
1987,9,1,0,0,1,0
6399,10,2,0,0,2,0
6399,9,2,0,0,2,0
6399,3,2,0,0,2,0
109296,10,3,0,0,3,0
109296,8,5,0,0,5,0
109296,3,1,0,0,1,0
109296,2,1,0,0,1,0
109296,1,1,0,0,1,0
10234,3,3,0,0,3,0
158886,5,3,0,0,3,0
158886,3,1,0,0,1,0
158886,1,1,0,0,1,0
94123,9,2,0,0,2,0
94123,7,21,0,0,21,0
94123,3,1,0,0,1,0
31767,8,10,0,0,10,0
31767,4,9,0,0,9,0
31767,2,2,0,0,2,0
42396,5,4,0,0,4,0
42396,4,2,0,0,2,0
42396,1,1,0,0,1,0
17687,3,8,0,0,8,0
17687,1,2,0,0,2,0
17924,10,3,0,0,3,0
17924,9,1,0,0,1,0
17924,4,1,0,0,1,0
17924,3,1,0,0,1,0
17924,2,1,0,0,1,0
248763,9,6,0,0,6,0
248763,2,1,0,0,1,0
252402,10,2,0,0,2,0
252402,5,3,0,0,3,0
6474,9,2,0,0,2,0
22378,10,2,0,0,2,0
22378,4,3,0,0,3,0
22378,1,1,0,0,1,0
2098,10,1,0,0,1,0
60126,3,1,0,0,1,0
9238,10,4,0,0,4,0
9238,9,3,0,0,3,0
9238,3,3,0,0,3,0
9238,2,1,0,0,1,0
1133,9,3,0,0,3,0
5166,10,1,0,0,1,0
5166,9,1,0,0,1,0
5166,8,6,0,0,6,0
157838,10,4,0,0,4,0
157838,9,1,0,0,1,0
157838,1,1,0,0,1,0
22254,10,1,0,0,1,0
22254,9,3,0,0,3,0
22254,2,1,0,0,1,0
5990,10,1,0,0,1,0
192352,10,3,0,0,3,0
192352,2,3,0,0,3,0
192352,1,1,0,0,1,0
42057,10,3,0,0,3,0
42057,3,1,0,0,1,0
10679,5,2,0,0,2,0
5394,3,1,0,0,1,0
7410,9,1,0,0,1,0
226312,3,1,0,0,1,0
2518,1,1,0,0,1,0
129348,6,8,0,0,8,0
129348,2,1,0,0,1,0
40258,1,1,0,0,1,0
204892,2,1,0,0,1,0
5522,10,1,0,0,1,0
5522,9,2,0,0,2,0
5522,3,4,0,0,4,0
5522,2,1,0,0,1,0
143416,3,2,0,0,2,0
143416,1,1,0,0,1,0
257073,9,3,0,0,3,0
257073,1,1,0,0,1,0
741,5,7,0,0,7,0
741,4,2,0,0,2,0
741,3,1,0,0,1,0
21219,2,2,0,0,2,0
21219,1,1,0,0,1,0
35294,10,1,0,0,1,0
35294,3,7,0,0,7,0
130600,1,2,0,0,2,0
4915,10,3,0,0,3,0
4915,2,1,0,0,1,0
177921,1,1,0,0,1,0
172164,3,1,0,0,1,0
5640,9,1,0,0,1,0
5640,8,3,0,0,3,0
5640,3,5,0,0,5,0
70597,10,3,0,0,3,0
70597,9,3,0,0,3,0
70597,2,1,0,0,1,0
70597,1,1,0,0,1,0
1087,9,3,0,0,3,0
243964,9,1,0,0,1,0
243964,3,3,0,0,3,0
243964,1,1,0,0,1,0
159437,9,5,0,0,5,0
159437,6,29,0,0,29,0
159437,4,14,0,0,14,0
159437,2,6,0,0,6,0
159437,1,1,0,0,1,0
5129,10,2,0,0,2,0
5129,8,2,0,0,2,0
5129,7,3,0,0,3,0
197909,1,3,0,0,3,0
166210,4,3,0,0,3,0
166210,1,1,0,0,1,0
24999,2,1,0,0,1,0
34014,9,1,0,0,1,0
58713,2,1,0,0,1,0
58713,1,1,0,0,1,0
269725,3,1,0,0,1,0
146034,9,2,0,0,2,0
112102,9,4,0,0,4,0
112102,4,6,0,0,6,0
112102,3,6,0,0,6,0
112102,2,2,0,0,2,0
226009,9,9,0,0,9,0
226009,5,4,0,0,4,0
226009,3,2,0,0,2,0
226009,2,1,0,0,1,0
1397,9,1,0,0,1,0
177248,1,1,0,0,1,0
214224,9,1,0,0,1,0
214224,8,7,0,0,7,0
178099,4,2,0,0,2,0
178099,3,2,0,0,2,0
178099,2,1,0,0,1,0
178099,1,1,0,0,1,0
174013,10,4,0,0,4,0
174013,3,1,0,0,1,0
220672,2,1,0,0,1,0
7993,9,1,0,0,1,0
7993,3,1,0,0,1,0
2910,7,1,0,0,1,0
2910,5,6,0,0,6,0
223096,9,4,0,0,4,0
139627,10,2,0,0,2,0
139627,8,8,0,0,8,0
139627,4,9,0,0,9,0
139627,3,4,0,0,4,0
84088,10,3,0,0,3,0
84088,5,7,0,0,7,0
84088,4,1,0,0,1,0
84088,3,1,0,0,1,0
23576,1,1,0,0,1,0
8626,2,4,0,0,4,0
160413,10,1,0,0,1,0
1991,9,1,0,0,1,0
647,2,1,0,0,1,0
122868,9,1,0,0,1,0
122868,3,5,0,0,5,0
121995,3,5,0,0,5,0
265683,4,3,0,0,3,0
21729,10,1,0,0,1,0
164930,10,1,0,0,1,0
4436,3,1,0,0,1,0
4436,2,1,0,0,1,0
4021,10,1,0,0,1,0
4021,2,1,0,0,1,0
2406,8,4,0,0,4,0
182801,9,1,0,0,1,0
182801,5,9,0,0,9,0
182801,3,2,0,0,2,0
182801,2,2,0,0,2,0
182801,1,1,0,0,1,0
57201,4,2,0,0,2,0
57201,3,1,0,0,1,0
57201,1,1,0,0,1,0
204141,10,5,0,0,5,0
204141,9,2,0,0,2,0
204141,3,4,0,0,4,0
204141,1,1,0,0,1,0
27626,10,1,0,0,1,0
27626,4,9,0,0,9,0
27626,3,1,0,0,1,0
27626,1,1,0,0,1,0
171779,10,5,0,0,5,0
171779,9,7,0,0,7,0
171779,2,1,0,0,1,0
5590,3,3,0,0,3,0
119472,9,1,0,0,1,0
119472,2,3,0,0,3,0
1247,10,1,0,0,1,0
1247,1,1,0,0,1,0
59576,4,3,0,0,3,0
59576,3,3,0,0,3,0
59576,2,1,0,0,1,0
245446,10,1,0,0,1,0
245446,2,2,0,0,2,0
245446,1,1,0,0,1,0
4918,10,1,0,0,1,0
4918,2,2,0,0,2,0
36554,3,2,0,0,2,0
36554,2,1,0,0,1,0
3360,3,3,0,0,3,0
3360,2,2,0,0,2,0
217890,10,1,0,0,1,0
217890,9,3,0,0,3,0
217890,2,2,0,0,2,0
217890,1,1,0,0,1,0
2986,10,2,0,0,2,0
2986,1,1,0,0,1,0
218200,10,3,0,0,3,0
218200,3,1,0,0,1,0
254017,4,1,0,0,1,0
254017,3,1,0,0,1,0
254017,1,1,0,0,1,0
29653,7,1,0,0,1,0
5242,1,1,0,0,1,0
118950,10,3,0,0,3,0
118950,3,2,0,0,2,0
118950,2,1,0,0,1,0
14191,7,7,0,0,7,0
160436,5,8,0,0,8,0
246855,6,11,0,0,11,0
246855,4,2,0,0,2,0
86406,4,3,0,0,3,0
86406,1,1,0,0,1,0
14361,10,1,0,0,1,0
14361,8,7,0,0,7,0
14361,2,7,0,0,7,0
217447,10,1,0,0,1,0
217447,9,2,0,0,2,0
6251,2,1,0,0,1,0
19616,8,5,0,0,5,0
19616,2,5,0,0,5,0
19616,1,2,0,0,2,0
153113,5,4,0,0,4,0
153113,1,1,0,0,1,0
221369,10,5,0,0,5,0
3513,10,1,0,0,1,0
194505,9,2,0,0,2,0
194505,3,5,0,0,5,0
20138,3,1,0,0,1,0
17965,8,4,0,0,4,0
4646,10,1,0,0,1,0
4646,9,1,0,0,1,0
5768,10,2,0,0,2,0
5768,4,1,0,0,1,0
205346,3,3,0,0,3,0
10579,3,1,0,0,1,0
4413,5,13,0,0,13,0
3028,1,1,0,0,1,0
157779,4,3,0,0,3,0
206715,9,10,0,0,10,0
212370,1,1,0,0,1,0
88931,2,1,0,0,1,0
1972,8,1,0,0,1,0
224319,1,1,0,0,1,0
2284,3,1,0,0,1,0
2284,2,2,0,0,2,0
35674,10,1,0,0,1,0
35674,2,1,0,0,1,0
33964,9,2,0,0,2,0
33964,3,4,0,0,4,0
33964,2,2,0,0,2,0
33964,1,1,0,0,1,0
556,8,4,0,0,4,0
556,2,2,0,0,2,0
556,1,1,0,0,1,0
24207,5,9,0,0,9,0
24207,4,8,0,0,8,0
24207,3,1,0,0,1,0
24207,2,1,0,0,1,0
10831,10,1,0,0,1,0
13164,1,1,0,0,1,0
14010,10,1,0,0,1,0
14010,9,4,0,0,4,0
56685,10,4,0,0,4,0
173648,9,4,0,0,4,0
173648,4,1,0,0,1,0
144631,10,1,0,0,1,0
144631,9,3,0,0,3,0
239845,4,3,0,0,3,0
239845,3,1,0,0,1,0
25567,9,1,0,0,1,0
25567,3,9,0,0,9,0
151684,9,4,0,0,4,0
216694,5,7,0,0,7,0
216694,4,2,0,0,2,0
55222,10,1,0,0,1,0
55222,9,2,0,0,2,0
55222,3,2,0,0,2,0
14781,4,4,0,0,4,0
27291,9,1,0,0,1,0
246567,9,16,0,0,16,0
246567,5,1,0,0,1,0
246567,4,3,0,0,3,0
2503,10,1,0,0,1,0
2503,3,7,0,0,7,0
2503,2,2,0,0,2,0
5502,7,13,0,0,13,0
5502,2,5,0,0,5,0
5502,1,1,0,0,1,0
113656,9,2,0,0,2,0
113656,4,3,0,0,3,0
113656,3,3,0,0,3,0
1620,4,4,0,0,4,0
8843,10,3,0,0,3,0
32157,8,4,0,0,4,0
32157,1,2,0,0,2,0
7501,10,5,0,0,5,0
7501,4,3,0,0,3,0
7501,2,1,0,0,1,0
7501,1,1,0,0,1,0
5662,8,1,0,0,1,0
177513,10,2,0,0,2,0
177513,5,4,0,0,4,0
177513,4,7,0,0,7,0
230898,9,4,0,0,4,0
230898,4,1,0,0,1,0
230898,3,1,0,0,1,0
230898,1,1,0,0,1,0
8727,1,1,0,0,1,0
16873,1,1,0,0,1,0
7958,10,2,0,0,2,0
7958,3,9,0,0,9,0
2110,10,1,0,0,1,0
2110,9,1,0,0,1,0
2110,8,1,0,0,1,0
2110,2,2,0,0,2,0
2110,1,1,0,0,1,0
32236,7,7,0,0,7,0
32236,3,20,0,0,20,0
32236,2,14,0,0,14,0
3273,9,3,0,0,3,0
383,9,3,0,0,3,0
383,4,3,0,0,3,0
121076,9,1,0,0,1,0
121076,4,2,0,0,2,0
121076,3,2,0,0,2,0
60158,5,16,0,0,16,0
60158,4,9,0,0,9,0
60158,3,1,0,0,1,0
60158,2,1,0,0,1,0
164590,9,4,0,0,4,0
90919,8,9,0,0,9,0
90919,2,4,0,0,4,0
716,10,3,0,0,3,0
134524,4,1,0,0,1,0
134524,3,1,0,0,1,0
134524,1,1,0,0,1,0
4445,1,1,0,0,1,0
242227,4,2,0,0,2,0
161109,10,2,0,0,2,0
161109,5,7,0,0,7,0
191374,10,3,0,0,3,0
191374,9,4,0,0,4,0
191374,3,2,0,0,2,0
182681,9,4,0,0,4,0
182681,5,9,0,0,9,0
182681,4,5,0,0,5,0
182681,2,1,0,0,1,0
255675,8,24,0,0,24,0
255675,3,1,0,0,1,0
255675,1,1,0,0,1,0
505,3,8,0,0,8,0
10043,8,1,0,0,1,0
10043,7,3,0,0,3,0
10043,1,1,0,0,1,0
206904,3,3,0,0,3,0
206904,1,1,0,0,1,0
15268,10,1,0,0,1,0
15268,9,1,0,0,1,0
208428,1,1,0,0,1,0
118177,3,4,0,0,4,0
89972,4,5,0,0,5,0
176286,5,7,0,0,7,0
176286,1,1,0,0,1,0
62214,5,2,0,0,2,0
62214,3,1,0,0,1,0
8909,9,4,0,0,4,0
231302,2,3,0,0,3,0
231302,1,1,0,0,1,0
137968,9,3,0,0,3,0
137968,2,1,0,0,1,0
137968,1,1,0,0,1,0
116596,8,2,0,0,2,0
40004,2,1,0,0,1,0
40004,1,1,0,0,1,0
17895,10,3,0,0,3,0
94002,2,2,0,0,2,0
199530,8,12,0,0,12,0
199530,3,4,0,0,4,0
199530,2,1,0,0,1,0
199530,1,1,0,0,1,0
10687,2,3,0,0,3,0
10687,1,1,0,0,1,0
219217,5,2,0,0,2,0
230751,5,3,0,0,3,0
230751,4,1,0,0,1,0
21249,9,1,0,0,1,0
26138,5,3,0,0,3,0
26138,2,1,0,0,1,0
1006,2,3,0,0,3,0
144790,2,2,0,0,2,0
1654,10,2,0,0,2,0
1654,9,1,0,0,1,0
1654,8,5,0,0,5,0
1654,2,1,0,0,1,0
31936,9,1,0,0,1,0
163771,4,2,0,0,2,0
181616,10,1,0,0,1,0
181616,9,2,0,0,2,0
5248,9,1,0,0,1,0
38337,10,2,0,0,2,0
38337,8,4,0,0,4,0
38337,1,2,0,0,2,0
220878,5,11,0,0,11,0
20590,10,3,0,0,3,0
172932,9,2,0,0,2,0
3305,10,1,0,0,1,0
3305,9,4,0,0,4,0
234834,4,9,0,0,9,0
234834,2,2,0,0,2,0
234834,1,1,0,0,1,0
127028,8,7,0,0,7,0
127028,3,2,0,0,2,0
7838,10,4,0,0,4,0
7838,5,9,0,0,9,0
7838,2,5,0,0,5,0
7860,10,2,0,0,2,0
7860,8,4,0,0,4,0
7860,1,3,0,0,3,0
41860,2,3,0,0,3,0
17971,5,4,0,0,4,0
15431,10,1,0,0,1,0
15431,9,1,0,0,1,0
15431,4,8,0,0,8,0
15431,2,4,0,0,4,0
15431,1,1,0,0,1,0
211047,9,4,0,0,4,0
211047,8,3,0,0,3,0
211047,3,3,0,0,3,0
211047,1,2,0,0,2,0
3636,8,3,0,0,3,0
204003,1,1,0,0,1,0
381,9,1,0,0,1,0
16110,10,1,0,0,1,0
1559,2,2,0,0,2,0
17863,5,1,0,0,1,0
17863,1,1,0,0,1,0
158968,3,3,0,0,3,0
158968,2,4,0,0,4,0
131321,4,4,0,0,4,0
66986,2,1,0,0,1,0
66986,1,1,0,0,1,0
21677,10,2,0,0,2,0
21677,9,1,0,0,1,0
2775,4,3,0,0,3,0
64955,9,1,0,0,1,0
64955,4,7,0,0,7,0
219670,4,6,0,0,6,0
3482,9,1,0,0,1,0
136238,10,3,0,0,3,0
136238,3,3,0,0,3,0
1082,10,1,0,0,1,0
1082,3,2,0,0,2,0
1082,1,1,0,0,1,0
7943,10,1,0,0,1,0
7943,9,2,0,0,2,0
7943,4,5,0,0,5,0
211175,10,1,0,0,1,0
211175,3,5,0,0,5,0
10186,3,1,0,0,1,0
28905,10,2,0,0,2,0
28905,7,10,0,0,10,0
28905,2,7,0,0,7,0
123587,9,2,0,0,2,0
123587,8,2,0,0,2,0
123587,2,1,0,0,1,0
176887,2,1,0,0,1,0
176887,1,1,0,0,1,0
169513,10,4,0,0,4,0
169513,1,1,0,0,1,0
33962,1,2,0,0,2,0
4292,4,2,0,0,2,0
167892,1,1,0,0,1,0
5172,10,1,0,0,1,0
145766,6,35,0,0,35,0
145766,4,5,0,0,5,0
145766,3,2,0,0,2,0
76322,10,2,0,0,2,0
181235,10,4,0,0,4,0
181235,5,2,0,0,2,0
181235,4,2,0,0,2,0
181235,3,1,0,0,1,0
148581,3,3,0,0,3,0
148581,2,4,0,0,4,0
148581,1,1,0,0,1,0
7048,10,1,0,0,1,0
7048,2,2,0,0,2,0
4196,2,2,0,0,2,0
4196,1,1,0,0,1,0
117823,3,2,0,0,2,0
117823,2,1,0,0,1,0
117823,1,1,0,0,1,0
11446,9,1,0,0,1,0
11446,8,4,0,0,4,0
182049,10,1,0,0,1,0
182049,9,2,0,0,2,0
182049,3,5,0,0,5,0
182049,2,1,0,0,1,0
6021,3,1,0,0,1,0
173336,10,2,0,0,2,0
173336,9,6,0,0,6,0
173336,2,2,0,0,2,0
160606,1,1,0,0,1,0
7051,9,3,0,0,3,0
7051,2,2,0,0,2,0
7051,1,1,0,0,1,0
131006,1,2,0,0,2,0
22799,9,1,0,0,1,0
22799,4,11,0,0,11,0
11436,6,8,0,0,8,0
11436,5,1,0,0,1,0
113937,10,1,0,0,1,0
9833,5,4,0,0,4,0
9833,4,2,0,0,2,0
191475,4,1,0,0,1,0
259537,4,3,0,0,3,0
259537,2,1,0,0,1,0
9681,8,6,0,0,6,0
9681,2,1,0,0,1,0
9681,1,1,0,0,1,0
32670,8,1,0,0,1,0
10272,4,3,0,0,3,0
182953,5,8,0,0,8,0
182953,4,1,0,0,1,0
182953,1,1,0,0,1,0
43171,10,2,0,0,2,0
43171,8,2,0,0,2,0
43171,7,10,0,0,10,0
43171,3,6,0,0,6,0
226631,3,1,0,0,1,0
3004,10,1,0,0,1,0
3004,1,1,0,0,1,0
209672,10,1,0,0,1,0
209672,9,1,0,0,1,0
209672,5,7,0,0,7,0
209672,4,3,0,0,3,0
209672,3,2,0,0,2,0
34390,10,4,0,0,4,0
137201,9,2,0,0,2,0
13830,2,1,0,0,1,0
12608,4,3,0,0,3,0
192924,2,1,0,0,1,0
70488,10,1,0,0,1,0
70488,1,1,0,0,1,0
179973,3,2,0,0,2,0
179973,2,1,0,0,1,0
1464,2,3,0,0,3,0
5778,3,1,0,0,1,0
231450,5,4,0,0,4,0
2709,9,2,0,0,2,0
2709,2,2,0,0,2,0
32465,10,1,0,0,1,0
32465,9,2,0,0,2,0
32465,3,2,0,0,2,0
2666,9,3,0,0,3,0
2666,3,1,0,0,1,0
4234,3,4,0,0,4,0
240094,3,5,0,0,5,0
240094,2,1,0,0,1,0
240094,1,1,0,0,1,0
143680,5,3,0,0,3,0
21324,3,1,0,0,1,0
21324,1,1,0,0,1,0
93895,10,4,0,0,4,0
93895,9,5,0,0,5,0
93895,5,6,0,0,6,0
93895,4,3,0,0,3,0
225000,3,1,0,0,1,0
225000,2,1,0,0,1,0
5897,10,1,0,0,1,0
151887,10,1,0,0,1,0
151887,9,1,0,0,1,0
151887,4,9,0,0,9,0
186435,1,2,0,0,2,0
258309,10,4,0,0,4,0
258309,5,1,0,0,1,0
258309,4,1,0,0,1,0
258309,3,1,0,0,1,0
20050,2,1,0,0,1,0
7255,3,1,0,0,1,0
82976,9,2,0,0,2,0
37686,10,1,0,0,1,0
37686,2,1,0,0,1,0
7184,9,2,0,0,2,0
256438,10,2,0,0,2,0
256438,9,1,0,0,1,0
256438,4,5,0,0,5,0
53840,10,2,0,0,2,0
53840,4,2,0,0,2,0
223514,3,1,0,0,1,0
223514,1,1,0,0,1,0
6725,2,3,0,0,3,0
6725,1,2,0,0,2,0
9812,9,1,0,0,1,0
9812,1,2,0,0,2,0
157673,5,18,0,0,18,0
118953,9,2,0,0,2,0
118953,5,11,0,0,11,0
118953,3,2,0,0,2,0
118953,2,1,0,0,1,0
39704,9,2,0,0,2,0
40801,3,5,0,0,5,0
40801,2,3,0,0,3,0
40801,1,2,0,0,2,0
6750,10,4,0,0,4,0
165628,10,4,0,0,4,0
165628,9,6,0,0,6,0
165628,7,22,0,0,22,0
165628,5,12,0,0,12,0
165628,3,3,0,0,3,0
236239,4,1,0,0,1,0
236239,1,1,0,0,1,0
13341,10,1,0,0,1,0
231942,5,3,0,0,3,0
231942,4,1,0,0,1,0
5488,10,1,0,0,1,0
5488,4,3,0,0,3,0
209282,9,3,0,0,3,0
209282,2,2,0,0,2,0
249673,10,2,0,0,2,0
249673,4,2,0,0,2,0
148264,5,5,0,0,5,0
148264,1,3,0,0,3,0
13357,10,1,0,0,1,0
13357,9,1,0,0,1,0
13357,4,7,0,0,7,0
18887,1,3,0,0,3,0
165523,9,3,0,0,3,0
165523,4,3,0,0,3,0
165523,3,1,0,0,1,0
174065,10,1,0,0,1,0
174065,9,1,0,0,1,0
174065,8,5,0,0,5,0
174065,7,14,0,0,14,0
174065,3,8,0,0,8,0
174065,1,1,0,0,1,0
154677,10,1,0,0,1,0
154677,9,3,0,0,3,0
154677,3,2,0,0,2,0
154677,1,2,0,0,2,0
3465,1,1,0,0,1,0
2918,2,1,0,0,1,0
63928,4,2,0,0,2,0
149794,10,1,0,0,1,0
155020,3,4,0,0,4,0
155020,1,1,0,0,1,0
224149,5,3,0,0,3,0
68931,10,1,0,0,1,0
194229,4,7,0,0,7,0
194229,3,1,0,0,1,0
173637,5,24,0,0,24,0
173637,4,7,0,0,7,0
173637,1,1,0,0,1,0
56759,2,1,0,0,1,0
8134,1,1,0,0,1,0
5882,10,1,0,0,1,0
8737,10,2,0,0,2,0
8737,3,1,0,0,1,0
18876,10,1,0,0,1,0
18876,9,3,0,0,3,0
200170,3,2,0,0,2,0
200170,2,1,0,0,1,0
200170,1,3,0,0,3,0
198147,10,5,0,0,5,0
198147,9,1,0,0,1,0
4657,5,1,0,0,1,0
22847,1,1,0,0,1,0
15267,8,8,0,0,8,0
15267,3,2,0,0,2,0
15267,1,1,0,0,1,0
6660,9,2,0,0,2,0
6660,2,1,0,0,1,0
188051,10,2,0,0,2,0
188051,9,2,0,0,2,0
188051,3,1,0,0,1,0
188051,2,1,0,0,1,0
8317,3,1,0,0,1,0
157083,8,4,0,0,4,0
157083,2,3,0,0,3,0
5428,8,1,0,0,1,0
22476,10,5,0,0,5,0
22476,9,3,0,0,3,0
22476,1,1,0,0,1,0
23870,9,1,0,0,1,0
212581,9,5,0,0,5,0
212581,1,1,0,0,1,0
161923,10,1,0,0,1,0
161923,9,1,0,0,1,0
159633,2,1,0,0,1,0
159633,1,2,0,0,2,0
11438,9,7,0,0,7,0
154890,9,1,0,0,1,0
154890,3,1,0,0,1,0
154890,2,1,0,0,1,0
154890,1,1,0,0,1,0
1278,10,1,0,0,1,0
74596,10,1,0,0,1,0
74596,5,1,0,0,1,0
74596,4,2,0,0,2,0
74596,3,1,0,0,1,0
561,10,3,0,0,3,0
561,2,1,0,0,1,0
224212,10,1,0,0,1,0
224212,7,5,0,0,5,0
224212,2,3,0,0,3,0
153757,10,2,0,0,2,0
34450,10,2,0,0,2,0
34450,9,2,0,0,2,0
34450,5,12,0,0,12,0
34450,4,4,0,0,4,0
34450,3,2,0,0,2,0
19351,10,3,0,0,3,0
19351,2,1,0,0,1,0
19351,1,7,0,0,7,0
246960,5,2,0,0,2,0
170274,10,4,0,0,4,0
170274,8,1,0,0,1,0
170274,7,10,0,0,10,0
170274,3,10,0,0,10,0
13373,10,1,0,0,1,0
13373,9,1,0,0,1,0
13373,1,2,0,0,2,0
8337,1,1,0,0,1,0
250878,10,5,0,0,5,0
193295,7,13,0,0,13,0
193295,3,5,0,0,5,0
173003,10,1,0,0,1,0
173003,9,3,0,0,3,0
173003,8,6,0,0,6,0
173003,4,5,0,0,5,0
173003,3,2,0,0,2,0
173003,1,1,0,0,1,0
12451,9,5,0,0,5,0
12451,3,2,0,0,2,0
916,1,1,0,0,1,0
146707,10,2,0,0,2,0
146707,8,9,0,0,9,0
146707,3,5,0,0,5,0
39939,4,1,0,0,1,0
39939,1,1,0,0,1,0
5777,10,2,0,0,2,0
5777,1,2,0,0,2,0
28857,8,1,0,0,1,0
20053,9,5,0,0,5,0
2743,10,1,0,0,1,0
5862,10,2,0,0,2,0
5862,9,5,0,0,5,0
5862,2,1,0,0,1,0
153103,4,3,0,0,3,0
153103,2,1,0,0,1,0
7463,10,1,0,0,1,0
7463,9,3,0,0,3,0
219122,9,5,0,0,5,0
230200,10,3,0,0,3,0
230200,4,1,0,0,1,0
1208,2,1,0,0,1,0
1208,1,1,0,0,1,0
138026,8,33,0,0,33,0
138026,4,1,0,0,1,0
66888,10,1,0,0,1,0
66888,8,8,0,0,8,0
194387,5,16,0,0,16,0
194387,4,5,0,0,5,0
194387,3,4,0,0,4,0
148744,4,3,0,0,3,0
148744,2,1,0,0,1,0
3561,10,1,0,0,1,0
3561,3,2,0,0,2,0
197,3,2,0,0,2,0
197,2,1,0,0,1,0
180939,5,14,0,0,14,0
180939,3,2,0,0,2,0
180939,2,3,0,0,3,0
155464,10,1,0,0,1,0
155464,1,2,0,0,2,0
6041,10,3,0,0,3,0
6041,9,1,0,0,1,0
6041,2,1,0,0,1,0
91394,8,4,0,0,4,0
91394,2,2,0,0,2,0
72083,9,1,0,0,1,0
72083,4,3,0,0,3,0
67426,10,3,0,0,3,0
172166,4,5,0,0,5,0
172166,3,1,0,0,1,0
172166,2,1,0,0,1,0
2736,2,1,0,0,1,0
2147,10,1,0,0,1,0
4764,3,3,0,0,3,0
4764,1,1,0,0,1,0
5532,9,1,0,0,1,0
5532,2,2,0,0,2,0
24280,2,2,0,0,2,0
17654,2,1,0,0,1,0
180238,2,1,0,0,1,0
36236,9,2,0,0,2,0
5354,9,1,0,0,1,0
153498,10,6,0,0,6,0
207167,9,3,0,0,3,0
207167,2,4,0,0,4,0
185302,2,1,0,0,1,0
185302,1,1,0,0,1,0
87288,10,1,0,0,1,0
87288,9,3,0,0,3,0
181319,5,7,0,0,7,0
124000,10,7,0,0,7,0
124000,7,21,0,0,21,0
124000,5,11,0,0,11,0
124000,3,1,0,0,1,0
124000,1,1,0,0,1,0
218395,6,1,0,0,1,0
218395,5,2,0,0,2,0
55031,10,1,0,0,1,0
55031,5,12,0,0,12,0
55031,3,3,0,0,3,0
34419,10,1,0,0,1,0
34419,3,3,0,0,3,0
34419,1,1,0,0,1,0
10904,3,2,0,0,2,0
10904,1,1,0,0,1,0
217338,9,2,0,0,2,0
217338,7,38,0,0,38,0
217338,4,3,0,0,3,0
217338,1,1,0,0,1,0
10575,10,2,0,0,2,0
153002,10,3,0,0,3,0
153002,9,4,0,0,4,0
179548,5,5,0,0,5,0
179548,3,2,0,0,2,0
105265,3,1,0,0,1,0
2499,10,1,0,0,1,0
2499,9,1,0,0,1,0
2499,3,5,0,0,5,0
2499,2,2,0,0,2,0
4217,3,1,0,0,1,0
4342,2,1,0,0,1,0
1760,10,4,0,0,4,0
1760,3,2,0,0,2,0
1760,2,1,0,0,1,0
1760,1,1,0,0,1,0
236178,1,1,0,0,1,0
1815,9,4,0,0,4,0
1138,10,2,0,0,2,0
1138,9,1,0,0,1,0
6529,1,1,0,0,1,0
179386,9,1,0,0,1,0
179386,4,5,0,0,5,0
179386,2,1,0,0,1,0
2138,10,1,0,0,1,0
2138,3,3,0,0,3,0
162614,2,3,0,0,3,0
162614,1,1,0,0,1,0
11060,10,2,0,0,2,0
11060,9,2,0,0,2,0
11060,3,1,0,0,1,0
77344,10,1,0,0,1,0
77344,1,1,0,0,1,0
28010,10,2,0,0,2,0
28010,8,4,0,0,4,0
125936,10,2,0,0,2,0
125936,4,1,0,0,1,0
125936,3,1,0,0,1,0
12822,10,1,0,0,1,0
12822,1,1,0,0,1,0
2161,1,1,0,0,1,0
10878,3,2,0,0,2,0
10878,2,1,0,0,1,0
34098,4,1,0,0,1,0
3762,9,3,0,0,3,0
3762,8,3,0,0,3,0
35452,10,2,0,0,2,0
1130,10,2,0,0,2,0
1130,6,31,0,0,31,0
997,10,1,0,0,1,0
997,4,12,0,0,12,0
997,1,1,0,0,1,0
8721,10,5,0,0,5,0
8721,3,1,0,0,1,0
252314,10,1,0,0,1,0
252314,9,2,0,0,2,0
252314,3,3,0,0,3,0
3160,10,1,0,0,1,0
3160,2,2,0,0,2,0
3160,1,1,0,0,1,0
223777,10,3,0,0,3,0
223777,5,1,0,0,1,0
223777,2,1,0,0,1,0
192283,1,2,0,0,2,0
217974,5,3,0,0,3,0
54239,8,4,0,0,4,0
23707,2,1,0,0,1,0
206780,9,12,0,0,12,0
206780,3,1,0,0,1,0
3054,10,2,0,0,2,0
8658,5,21,0,0,21,0
234846,10,2,0,0,2,0
234846,9,2,0,0,2,0
234846,2,1,0,0,1,0
234846,1,1,0,0,1,0
8056,10,2,0,0,2,0
8056,9,1,0,0,1,0
8056,3,2,0,0,2,0
8056,1,1,0,0,1,0
8571,10,1,0,0,1,0
8571,9,3,0,0,3,0
2492,3,8,0,0,8,0
2492,2,2,0,0,2,0
21702,7,2,0,0,2,0
146146,2,1,0,0,1,0
258104,10,1,0,0,1,0
258104,9,3,0,0,3,0
258104,6,26,0,0,26,0
258104,5,5,0,0,5,0
258104,4,1,0,0,1,0
38,9,1,0,0,1,0
195533,5,3,0,0,3,0
195533,1,1,0,0,1,0
221848,5,1,0,0,1,0
239,4,3,0,0,3,0
194640,10,1,0,0,1,0
194640,2,1,0,0,1,0
35665,9,3,0,0,3,0
35665,3,3,0,0,3,0
35665,2,1,0,0,1,0
5001,10,1,0,0,1,0
5001,9,4,0,0,4,0
5001,2,3,0,0,3,0
231309,9,8,0,0,8,0
231309,4,2,0,0,2,0
231309,1,1,0,0,1,0
36560,10,1,0,0,1,0
36560,1,1,0,0,1,0
3839,10,1,0,0,1,0
3839,9,1,0,0,1,0
3839,1,2,0,0,2,0
660,9,1,0,0,1,0
2721,10,1,0,0,1,0
118732,3,2,0,0,2,0
118732,2,2,0,0,2,0
214898,10,1,0,0,1,0
214898,9,12,0,0,12,0
214898,8,14,0,0,14,0
214898,4,3,0,0,3,0
214898,3,1,0,0,1,0
2885,5,8,0,0,8,0
12135,3,2,0,0,2,0
136954,9,2,0,0,2,0
136954,3,1,0,0,1,0
103236,5,16,0,0,16,0
103236,4,7,0,0,7,0
103236,3,2,0,0,2,0
103236,2,1,0,0,1,0
34948,10,3,0,0,3,0
34948,9,1,0,0,1,0
34948,3,3,0,0,3,0
12501,10,1,0,0,1,0
12501,4,3,0,0,3,0
12501,2,1,0,0,1,0
2099,8,2,0,0,2,0
2099,7,7,0,0,7,0
2099,2,7,0,0,7,0
2099,1,1,0,0,1,0
27408,4,5,0,0,5,0
125395,10,3,0,0,3,0
125395,4,4,0,0,4,0
246316,5,8,0,0,8,0
246316,1,1,0,0,1,0
10291,10,3,0,0,3,0
151396,2,1,0,0,1,0
217353,3,2,0,0,2,0
217353,1,1,0,0,1,0
183361,10,2,0,0,2,0
40480,2,5,0,0,5,0
9132,4,2,0,0,2,0
9132,2,1,0,0,1,0
232216,5,12,0,0,12,0
200371,5,6,0,0,6,0
200371,2,3,0,0,3,0
21734,10,1,0,0,1,0
198328,10,4,0,0,4,0
198328,9,4,0,0,4,0
198328,5,16,0,0,16,0
198328,4,4,0,0,4,0
198328,3,2,0,0,2,0
126168,9,1,0,0,1,0
126168,8,9,0,0,9,0
126168,1,1,0,0,1,0
134279,6,21,0,0,21,0
134279,3,1,0,0,1,0
134279,2,3,0,0,3,0
3525,8,6,0,0,6,0
3525,1,2,0,0,2,0
177976,10,3,0,0,3,0
177976,4,1,0,0,1,0
6891,10,2,0,0,2,0
180489,10,3,0,0,3,0
180489,2,2,0,0,2,0
180489,1,2,0,0,2,0
270314,10,2,0,0,2,0
270314,5,1,0,0,1,0
270314,4,2,0,0,2,0
20217,10,2,0,0,2,0
20217,7,6,0,0,6,0
20217,2,3,0,0,3,0
20217,1,1,0,0,1,0
5733,10,1,0,0,1,0
5733,9,1,0,0,1,0
5733,2,1,0,0,1,0
5733,1,2,0,0,2,0
26233,9,4,0,0,4,0
26233,3,1,0,0,1,0
148074,10,2,0,0,2,0
148074,7,24,0,0,24,0
148074,4,5,0,0,5,0
148074,3,2,0,0,2,0
130841,9,1,0,0,1,0
130841,2,1,0,0,1,0
1699,1,1,0,0,1,0
214343,9,2,0,0,2,0
131389,9,2,0,0,2,0
211734,7,35,0,0,35,0
8089,3,1,0,0,1,0
139042,5,6,0,0,6,0
139042,4,1,0,0,1,0
139042,3,3,0,0,3,0
139042,2,1,0,0,1,0
955,10,1,0,0,1,0
232944,10,1,0,0,1,0
232944,9,1,0,0,1,0
232944,1,1,0,0,1,0
69175,10,1,0,0,1,0
69175,4,17,0,0,17,0
69175,2,3,0,0,3,0
69175,1,1,0,0,1,0
38866,9,1,0,0,1,0
38866,8,4,0,0,4,0
76728,4,3,0,0,3,0
76728,2,1,0,0,1,0
76728,1,1,0,0,1,0
24693,10,1,0,0,1,0
41247,1,1,0,0,1,0
232242,1,1,0,0,1,0
193121,9,1,0,0,1,0
193121,2,1,0,0,1,0
193121,1,1,0,0,1,0
108832,9,1,0,0,1,0
108832,3,2,0,0,2,0
108832,1,1,0,0,1,0
25944,10,1,0,0,1,0
25944,8,5,0,0,5,0
25944,3,1,0,0,1,0
140314,5,3,0,0,3,0
140314,3,1,0,0,1,0
140314,2,1,0,0,1,0
140314,1,1,0,0,1,0
215066,10,2,0,0,2,0
215066,5,9,0,0,9,0
215066,2,2,0,0,2,0
215066,1,1,0,0,1,0
89478,5,15,0,0,15,0
174243,4,1,0,0,1,0
104527,8,2,0,0,2,0
5775,8,1,0,0,1,0
406,9,1,0,0,1,0
406,3,6,0,0,6,0
73312,4,4,0,0,4,0
73312,2,2,0,0,2,0
165552,9,3,0,0,3,0
165552,1,1,0,0,1,0
207568,6,4,0,0,4,0
207568,3,1,0,0,1,0
129417,10,2,0,0,2,0
129417,9,3,0,0,3,0
129417,4,2,0,0,2,0
42881,10,1,0,0,1,0
42881,2,1,0,0,1,0
36895,9,3,0,0,3,0
36895,7,6,0,0,6,0
240464,10,3,0,0,3,0
240464,6,7,0,0,7,0
240464,5,2,0,0,2,0
240464,4,2,0,0,2,0
240464,1,1,0,0,1,0
6976,5,4,0,0,4,0
198305,7,10,0,0,10,0
198305,4,14,0,0,14,0
198305,3,4,0,0,4,0
244170,10,3,0,0,3,0
244170,5,8,0,0,8,0
244170,4,3,0,0,3,0
223996,10,2,0,0,2,0
223996,6,19,0,0,19,0
223996,5,1,0,0,1,0
223996,2,1,0,0,1,0
154008,8,3,0,0,3,0
154008,1,2,0,0,2,0
137152,9,2,0,0,2,0
180204,2,1,0,0,1,0
234465,5,10,0,0,10,0
162384,3,1,0,0,1,0
66603,1,1,0,0,1,0
159084,1,2,0,0,2,0
6406,10,2,0,0,2,0
4502,1,1,0,0,1,0
13309,1,2,0,0,2,0
8322,10,1,0,0,1,0
25069,10,1,0,0,1,0
25069,9,3,0,0,3,0
25069,8,4,0,0,4,0
25069,2,1,0,0,1,0
6047,10,1,0,0,1,0
32820,9,7,0,0,7,0
17211,9,1,0,0,1,0
191135,1,1,0,0,1,0
156945,10,1,0,0,1,0
156945,9,3,0,0,3,0
69973,7,13,0,0,13,0
69973,1,2,0,0,2,0
42783,9,5,0,0,5,0
42783,4,1,0,0,1,0
1963,9,1,0,0,1,0
176433,10,1,0,0,1,0
176433,2,1,0,0,1,0
176433,1,1,0,0,1,0
172006,2,1,0,0,1,0
238094,10,5,0,0,5,0
238094,6,8,0,0,8,0
238094,4,1,0,0,1,0
79216,9,1,0,0,1,0
79216,3,6,0,0,6,0
79216,1,1,0,0,1,0
199076,5,2,0,0,2,0
199076,3,1,0,0,1,0
199076,1,1,0,0,1,0
190073,10,4,0,0,4,0
190073,9,7,0,0,7,0
190073,1,1,0,0,1,0
489,9,1,0,0,1,0
1171,9,1,0,0,1,0
1171,1,1,0,0,1,0
161887,10,1,0,0,1,0
161887,8,8,0,0,8,0
161887,3,5,0,0,5,0
161887,1,2,0,0,2,0
24784,10,1,0,0,1,0
24784,8,8,0,0,8,0
24784,5,13,0,0,13,0
24784,3,4,0,0,4,0
24784,1,1,0,0,1,0
2599,10,2,0,0,2,0
2599,9,1,0,0,1,0
2599,3,1,0,0,1,0
844,10,1,0,0,1,0
225977,10,1,0,0,1,0
225977,9,3,0,0,3,0
225977,5,5,0,0,5,0
225977,4,1,0,0,1,0
225977,2,1,0,0,1,0
216600,5,3,0,0,3,0
46669,5,2,0,0,2,0
164655,1,1,0,0,1,0
8063,9,1,0,0,1,0
8063,8,1,0,0,1,0
4593,10,1,0,0,1,0
4593,9,1,0,0,1,0
4593,8,5,0,0,5,0
202942,1,1,0,0,1,0
154515,10,1,0,0,1,0
154515,3,2,0,0,2,0
154515,1,1,0,0,1,0
227888,6,1,0,0,1,0
227888,5,1,0,0,1,0
227888,4,1,0,0,1,0
227888,1,1,0,0,1,0
54559,10,1,0,0,1,0
54559,8,1,0,0,1,0
85563,9,1,0,0,1,0
99976,9,3,0,0,3,0
99976,5,10,0,0,10,0
99976,3,2,0,0,2,0
7834,9,2,0,0,2,0
7834,1,1,0,0,1,0
4276,9,3,0,0,3,0
11694,10,1,0,0,1,0
5400,4,1,0,0,1,0
5400,1,1,0,0,1,0
71402,9,1,0,0,1,0
71402,7,8,0,0,8,0
71402,2,1,0,0,1,0
153510,3,1,0,0,1,0
4291,5,5,0,0,5,0
4291,2,1,0,0,1,0
31623,3,2,0,0,2,0
3932,4,4,0,0,4,0
161882,4,1,0,0,1,0
8757,3,1,0,0,1,0
23292,9,3,0,0,3,0
199086,5,6,0,0,6,0
199086,4,3,0,0,3,0
199086,3,2,0,0,2,0
199086,1,1,0,0,1,0
27668,7,8,0,0,8,0
182952,8,17,0,0,17,0
182952,7,19,0,0,19,0
182952,5,8,0,0,8,0
182952,4,3,0,0,3,0
4119,10,1,0,0,1,0
4119,9,1,0,0,1,0
4119,2,2,0,0,2,0
233206,6,16,0,0,16,0
233206,2,2,0,0,2,0
233206,1,1,0,0,1,0
4357,4,3,0,0,3,0
4357,3,2,0,0,2,0
254189,5,6,0,0,6,0
254189,4,1,0,0,1,0
254189,2,1,0,0,1,0
181694,10,3,0,0,3,0
181694,9,2,0,0,2,0
181694,4,1,0,0,1,0
18499,9,2,0,0,2,0
18499,8,4,0,0,4,0
18499,1,1,0,0,1,0
144958,10,1,0,0,1,0
144958,9,1,0,0,1,0
56022,9,1,0,0,1,0
12266,10,1,0,0,1,0
12266,5,2,0,0,2,0
229244,5,4,0,0,4,0
20146,3,2,0,0,2,0
20146,2,3,0,0,3,0
22233,10,2,0,0,2,0
22233,9,1,0,0,1,0
22233,2,1,0,0,1,0
123162,9,5,0,0,5,0
123162,4,5,0,0,5,0
123162,2,2,0,0,2,0
187056,1,1,0,0,1,0
178655,1,1,0,0,1,0
6210,10,2,0,0,2,0
6210,8,1,0,0,1,0
9251,10,1,0,0,1,0
9251,9,1,0,0,1,0
18498,10,1,0,0,1,0
18498,8,2,0,0,2,0
198087,5,1,0,0,1,0
198087,4,2,0,0,2,0
198087,3,1,0,0,1,0
43489,2,1,0,0,1,0
6086,9,2,0,0,2,0
6086,3,3,0,0,3,0
240624,4,1,0,0,1,0
240624,3,1,0,0,1,0
108341,3,2,0,0,2,0
18788,9,2,0,0,2,0
18788,3,4,0,0,4,0
18788,2,3,0,0,3,0
18788,1,1,0,0,1,0
9079,8,1,0,0,1,0
12141,1,1,0,0,1,0
18011,1,1,0,0,1,0
145897,8,3,0,0,3,0
145897,3,4,0,0,4,0
17062,10,2,0,0,2,0
17062,8,3,0,0,3,0
17062,1,3,0,0,3,0
94949,4,2,0,0,2,0
5573,3,1,0,0,1,0
216497,10,1,0,0,1,0
220861,9,2,0,0,2,0
17995,10,1,0,0,1,0
17995,9,3,0,0,3,0
17995,8,19,0,0,19,0
17995,4,3,0,0,3,0
5997,10,4,0,0,4,0
5997,9,2,0,0,2,0
5997,4,2,0,0,2,0
5997,2,1,0,0,1,0
194577,9,2,0,0,2,0
194577,8,7,0,0,7,0
194577,4,2,0,0,2,0
194577,3,3,0,0,3,0
194577,2,2,0,0,2,0
155245,4,5,0,0,5,0
155245,2,1,0,0,1,0
15173,4,3,0,0,3,0
15173,2,1,0,0,1,0
4121,3,1,0,0,1,0
4121,1,1,0,0,1,0
228603,2,1,0,0,1,0
191128,10,4,0,0,4,0
191128,9,2,0,0,2,0
191128,5,9,0,0,9,0
191128,3,2,0,0,2,0
203800,7,5,0,0,5,0
203800,2,1,0,0,1,0
121295,10,2,0,0,2,0
121295,4,5,0,0,5,0
2402,1,1,0,0,1,0
208023,9,7,0,0,7,0
208023,6,17,0,0,17,0
208023,5,11,0,0,11,0
2100,9,1,0,0,1,0
2100,2,6,0,0,6,0
2100,1,2,0,0,2,0
5516,5,8,0,0,8,0
5516,3,1,0,0,1,0
21769,10,4,0,0,4,0
21769,3,2,0,0,2,0
3276,10,2,0,0,2,0
80836,8,4,0,0,4,0
6578,9,5,0,0,5,0
6578,1,2,0,0,2,0
151640,1,3,0,0,3,0
251622,10,1,0,0,1,0
184473,10,1,0,0,1,0
184473,9,1,0,0,1,0
20810,9,2,0,0,2,0
20810,3,2,0,0,2,0
72622,10,1,0,0,1,0
139236,3,1,0,0,1,0
139236,2,1,0,0,1,0
24658,10,1,0,0,1,0
145470,10,4,0,0,4,0
145470,5,6,0,0,6,0
145470,3,2,0,0,2,0
145470,2,2,0,0,2,0
145470,1,2,0,0,2,0
158971,10,1,0,0,1,0
158971,9,3,0,0,3,0
158971,3,1,0,0,1,0
158971,2,1,0,0,1,0
158971,1,1,0,0,1,0
4049,10,1,0,0,1,0
4049,9,1,0,0,1,0
8327,9,1,0,0,1,0
20043,10,2,0,0,2,0
76443,1,2,0,0,2,0
1310,3,1,0,0,1,0
1310,2,1,0,0,1,0
142333,10,1,0,0,1,0
142333,3,1,0,0,1,0
181245,10,1,0,0,1,0
181245,5,16,0,0,16,0
1941,10,1,0,0,1,0
129322,3,3,0,0,3,0
129322,2,3,0,0,3,0
4580,9,3,0,0,3,0
4580,3,4,0,0,4,0
4580,2,2,0,0,2,0
1635,3,2,0,0,2,0
69761,10,1,0,0,1,0
69761,1,2,0,0,2,0
215436,8,23,0,0,23,0
215436,3,1,0,0,1,0
215436,1,3,0,0,3,0
9710,3,5,0,0,5,0
164670,9,1,0,0,1,0
164670,3,3,0,0,3,0
164670,1,1,0,0,1,0
28298,10,4,0,0,4,0
28298,2,3,0,0,3,0
12920,2,1,0,0,1,0
12920,1,1,0,0,1,0
95128,7,7,0,0,7,0
95128,1,1,0,0,1,0
848,10,1,0,0,1,0
848,9,2,0,0,2,0
848,2,2,0,0,2,0
848,1,1,0,0,1,0
98189,8,1,0,0,1,0
98189,3,6,0,0,6,0
98189,2,2,0,0,2,0
5751,4,2,0,0,2,0
5751,2,1,0,0,1,0
146104,3,3,0,0,3,0
146104,2,1,0,0,1,0
261262,9,1,0,0,1,0
261262,4,2,0,0,2,0
261262,3,1,0,0,1,0
191043,9,4,0,0,4,0
171708,2,1,0,0,1,0
165796,10,1,0,0,1,0
165796,9,1,0,0,1,0
165796,3,4,0,0,4,0
165796,1,1,0,0,1,0
603,10,1,0,0,1,0
603,8,8,0,0,8,0
603,2,2,0,0,2,0
168792,2,1,0,0,1,0
173389,9,1,0,0,1,0
173389,8,3,0,0,3,0
129290,10,1,0,0,1,0
129290,9,2,0,0,2,0
129290,3,3,0,0,3,0
129290,1,4,0,0,4,0
256442,10,1,0,0,1,0
256442,2,2,0,0,2,0
1981,9,1,0,0,1,0
1981,2,1,0,0,1,0
160517,4,4,0,0,4,0
19372,3,2,0,0,2,0
69292,10,3,0,0,3,0
69292,9,2,0,0,2,0
1907,2,1,0,0,1,0
55896,2,2,0,0,2,0
32245,9,4,0,0,4,0
32245,7,10,0,0,10,0
32245,1,1,0,0,1,0
56406,9,2,0,0,2,0
56406,7,13,0,0,13,0
244795,3,2,0,0,2,0
13817,1,5,0,0,5,0
36973,9,1,0,0,1,0
32683,10,1,0,0,1,0
140236,10,6,0,0,6,0
140236,4,2,0,0,2,0
60228,10,2,0,0,2,0
60228,3,1,0,0,1,0
165022,5,4,0,0,4,0
165022,4,4,0,0,4,0
60464,5,12,0,0,12,0
60464,4,2,0,0,2,0
187587,10,4,0,0,4,0
187587,9,4,0,0,4,0
187587,1,1,0,0,1,0
17132,3,1,0,0,1,0
17132,1,1,0,0,1,0
6914,10,1,0,0,1,0
6914,3,1,0,0,1,0
222531,6,4,0,0,4,0
222531,3,1,0,0,1,0
253763,9,2,0,0,2,0
253763,4,8,0,0,8,0
253763,3,1,0,0,1,0
253763,2,2,0,0,2,0
253763,1,1,0,0,1,0
248065,8,7,0,0,7,0
248065,6,2,0,0,2,0
248065,5,2,0,0,2,0
248065,2,2,0,0,2,0
234373,10,2,0,0,2,0
234373,4,3,0,0,3,0
234373,3,2,0,0,2,0
234373,1,1,0,0,1,0
9559,3,7,0,0,7,0
35585,10,1,0,0,1,0
35585,8,2,0,0,2,0
35585,7,4,0,0,4,0
240108,2,1,0,0,1,0
10267,2,2,0,0,2,0
71956,4,2,0,0,2,0
207883,4,3,0,0,3,0
207883,1,1,0,0,1,0
154,4,3,0,0,3,0
154,2,1,0,0,1,0
233361,5,1,0,0,1,0
182954,5,6,0,0,6,0
182954,4,2,0,0,2,0
172307,9,2,0,0,2,0
172307,8,3,0,0,3,0
172307,7,4,0,0,4,0
172307,1,2,0,0,2,0
172064,10,1,0,0,1,0
172064,9,1,0,0,1,0
172064,1,1,0,0,1,0
262201,6,1,0,0,1,0
262201,5,1,0,0,1,0
98857,1,2,0,0,2,0
166858,3,2,0,0,2,0
80296,9,1,0,0,1,0
80296,3,2,0,0,2,0
80296,2,2,0,0,2,0
80296,1,1,0,0,1,0
166710,10,1,0,0,1,0
166710,9,2,0,0,2,0
166710,1,1,0,0,1,0
81826,9,2,0,0,2,0
81826,2,1,0,0,1,0
103843,9,4,0,0,4,0
56604,10,8,0,0,8,0
56604,6,20,0,0,20,0
56604,5,11,0,0,11,0
56604,4,8,0,0,8,0
56604,3,2,0,0,2,0
149322,10,2,0,0,2,0
149322,9,1,0,0,1,0
149322,8,7,0,0,7,0
149322,1,1,0,0,1,0
234438,3,1,0,0,1,0
234438,1,2,0,0,2,0
138484,10,4,0,0,4,0
5162,9,1,0,0,1,0
5162,2,1,0,0,1,0
236365,10,1,0,0,1,0
236365,1,2,0,0,2,0
563,3,2,0,0,2,0
90375,9,1,0,0,1,0
90375,4,8,0,0,8,0
90375,3,2,0,0,2,0
90375,2,1,0,0,1,0
137348,9,1,0,0,1,0
137348,8,3,0,0,3,0
137348,4,16,0,0,16,0
108429,3,1,0,0,1,0
108429,2,1,0,0,1,0
108429,1,1,0,0,1,0
1004,4,5,0,0,5,0
136890,5,2,0,0,2,0
169366,4,1,0,0,1,0
169366,1,1,0,0,1,0
6937,5,6,0,0,6,0
6937,2,1,0,0,1,0
7487,3,1,0,0,1,0
177245,10,2,0,0,2,0
177245,9,2,0,0,2,0
177245,1,2,0,0,2,0
6764,10,1,0,0,1,0
6764,8,1,0,0,1,0
6764,1,4,0,0,4,0
138748,9,4,0,0,4,0
138748,1,1,0,0,1,0
266121,7,9,0,0,9,0
266121,5,4,0,0,4,0
217098,2,1,0,0,1,0
256478,10,1,0,0,1,0
256478,5,2,0,0,2,0
256478,4,1,0,0,1,0
21703,10,1,0,0,1,0
155314,10,1,0,0,1,0
155314,5,10,0,0,10,0
155314,3,2,0,0,2,0
155314,2,1,0,0,1,0
1173,9,4,0,0,4,0
1173,1,1,0,0,1,0
39552,10,1,0,0,1,0
39552,8,4,0,0,4,0
8970,10,2,0,0,2,0
192353,10,2,0,0,2,0
192353,8,3,0,0,3,0
192353,2,1,0,0,1,0
192353,1,1,0,0,1,0
249404,5,4,0,0,4,0
249404,4,2,0,0,2,0
249404,3,2,0,0,2,0
14990,10,1,0,0,1,0
14990,9,1,0,0,1,0
14990,7,5,0,0,5,0
14990,2,2,0,0,2,0
250781,4,3,0,0,3,0
250781,3,2,0,0,2,0
3358,9,1,0,0,1,0
9237,4,1,0,0,1,0
112840,9,2,0,0,2,0
112840,3,2,0,0,2,0
112840,2,1,0,0,1,0
162391,10,1,0,0,1,0
162391,9,5,0,0,5,0
162391,6,16,0,0,16,0
162391,4,3,0,0,3,0
3523,4,2,0,0,2,0
6919,4,4,0,0,4,0
6919,2,1,0,0,1,0
4802,10,2,0,0,2,0
4802,3,2,0,0,2,0
4802,2,1,0,0,1,0
9971,2,1,0,0,1,0
2304,4,2,0,0,2,0
2304,3,3,0,0,3,0
835,4,2,0,0,2,0
835,2,1,0,0,1,0
8742,3,1,0,0,1,0
244169,10,3,0,0,3,0
244169,4,2,0,0,2,0
246812,10,4,0,0,4,0
246812,5,9,0,0,9,0
246812,3,1,0,0,1,0
209206,5,3,0,0,3,0
209206,4,1,0,0,1,0
209206,1,1,0,0,1,0
124648,10,3,0,0,3,0
124648,9,6,0,0,6,0
199690,9,5,0,0,5,0
199690,3,4,0,0,4,0
16415,9,1,0,0,1,0
17925,10,1,0,0,1,0
17925,8,20,0,0,20,0
17925,5,5,0,0,5,0
10262,10,2,0,0,2,0
9619,10,2,0,0,2,0
9619,2,1,0,0,1,0
10386,10,1,0,0,1,0
10386,3,1,0,0,1,0
86542,9,1,0,0,1,0
86542,5,8,0,0,8,0
86542,4,2,0,0,2,0
29281,9,1,0,0,1,0
29281,3,1,0,0,1,0
160762,3,2,0,0,2,0
160762,2,2,0,0,2,0
22910,9,2,0,0,2,0
22910,2,1,0,0,1,0
4877,10,1,0,0,1,0
4877,2,2,0,0,2,0
78247,8,2,0,0,2,0
1307,10,1,0,0,1,0
1307,4,7,0,0,7,0
1307,2,1,0,0,1,0
3970,9,2,0,0,2,0
58625,5,1,0,0,1,0
58625,4,1,0,0,1,0
58625,1,1,0,0,1,0
4510,4,1,0,0,1,0
4510,3,2,0,0,2,0
4000,8,4,0,0,4,0
4000,2,3,0,0,3,0
172410,9,1,0,0,1,0
172410,3,3,0,0,3,0
172410,2,5,0,0,5,0
3340,4,1,0,0,1,0
3340,1,1,0,0,1,0
165812,4,3,0,0,3,0
144416,10,1,0,0,1,0
144416,9,2,0,0,2,0
144416,3,1,0,0,1,0
172597,10,5,0,0,5,0
172597,9,6,0,0,6,0
172597,3,1,0,0,1,0
172597,2,1,0,0,1,0
172597,1,2,0,0,2,0
216798,5,4,0,0,4,0
83117,3,4,0,0,4,0
83117,2,5,0,0,5,0
10565,10,3,0,0,3,0
144228,10,7,0,0,7,0
8643,2,1,0,0,1,0
1731,9,1,0,0,1,0
1731,8,2,0,0,2,0
1731,1,1,0,0,1,0
121663,10,1,0,0,1,0
121663,5,22,0,0,22,0
121663,4,5,0,0,5,0
121663,3,2,0,0,2,0
4578,10,2,0,0,2,0
4578,8,1,0,0,1,0
1890,1,1,0,0,1,0
194028,10,1,0,0,1,0
194028,8,8,0,0,8,0
194028,5,11,0,0,11,0
194028,4,3,0,0,3,0
194028,3,1,0,0,1,0
29317,10,1,0,0,1,0
29317,2,1,0,0,1,0
4325,10,3,0,0,3,0
190266,10,4,0,0,4,0
190266,4,1,0,0,1,0
237229,10,3,0,0,3,0
237229,3,2,0,0,2,0
202884,10,3,0,0,3,0
202884,3,2,0,0,2,0
202884,1,1,0,0,1,0
131387,3,1,0,0,1,0
11531,10,1,0,0,1,0
11531,3,1,0,0,1,0
37061,1,1,0,0,1,0
35254,8,8,0,0,8,0
35254,2,2,0,0,2,0
101685,2,2,0,0,2,0
101685,1,1,0,0,1,0
1879,4,2,0,0,2,0
1879,1,1,0,0,1,0
4977,3,2,0,0,2,0
189434,10,1,0,0,1,0
189434,3,3,0,0,3,0
189434,2,1,0,0,1,0
189434,1,2,0,0,2,0
5998,10,1,0,0,1,0
174988,10,12,0,0,12,0
174988,7,2,0,0,2,0
174988,3,6,0,0,6,0
174988,1,2,0,0,2,0
154811,10,2,0,0,2,0
154811,3,2,0,0,2,0
154811,2,1,0,0,1,0
154811,1,2,0,0,2,0
8247,2,1,0,0,1,0
111142,9,2,0,0,2,0
111142,8,13,0,0,13,0
111142,4,8,0,0,8,0
111142,3,1,0,0,1,0
111142,2,2,0,0,2,0
111142,1,1,0,0,1,0
165719,10,3,0,0,3,0
165719,9,6,0,0,6,0
165719,2,1,0,0,1,0
125022,4,1,0,0,1,0
125022,3,1,0,0,1,0
31553,1,1,0,0,1,0
103975,9,3,0,0,3,0
103975,2,1,0,0,1,0
194301,3,3,0,0,3,0
876,1,1,0,0,1,0
245950,10,4,0,0,4,0
245950,9,3,0,0,3,0
245950,3,1,0,0,1,0
9112,5,4,0,0,4,0
149051,10,1,0,0,1,0
149051,8,1,0,0,1,0
149051,7,1,0,0,1,0
149051,2,8,0,0,8,0
149051,1,5,0,0,5,0
177048,10,1,0,0,1,0
177048,3,5,0,0,5,0
12274,10,1,0,0,1,0
12274,9,1,0,0,1,0
3731,10,1,0,0,1,0
3731,9,4,0,0,4,0
3731,8,5,0,0,5,0
53723,10,1,0,0,1,0
53723,9,3,0,0,3,0
53723,3,2,0,0,2,0
53723,2,1,0,0,1,0
53723,1,1,0,0,1,0
4036,10,2,0,0,2,0
4036,3,1,0,0,1,0
193488,5,10,0,0,10,0
5835,9,3,0,0,3,0
5835,3,2,0,0,2,0
5835,1,1,0,0,1,0
201006,9,5,0,0,5,0
201006,5,1,0,0,1,0
201006,4,2,0,0,2,0
201006,3,1,0,0,1,0
218236,8,3,0,0,3,0
218236,4,7,0,0,7,0
218236,2,2,0,0,2,0
66964,3,2,0,0,2,0
43890,7,9,0,0,9,0
43890,1,1,0,0,1,0
200632,10,1,0,0,1,0
200632,2,1,0,0,1,0
17285,2,3,0,0,3,0
152955,10,2,0,0,2,0
152955,7,1,0,0,1,0
221371,10,6,0,0,6,0
221371,3,1,0,0,1,0
221371,1,1,0,0,1,0
3102,9,1,0,0,1,0
3102,2,1,0,0,1,0
14423,10,1,0,0,1,0
14423,1,1,0,0,1,0
46614,10,2,0,0,2,0
137141,5,1,0,0,1,0
137141,1,1,0,0,1,0
8815,10,3,0,0,3,0
8815,5,11,0,0,11,0
8815,2,1,0,0,1,0
177099,1,1,0,0,1,0
22061,10,4,0,0,4,0
22061,6,19,0,0,19,0
22061,3,2,0,0,2,0
22061,2,1,0,0,1,0
6485,7,4,0,0,4,0
6485,6,6,0,0,6,0
6485,5,5,0,0,5,0
6485,4,8,0,0,8,0
4326,3,2,0,0,2,0
7712,10,2,0,0,2,0
7712,9,2,0,0,2,0
7712,3,4,0,0,4,0
2436,4,5,0,0,5,0
2436,1,1,0,0,1,0
248182,5,6,0,0,6,0
248182,4,1,0,0,1,0
248182,2,2,0,0,2,0
171351,5,3,0,0,3,0
171351,4,3,0,0,3,0
171351,3,2,0,0,2,0
102159,2,2,0,0,2,0
172563,4,2,0,0,2,0
6197,5,5,0,0,5,0
12601,10,2,0,0,2,0
256998,6,15,0,0,15,0
256998,5,7,0,0,7,0
18579,3,3,0,0,3,0
18579,1,1,0,0,1,0
194061,5,2,0,0,2,0
194061,4,1,0,0,1,0
790,10,1,0,0,1,0
790,8,10,0,0,10,0
790,7,20,0,0,20,0
790,1,2,0,0,2,0
176247,5,4,0,0,4,0
176247,4,2,0,0,2,0
9725,10,4,0,0,4,0
9725,8,5,0,0,5,0
218519,6,15,0,0,15,0
218519,5,5,0,0,5,0
218519,4,3,0,0,3,0
16860,1,1,0,0,1,0
8393,10,2,0,0,2,0
8393,9,1,0,0,1,0
8393,8,1,0,0,1,0
8393,1,2,0,0,2,0
4364,4,2,0,0,2,0
209926,6,11,0,0,11,0
209926,2,1,0,0,1,0
23657,10,1,0,0,1,0
4555,9,1,0,0,1,0
4555,4,7,0,0,7,0
220707,10,1,0,0,1,0
220707,3,3,0,0,3,0
3314,10,1,0,0,1,0
3314,9,1,0,0,1,0
3314,8,5,0,0,5,0
3314,1,1,0,0,1,0
206274,10,2,0,0,2,0
206274,8,4,0,0,4,0
206274,7,3,0,0,3,0
206274,5,12,0,0,12,0
118515,10,1,0,0,1,0
118515,9,2,0,0,2,0
198671,4,2,0,0,2,0
4175,9,1,0,0,1,0
4175,1,2,0,0,2,0
172599,10,5,0,0,5,0
172599,9,6,0,0,6,0
172599,5,7,0,0,7,0
172599,4,6,0,0,6,0
172599,3,2,0,0,2,0
143520,9,2,0,0,2,0
143520,5,4,0,0,4,0
7739,1,1,0,0,1,0
194820,4,4,0,0,4,0
235628,10,1,0,0,1,0
235628,9,3,0,0,3,0
235628,2,2,0,0,2,0
209734,4,6,0,0,6,0
209734,3,2,0,0,2,0
209734,2,2,0,0,2,0
209734,1,1,0,0,1,0
84913,5,5,0,0,5,0
93678,10,1,0,0,1,0
93678,9,2,0,0,2,0
93678,1,1,0,0,1,0
5244,10,2,0,0,2,0
5244,1,2,0,0,2,0
145401,10,1,0,0,1,0
145401,9,1,0,0,1,0
145401,4,12,0,0,12,0
145401,2,1,0,0,1,0
5038,10,4,0,0,4,0
5038,4,2,0,0,2,0
2480,9,4,0,0,4,0
138195,8,3,0,0,3,0
212873,5,17,0,0,17,0
8475,10,1,0,0,1,0
8475,9,1,0,0,1,0
119194,8,1,0,0,1,0
119194,5,24,0,0,24,0
119194,1,1,0,0,1,0
180355,10,2,0,0,2,0
180355,4,2,0,0,2,0
180355,3,1,0,0,1,0
4297,4,14,0,0,14,0
4297,1,1,0,0,1,0
169934,10,1,0,0,1,0
169934,9,1,0,0,1,0
214880,6,4,0,0,4,0
214880,5,2,0,0,2,0
4902,10,1,0,0,1,0
4902,7,4,0,0,4,0
4902,1,2,0,0,2,0
174219,10,1,0,0,1,0
174219,7,30,0,0,30,0
174219,4,1,0,0,1,0
174219,3,1,0,0,1,0
3035,10,2,0,0,2,0
3035,3,1,0,0,1,0
4374,8,3,0,0,3,0
191991,5,3,0,0,3,0
191991,4,1,0,0,1,0
238412,3,2,0,0,2,0
238412,1,1,0,0,1,0
191296,5,1,0,0,1,0
246530,9,4,0,0,4,0
106929,10,1,0,0,1,0
106929,9,3,0,0,3,0
106929,1,1,0,0,1,0
13715,10,2,0,0,2,0
13715,9,2,0,0,2,0
236931,5,3,0,0,3,0
12211,10,2,0,0,2,0
12211,9,1,0,0,1,0
12211,4,3,0,0,3,0
573,10,1,0,0,1,0
51197,10,1,0,0,1,0
258752,4,1,0,0,1,0
690,10,2,0,0,2,0
690,9,3,0,0,3,0
571,10,1,0,0,1,0
571,4,3,0,0,3,0
4500,10,2,0,0,2,0
4500,3,1,0,0,1,0
8362,10,4,0,0,4,0
8362,2,1,0,0,1,0
180674,2,3,0,0,3,0
2799,10,2,0,0,2,0
2799,9,1,0,0,1,0
2799,8,2,0,0,2,0
194088,10,1,0,0,1,0
194088,9,2,0,0,2,0
194088,4,7,0,0,7,0
194088,3,2,0,0,2,0
14511,7,4,0,0,4,0
11160,10,1,0,0,1,0
11160,8,9,0,0,9,0
11160,3,3,0,0,3,0
11160,2,2,0,0,2,0
11160,1,1,0,0,1,0
60342,9,1,0,0,1,0
16387,7,2,0,0,2,0
146207,6,7,0,0,7,0
146207,5,1,0,0,1,0
240957,10,1,0,0,1,0
240957,4,1,0,0,1,0
240957,2,1,0,0,1,0
154553,2,3,0,0,3,0
4366,4,1,0,0,1,0
3793,2,1,0,0,1,0
129939,9,1,0,0,1,0
129939,8,1,0,0,1,0
129939,7,3,0,0,3,0
140594,3,4,0,0,4,0
247417,6,3,0,0,3,0
247417,5,4,0,0,4,0
247417,4,1,0,0,1,0
9017,10,1,0,0,1,0
9017,8,3,0,0,3,0
9017,3,4,0,0,4,0
9017,1,2,0,0,2,0
231045,10,4,0,0,4,0
231045,7,15,0,0,15,0
231045,4,4,0,0,4,0
231045,2,2,0,0,2,0
1105,3,4,0,0,4,0
214747,10,6,0,0,6,0
214747,6,8,0,0,8,0
206463,9,3,0,0,3,0
206463,5,5,0,0,5,0
7605,9,1,0,0,1,0
7605,8,6,0,0,6,0
7605,1,8,0,0,8,0
9135,4,2,0,0,2,0
9135,1,1,0,0,1,0
2602,3,1,0,0,1,0
2602,2,2,0,0,2,0
167650,4,1,0,0,1,0
167650,1,3,0,0,3,0
156722,9,2,0,0,2,0
156722,5,11,0,0,11,0
156722,3,1,0,0,1,0
6668,7,4,0,0,4,0
5858,10,3,0,0,3,0
5858,4,6,0,0,6,0
5858,1,1,0,0,1,0
209649,3,2,0,0,2,0
209649,1,1,0,0,1,0
90855,10,2,0,0,2,0
90855,2,4,0,0,4,0
90855,1,1,0,0,1,0
7999,3,5,0,0,5,0
206925,10,2,0,0,2,0
206925,8,18,0,0,18,0
206925,1,1,0,0,1,0
182556,4,6,0,0,6,0
182556,3,7,0,0,7,0
182556,2,1,0,0,1,0
182556,1,1,0,0,1,0
31443,10,6,0,0,6,0
146290,9,1,0,0,1,0
146290,3,2,0,0,2,0
8517,10,1,0,0,1,0
3209,10,1,0,0,1,0
3209,9,2,0,0,2,0
162191,9,2,0,0,2,0
162191,7,17,0,0,17,0
162191,4,6,0,0,6,0
162191,2,1,0,0,1,0
17700,10,1,0,0,1,0
17700,9,2,0,0,2,0
17700,8,3,0,0,3,0
17700,1,1,0,0,1,0
208804,10,3,0,0,3,0
208804,6,5,0,0,5,0
208804,3,1,0,0,1,0
181268,10,7,0,0,7,0
181268,9,3,0,0,3,0
181268,4,3,0,0,3,0
181268,3,2,0,0,2,0
75382,2,1,0,0,1,0
2300,10,1,0,0,1,0
2300,9,1,0,0,1,0
2300,5,6,0,0,6,0
2300,4,2,0,0,2,0
9506,10,1,0,0,1,0
59602,8,7,0,0,7,0
59602,4,8,0,0,8,0
182090,10,4,0,0,4,0
182090,7,12,0,0,12,0
324,2,1,0,0,1,0
264476,7,4,0,0,4,0
264476,6,1,0,0,1,0
4952,10,1,0,0,1,0
4952,2,3,0,0,3,0
143657,10,1,0,0,1,0
143657,6,17,0,0,17,0
143657,3,2,0,0,2,0
13920,4,4,0,0,4,0
231674,9,1,0,0,1,0
231674,3,3,0,0,3,0
231674,1,2,0,0,2,0
650,9,3,0,0,3,0
134964,10,1,0,0,1,0
134964,4,2,0,0,2,0
134964,3,1,0,0,1,0
134964,2,1,0,0,1,0
1651,9,3,0,0,3,0
8103,10,6,0,0,6,0
8103,9,2,0,0,2,0
8103,1,2,0,0,2,0
5940,5,9,0,0,9,0
5940,3,2,0,0,2,0
168549,10,1,0,0,1,0
168549,4,6,0,0,6,0
193422,9,3,0,0,3,0
193422,4,3,0,0,3,0
109718,9,1,0,0,1,0
109718,2,2,0,0,2,0
223312,5,6,0,0,6,0
223312,4,2,0,0,2,0
223312,3,1,0,0,1,0
65554,3,1,0,0,1,0
65554,2,1,0,0,1,0
201345,1,1,0,0,1,0
188129,10,1,0,0,1,0
188129,9,4,0,0,4,0
146204,10,5,0,0,5,0
146204,2,1,0,0,1,0
35003,4,3,0,0,3,0
35003,1,1,0,0,1,0
234946,10,3,0,0,3,0
234946,4,2,0,0,2,0
234946,3,3,0,0,3,0
150049,10,5,0,0,5,0
150049,9,5,0,0,5,0
150049,3,1,0,0,1,0
808,9,2,0,0,2,0
808,2,2,0,0,2,0
244267,9,2,0,0,2,0
244267,2,1,0,0,1,0
1367,10,2,0,0,2,0
1367,1,1,0,0,1,0
147563,10,1,0,0,1,0
147563,9,1,0,0,1,0
147563,8,20,0,0,20,0
147563,3,1,0,0,1,0
146596,1,2,0,0,2,0
564,2,2,0,0,2,0
3885,10,1,0,0,1,0
3885,3,1,0,0,1,0
2176,10,1,0,0,1,0
2176,9,1,0,0,1,0
2176,8,2,0,0,2,0
98975,10,3,0,0,3,0
98975,4,3,0,0,3,0
8756,10,1,0,0,1,0
8756,3,2,0,0,2,0
8756,2,1,0,0,1,0
8756,1,1,0,0,1,0
224664,9,1,0,0,1,0
224664,3,2,0,0,2,0
224664,2,1,0,0,1,0
224664,1,1,0,0,1,0
11464,10,1,0,0,1,0
11464,2,2,0,0,2,0
5420,10,1,0,0,1,0
230968,5,7,0,0,7,0
230968,4,3,0,0,3,0
230968,3,1,0,0,1,0
180910,10,1,0,0,1,0
180910,9,2,0,0,2,0
180910,1,1,0,0,1,0
91831,10,1,0,0,1,0
91831,2,1,0,0,1,0
188793,10,2,0,0,2,0
188793,5,11,0,0,11,0
90142,10,1,0,0,1,0
90142,3,2,0,0,2,0
10269,10,1,0,0,1,0
10269,4,4,0,0,4,0
10269,3,1,0,0,1,0
183836,4,1,0,0,1,0
183836,3,1,0,0,1,0
37383,2,1,0,0,1,0
37383,1,1,0,0,1,0
104736,10,1,0,0,1,0
104736,2,1,0,0,1,0
104736,1,1,0,0,1,0
3807,9,1,0,0,1,0
3807,5,2,0,0,2,0
3807,2,1,0,0,1,0
109005,8,9,0,0,9,0
174298,6,1,0,0,1,0
174298,1,1,0,0,1,0
91739,10,4,0,0,4,0
91739,3,1,0,0,1,0
6532,9,1,0,0,1,0
6532,8,1,0,0,1,0
6532,7,8,0,0,8,0
6532,2,10,0,0,10,0
6532,1,3,0,0,3,0
202582,10,2,0,0,2,0
202582,8,15,0,0,15,0
6022,1,1,0,0,1,0
8140,9,4,0,0,4,0
65565,4,1,0,0,1,0
65565,1,1,0,0,1,0
3000,10,3,0,0,3,0
3000,3,1,0,0,1,0
3000,1,1,0,0,1,0
204201,9,7,0,0,7,0
204201,4,3,0,0,3,0
204201,1,1,0,0,1,0
253679,9,5,0,0,5,0
253679,5,3,0,0,3,0
253679,4,3,0,0,3,0
253679,2,1,0,0,1,0
165551,9,1,0,0,1,0
126550,5,10,0,0,10,0
126550,4,4,0,0,4,0
191895,10,2,0,0,2,0
191895,9,1,0,0,1,0
191895,8,16,0,0,16,0
191895,5,12,0,0,12,0
191895,4,1,0,0,1,0
191895,3,1,0,0,1,0
58707,9,1,0,0,1,0
58707,8,9,0,0,9,0
58707,5,11,0,0,11,0
81297,9,3,0,0,3,0
81297,3,1,0,0,1,0
3574,10,1,0,0,1,0
3574,9,1,0,0,1,0
37394,9,1,0,0,1,0
2403,7,7,0,0,7,0
2403,2,2,0,0,2,0
11001,2,2,0,0,2,0
11001,1,2,0,0,2,0
791,9,1,0,0,1,0
136279,10,1,0,0,1,0
220284,3,1,0,0,1,0
220284,1,1,0,0,1,0
196698,3,1,0,0,1,0
196698,1,1,0,0,1,0
22029,3,2,0,0,2,0
3077,10,1,0,0,1,0
3077,9,4,0,0,4,0
3077,2,2,0,0,2,0
1657,9,1,0,0,1,0
1657,4,9,0,0,9,0
6009,10,2,0,0,2,0
6009,3,2,0,0,2,0
3603,10,1,0,0,1,0
3603,4,4,0,0,4,0
3603,1,1,0,0,1,0
55781,10,1,0,0,1,0
55781,9,1,0,0,1,0
123991,9,2,0,0,2,0
123991,8,5,0,0,5,0
123991,7,14,0,0,14,0
123991,5,14,0,0,14,0
123991,4,9,0,0,9,0
114316,4,4,0,0,4,0
227466,5,4,0,0,4,0
227466,2,1,0,0,1,0
35910,10,2,0,0,2,0
230424,4,3,0,0,3,0
1063,10,1,0,0,1,0
1063,8,3,0,0,3,0
8304,9,4,0,0,4,0
8304,2,2,0,0,2,0
8304,1,1,0,0,1,0
14538,8,3,0,0,3,0
14538,7,4,0,0,4,0
165797,10,1,0,0,1,0
165797,9,2,0,0,2,0
165797,2,1,0,0,1,0
146864,10,1,0,0,1,0
146864,3,6,0,0,6,0
146864,2,3,0,0,3,0
141825,4,1,0,0,1,0
141825,3,1,0,0,1,0
70376,9,2,0,0,2,0
70376,4,5,0,0,5,0
70376,3,6,0,0,6,0
70376,2,2,0,0,2,0
70376,1,1,0,0,1,0
18588,9,1,0,0,1,0
18588,3,1,0,0,1,0
18588,2,2,0,0,2,0
208256,5,6,0,0,6,0
208256,4,1,0,0,1,0
208256,3,1,0,0,1,0
173005,9,2,0,0,2,0
173005,1,1,0,0,1,0
7377,3,1,0,0,1,0
7377,1,1,0,0,1,0
42066,8,4,0,0,4,0
42066,5,7,0,0,7,0
42066,2,2,0,0,2,0
42066,1,1,0,0,1,0
9583,3,5,0,0,5,0
9583,2,2,0,0,2,0
9583,1,1,0,0,1,0
8332,10,2,0,0,2,0
172035,8,5,0,0,5,0
172035,3,1,0,0,1,0
250821,4,1,0,0,1,0
175090,9,2,0,0,2,0
175090,8,3,0,0,3,0
175090,1,3,0,0,3,0
153213,5,6,0,0,6,0
153213,1,1,0,0,1,0
43693,10,3,0,0,3,0
707,10,2,0,0,2,0
179547,6,3,0,0,3,0
179547,5,2,0,0,2,0
179547,4,1,0,0,1,0
179547,3,2,0,0,2,0
179547,2,1,0,0,1,0
179547,1,4,0,0,4,0
33259,10,3,0,0,3,0
33259,5,3,0,0,3,0
154477,3,3,0,0,3,0
801,10,1,0,0,1,0
2369,3,1,0,0,1,0
2369,2,1,0,0,1,0
104558,4,5,0,0,5,0
8965,10,1,0,0,1,0
8965,3,1,0,0,1,0
8965,1,1,0,0,1,0
180908,9,1,0,0,1,0
180908,3,2,0,0,2,0
9077,10,3,0,0,3,0
9077,4,1,0,0,1,0
9077,1,2,0,0,2,0
111119,10,6,0,0,6,0
111119,9,3,0,0,3,0
111119,4,1,0,0,1,0
111119,3,2,0,0,2,0
13654,10,1,0,0,1,0
13654,2,1,0,0,1,0
3516,10,1,0,0,1,0
3516,4,5,0,0,5,0
3516,1,1,0,0,1,0
18875,9,2,0,0,2,0
6010,8,3,0,0,3,0
6010,1,2,0,0,2,0
66551,8,6,0,0,6,0
66551,1,2,0,0,2,0
8479,9,1,0,0,1,0
8479,1,1,0,0,1,0
56943,4,2,0,0,2,0
56943,3,1,0,0,1,0
15383,8,4,0,0,4,0
15383,3,1,0,0,1,0
15383,1,1,0,0,1,0
783,1,1,0,0,1,0
221263,6,28,0,0,28,0
221263,2,2,0,0,2,0
221263,1,1,0,0,1,0
148940,10,1,0,0,1,0
148940,4,12,0,0,12,0
148940,2,3,0,0,3,0
148940,1,1,0,0,1,0
203885,10,3,0,0,3,0
203885,5,4,0,0,4,0
203885,4,4,0,0,4,0
16620,8,2,0,0,2,0
16620,1,1,0,0,1,0
6040,10,1,0,0,1,0
6040,9,1,0,0,1,0
30261,9,2,0,0,2,0
191906,5,12,0,0,12,0
191906,1,2,0,0,2,0
105864,3,2,0,0,2,0
127646,9,3,0,0,3,0
127646,3,3,0,0,3,0
127646,2,1,0,0,1,0
19416,4,3,0,0,3,0
19416,1,1,0,0,1,0
20269,10,2,0,0,2,0
20269,4,2,0,0,2,0
26604,3,2,0,0,2,0
26604,2,1,0,0,1,0
26604,1,1,0,0,1,0
3457,1,1,0,0,1,0
224060,3,2,0,0,2,0
224060,2,1,0,0,1,0
101335,8,2,0,0,2,0
189154,10,1,0,0,1,0
189154,9,5,0,0,5,0
189154,2,1,0,0,1,0
225736,10,3,0,0,3,0
165889,2,1,0,0,1,0
6363,10,2,0,0,2,0
6363,1,2,0,0,2,0
25204,9,1,0,0,1,0
25204,8,4,0,0,4,0
25204,2,1,0,0,1,0
95115,8,8,0,0,8,0
95115,5,8,0,0,8,0
141089,9,5,0,0,5,0
141089,4,5,0,0,5,0
141089,3,2,0,0,2,0
11899,3,3,0,0,3,0
11899,2,2,0,0,2,0
36790,9,1,0,0,1,0
36790,2,1,0,0,1,0
202490,10,2,0,0,2,0
202490,5,7,0,0,7,0
4893,2,4,0,0,4,0
1443,2,2,0,0,2,0
1443,1,1,0,0,1,0
6840,9,2,0,0,2,0
195253,10,3,0,0,3,0
195253,9,5,0,0,5,0
195253,5,11,0,0,11,0
195253,2,1,0,0,1,0
21343,3,3,0,0,3,0
934,8,3,0,0,3,0
934,2,3,0,0,3,0
5993,3,1,0,0,1,0
207311,8,7,0,0,7,0
207311,1,1,0,0,1,0
137179,10,1,0,0,1,0
137179,3,2,0,0,2,0
15196,9,1,0,0,1,0
1703,8,1,0,0,1,0
8747,2,1,0,0,1,0
8747,1,1,0,0,1,0
84230,10,2,0,0,2,0
84230,9,4,0,0,4,0
84230,2,4,0,0,4,0
32849,10,1,0,0,1,0
32849,2,2,0,0,2,0
32849,1,1,0,0,1,0
42361,2,1,0,0,1,0
42361,1,1,0,0,1,0
4240,10,1,0,0,1,0
4240,7,6,0,0,6,0
231644,10,1,0,0,1,0
231644,9,4,0,0,4,0
231644,4,2,0,0,2,0
231644,3,1,0,0,1,0
231644,2,1,0,0,1,0
781,2,4,0,0,4,0
136,3,2,0,0,2,0
136,1,1,0,0,1,0
166019,9,1,0,0,1,0
166019,8,14,0,0,14,0
166019,3,2,0,0,2,0
166019,2,2,0,0,2,0
166019,1,1,0,0,1,0
130734,10,1,0,0,1,0
130734,9,1,0,0,1,0
130734,8,8,0,0,8,0
2563,2,2,0,0,2,0
2563,1,1,0,0,1,0
2751,10,1,0,0,1,0
85004,10,1,0,0,1,0
85004,1,1,0,0,1,0
4623,9,2,0,0,2,0
16232,10,1,0,0,1,0
16232,7,3,0,0,3,0
16232,2,7,0,0,7,0
184462,9,4,0,0,4,0
184462,3,1,0,0,1,0
184462,1,1,0,0,1,0
123635,1,1,0,0,1,0
38680,10,1,0,0,1,0
38680,4,1,0,0,1,0
8471,2,2,0,0,2,0
184170,6,14,0,0,14,0
184170,5,5,0,0,5,0
184170,4,1,0,0,1,0
184170,1,1,0,0,1,0
42380,9,2,0,0,2,0
26089,9,1,0,0,1,0
194307,5,5,0,0,5,0
194307,3,2,0,0,2,0
194307,1,1,0,0,1,0
11482,3,2,0,0,2,0
11482,2,3,0,0,3,0
7636,10,4,0,0,4,0
7636,4,2,0,0,2,0
7636,3,1,0,0,1,0
7636,1,1,0,0,1,0
256838,10,1,0,0,1,0
256838,5,9,0,0,9,0
163565,9,4,0,0,4,0
163565,3,1,0,0,1,0
163565,1,1,0,0,1,0
17735,10,2,0,0,2,0
17735,4,7,0,0,7,0
17735,3,1,0,0,1,0
17735,1,1,0,0,1,0
222951,4,3,0,0,3,0
222951,3,1,0,0,1,0
240827,10,2,0,0,2,0
240827,1,1,0,0,1,0
14236,10,2,0,0,2,0
14236,1,1,0,0,1,0
195353,1,1,0,0,1,0
175855,1,1,0,0,1,0
94481,9,1,0,0,1,0
94481,1,2,0,0,2,0
43196,9,6,0,0,6,0
225976,9,6,0,0,6,0
225976,4,2,0,0,2,0
117862,2,4,0,0,4,0
168265,6,25,0,0,25,0
168265,4,2,0,0,2,0
184800,10,4,0,0,4,0
184800,4,1,0,0,1,0
184800,3,1,0,0,1,0
2337,9,1,0,0,1,0
2337,8,6,0,0,6,0
2337,5,17,0,0,17,0
193029,9,1,0,0,1,0
193029,3,4,0,0,4,0
193029,2,1,0,0,1,0
159865,10,1,0,0,1,0
159865,8,11,0,0,11,0
159865,2,1,0,0,1,0
131199,9,1,0,0,1,0
38577,10,1,0,0,1,0
38577,9,2,0,0,2,0
38577,2,1,0,0,1,0
38577,1,3,0,0,3,0
141980,4,9,0,0,9,0
141980,2,2,0,0,2,0
8491,10,1,0,0,1,0
8491,9,1,0,0,1,0
8491,8,3,0,0,3,0
8491,3,3,0,0,3,0
131393,1,1,0,0,1,0
125549,10,1,0,0,1,0
125549,9,4,0,0,4,0
125549,3,2,0,0,2,0
251037,3,1,0,0,1,0
251037,2,4,0,0,4,0
4494,4,7,0,0,7,0
11964,9,4,0,0,4,0
11964,2,1,0,0,1,0
177619,5,6,0,0,6,0
177619,4,1,0,0,1,0
177619,3,1,0,0,1,0
177619,2,1,0,0,1,0
54986,9,1,0,0,1,0
54986,3,3,0,0,3,0
2277,4,4,0,0,4,0
2277,3,1,0,0,1,0
3547,9,1,0,0,1,0
3050,6,6,0,0,6,0
3050,5,1,0,0,1,0
149069,10,2,0,0,2,0
149069,3,2,0,0,2,0
236305,5,2,0,0,2,0
236305,1,1,0,0,1,0
24141,9,1,0,0,1,0
24141,8,6,0,0,6,0
24141,3,2,0,0,2,0
3270,10,3,0,0,3,0
856,2,1,0,0,1,0
856,1,1,0,0,1,0
211454,4,2,0,0,2,0
194536,10,2,0,0,2,0
194536,9,1,0,0,1,0
194536,5,13,0,0,13,0
194536,4,10,0,0,10,0
194536,3,1,0,0,1,0
217424,7,17,0,0,17,0
217424,4,8,0,0,8,0
217424,1,1,0,0,1,0
8336,9,1,0,0,1,0
204281,10,3,0,0,3,0
204281,3,3,0,0,3,0
708,4,4,0,0,4,0
708,3,2,0,0,2,0
708,1,1,0,0,1,0
22790,10,2,0,0,2,0
22790,9,2,0,0,2,0
22790,2,1,0,0,1,0
104780,3,3,0,0,3,0
104780,2,1,0,0,1,0
103828,9,1,0,0,1,0
5065,4,3,0,0,3,0
665,10,1,0,0,1,0
32337,10,1,0,0,1,0
7382,5,2,0,0,2,0
7382,4,1,0,0,1,0
181807,1,1,0,0,1,0
51067,8,5,0,0,5,0
51067,7,8,0,0,8,0
51067,1,1,0,0,1,0
39375,10,1,0,0,1,0
39375,9,1,0,0,1,0
180006,8,6,0,0,6,0
180006,3,1,0,0,1,0
1259,8,2,0,0,2,0
1259,1,1,0,0,1,0
30879,10,1,0,0,1,0
30879,4,6,0,0,6,0
98352,9,2,0,0,2,0
98352,3,1,0,0,1,0
98352,2,1,0,0,1,0
134777,7,9,0,0,9,0
134777,5,6,0,0,6,0
233094,10,1,0,0,1,0
233094,4,6,0,0,6,0
233094,2,1,0,0,1,0
233094,1,1,0,0,1,0
22839,8,3,0,0,3,0
22839,1,5,0,0,5,0
186295,9,3,0,0,3,0
7267,10,1,0,0,1,0
7267,9,2,0,0,2,0
175263,10,1,0,0,1,0
175263,5,9,0,0,9,0
175263,3,1,0,0,1,0
175263,1,1,0,0,1,0
11429,5,4,0,0,4,0
11429,1,1,0,0,1,0
214970,10,1,0,0,1,0
1680,9,1,0,0,1,0
1680,5,12,0,0,12,0
1680,3,3,0,0,3,0
1680,2,1,0,0,1,0
14523,1,1,0,0,1,0
33208,8,4,0,0,4,0
33208,3,1,0,0,1,0
33208,2,2,0,0,2,0
6,3,1,0,0,1,0
4960,10,2,0,0,2,0
4960,9,3,0,0,3,0
4960,2,1,0,0,1,0
24013,10,1,0,0,1,0
24013,9,1,0,0,1,0
160550,2,1,0,0,1,0
207351,3,1,0,0,1,0
207351,1,1,0,0,1,0
208807,10,1,0,0,1,0
208807,9,5,0,0,5,0
208807,3,3,0,0,3,0
208807,2,2,0,0,2,0
217012,3,1,0,0,1,0
39070,10,2,0,0,2,0
39070,2,1,0,0,1,0
196031,9,1,0,0,1,0
196031,3,5,0,0,5,0
196031,2,2,0,0,2,0
196031,1,2,0,0,2,0
39536,3,4,0,0,4,0
22090,8,2,0,0,2,0
5519,3,1,0,0,1,0
13926,9,2,0,0,2,0
13926,2,1,0,0,1,0
13926,1,1,0,0,1,0
5702,10,1,0,0,1,0
5702,5,3,0,0,3,0
180387,4,3,0,0,3,0
7378,2,1,0,0,1,0
42636,4,10,0,0,10,0
42636,2,1,0,0,1,0
129609,9,1,0,0,1,0
129609,4,10,0,0,10,0
129609,3,2,0,0,2,0
1136,8,4,0,0,4,0
1136,2,4,0,0,4,0
24053,9,1,0,0,1,0
24053,1,2,0,0,2,0
13295,7,12,0,0,12,0
13295,2,1,0,0,1,0
189030,10,3,0,0,3,0
189030,6,17,0,0,17,0
189030,5,3,0,0,3,0
189030,4,3,0,0,3,0
189030,2,1,0,0,1,0
169986,4,2,0,0,2,0
163242,10,3,0,0,3,0
163242,8,3,0,0,3,0
163242,2,3,0,0,3,0
1649,10,2,0,0,2,0
1649,2,2,0,0,2,0
156453,10,1,0,0,1,0
156453,3,1,0,0,1,0
156453,2,1,0,0,1,0
2784,9,1,0,0,1,0
2784,7,10,0,0,10,0
2784,2,5,0,0,5,0
124958,10,1,0,0,1,0
124958,9,2,0,0,2,0
124958,2,5,0,0,5,0
124958,1,1,0,0,1,0
186020,9,16,0,0,16,0
186020,7,4,0,0,4,0
186020,6,8,0,0,8,0
186020,5,1,0,0,1,0
186020,4,2,0,0,2,0
186020,1,1,0,0,1,0
189504,5,4,0,0,4,0
189504,1,1,0,0,1,0
8985,2,2,0,0,2,0
7625,3,1,0,0,1,0
7625,2,3,0,0,3,0
103328,9,3,0,0,3,0
103328,4,4,0,0,4,0
103328,3,2,0,0,2,0
103328,2,2,0,0,2,0
103328,1,1,0,0,1,0
131282,1,1,0,0,1,0
197944,10,3,0,0,3,0
197944,4,2,0,0,2,0
112118,3,1,0,0,1,0
19888,9,1,0,0,1,0
8459,9,1,0,0,1,0
183778,10,1,0,0,1,0
183778,9,1,0,0,1,0
186904,10,2,0,0,2,0
186904,6,10,0,0,10,0
186904,4,1,0,0,1,0
9540,9,1,0,0,1,0
9540,8,2,0,0,2,0
33018,10,3,0,0,3,0
7503,10,1,0,0,1,0
7503,9,5,0,0,5,0
7503,4,1,0,0,1,0
7503,2,1,0,0,1,0
8193,2,1,0,0,1,0
8193,1,1,0,0,1,0
92177,10,1,0,0,1,0
92177,3,3,0,0,3,0
27042,9,3,0,0,3,0
27042,2,1,0,0,1,0
2864,9,2,0,0,2,0
81691,4,1,0,0,1,0
81691,3,1,0,0,1,0
131982,9,1,0,0,1,0
131982,7,10,0,0,10,0
131982,1,3,0,0,3,0
4861,1,1,0,0,1,0
131933,9,1,0,0,1,0
1653,8,1,0,0,1,0
202652,4,3,0,0,3,0
119500,8,6,0,0,6,0
119500,7,8,0,0,8,0
119500,2,3,0,0,3,0
32885,8,4,0,0,4,0
131416,9,3,0,0,3,0
131416,4,3,0,0,3,0
6647,9,1,0,0,1,0
6647,8,5,0,0,5,0
6647,4,7,0,0,7,0
6647,3,14,0,0,14,0
42216,10,5,0,0,5,0
42216,8,7,0,0,7,0
42216,2,1,0,0,1,0
139779,3,5,0,0,5,0
139779,1,1,0,0,1,0
77596,9,1,0,0,1,0
77596,1,3,0,0,3,0
7869,7,2,0,0,2,0
7869,1,2,0,0,2,0
43856,9,1,0,0,1,0
234439,4,4,0,0,4,0
234439,3,1,0,0,1,0
234439,2,2,0,0,2,0
63899,10,1,0,0,1,0
63899,2,1,0,0,1,0
7849,10,3,0,0,3,0
7849,1,1,0,0,1,0
3080,9,1,0,0,1,0
3080,2,2,0,0,2,0
108155,8,6,0,0,6,0
108155,3,2,0,0,2,0
108155,2,1,0,0,1,0
8402,4,1,0,0,1,0
5549,5,2,0,0,2,0
5549,3,1,0,0,1,0
5549,1,1,0,0,1,0
220499,9,4,0,0,4,0
220499,1,1,0,0,1,0
14314,1,2,0,0,2,0
253185,4,1,0,0,1,0
253185,1,1,0,0,1,0
7473,10,1,0,0,1,0
7473,9,1,0,0,1,0
7473,1,2,0,0,2,0
7058,10,2,0,0,2,0
7058,4,7,0,0,7,0
7058,3,1,0,0,1,0
7058,2,1,0,0,1,0
90730,4,2,0,0,2,0
90730,3,1,0,0,1,0
21012,10,1,0,0,1,0
21012,3,2,0,0,2,0
21012,2,1,0,0,1,0
21012,1,1,0,0,1,0
147400,3,1,0,0,1,0
85609,6,3,0,0,3,0
6553,2,2,0,0,2,0
114800,9,8,0,0,8,0
114800,7,13,0,0,13,0
114800,6,13,0,0,13,0
114800,5,3,0,0,3,0
114800,4,2,0,0,2,0
114800,3,1,0,0,1,0
6509,10,4,0,0,4,0
11955,9,2,0,0,2,0
164566,10,3,0,0,3,0
164566,9,3,0,0,3,0
164566,3,1,0,0,1,0
28289,10,2,0,0,2,0
211996,10,3,0,0,3,0
211996,9,4,0,0,4,0
211996,3,2,0,0,2,0
211996,1,1,0,0,1,0
8913,10,1,0,0,1,0
8913,4,6,0,0,6,0
7847,10,1,0,0,1,0
7847,9,1,0,0,1,0
185028,2,1,0,0,1,0
185028,1,4,0,0,4,0
4273,10,1,0,0,1,0
186905,9,3,0,0,3,0
186905,4,5,0,0,5,0
186905,2,1,0,0,1,0
266967,9,10,0,0,10,0
266967,6,6,0,0,6,0
3005,10,3,0,0,3,0
410,10,1,0,0,1,0
410,9,1,0,0,1,0
260788,4,4,0,0,4,0
130393,3,1,0,0,1,0
191432,9,3,0,0,3,0
191432,4,6,0,0,6,0
191432,2,1,0,0,1,0
201446,4,1,0,0,1,0
201446,3,2,0,0,2,0
852,2,1,0,0,1,0
183402,9,3,0,0,3,0
183402,5,10,0,0,10,0
183402,4,2,0,0,2,0
160773,10,1,0,0,1,0
160773,9,5,0,0,5,0
160773,7,12,0,0,12,0
160773,6,19,0,0,19,0
160773,3,3,0,0,3,0
12420,8,2,0,0,2,0
12420,2,1,0,0,1,0
703,10,2,0,0,2,0
703,4,1,0,0,1,0
703,3,1,0,0,1,0
226006,5,2,0,0,2,0
226006,4,1,0,0,1,0
229708,9,2,0,0,2,0
229708,5,4,0,0,4,0
229708,4,1,0,0,1,0
229708,2,2,0,0,2,0
69232,3,5,0,0,5,0
455,3,1,0,0,1,0
197066,9,3,0,0,3,0
197066,2,2,0,0,2,0
193725,5,1,0,0,1,0
193725,1,1,0,0,1,0
39447,10,1,0,0,1,0
39447,9,2,0,0,2,0
39447,3,3,0,0,3,0
182228,10,1,0,0,1,0
182228,9,2,0,0,2,0
182228,3,1,0,0,1,0
5494,3,1,0,0,1,0
5494,1,1,0,0,1,0
97287,8,2,0,0,2,0
21182,10,3,0,0,3,0
21182,2,1,0,0,1,0
158888,5,1,0,0,1,0
158888,3,1,0,0,1,0
99573,6,4,0,0,4,0
99573,5,2,0,0,2,0
99573,1,1,0,0,1,0
216907,10,1,0,0,1,0
216907,9,2,0,0,2,0
216907,5,6,0,0,6,0
216907,4,13,0,0,13,0
216907,2,2,0,0,2,0
97683,5,2,0,0,2,0
97683,2,1,0,0,1,0
153780,9,1,0,0,1,0
153780,8,1,0,0,1,0
153780,7,10,0,0,10,0
2616,2,2,0,0,2,0
2616,1,1,0,0,1,0
1626,9,1,0,0,1,0
1626,1,2,0,0,2,0
174252,2,1,0,0,1,0
174252,1,1,0,0,1,0
215503,3,1,0,0,1,0
163601,8,8,0,0,8,0
163601,5,8,0,0,8,0
163601,4,3,0,0,3,0
38050,9,3,0,0,3,0
5136,4,5,0,0,5,0
60697,7,7,0,0,7,0
24826,7,12,0,0,12,0
24826,2,2,0,0,2,0
176872,2,1,0,0,1,0
176872,1,2,0,0,2,0
135530,4,2,0,0,2,0
20281,9,2,0,0,2,0
20281,6,11,0,0,11,0
20281,1,1,0,0,1,0
227127,6,2,0,0,2,0
183508,6,27,0,0,27,0
183508,5,13,0,0,13,0
183508,4,3,0,0,3,0
183508,2,1,0,0,1,0
183508,1,3,0,0,3,0
2314,1,1,0,0,1,0
21849,9,3,0,0,3,0
21849,7,12,0,0,12,0
21849,5,16,0,0,16,0
21849,3,3,0,0,3,0
36616,9,1,0,0,1,0
36616,3,2,0,0,2,0
36616,2,1,0,0,1,0
136585,9,3,0,0,3,0
136585,1,1,0,0,1,0
10346,2,1,0,0,1,0
10346,1,1,0,0,1,0
217470,9,2,0,0,2,0
217470,5,3,0,0,3,0
34276,2,1,0,0,1,0
34276,1,2,0,0,2,0
104769,9,1,0,0,1,0
104769,3,1,0,0,1,0
104769,2,2,0,0,2,0
104769,1,1,0,0,1,0
191901,9,4,0,0,4,0
191901,4,1,0,0,1,0
191901,2,2,0,0,2,0
8720,10,1,0,0,1,0
8720,8,7,0,0,7,0
8720,4,3,0,0,3,0
8720,3,1,0,0,1,0
1936,9,1,0,0,1,0
256883,10,5,0,0,5,0
256883,2,1,0,0,1,0
223763,2,1,0,0,1,0
41834,10,1,0,0,1,0
240271,7,2,0,0,2,0
240271,6,3,0,0,3,0
108080,9,3,0,0,3,0
108080,4,2,0,0,2,0
108080,2,1,0,0,1,0
92046,10,1,0,0,1,0
167404,9,5,0,0,5,0
167404,7,25,0,0,25,0
167404,1,1,0,0,1,0
194392,5,1,0,0,1,0
194392,2,1,0,0,1,0
194392,1,1,0,0,1,0
133524,5,5,0,0,5,0
133524,3,3,0,0,3,0
133524,1,1,0,0,1,0
145675,4,4,0,0,4,0
11821,1,1,0,0,1,0
3846,1,1,0,0,1,0
1405,4,4,0,0,4,0
174696,9,2,0,0,2,0
174696,8,6,0,0,6,0
174696,3,3,0,0,3,0
17697,9,1,0,0,1,0
209190,9,1,0,0,1,0
209190,2,1,0,0,1,0
2051,8,4,0,0,4,0
2051,3,3,0,0,3,0
1547,5,3,0,0,3,0
65592,9,2,0,0,2,0
65592,6,18,0,0,18,0
108430,1,1,0,0,1,0
59008,7,11,0,0,11,0
136089,10,1,0,0,1,0
136089,9,1,0,0,1,0
136089,5,6,0,0,6,0
3979,10,1,0,0,1,0
3979,9,1,0,0,1,0
3979,8,6,0,0,6,0
3979,4,10,0,0,10,0
3979,3,1,0,0,1,0
112462,10,2,0,0,2,0
112462,3,3,0,0,3,0
5023,4,3,0,0,3,0
22843,4,3,0,0,3,0
22843,1,2,0,0,2,0
131144,5,8,0,0,8,0
131144,1,1,0,0,1,0
23954,10,3,0,0,3,0
23954,9,1,0,0,1,0
23954,4,4,0,0,4,0
23954,3,2,0,0,2,0
4048,10,1,0,0,1,0
103844,10,1,0,0,1,0
103844,1,4,0,0,4,0
166888,9,3,0,0,3,0
166888,3,1,0,0,1,0
166888,2,2,0,0,2,0
14001,3,5,0,0,5,0
14001,1,1,0,0,1,0
31070,2,1,0,0,1,0
31070,1,1,0,0,1,0
2151,10,1,0,0,1,0
2151,7,7,0,0,7,0
2151,3,1,0,0,1,0
161429,2,1,0,0,1,0
38870,10,3,0,0,3,0
38870,9,5,0,0,5,0
38870,5,2,0,0,2,0
38870,2,1,0,0,1,0
38870,1,1,0,0,1,0
136285,9,1,0,0,1,0
136285,8,2,0,0,2,0
136285,4,11,0,0,11,0
136285,3,7,0,0,7,0
136285,2,2,0,0,2,0
136285,1,1,0,0,1,0
294,4,1,0,0,1,0
3417,9,3,0,0,3,0
3417,1,1,0,0,1,0
41849,5,4,0,0,4,0
41849,4,1,0,0,1,0
41849,1,1,0,0,1,0
140986,10,5,0,0,5,0
140986,9,8,0,0,8,0
140986,5,5,0,0,5,0
140986,2,1,0,0,1,0
94140,10,1,0,0,1,0
8703,10,3,0,0,3,0
8703,3,1,0,0,1,0
142691,10,1,0,0,1,0
142691,9,1,0,0,1,0
142691,1,1,0,0,1,0
65559,8,4,0,0,4,0
205164,6,2,0,0,2,0
205164,1,1,0,0,1,0
132416,4,3,0,0,3,0
30582,9,1,0,0,1,0
30582,2,1,0,0,1,0
30582,1,1,0,0,1,0
266179,4,2,0,0,2,0
148047,10,1,0,0,1,0
148047,9,1,0,0,1,0
148047,3,3,0,0,3,0
197893,10,1,0,0,1,0
197893,9,1,0,0,1,0
197893,8,8,0,0,8,0
197893,3,2,0,0,2,0
197893,2,1,0,0,1,0
197893,1,1,0,0,1,0
189628,10,3,0,0,3,0
189628,9,3,0,0,3,0
189628,2,2,0,0,2,0
5548,7,17,0,0,17,0
5548,4,3,0,0,3,0
141428,9,3,0,0,3,0
141428,3,2,0,0,2,0
141428,1,1,0,0,1,0
124759,3,2,0,0,2,0
36788,9,2,0,0,2,0
36788,5,8,0,0,8,0
107971,8,3,0,0,3,0
107971,2,3,0,0,3,0
107971,1,2,0,0,2,0
246696,10,1,0,0,1,0
32346,3,3,0,0,3,0
32346,2,1,0,0,1,0
175848,7,12,0,0,12,0
175848,2,1,0,0,1,0
175848,1,3,0,0,3,0
31302,3,3,0,0,3,0
31302,1,1,0,0,1,0
235767,10,1,0,0,1,0
235767,9,3,0,0,3,0
235767,4,3,0,0,3,0
235767,2,1,0,0,1,0
190577,2,1,0,0,1,0
4935,10,1,0,0,1,0
4935,8,8,0,0,8,0
151416,9,1,0,0,1,0
70912,9,1,0,0,1,0
70912,8,11,0,0,11,0
70912,5,8,0,0,8,0
70912,4,7,0,0,7,0
28989,9,1,0,0,1,0
28989,8,3,0,0,3,0
28989,2,6,0,0,6,0
28989,1,2,0,0,2,0
31138,2,1,0,0,1,0
14133,9,1,0,0,1,0
133557,7,12,0,0,12,0
133557,3,3,0,0,3,0
11404,2,1,0,0,1,0
218556,7,8,0,0,8,0
206588,10,1,0,0,1,0
206588,9,3,0,0,3,0
206588,8,5,0,0,5,0
206588,4,3,0,0,3,0
177080,10,1,0,0,1,0
177080,1,3,0,0,3,0
9650,3,2,0,0,2,0
54541,10,1,0,0,1,0
54541,5,8,0,0,8,0
54541,4,4,0,0,4,0
54541,2,1,0,0,1,0
191041,7,6,0,0,6,0
7650,10,2,0,0,2,0
7650,9,1,0,0,1,0
5277,4,2,0,0,2,0
5277,3,2,0,0,2,0
5277,1,1,0,0,1,0
226354,10,2,0,0,2,0
226354,8,13,0,0,13,0
226354,5,13,0,0,13,0
226354,4,1,0,0,1,0
5321,9,4,0,0,4,0
5321,2,1,0,0,1,0
5321,1,1,0,0,1,0
25155,10,1,0,0,1,0
25155,4,10,0,0,10,0
53557,8,2,0,0,2,0
53557,7,4,0,0,4,0
53557,2,4,0,0,4,0
189341,10,2,0,0,2,0
189341,9,2,0,0,2,0
189341,8,16,0,0,16,0
189341,7,28,0,0,28,0
189341,3,1,0,0,1,0
189341,1,2,0,0,2,0
11978,9,5,0,0,5,0
11978,3,1,0,0,1,0
4919,10,1,0,0,1,0
246744,9,4,0,0,4,0
246744,2,1,0,0,1,0
4300,3,1,0,0,1,0
4300,2,1,0,0,1,0
4437,4,5,0,0,5,0
26132,4,2,0,0,2,0
26132,3,1,0,0,1,0
10300,3,1,0,0,1,0
17578,10,1,0,0,1,0
17578,9,1,0,0,1,0
122598,7,6,0,0,6,0
111830,3,3,0,0,3,0
111830,2,1,0,0,1,0
166931,9,1,0,0,1,0
166931,3,3,0,0,3,0
3488,8,4,0,0,4,0
7334,9,1,0,0,1,0
7334,2,1,0,0,1,0
2164,10,1,0,0,1,0
32161,8,1,0,0,1,0
32161,2,4,0,0,4,0
171547,9,1,0,0,1,0
171547,8,2,0,0,2,0
171547,7,10,0,0,10,0
32109,1,1,0,0,1,0
35023,3,4,0,0,4,0
35023,2,2,0,0,2,0
162383,4,1,0,0,1,0
162383,1,2,0,0,2,0
155315,10,3,0,0,3,0
155315,4,1,0,0,1,0
155315,2,1,0,0,1,0
139660,9,1,0,0,1,0
139660,3,1,0,0,1,0
2840,8,3,0,0,3,0
2840,2,2,0,0,2,0
2840,1,1,0,0,1,0
185845,7,13,0,0,13,0
185845,6,8,0,0,8,0
185845,3,1,0,0,1,0
160614,10,2,0,0,2,0
160614,9,7,0,0,7,0
160614,8,7,0,0,7,0
160614,2,1,0,0,1,0
160614,1,1,0,0,1,0
154878,1,2,0,0,2,0
28308,10,1,0,0,1,0
28308,9,1,0,0,1,0
28308,7,8,0,0,8,0
29099,8,2,0,0,2,0
29099,1,5,0,0,5,0
138799,9,3,0,0,3,0
138799,5,6,0,0,6,0
138799,1,3,0,0,3,0
6375,10,1,0,0,1,0
6375,9,2,0,0,2,0
175150,9,1,0,0,1,0
175150,5,11,0,0,11,0
175150,4,6,0,0,6,0
175150,3,2,0,0,2,0
175150,2,1,0,0,1,0
1729,9,1,0,0,1,0
1729,1,1,0,0,1,0
2584,2,1,0,0,1,0
32751,2,2,0,0,2,0
32751,1,1,0,0,1,0
4222,9,4,0,0,4,0
4222,5,6,0,0,6,0
7065,4,5,0,0,5,0
7065,3,2,0,0,2,0
5346,10,2,0,0,2,0
5346,3,1,0,0,1,0
5346,2,1,0,0,1,0
5346,1,1,0,0,1,0
23977,3,1,0,0,1,0
70329,10,2,0,0,2,0
70329,8,3,0,0,3,0
70329,7,4,0,0,4,0
25968,8,4,0,0,4,0
25968,1,1,0,0,1,0
221661,2,1,0,0,1,0
130227,8,3,0,0,3,0
130227,3,4,0,0,4,0
23400,5,2,0,0,2,0
23400,3,1,0,0,1,0
198630,5,2,0,0,2,0
198630,4,1,0,0,1,0
43845,5,3,0,0,3,0
43845,4,1,0,0,1,0
2153,10,2,0,0,2,0
68251,3,5,0,0,5,0
68251,1,1,0,0,1,0
75957,1,1,0,0,1,0
137017,9,1,0,0,1,0
137017,8,4,0,0,4,0
137017,7,12,0,0,12,0
137017,3,4,0,0,4,0
137017,2,2,0,0,2,0
5834,2,1,0,0,1,0
119316,4,7,0,0,7,0
10634,10,1,0,0,1,0
10634,9,1,0,0,1,0
10634,3,2,0,0,2,0
10634,1,1,0,0,1,0
67026,9,1,0,0,1,0
67026,3,6,0,0,6,0
67026,2,4,0,0,4,0
67026,1,2,0,0,2,0
7991,10,1,0,0,1,0
7991,9,2,0,0,2,0
7991,1,1,0,0,1,0
22940,5,3,0,0,3,0
199382,10,1,0,0,1,0
199382,5,12,0,0,12,0
199382,4,11,0,0,11,0
199382,3,1,0,0,1,0
199382,2,1,0,0,1,0
199382,1,1,0,0,1,0
227018,9,2,0,0,2,0
227018,8,9,0,0,9,0
227018,5,9,0,0,9,0
227018,2,1,0,0,1,0
625,10,2,0,0,2,0
625,9,2,0,0,2,0
13576,7,10,0,0,10,0
180292,2,1,0,0,1,0
234451,4,2,0,0,2,0
234451,2,2,0,0,2,0
4060,3,1,0,0,1,0
10912,8,1,0,0,1,0
10912,1,1,0,0,1,0
180644,8,11,0,0,11,0
180644,5,4,0,0,4,0
5621,2,4,0,0,4,0
3471,3,1,0,0,1,0
10716,10,3,0,0,3,0
10716,2,1,0,0,1,0
260407,3,1,0,0,1,0
260407,1,1,0,0,1,0
23304,9,1,0,0,1,0
23304,3,6,0,0,6,0
85633,4,2,0,0,2,0
85633,2,1,0,0,1,0
16435,9,3,0,0,3,0
258693,7,17,0,0,17,0
258693,6,12,0,0,12,0
258693,4,1,0,0,1,0
258693,3,1,0,0,1,0
29924,10,1,0,0,1,0
29924,9,1,0,0,1,0
29924,8,1,0,0,1,0
29924,2,2,0,0,2,0
29924,1,1,0,0,1,0
16792,10,2,0,0,2,0
16792,3,1,0,0,1,0
4189,10,1,0,0,1,0
4189,8,1,0,0,1,0
19621,2,3,0,0,3,0
20623,2,1,0,0,1,0
7047,10,1,0,0,1,0
7047,1,2,0,0,2,0
134477,9,1,0,0,1,0
134477,8,3,0,0,3,0
134477,2,1,0,0,1,0
9918,10,4,0,0,4,0
9918,6,9,0,0,9,0
7694,3,1,0,0,1,0
181377,9,5,0,0,5,0
181377,5,4,0,0,4,0
181377,4,1,0,0,1,0
181377,3,1,0,0,1,0
773,1,2,0,0,2,0
9610,9,1,0,0,1,0
9610,5,7,0,0,7,0
2171,9,2,0,0,2,0
2171,5,6,0,0,6,0
2171,3,1,0,0,1,0
246746,9,7,0,0,7,0
246746,5,3,0,0,3,0
246746,4,2,0,0,2,0
72298,10,3,0,0,3,0
190915,5,7,0,0,7,0
190915,4,3,0,0,3,0
190915,2,2,0,0,2,0
190915,1,1,0,0,1,0
129295,9,1,0,0,1,0
129295,3,2,0,0,2,0
129295,1,1,0,0,1,0
4567,9,1,0,0,1,0
4567,7,4,0,0,4,0
162223,7,10,0,0,10,0
162223,6,27,0,0,27,0
162223,4,9,0,0,9,0
162223,3,2,0,0,2,0
162223,2,4,0,0,4,0
3993,2,1,0,0,1,0
75991,10,1,0,0,1,0
75991,8,2,0,0,2,0
144955,10,1,0,0,1,0
144955,9,2,0,0,2,0
144955,8,16,0,0,16,0
144955,4,1,0,0,1,0
144955,3,1,0,0,1,0
144955,1,1,0,0,1,0
11525,9,1,0,0,1,0
2410,9,1,0,0,1,0
2410,4,4,0,0,4,0
175274,10,1,0,0,1,0
175274,9,3,0,0,3,0
175274,8,10,0,0,10,0
175274,3,4,0,0,4,0
6355,8,6,0,0,6,0
81561,8,8,0,0,8,0
81561,6,23,0,0,23,0
81561,3,4,0,0,4,0
81561,2,1,0,0,1,0
81561,1,2,0,0,2,0
203845,5,4,0,0,4,0
203845,1,1,0,0,1,0
21749,8,2,0,0,2,0
25925,9,2,0,0,2,0
25925,1,1,0,0,1,0
259809,9,9,0,0,9,0
259809,8,30,0,0,30,0
259809,6,11,0,0,11,0
259809,4,3,0,0,3,0
259809,2,2,0,0,2,0
20771,8,3,0,0,3,0
2814,10,1,0,0,1,0
2814,3,1,0,0,1,0
3985,5,6,0,0,6,0
3985,3,1,0,0,1,0
204461,4,1,0,0,1,0
204461,3,1,0,0,1,0
249410,10,3,0,0,3,0
249410,5,3,0,0,3,0
249410,4,2,0,0,2,0
229241,9,2,0,0,2,0
229241,3,1,0,0,1,0
137244,10,1,0,0,1,0
137244,8,1,0,0,1,0
137244,3,3,0,0,3,0
137244,2,4,0,0,4,0
19902,2,1,0,0,1,0
31053,10,3,0,0,3,0
31053,9,1,0,0,1,0
31053,5,7,0,0,7,0
4874,10,4,0,0,4,0
4874,3,1,0,0,1,0
4874,2,1,0,0,1,0
183360,7,13,0,0,13,0
183360,4,1,0,0,1,0
183360,3,1,0,0,1,0
183360,2,1,0,0,1,0
224656,7,11,0,0,11,0
224656,5,1,0,0,1,0
224656,4,6,0,0,6,0
124589,10,1,0,0,1,0
124589,9,1,0,0,1,0
124589,8,3,0,0,3,0
124589,3,7,0,0,7,0
124589,1,1,0,0,1,0
195515,10,1,0,0,1,0
195515,4,2,0,0,2,0
144460,9,2,0,0,2,0
144460,5,4,0,0,4,0
144460,2,1,0,0,1,0
227995,6,2,0,0,2,0
180598,10,2,0,0,2,0
180598,3,1,0,0,1,0
180598,2,3,0,0,3,0
254713,5,3,0,0,3,0
254713,3,1,0,0,1,0
39834,9,1,0,0,1,0
9916,10,2,0,0,2,0
228882,2,1,0,0,1,0
202296,10,1,0,0,1,0
202296,5,10,0,0,10,0
202296,4,6,0,0,6,0
175221,9,2,0,0,2,0
175221,4,8,0,0,8,0
175221,1,1,0,0,1,0
240926,9,3,0,0,3,0
240926,8,12,0,0,12,0
240926,4,3,0,0,3,0
240926,3,2,0,0,2,0
97377,5,5,0,0,5,0
97377,1,1,0,0,1,0
24487,4,6,0,0,6,0
24487,1,1,0,0,1,0
94822,4,7,0,0,7,0
94822,2,2,0,0,2,0
220276,4,4,0,0,4,0
220276,2,2,0,0,2,0
179629,10,1,0,0,1,0
179629,3,4,0,0,4,0
179629,1,1,0,0,1,0
94615,10,2,0,0,2,0
37777,9,5,0,0,5,0
37777,8,7,0,0,7,0
37777,3,2,0,0,2,0
37777,2,1,0,0,1,0
133518,10,1,0,0,1,0
133518,6,7,0,0,7,0
133518,4,1,0,0,1,0
1985,3,1,0,0,1,0
1985,2,1,0,0,1,0
156843,3,1,0,0,1,0
156843,2,1,0,0,1,0
156843,1,1,0,0,1,0
257836,10,2,0,0,2,0
257836,9,2,0,0,2,0
257836,5,9,0,0,9,0
257836,4,2,0,0,2,0
5453,3,1,0,0,1,0
5453,2,1,0,0,1,0
1673,1,2,0,0,2,0
648,5,17,0,0,17,0
140829,9,1,0,0,1,0
149970,2,1,0,0,1,0
165737,10,1,0,0,1,0
165737,3,1,0,0,1,0
228142,10,1,0,0,1,0
228142,9,4,0,0,4,0
228142,5,5,0,0,5,0
228142,4,4,0,0,4,0
202096,9,1,0,0,1,0
202096,6,8,0,0,8,0
202096,3,1,0,0,1,0
233048,5,3,0,0,3,0
233048,4,1,0,0,1,0
233048,3,5,0,0,5,0
158232,10,1,0,0,1,0
158232,3,8,0,0,8,0
10304,10,2,0,0,2,0
10304,3,1,0,0,1,0
10304,2,1,0,0,1,0
1341,9,1,0,0,1,0
1341,2,1,0,0,1,0
1656,10,2,0,0,2,0
1656,1,1,0,0,1,0
171424,8,3,0,0,3,0
171424,7,10,0,0,10,0
171424,4,9,0,0,9,0
171424,2,1,0,0,1,0
5173,2,1,0,0,1,0
5483,3,2,0,0,2,0
5483,1,1,0,0,1,0
4381,10,1,0,0,1,0
11528,10,1,0,0,1,0
11528,1,1,0,0,1,0
183839,8,2,0,0,2,0
298,8,1,0,0,1,0
298,6,18,0,0,18,0
298,2,1,0,0,1,0
100089,10,1,0,0,1,0
100089,9,2,0,0,2,0
100089,4,2,0,0,2,0
121471,9,2,0,0,2,0
188825,3,3,0,0,3,0
41017,10,1,0,0,1,0
41017,7,4,0,0,4,0
41017,1,1,0,0,1,0
41844,8,7,0,0,7,0
41844,5,12,0,0,12,0
41844,2,1,0,0,1,0
169502,10,1,0,0,1,0
86445,2,1,0,0,1,0
207347,9,2,0,0,2,0
20586,1,3,0,0,3,0
6049,10,1,0,0,1,0
6049,4,7,0,0,7,0
4379,10,2,0,0,2,0
4379,9,1,0,0,1,0
29848,1,1,0,0,1,0
3673,4,6,0,0,6,0
3673,2,3,0,0,3,0
8751,4,2,0,0,2,0
2418,7,8,0,0,8,0
2418,3,7,0,0,7,0
24485,9,1,0,0,1,0
24485,2,4,0,0,4,0
236360,10,5,0,0,5,0
236360,5,3,0,0,3,0
236360,4,4,0,0,4,0
236360,2,3,0,0,3,0
40507,3,3,0,0,3,0
33140,9,1,0,0,1,0
33140,3,2,0,0,2,0
309,8,7,0,0,7,0
50764,5,3,0,0,3,0
54300,2,1,0,0,1,0
6909,10,1,0,0,1,0
6909,9,3,0,0,3,0
6909,8,7,0,0,7,0
6909,4,7,0,0,7,0
248909,9,2,0,0,2,0
248909,4,4,0,0,4,0
248909,3,1,0,0,1,0
17158,1,1,0,0,1,0
111855,9,1,0,0,1,0
111855,8,5,0,0,5,0
111855,5,7,0,0,7,0
111855,2,1,0,0,1,0
871,9,1,0,0,1,0
152761,10,2,0,0,2,0
152761,2,1,0,0,1,0
66641,10,2,0,0,2,0
66641,9,2,0,0,2,0
66641,5,8,0,0,8,0
66641,2,2,0,0,2,0
216282,10,2,0,0,2,0
216282,3,2,0,0,2,0
122831,4,1,0,0,1,0
1984,1,2,0,0,2,0
9117,10,2,0,0,2,0
9117,4,3,0,0,3,0
94346,8,2,0,0,2,0
94346,1,1,0,0,1,0
257957,1,1,0,0,1,0
163099,10,2,0,0,2,0
163099,9,1,0,0,1,0
163099,5,6,0,0,6,0
163099,2,1,0,0,1,0
1581,9,1,0,0,1,0
2826,3,2,0,0,2,0
257273,8,8,0,0,8,0
257273,4,2,0,0,2,0
3504,7,1,0,0,1,0
3504,6,1,0,0,1,0
3390,8,1,0,0,1,0
18983,10,2,0,0,2,0
18983,9,1,0,0,1,0
18983,7,8,0,0,8,0
18983,2,1,0,0,1,0
18983,1,2,0,0,2,0
27853,9,2,0,0,2,0
139747,5,1,0,0,1,0
139747,1,1,0,0,1,0
10376,10,2,0,0,2,0
10376,5,2,0,0,2,0
10376,4,3,0,0,3,0
121987,6,23,0,0,23,0
121987,5,8,0,0,8,0
22644,2,1,0,0,1,0
114,10,3,0,0,3,0
114,5,8,0,0,8,0
114,4,4,0,0,4,0
114,3,2,0,0,2,0
27682,3,3,0,0,3,0
77148,10,1,0,0,1,0
77148,4,5,0,0,5,0
25196,10,2,0,0,2,0
25196,9,2,0,0,2,0
8470,10,1,0,0,1,0
5878,9,2,0,0,2,0
2433,6,8,0,0,8,0
42727,7,12,0,0,12,0
42727,5,2,0,0,2,0
164446,7,6,0,0,6,0
164446,4,1,0,0,1,0
164446,3,1,0,0,1,0
164446,1,2,0,0,2,0
12957,2,1,0,0,1,0
858,9,2,0,0,2,0
858,8,2,0,0,2,0
118567,9,1,0,0,1,0
118567,4,5,0,0,5,0
118567,1,2,0,0,2,0
6272,10,1,0,0,1,0
6272,2,1,0,0,1,0
19630,2,1,0,0,1,0
245085,4,2,0,0,2,0
245085,3,2,0,0,2,0
245085,1,1,0,0,1,0
2911,8,2,0,0,2,0
144607,4,1,0,0,1,0
144607,1,1,0,0,1,0
40656,8,1,0,0,1,0
4353,9,1,0,0,1,0
4353,1,2,0,0,2,0
35137,9,3,0,0,3,0
209541,9,1,0,0,1,0
209541,8,5,0,0,5,0
5203,1,1,0,0,1,0
10203,9,3,0,0,3,0
10203,2,1,0,0,1,0
17994,10,2,0,0,2,0
17994,9,2,0,0,2,0
17994,8,20,0,0,20,0
37498,10,2,0,0,2,0
37498,9,1,0,0,1,0
37498,8,2,0,0,2,0
37498,7,7,0,0,7,0
37498,3,4,0,0,4,0
37498,1,1,0,0,1,0
92188,10,2,0,0,2,0
92188,9,9,0,0,9,0
92188,1,1,0,0,1,0
235533,5,2,0,0,2,0
530,9,1,0,0,1,0
530,2,1,0,0,1,0
235944,10,1,0,0,1,0
235944,8,13,0,0,13,0
235944,4,4,0,0,4,0
235944,3,2,0,0,2,0
235944,2,2,0,0,2,0
6597,10,1,0,0,1,0
6597,9,1,0,0,1,0
6597,7,1,0,0,1,0
146937,5,4,0,0,4,0
146937,4,1,0,0,1,0
146937,1,1,0,0,1,0
13584,10,3,0,0,3,0
13584,3,1,0,0,1,0
21835,1,2,0,0,2,0
31074,3,1,0,0,1,0
4997,3,3,0,0,3,0
4997,2,1,0,0,1,0
7973,4,6,0,0,6,0
62478,8,5,0,0,5,0
62478,3,4,0,0,4,0
62478,2,1,0,0,1,0
156836,10,1,0,0,1,0
156836,8,10,0,0,10,0
156836,7,17,0,0,17,0
156836,5,10,0,0,10,0
168446,10,2,0,0,2,0
168446,9,1,0,0,1,0
168446,4,5,0,0,5,0
168446,2,1,0,0,1,0
7590,5,4,0,0,4,0
7590,3,1,0,0,1,0
187719,10,3,0,0,3,0
187719,8,2,0,0,2,0
13384,9,1,0,0,1,0
13384,1,2,0,0,2,0
2495,9,1,0,0,1,0
2495,8,6,0,0,6,0
2495,3,1,0,0,1,0
10581,2,1,0,0,1,0
13490,9,1,0,0,1,0
13490,1,1,0,0,1,0
26293,9,1,0,0,1,0
26293,8,6,0,0,6,0
26293,6,30,0,0,30,0
7090,3,1,0,0,1,0
1184,1,1,0,0,1,0
7995,2,1,0,0,1,0
69721,10,1,0,0,1,0
69721,8,3,0,0,3,0
69721,4,2,0,0,2,0
69721,3,2,0,0,2,0
69721,2,2,0,0,2,0
4363,10,3,0,0,3,0
4363,4,2,0,0,2,0
7938,10,1,0,0,1,0
7938,4,3,0,0,3,0
6004,10,1,0,0,1,0
6004,9,1,0,0,1,0
163983,9,2,0,0,2,0
163983,8,10,0,0,10,0
163983,3,1,0,0,1,0
3901,3,1,0,0,1,0
3901,1,2,0,0,2,0
208661,6,18,0,0,18,0
208661,3,4,0,0,4,0
36615,9,1,0,0,1,0
36615,8,4,0,0,4,0
14119,10,1,0,0,1,0
41185,9,4,0,0,4,0
41185,8,12,0,0,12,0
41185,5,3,0,0,3,0
41185,3,1,0,0,1,0
41185,1,1,0,0,1,0
1790,9,3,0,0,3,0
1790,2,1,0,0,1,0
62979,9,3,0,0,3,0
62979,6,19,0,0,19,0
62979,1,2,0,0,2,0
5335,10,3,0,0,3,0
5335,1,1,0,0,1,0
149332,9,1,0,0,1,0
149332,8,10,0,0,10,0
149332,3,2,0,0,2,0
149332,1,1,0,0,1,0
2326,10,1,0,0,1,0
2326,9,1,0,0,1,0
11514,9,2,0,0,2,0
11514,3,1,0,0,1,0
141896,2,2,0,0,2,0
141896,1,4,0,0,4,0
209849,10,1,0,0,1,0
209849,9,1,0,0,1,0
163048,6,3,0,0,3,0
163048,5,2,0,0,2,0
163048,1,3,0,0,3,0
24025,10,2,0,0,2,0
24025,3,2,0,0,2,0
24025,1,2,0,0,2,0
155208,7,1,0,0,1,0
169984,4,7,0,0,7,0
169984,1,1,0,0,1,0
28738,9,1,0,0,1,0
28738,4,1,0,0,1,0
28738,3,2,0,0,2,0
28738,2,1,0,0,1,0
28738,1,2,0,0,2,0
5822,3,1,0,0,1,0
5822,2,1,0,0,1,0
158586,5,4,0,0,4,0
158586,2,2,0,0,2,0
18652,10,2,0,0,2,0
18652,5,1,0,0,1,0
224662,10,3,0,0,3,0
224662,5,9,0,0,9,0
224662,4,4,0,0,4,0
224662,3,4,0,0,4,0
224662,2,1,0,0,1,0
224662,1,3,0,0,3,0
90968,3,2,0,0,2,0
90968,2,2,0,0,2,0
179804,10,3,0,0,3,0
179804,5,3,0,0,3,0
179804,1,1,0,0,1,0
193584,5,2,0,0,2,0
28678,4,1,0,0,1,0
19083,9,1,0,0,1,0
19083,8,5,0,0,5,0
19083,7,4,0,0,4,0
116046,5,1,0,0,1,0
116046,4,1,0,0,1,0
116046,3,1,0,0,1,0
116046,2,1,0,0,1,0
163040,10,2,0,0,2,0
163040,7,16,0,0,16,0
163040,4,1,0,0,1,0
163040,2,2,0,0,2,0
3615,10,1,0,0,1,0
3615,3,2,0,0,2,0
238136,5,6,0,0,6,0
238136,3,1,0,0,1,0
254923,3,2,0,0,2,0
5193,2,2,0,0,2,0
3070,1,2,0,0,2,0
20302,10,1,0,0,1,0
117908,10,1,0,0,1,0
117908,9,1,0,0,1,0
117908,8,8,0,0,8,0
117908,2,2,0,0,2,0
117908,1,1,0,0,1,0
100795,9,3,0,0,3,0
100795,8,6,0,0,6,0
100795,3,2,0,0,2,0
1043,9,4,0,0,4,0
1043,8,7,0,0,7,0
1959,5,12,0,0,12,0
30246,10,1,0,0,1,0
230785,10,2,0,0,2,0
230785,6,14,0,0,14,0
230785,5,3,0,0,3,0
230785,4,2,0,0,2,0
207796,3,1,0,0,1,0
207796,2,1,0,0,1,0
207230,5,1,0,0,1,0
207230,1,1,0,0,1,0
192909,10,7,0,0,7,0
192909,9,2,0,0,2,0
192909,4,2,0,0,2,0
192909,3,1,0,0,1,0
235251,10,3,0,0,3,0
235251,3,4,0,0,4,0
235251,2,1,0,0,1,0
235251,1,1,0,0,1,0
56197,9,1,0,0,1,0
56197,3,4,0,0,4,0
56197,2,2,0,0,2,0
135812,4,1,0,0,1,0
146451,6,6,0,0,6,0
146451,5,1,0,0,1,0
146451,4,1,0,0,1,0
146451,1,1,0,0,1,0
212687,1,2,0,0,2,0
102631,9,5,0,0,5,0
102631,7,11,0,0,11,0
102631,5,4,0,0,4,0
102631,4,8,0,0,8,0
102631,2,1,0,0,1,0
25037,10,5,0,0,5,0
25037,1,1,0,0,1,0
94338,10,1,0,0,1,0
94338,5,10,0,0,10,0
94338,4,1,0,0,1,0
4294,9,1,0,0,1,0
4293,4,3,0,0,3,0
4293,3,1,0,0,1,0
9093,9,1,0,0,1,0
9093,1,1,0,0,1,0
11091,5,2,0,0,2,0
11091,3,1,0,0,1,0
5959,9,1,0,0,1,0
2116,9,1,0,0,1,0
23388,7,1,0,0,1,0
29106,10,1,0,0,1,0
29106,4,4,0,0,4,0
165044,7,9,0,0,9,0
165044,5,8,0,0,8,0
165044,4,3,0,0,3,0
18724,9,2,0,0,2,0
18724,4,1,0,0,1,0
18724,2,1,0,0,1,0
3532,9,1,0,0,1,0
3532,8,7,0,0,7,0
3532,3,2,0,0,2,0
232414,5,4,0,0,4,0
232414,3,1,0,0,1,0
232414,2,1,0,0,1,0
232414,1,1,0,0,1,0
7457,9,1,0,0,1,0
7457,8,3,0,0,3,0
7457,2,4,0,0,4,0
7950,3,2,0,0,2,0
48863,9,9,0,0,9,0
48863,6,10,0,0,10,0
48863,5,3,0,0,3,0
48863,4,2,0,0,2,0
48863,1,1,0,0,1,0
3554,10,2,0,0,2,0
154681,9,1,0,0,1,0
154681,4,6,0,0,6,0
154681,3,1,0,0,1,0
246531,9,4,0,0,4,0
246531,4,1,0,0,1,0
109922,2,1,0,0,1,0
11166,4,1,0,0,1,0
22770,7,2,0,0,2,0
256538,4,4,0,0,4,0
256538,2,2,0,0,2,0
172382,2,2,0,0,2,0
172382,1,1,0,0,1,0
3604,3,1,0,0,1,0
3751,3,2,0,0,2,0
3751,2,1,0,0,1,0
232478,4,1,0,0,1,0
232478,1,1,0,0,1,0
28231,7,1,0,0,1,0
6487,3,2,0,0,2,0
886,4,6,0,0,6,0
153830,10,2,0,0,2,0
153830,9,4,0,0,4,0
153830,7,13,0,0,13,0
153830,4,2,0,0,2,0
153830,3,1,0,0,1,0
153830,2,4,0,0,4,0
153830,1,1,0,0,1,0
9475,9,2,0,0,2,0
9475,8,1,0,0,1,0
9475,2,6,0,0,6,0
9475,1,2,0,0,2,0
193912,3,2,0,0,2,0
148040,9,1,0,0,1,0
148040,8,2,0,0,2,0
148040,4,5,0,0,5,0
148040,2,3,0,0,3,0
148040,1,2,0,0,2,0
55828,10,2,0,0,2,0
55828,4,5,0,0,5,0
55828,2,2,0,0,2,0
55756,9,2,0,0,2,0
55756,8,15,0,0,15,0
12763,7,4,0,0,4,0
12763,1,4,0,0,4,0
255805,10,1,0,0,1,0
255805,6,20,0,0,20,0
255805,4,2,0,0,2,0
255805,1,1,0,0,1,0
180943,9,2,0,0,2,0
180943,5,5,0,0,5,0
180943,3,3,0,0,3,0
2036,10,1,0,0,1,0
2036,8,2,0,0,2,0
2036,1,1,0,0,1,0
18464,3,5,0,0,5,0
18464,2,2,0,0,2,0
38361,10,2,0,0,2,0
38361,5,2,0,0,2,0
228943,5,3,0,0,3,0
228943,4,1,0,0,1,0
228943,3,2,0,0,2,0
228943,2,5,0,0,5,0
252776,10,3,0,0,3,0
252776,9,2,0,0,2,0
252776,5,3,0,0,3,0
252776,4,1,0,0,1,0
252776,2,1,0,0,1,0
7181,10,6,0,0,6,0
32124,6,3,0,0,3,0
32124,5,3,0,0,3,0
123604,10,1,0,0,1,0
123604,4,2,0,0,2,0
86003,10,10,0,0,10,0
4917,2,2,0,0,2,0
22122,9,2,0,0,2,0
22122,8,3,0,0,3,0
22122,3,2,0,0,2,0
22122,2,1,0,0,1,0
118340,10,1,0,0,1,0
118340,9,1,0,0,1,0
118340,1,2,0,0,2,0
218637,3,2,0,0,2,0
22991,10,1,0,0,1,0
22991,9,1,0,0,1,0
22991,3,4,0,0,4,0
22991,1,1,0,0,1,0
212807,3,1,0,0,1,0
49010,8,1,0,0,1,0
49010,1,1,0,0,1,0
2734,10,1,0,0,1,0
21061,9,2,0,0,2,0
21061,4,4,0,0,4,0
21061,3,3,0,0,3,0
80503,9,1,0,0,1,0
80503,7,5,0,0,5,0
7823,10,4,0,0,4,0
7823,5,1,0,0,1,0
7823,2,1,0,0,1,0
175265,9,3,0,0,3,0
175265,4,2,0,0,2,0
2207,10,1,0,0,1,0
2207,3,2,0,0,2,0
252153,6,4,0,0,4,0
252153,5,2,0,0,2,0
252153,1,1,0,0,1,0
153388,2,1,0,0,1,0
153388,1,1,0,0,1,0
91440,9,1,0,0,1,0
91440,3,2,0,0,2,0
30363,10,1,0,0,1,0
30363,1,1,0,0,1,0
21566,10,1,0,0,1,0
21566,8,2,0,0,2,0
21566,5,15,0,0,15,0
21566,1,1,0,0,1,0
167604,3,1,0,0,1,0
167604,1,1,0,0,1,0
63779,10,1,0,0,1,0
63779,5,9,0,0,9,0
63779,3,2,0,0,2,0
258665,5,1,0,0,1,0
258665,3,3,0,0,3,0
258665,1,3,0,0,3,0
12795,10,2,0,0,2,0
12795,9,1,0,0,1,0
12795,4,6,0,0,6,0
12795,2,1,0,0,1,0
33958,10,1,0,0,1,0
33958,9,1,0,0,1,0
33958,4,7,0,0,7,0
33958,2,1,0,0,1,0
238102,8,3,0,0,3,0
238102,7,7,0,0,7,0
238102,4,7,0,0,7,0
238102,3,10,0,0,10,0
238102,2,3,0,0,3,0
238102,1,2,0,0,2,0
182799,9,1,0,0,1,0
182799,5,8,0,0,8,0
24484,9,1,0,0,1,0
24484,8,3,0,0,3,0
24484,7,6,0,0,6,0
24484,3,4,0,0,4,0
24484,1,1,0,0,1,0
3174,1,1,0,0,1,0
85857,9,1,0,0,1,0
96703,9,1,0,0,1,0
207975,10,1,0,0,1,0
207975,9,3,0,0,3,0
207975,2,3,0,0,3,0
139607,10,1,0,0,1,0
139607,9,9,0,0,9,0
139607,8,11,0,0,11,0
139607,7,14,0,0,14,0
139607,5,6,0,0,6,0
139607,3,2,0,0,2,0
193161,10,1,0,0,1,0
193161,4,4,0,0,4,0
193161,2,1,0,0,1,0
124954,8,4,0,0,4,0
124954,7,11,0,0,11,0
124954,2,1,0,0,1,0
12736,3,1,0,0,1,0
165984,9,1,0,0,1,0
165984,5,3,0,0,3,0
13915,10,1,0,0,1,0
154901,10,1,0,0,1,0
154901,9,1,0,0,1,0
1396,10,2,0,0,2,0
218769,10,1,0,0,1,0
218769,9,2,0,0,2,0
218769,4,5,0,0,5,0
218769,3,3,0,0,3,0
218769,1,1,0,0,1,0
20580,9,1,0,0,1,0
3036,2,1,0,0,1,0
3036,1,1,0,0,1,0
112694,6,2,0,0,2,0
112694,5,1,0,0,1,0
112694,4,1,0,0,1,0
112694,1,1,0,0,1,0
235362,7,11,0,0,11,0
235362,6,3,0,0,3,0
235362,4,1,0,0,1,0
1011,9,1,0,0,1,0
1011,8,2,0,0,2,0
1011,6,16,0,0,16,0
1011,1,1,0,0,1,0
76668,8,1,0,0,1,0
76668,7,5,0,0,5,0
37477,4,3,0,0,3,0
37477,3,3,0,0,3,0
18117,9,2,0,0,2,0
18117,7,5,0,0,5,0
18117,2,3,0,0,3,0
18117,1,1,0,0,1,0
57215,9,1,0,0,1,0
158487,10,1,0,0,1,0
158487,9,3,0,0,3,0
158487,3,2,0,0,2,0
10244,4,3,0,0,3,0
10244,2,2,0,0,2,0
194960,2,3,0,0,3,0
133425,9,1,0,0,1,0
133425,8,2,0,0,2,0
217581,10,3,0,0,3,0
217581,4,3,0,0,3,0
217581,3,1,0,0,1,0
217581,1,1,0,0,1,0
11950,10,3,0,0,3,0
11950,8,1,0,0,1,0
11950,7,4,0,0,4,0
19161,3,2,0,0,2,0
19161,2,2,0,0,2,0
11973,9,1,0,0,1,0
11973,8,11,0,0,11,0
11973,7,20,0,0,20,0
11973,5,8,0,0,8,0
150923,3,1,0,0,1,0
7600,10,1,0,0,1,0
7600,6,5,0,0,5,0
203104,10,1,0,0,1,0
203104,9,1,0,0,1,0
203104,4,2,0,0,2,0
203104,3,1,0,0,1,0
203104,2,2,0,0,2,0
203104,1,1,0,0,1,0
3860,5,5,0,0,5,0
12600,10,2,0,0,2,0
228370,8,2,0,0,2,0
228370,6,3,0,0,3,0
186755,10,3,0,0,3,0
186755,9,1,0,0,1,0
186755,8,5,0,0,5,0
186755,3,4,0,0,4,0
186755,2,1,0,0,1,0
67144,10,2,0,0,2,0
67144,9,1,0,0,1,0
67144,8,9,0,0,9,0
67144,1,1,0,0,1,0
203997,9,1,0,0,1,0
203997,3,3,0,0,3,0
203997,1,2,0,0,2,0
156350,8,1,0,0,1,0
156350,3,6,0,0,6,0
161886,4,1,0,0,1,0
161886,3,1,0,0,1,0
161886,2,1,0,0,1,0
7549,3,3,0,0,3,0
168654,10,1,0,0,1,0
168654,6,22,0,0,22,0
37633,2,1,0,0,1,0
192762,9,6,0,0,6,0
192762,4,3,0,0,3,0
928,9,1,0,0,1,0
928,1,1,0,0,1,0
197928,10,1,0,0,1,0
197928,7,15,0,0,15,0
197928,2,2,0,0,2,0
12289,8,2,0,0,2,0
12289,2,2,0,0,2,0
9865,6,3,0,0,3,0
2089,8,4,0,0,4,0
2089,3,3,0,0,3,0
4476,2,5,0,0,5,0
4683,10,2,0,0,2,0
4683,1,1,0,0,1,0
72460,10,1,0,0,1,0
195232,1,1,0,0,1,0
163478,10,1,0,0,1,0
163478,8,11,0,0,11,0
163478,4,8,0,0,8,0
163478,3,5,0,0,5,0
206082,2,2,0,0,2,0
246873,6,4,0,0,4,0
25569,10,1,0,0,1,0
25569,9,1,0,0,1,0
25569,3,2,0,0,2,0
25569,1,1,0,0,1,0
173100,8,4,0,0,4,0
173100,7,10,0,0,10,0
173100,2,1,0,0,1,0
173100,1,1,0,0,1,0
2104,3,3,0,0,3,0
192605,4,4,0,0,4,0
192605,2,1,0,0,1,0
192605,1,2,0,0,2,0
57310,9,1,0,0,1,0
156097,9,2,0,0,2,0
156097,5,1,0,0,1,0
156097,4,1,0,0,1,0
37260,10,1,0,0,1,0
37260,9,1,0,0,1,0
37168,10,4,0,0,4,0
37168,9,1,0,0,1,0
37168,8,3,0,0,3,0
37168,7,3,0,0,3,0
37168,6,18,0,0,18,0
37168,4,11,0,0,11,0
37168,3,5,0,0,5,0
37168,2,3,0,0,3,0
165292,5,1,0,0,1,0
165292,3,1,0,0,1,0
165292,1,2,0,0,2,0
19903,6,5,0,0,5,0
141636,9,1,0,0,1,0
141636,7,3,0,0,3,0
1779,10,1,0,0,1,0
1779,8,1,0,0,1,0
1779,7,5,0,0,5,0
34902,9,1,0,0,1,0
222885,10,1,0,0,1,0
222885,5,11,0,0,11,0
222885,4,2,0,0,2,0
26315,3,2,0,0,2,0
26315,1,1,0,0,1,0
29405,10,1,0,0,1,0
29405,9,1,0,0,1,0
29405,7,4,0,0,4,0
1954,10,1,0,0,1,0
1954,5,13,0,0,13,0
16160,10,1,0,0,1,0
16160,9,2,0,0,2,0
16160,2,2,0,0,2,0
16160,1,1,0,0,1,0
1945,5,10,0,0,10,0
1945,2,2,0,0,2,0
152488,8,1,0,0,1,0
152488,7,2,0,0,2,0
152488,6,10,0,0,10,0
152488,4,12,0,0,12,0
3691,4,2,0,0,2,0
3691,2,1,0,0,1,0
10102,10,1,0,0,1,0
10102,9,1,0,0,1,0
10102,3,2,0,0,2,0
180599,9,2,0,0,2,0
180599,3,1,0,0,1,0
7522,10,1,0,0,1,0
7522,9,1,0,0,1,0
7522,3,2,0,0,2,0
109612,9,1,0,0,1,0
109612,4,4,0,0,4,0
109612,3,1,0,0,1,0
5759,9,1,0,0,1,0
158122,3,1,0,0,1,0
18056,10,1,0,0,1,0
18056,9,4,0,0,4,0
18056,8,16,0,0,16,0
147920,10,1,0,0,1,0
147920,4,3,0,0,3,0
83907,5,7,0,0,7,0
83907,4,4,0,0,4,0
83907,3,2,0,0,2,0
83907,1,2,0,0,2,0
183649,3,1,0,0,1,0
192315,3,1,0,0,1,0
173344,8,6,0,0,6,0
173344,3,4,0,0,4,0
6122,9,1,0,0,1,0
6122,2,4,0,0,4,0
6122,1,2,0,0,2,0
53279,9,1,0,0,1,0
53279,4,12,0,0,12,0
53279,3,4,0,0,4,0
53279,2,2,0,0,2,0
53279,1,1,0,0,1,0
163031,4,6,0,0,6,0
163031,3,5,0,0,5,0
163031,1,1,0,0,1,0
6499,1,1,0,0,1,0
5958,3,1,0,0,1,0
208217,10,3,0,0,3,0
208217,9,7,0,0,7,0
208217,7,16,0,0,16,0
208217,5,10,0,0,10,0
208217,3,1,0,0,1,0
208217,2,2,0,0,2,0
183881,9,1,0,0,1,0
183881,8,11,0,0,11,0
183881,7,11,0,0,11,0
183881,3,5,0,0,5,0
183881,1,1,0,0,1,0
97990,8,6,0,0,6,0
97990,3,3,0,0,3,0
38868,10,1,0,0,1,0
38868,9,1,0,0,1,0
38868,3,2,0,0,2,0
282,3,1,0,0,1,0
282,1,1,0,0,1,0
257306,10,1,0,0,1,0
257306,5,5,0,0,5,0
257306,4,2,0,0,2,0
257306,3,1,0,0,1,0
6000,10,1,0,0,1,0
6000,2,3,0,0,3,0
16271,2,1,0,0,1,0
16271,1,1,0,0,1,0
148434,10,1,0,0,1,0
148434,9,2,0,0,2,0
148434,8,5,0,0,5,0
30795,10,1,0,0,1,0
30795,5,1,0,0,1,0
30795,2,1,0,0,1,0
5220,9,1,0,0,1,0
5220,3,2,0,0,2,0
196122,10,1,0,0,1,0
196122,3,1,0,0,1,0
253766,9,1,0,0,1,0
253766,7,21,0,0,21,0
253766,3,4,0,0,4,0
253766,1,1,0,0,1,0
147590,8,4,0,0,4,0
147590,4,6,0,0,6,0
147590,2,3,0,0,3,0
137328,9,2,0,0,2,0
137328,8,2,0,0,2,0
137328,4,3,0,0,3,0
137328,3,1,0,0,1,0
137328,1,1,0,0,1,0
10564,8,6,0,0,6,0
10564,2,2,0,0,2,0
8180,3,2,0,0,2,0
116124,9,1,0,0,1,0
116124,7,10,0,0,10,0
116124,4,8,0,0,8,0
116124,3,1,0,0,1,0
127324,3,1,0,0,1,0
204504,9,5,0,0,5,0
10551,3,1,0,0,1,0
6007,3,2,0,0,2,0
241760,10,6,0,0,6,0
241760,8,9,0,0,9,0
241760,5,6,0,0,6,0
241760,4,1,0,0,1,0
241760,3,2,0,0,2,0
241760,2,2,0,0,2,0
3736,9,2,0,0,2,0
3736,7,2,0,0,2,0
40236,10,1,0,0,1,0
40236,1,1,0,0,1,0
63011,10,3,0,0,3,0
11500,3,2,0,0,2,0
36623,10,3,0,0,3,0
36623,9,1,0,0,1,0
36623,4,3,0,0,3,0
36623,3,1,0,0,1,0
2764,8,1,0,0,1,0
2764,3,7,0,0,7,0
2764,1,3,0,0,3,0
787,8,5,0,0,5,0
787,2,1,0,0,1,0
129751,10,1,0,0,1,0
129751,3,1,0,0,1,0
39290,9,1,0,0,1,0
39290,4,2,0,0,2,0
6548,9,5,0,0,5,0
6548,2,1,0,0,1,0
160601,4,4,0,0,4,0
160601,3,2,0,0,2,0
170337,9,1,0,0,1,0
170337,7,14,0,0,14,0
170337,5,5,0,0,5,0
2811,8,2,0,0,2,0
41021,9,1,0,0,1,0
41021,8,2,0,0,2,0
6020,10,1,0,0,1,0
6020,8,1,0,0,1,0
6020,7,3,0,0,3,0
128999,10,5,0,0,5,0
128999,9,4,0,0,4,0
128999,4,2,0,0,2,0
257834,10,4,0,0,4,0
257834,5,7,0,0,7,0
257834,1,1,0,0,1,0
203584,5,2,0,0,2,0
203584,4,1,0,0,1,0
203584,1,1,0,0,1,0
225645,5,4,0,0,4,0
225645,2,1,0,0,1,0
225645,1,1,0,0,1,0
8903,10,1,0,0,1,0
8903,9,1,0,0,1,0
3825,1,1,0,0,1,0
6702,10,1,0,0,1,0
6702,9,3,0,0,3,0
6702,8,1,0,0,1,0
2656,2,3,0,0,3,0
24127,10,3,0,0,3,0
24127,1,2,0,0,2,0
2839,4,2,0,0,2,0
2839,3,4,0,0,4,0
2839,2,1,0,0,1,0
2405,2,1,0,0,1,0
173093,6,12,0,0,12,0
173093,5,4,0,0,4,0
1013,9,4,0,0,4,0
1013,4,1,0,0,1,0
14585,10,1,0,0,1,0
14585,9,2,0,0,2,0
14585,1,1,0,0,1,0
27712,9,1,0,0,1,0
27712,7,9,0,0,9,0
27712,5,18,0,0,18,0
27712,3,5,0,0,5,0
27712,2,3,0,0,3,0
3051,9,4,0,0,4,0
3051,3,1,0,0,1,0
3051,2,1,0,0,1,0
5265,10,2,0,0,2,0
5265,9,1,0,0,1,0
5265,1,2,0,0,2,0
206757,6,2,0,0,2,0
163144,10,1,0,0,1,0
163144,9,3,0,0,3,0
163144,8,6,0,0,6,0
163144,3,1,0,0,1,0
32996,9,1,0,0,1,0
256479,10,1,0,0,1,0
256479,9,2,0,0,2,0
256479,6,18,0,0,18,0
256479,4,11,0,0,11,0
256479,3,5,0,0,5,0
209450,10,2,0,0,2,0
209450,8,8,0,0,8,0
209450,5,5,0,0,5,0
209450,2,1,0,0,1,0
76487,9,1,0,0,1,0
76487,2,1,0,0,1,0
4568,9,1,0,0,1,0
4568,7,13,0,0,13,0
197528,10,2,0,0,2,0
197528,4,2,0,0,2,0
197528,2,1,0,0,1,0
1718,7,3,0,0,3,0
1718,1,2,0,0,2,0
33020,10,1,0,0,1,0
33020,9,1,0,0,1,0
33020,7,2,0,0,2,0
33020,3,3,0,0,3,0
33020,2,1,0,0,1,0
33020,1,3,0,0,3,0
3698,10,1,0,0,1,0
3698,9,1,0,0,1,0
257074,10,4,0,0,4,0
257074,9,2,0,0,2,0
257074,8,4,0,0,4,0
257074,4,4,0,0,4,0
1865,8,2,0,0,2,0
1865,1,1,0,0,1,0
99313,5,1,0,0,1,0
130548,10,5,0,0,5,0
130548,7,17,0,0,17,0
130548,4,1,0,0,1,0
130548,3,1,0,0,1,0
179600,10,2,0,0,2,0
179600,4,5,0,0,5,0
120000,3,3,0,0,3,0
120000,2,1,0,0,1,0
228740,2,1,0,0,1,0
169555,10,2,0,0,2,0
169555,5,5,0,0,5,0
169555,4,1,0,0,1,0
169555,3,1,0,0,1,0
9194,10,3,0,0,3,0
9194,9,1,0,0,1,0
9194,4,3,0,0,3,0
9194,2,2,0,0,2,0
9194,1,1,0,0,1,0
688,9,1,0,0,1,0
174517,10,3,0,0,3,0
174517,9,8,0,0,8,0
174517,4,1,0,0,1,0
174517,3,1,0,0,1,0
18867,1,1,0,0,1,0
116422,9,1,0,0,1,0
116422,8,1,0,0,1,0
6701,10,1,0,0,1,0
6701,9,2,0,0,2,0
6701,5,10,0,0,10,0
6701,1,1,0,0,1,0
151847,3,5,0,0,5,0
151847,1,2,0,0,2,0
8042,10,2,0,0,2,0
40083,10,1,0,0,1,0
40083,9,2,0,0,2,0
40083,7,9,0,0,9,0
40083,1,1,0,0,1,0
63067,3,2,0,0,2,0
63067,1,1,0,0,1,0
201281,10,1,0,0,1,0
30820,8,3,0,0,3,0
212378,5,6,0,0,6,0
212378,3,1,0,0,1,0
199689,9,3,0,0,3,0
199689,5,11,0,0,11,0
193831,10,4,0,0,4,0
193831,9,2,0,0,2,0
193831,8,7,0,0,7,0
193831,2,2,0,0,2,0
247191,10,1,0,0,1,0
247191,5,4,0,0,4,0
247191,4,2,0,0,2,0
10506,9,1,0,0,1,0
10506,1,6,0,0,6,0
41006,4,1,0,0,1,0
41006,2,1,0,0,1,0
149618,8,22,0,0,22,0
149618,3,2,0,0,2,0
3210,3,1,0,0,1,0
165447,3,4,0,0,4,0
5018,10,1,0,0,1,0
5018,8,2,0,0,2,0
13128,7,5,0,0,5,0
13128,2,1,0,0,1,0
26999,10,1,0,0,1,0
5964,10,1,0,0,1,0
5964,2,1,0,0,1,0
133337,7,10,0,0,10,0
7329,1,1,0,0,1,0
26137,8,5,0,0,5,0
202477,10,2,0,0,2,0
202477,4,1,0,0,1,0
202477,3,2,0,0,2,0
202477,2,1,0,0,1,0
202477,1,1,0,0,1,0
124758,8,3,0,0,3,0
18563,2,1,0,0,1,0
254230,7,9,0,0,9,0
254230,5,3,0,0,3,0
254230,3,3,0,0,3,0
209344,1,1,0,0,1,0
103077,9,4,0,0,4,0
103077,8,5,0,0,5,0
103077,5,13,0,0,13,0
103077,2,4,0,0,4,0
8283,10,1,0,0,1,0
5054,10,3,0,0,3,0
5054,3,2,0,0,2,0
151078,2,1,0,0,1,0
84864,10,1,0,0,1,0
84864,8,7,0,0,7,0
120269,1,1,0,0,1,0
42101,5,4,0,0,4,0
42101,3,2,0,0,2,0
42101,1,1,0,0,1,0
2806,10,2,0,0,2,0
2806,2,1,0,0,1,0
96608,9,2,0,0,2,0
96608,5,17,0,0,17,0
96608,4,5,0,0,5,0
96608,2,1,0,0,1,0
160560,5,6,0,0,6,0
160560,3,2,0,0,2,0
8803,10,1,0,0,1,0
8803,9,1,0,0,1,0
183720,6,19,0,0,19,0
183720,3,1,0,0,1,0
11111,5,4,0,0,4,0
11111,3,1,0,0,1,0
153516,10,2,0,0,2,0
153516,9,1,0,0,1,0
153516,8,3,0,0,3,0
153516,5,9,0,0,9,0
153516,4,4,0,0,4,0
153516,3,2,0,0,2,0
153516,2,4,0,0,4,0
153516,1,2,0,0,2,0
1271,9,2,0,0,2,0
1271,1,1,0,0,1,0
100447,10,1,0,0,1,0
100447,9,1,0,0,1,0
100447,5,8,0,0,8,0
100447,4,3,0,0,3,0
100447,3,3,0,0,3,0
4373,10,1,0,0,1,0
4373,8,1,0,0,1,0
29010,10,1,0,0,1,0
29010,1,2,0,0,2,0
125832,10,2,0,0,2,0
125832,8,8,0,0,8,0
125832,5,11,0,0,11,0
26106,8,1,0,0,1,0
26106,7,3,0,0,3,0
139807,4,3,0,0,3,0
140693,4,2,0,0,2,0
140693,1,1,0,0,1,0
166661,8,4,0,0,4,0
257667,4,3,0,0,3,0
257667,3,1,0,0,1,0
146245,3,1,0,0,1,0
146245,2,2,0,0,2,0
146245,1,1,0,0,1,0
228409,6,9,0,0,9,0
228409,4,1,0,0,1,0
174231,10,9,0,0,9,0
174231,9,9,0,0,9,0
174231,5,2,0,0,2,0
174231,4,4,0,0,4,0
174231,1,1,0,0,1,0
257669,10,1,0,0,1,0
257669,9,4,0,0,4,0
257669,4,2,0,0,2,0
3161,10,3,0,0,3,0
3161,9,2,0,0,2,0
3161,4,1,0,0,1,0
3161,3,2,0,0,2,0
3161,2,1,0,0,1,0
231954,8,2,0,0,2,0
231954,7,5,0,0,5,0
231954,6,10,0,0,10,0
218235,3,2,0,0,2,0
218235,1,1,0,0,1,0
200500,10,1,0,0,1,0
200500,5,6,0,0,6,0
200500,4,1,0,0,1,0
200500,3,2,0,0,2,0
127533,8,1,0,0,1,0
127533,7,1,0,0,1,0
148730,10,1,0,0,1,0
148730,9,2,0,0,2,0
148730,5,4,0,0,4,0
148730,4,1,0,0,1,0
148730,1,1,0,0,1,0
270673,6,12,0,0,12,0
270673,5,4,0,0,4,0
205506,10,1,0,0,1,0
205506,9,1,0,0,1,0
205506,4,3,0,0,3,0
205790,10,1,0,0,1,0
205790,9,3,0,0,3,0
205790,5,6,0,0,6,0
205790,3,1,0,0,1,0
205790,1,1,0,0,1,0
46800,9,1,0,0,1,0
46800,5,8,0,0,8,0
46800,3,6,0,0,6,0
4310,10,1,0,0,1,0
33803,9,1,0,0,1,0
205544,10,4,0,0,4,0
223322,10,2,0,0,2,0
223322,4,2,0,0,2,0
169987,9,1,0,0,1,0
169987,7,3,0,0,3,0
169987,2,3,0,0,3,0
118568,6,11,0,0,11,0
118568,4,3,0,0,3,0
118568,3,2,0,0,2,0
31794,7,3,0,0,3,0
31794,6,9,0,0,9,0
31794,3,16,0,0,16,0
1599,2,1,0,0,1,0
219359,9,1,0,0,1,0
219359,4,5,0,0,5,0
219359,2,2,0,0,2,0
142980,4,5,0,0,5,0
142980,3,3,0,0,3,0
142980,1,1,0,0,1,0
214879,3,2,0,0,2,0
214879,2,1,0,0,1,0
193301,9,1,0,0,1,0
182259,10,5,0,0,5,0
182259,4,3,0,0,3,0
182259,3,3,0,0,3,0
182259,1,1,0,0,1,0
169045,3,2,0,0,2,0
169045,2,2,0,0,2,0
169045,1,2,0,0,2,0
163186,4,3,0,0,3,0
163186,2,1,0,0,1,0
164702,6,3,0,0,3,0
164702,4,1,0,0,1,0
96061,10,5,0,0,5,0
96061,6,2,0,0,2,0
96061,4,1,0,0,1,0
155494,9,2,0,0,2,0
155494,8,8,0,0,8,0
28063,8,3,0,0,3,0
4518,9,3,0,0,3,0
4518,5,10,0,0,10,0
8736,10,2,0,0,2,0
5181,10,1,0,0,1,0
5181,9,1,0,0,1,0
124991,10,4,0,0,4,0
124991,5,2,0,0,2,0
19552,10,2,0,0,2,0
19552,9,2,0,0,2,0
19552,8,4,0,0,4,0
237860,4,1,0,0,1,0
218632,10,1,0,0,1,0
218632,4,6,0,0,6,0
218632,3,4,0,0,4,0
218632,2,2,0,0,2,0
218632,1,1,0,0,1,0
43332,10,2,0,0,2,0
43332,4,1,0,0,1,0
38001,7,6,0,0,6,0
38001,4,11,0,0,11,0
3275,5,2,0,0,2,0
3275,4,2,0,0,2,0
156648,10,2,0,0,2,0
156648,9,1,0,0,1,0
156648,8,2,0,0,2,0
29,3,1,0,0,1,0
610,10,1,0,0,1,0
610,8,1,0,0,1,0
11110,10,1,0,0,1,0
22035,9,1,0,0,1,0
22035,8,7,0,0,7,0
22035,3,2,0,0,2,0
11414,7,8,0,0,8,0
40455,1,1,0,0,1,0
74936,9,1,0,0,1,0
74936,8,6,0,0,6,0
74936,2,4,0,0,4,0
156101,5,5,0,0,5,0
156101,3,1,0,0,1,0
113070,7,9,0,0,9,0
113070,1,1,0,0,1,0
132717,9,3,0,0,3,0
132717,8,4,0,0,4,0
132717,7,3,0,0,3,0
132717,4,11,0,0,11,0
132717,3,3,0,0,3,0
132717,1,1,0,0,1,0
139471,9,3,0,0,3,0
139471,5,6,0,0,6,0
139471,4,7,0,0,7,0
234860,5,3,0,0,3,0
234860,4,5,0,0,5,0
54457,10,1,0,0,1,0
54457,9,2,0,0,2,0
54457,4,1,0,0,1,0
124372,10,1,0,0,1,0
124372,9,1,0,0,1,0
124372,4,6,0,0,6,0
124372,3,3,0,0,3,0
124372,2,2,0,0,2,0
7248,10,1,0,0,1,0
4139,10,1,0,0,1,0
4139,2,1,0,0,1,0
13951,1,1,0,0,1,0
137404,9,2,0,0,2,0
137404,8,1,0,0,1,0
137404,3,1,0,0,1,0
144346,9,2,0,0,2,0
158256,9,1,0,0,1,0
158256,8,1,0,0,1,0
158256,4,9,0,0,9,0
158256,2,1,0,0,1,0
250539,4,2,0,0,2,0
250539,2,1,0,0,1,0
250539,1,2,0,0,2,0
209014,5,8,0,0,8,0
209014,4,3,0,0,3,0
224478,7,13,0,0,13,0
224478,4,7,0,0,7,0
224478,2,1,0,0,1,0
134255,10,1,0,0,1,0
134255,7,8,0,0,8,0
134255,2,2,0,0,2,0
134255,1,2,0,0,2,0
8447,10,1,0,0,1,0
8447,9,1,0,0,1,0
1939,9,1,0,0,1,0
1939,7,3,0,0,3,0
1939,1,1,0,0,1,0
9867,10,5,0,0,5,0
194079,10,1,0,0,1,0
194079,9,1,0,0,1,0
194079,8,4,0,0,4,0
194079,7,9,0,0,9,0
194079,3,2,0,0,2,0
276,3,2,0,0,2,0
8191,7,1,0,0,1,0
151985,10,4,0,0,4,0
151985,9,3,0,0,3,0
151985,6,15,0,0,15,0
151985,3,4,0,0,4,0
151985,2,1,0,0,1,0
146152,9,1,0,0,1,0
146152,2,1,0,0,1,0
4349,4,5,0,0,5,0
4349,3,2,0,0,2,0
4349,2,1,0,0,1,0
16674,2,1,0,0,1,0
26250,4,2,0,0,2,0
40514,10,2,0,0,2,0
40514,9,1,0,0,1,0
40514,1,1,0,0,1,0
194874,1,1,0,0,1,0
31764,10,5,0,0,5,0
31764,7,9,0,0,9,0
31764,3,2,0,0,2,0
6988,9,2,0,0,2,0
6988,7,17,0,0,17,0
6988,2,1,0,0,1,0
6988,1,1,0,0,1,0
136286,10,1,0,0,1,0
136286,8,1,0,0,1,0
136286,2,1,0,0,1,0
136286,1,2,0,0,2,0
62854,10,1,0,0,1,0
176651,10,2,0,0,2,0
179876,9,1,0,0,1,0
179876,8,2,0,0,2,0
179876,5,15,0,0,15,0
89931,10,1,0,0,1,0
89931,8,2,0,0,2,0
89931,1,1,0,0,1,0
124378,9,1,0,0,1,0
124378,8,2,0,0,2,0
124378,3,4,0,0,4,0
11699,4,4,0,0,4,0
20192,8,4,0,0,4,0
245700,3,2,0,0,2,0
249814,4,1,0,0,1,0
249814,1,1,0,0,1,0
136566,9,2,0,0,2,0
136566,3,3,0,0,3,0
11283,10,1,0,0,1,0
11283,9,4,0,0,4,0
11283,1,1,0,0,1,0
235252,8,2,0,0,2,0
235252,5,5,0,0,5,0
235252,1,1,0,0,1,0
224986,3,1,0,0,1,0
15211,9,2,0,0,2,0
15211,3,1,0,0,1,0
169246,2,1,0,0,1,0
3140,10,1,0,0,1,0
3140,9,1,0,0,1,0
3140,8,1,0,0,1,0
3140,1,1,0,0,1,0
1618,5,1,0,0,1,0
1618,3,1,0,0,1,0
84825,9,2,0,0,2,0
83283,10,2,0,0,2,0
83283,5,4,0,0,4,0
91512,8,7,0,0,7,0
250488,4,1,0,0,1,0
250488,1,1,0,0,1,0
2011,4,6,0,0,6,0
2011,2,1,0,0,1,0
6686,8,1,0,0,1,0
5769,6,9,0,0,9,0
5769,5,2,0,0,2,0
5769,4,1,0,0,1,0
5769,3,1,0,0,1,0
225759,7,3,0,0,3,0
225759,5,2,0,0,2,0
219807,2,1,0,0,1,0
38975,3,1,0,0,1,0
3430,2,6,0,0,6,0
8036,9,2,0,0,2,0
10096,9,2,0,0,2,0
10096,8,8,0,0,8,0
10096,7,13,0,0,13,0
10096,3,2,0,0,2,0
849,9,1,0,0,1,0
849,1,2,0,0,2,0
4472,10,2,0,0,2,0
4472,3,1,0,0,1,0
158891,7,15,0,0,15,0
158891,4,3,0,0,3,0
25299,10,1,0,0,1,0
25299,2,1,0,0,1,0
5052,10,1,0,0,1,0
12253,6,4,0,0,4,0
12253,4,1,0,0,1,0
182960,10,1,0,0,1,0
182960,9,2,0,0,2,0
182960,8,4,0,0,4,0
182960,4,7,0,0,7,0
24783,4,1,0,0,1,0
7748,5,1,0,0,1,0
38772,1,1,0,0,1,0
149793,9,4,0,0,4,0
149793,5,1,0,0,1,0
149793,4,1,0,0,1,0
25462,3,2,0,0,2,0
16439,4,4,0,0,4,0
197783,10,2,0,0,2,0
197783,4,3,0,0,3,0
197783,2,1,0,0,1,0
197783,1,1,0,0,1,0
256422,6,3,0,0,3,0
256422,5,1,0,0,1,0
256422,4,1,0,0,1,0
217270,4,1,0,0,1,0
130347,8,4,0,0,4,0
130347,4,14,0,0,14,0
264196,6,2,0,0,2,0
264196,4,1,0,0,1,0
162578,10,1,0,0,1,0
162578,9,1,0,0,1,0
162578,5,11,0,0,11,0
267652,7,3,0,0,3,0
267652,5,1,0,0,1,0
247034,10,1,0,0,1,0
247034,1,1,0,0,1,0
141249,10,2,0,0,2,0
141249,7,9,0,0,9,0
141249,5,5,0,0,5,0
141249,4,3,0,0,3,0
141249,3,1,0,0,1,0
24186,2,1,0,0,1,0
61477,10,1,0,0,1,0
61477,9,2,0,0,2,0
61477,2,1,0,0,1,0
207202,5,3,0,0,3,0
12276,9,1,0,0,1,0
13645,10,1,0,0,1,0
2295,8,2,0,0,2,0
2295,1,1,0,0,1,0
161813,5,2,0,0,2,0
161813,1,1,0,0,1,0
157452,1,2,0,0,2,0
204601,1,1,0,0,1,0
2317,9,2,0,0,2,0
2317,8,3,0,0,3,0
2317,4,5,0,0,5,0
1142,9,2,0,0,2,0
187420,10,6,0,0,6,0
187420,9,4,0,0,4,0
5200,9,2,0,0,2,0
6705,8,4,0,0,4,0
6705,4,5,0,0,5,0
6705,3,2,0,0,2,0
757,2,2,0,0,2,0
2175,8,1,0,0,1,0
2175,1,1,0,0,1,0
37743,9,1,0,0,1,0
37743,2,1,0,0,1,0
24782,8,1,0,0,1,0
24782,7,4,0,0,4,0
23695,2,1,0,0,1,0
5058,6,7,0,0,7,0
5058,5,2,0,0,2,0
5058,4,2,0,0,2,0
5058,3,1,0,0,1,0
5058,1,1,0,0,1,0
140600,9,1,0,0,1,0
36413,9,3,0,0,3,0
209383,9,1,0,0,1,0
129053,7,7,0,0,7,0
129053,3,3,0,0,3,0
5167,10,1,0,0,1,0
5167,9,1,0,0,1,0
5167,4,7,0,0,7,0
5167,3,1,0,0,1,0
182225,3,4,0,0,4,0
182225,2,1,0,0,1,0
49454,9,3,0,0,3,0
49454,8,4,0,0,4,0
49454,7,8,0,0,8,0
49454,4,5,0,0,5,0
49454,2,2,0,0,2,0
984,9,1,0,0,1,0
984,3,2,0,0,2,0
984,1,1,0,0,1,0
245389,10,2,0,0,2,0
245389,9,3,0,0,3,0
245389,2,1,0,0,1,0
245389,1,1,0,0,1,0
187550,9,2,0,0,2,0
187550,2,4,0,0,4,0
109143,5,7,0,0,7,0
109143,4,2,0,0,2,0
129224,3,4,0,0,4,0
8109,3,2,0,0,2,0
89915,9,1,0,0,1,0
89915,8,1,0,0,1,0
193278,10,1,0,0,1,0
193278,6,15,0,0,15,0
193278,5,7,0,0,7,0
193278,1,1,0,0,1,0
1937,9,1,0,0,1,0
1937,8,1,0,0,1,0
1937,1,1,0,0,1,0
229477,1,1,0,0,1,0
193428,8,4,0,0,4,0
193428,7,1,0,0,1,0
193428,1,3,0,0,3,0
8542,8,1,0,0,1,0
8542,1,1,0,0,1,0
146144,2,1,0,0,1,0
146144,1,1,0,0,1,0
9063,10,1,0,0,1,0
9063,9,1,0,0,1,0
9063,5,4,0,0,4,0
172278,10,2,0,0,2,0
172278,9,5,0,0,5,0
172278,2,1,0,0,1,0
172278,1,2,0,0,2,0
2336,10,1,0,0,1,0
2336,9,1,0,0,1,0
2336,2,2,0,0,2,0
257598,8,8,0,0,8,0
257598,5,4,0,0,4,0
257598,4,3,0,0,3,0
265489,5,2,0,0,2,0
36903,6,4,0,0,4,0
36903,1,1,0,0,1,0
99880,8,6,0,0,6,0
260212,9,1,0,0,1,0
260212,1,1,0,0,1,0
2367,10,1,0,0,1,0
2367,8,1,0,0,1,0
177053,5,4,0,0,4,0
347,4,4,0,0,4,0
347,3,3,0,0,3,0
347,2,1,0,0,1,0
11646,9,6,0,0,6,0
11646,2,1,0,0,1,0
6543,10,1,0,0,1,0
6543,9,1,0,0,1,0
202223,5,9,0,0,9,0
202223,2,1,0,0,1,0
202223,1,1,0,0,1,0
235467,8,9,0,0,9,0
235467,4,7,0,0,7,0
235467,3,3,0,0,3,0
7982,10,1,0,0,1,0
7982,7,5,0,0,5,0
7982,3,2,0,0,2,0
7982,2,1,0,0,1,0
227582,10,2,0,0,2,0
227582,9,3,0,0,3,0
9704,1,1,0,0,1,0
7008,6,8,0,0,8,0
7008,3,1,0,0,1,0
5185,2,2,0,0,2,0
14935,8,2,0,0,2,0
146253,8,3,0,0,3,0
146253,7,5,0,0,5,0
146253,4,9,0,0,9,0
21569,4,2,0,0,2,0
21569,1,1,0,0,1,0
256792,10,2,0,0,2,0
256792,8,4,0,0,4,0
256792,4,6,0,0,6,0
256792,2,2,0,0,2,0
256792,1,1,0,0,1,0
14410,9,2,0,0,2,0
14410,3,1,0,0,1,0
14410,2,1,0,0,1,0
193818,5,2,0,0,2,0
193818,4,1,0,0,1,0
193818,1,1,0,0,1,0
13367,9,1,0,0,1,0
13367,3,2,0,0,2,0
13367,2,1,0,0,1,0
9545,10,3,0,0,3,0
9545,8,2,0,0,2,0
9545,7,2,0,0,2,0
17958,10,2,0,0,2,0
95679,5,6,0,0,6,0
95679,4,2,0,0,2,0
252892,10,1,0,0,1,0
252892,9,1,0,0,1,0
252892,8,4,0,0,4,0
252892,4,6,0,0,6,0
252892,2,5,0,0,5,0
252892,1,1,0,0,1,0
31975,4,1,0,0,1,0
31975,2,1,0,0,1,0
233262,7,3,0,0,3,0
233262,6,4,0,0,4,0
233262,5,1,0,0,1,0
233262,3,1,0,0,1,0
233262,1,2,0,0,2,0
30364,9,1,0,0,1,0
30364,8,3,0,0,3,0
30364,1,2,0,0,2,0
15678,4,3,0,0,3,0
15678,3,1,0,0,1,0
56410,9,3,0,0,3,0
56410,5,9,0,0,9,0
56410,4,5,0,0,5,0
56410,2,1,0,0,1,0
89611,8,3,0,0,3,0
89611,5,7,0,0,7,0
89611,1,2,0,0,2,0
17208,9,1,0,0,1,0
17208,4,2,0,0,2,0
17208,2,1,0,0,1,0
13260,10,1,0,0,1,0
13260,7,7,0,0,7,0
13260,1,2,0,0,2,0
1625,10,2,0,0,2,0
1625,9,2,0,0,2,0
254695,9,2,0,0,2,0
254695,5,8,0,0,8,0
254695,4,1,0,0,1,0
5999,10,1,0,0,1,0
5999,4,4,0,0,4,0
5999,2,1,0,0,1,0
3527,9,2,0,0,2,0
3527,1,1,0,0,1,0
245824,10,1,0,0,1,0
245824,4,3,0,0,3,0
245824,3,1,0,0,1,0
260986,4,2,0,0,2,0
260986,3,2,0,0,2,0
260986,2,1,0,0,1,0
2635,9,1,0,0,1,0
2635,8,1,0,0,1,0
67022,8,6,0,0,6,0
67022,5,6,0,0,6,0
67022,4,1,0,0,1,0
193291,5,5,0,0,5,0
193291,4,1,0,0,1,0
132229,5,4,0,0,4,0
132229,4,1,0,0,1,0
132229,3,1,0,0,1,0
132229,1,1,0,0,1,0
74987,4,2,0,0,2,0
249550,7,3,0,0,3,0
249550,6,1,0,0,1,0
249550,1,1,0,0,1,0
1053,8,11,0,0,11,0
204803,10,1,0,0,1,0
204803,9,5,0,0,5,0
204803,7,15,0,0,15,0
204803,5,2,0,0,2,0
204803,4,1,0,0,1,0
204803,3,2,0,0,2,0
204803,1,1,0,0,1,0
30306,8,3,0,0,3,0
30306,7,7,0,0,7,0
30306,5,10,0,0,10,0
30306,2,6,0,0,6,0
4680,10,1,0,0,1,0
260269,10,2,0,0,2,0
260269,5,4,0,0,4,0
260269,4,2,0,0,2,0
260269,3,3,0,0,3,0
260269,2,1,0,0,1,0
1684,9,1,0,0,1,0
1684,8,2,0,0,2,0
1684,1,4,0,0,4,0
9504,9,1,0,0,1,0
9504,5,2,0,0,2,0
9504,4,3,0,0,3,0
9504,3,1,0,0,1,0
27071,9,1,0,0,1,0
27071,2,1,0,0,1,0
176071,8,8,0,0,8,0
176071,2,1,0,0,1,0
3973,9,2,0,0,2,0
3973,5,7,0,0,7,0
6958,6,17,0,0,17,0
219622,10,1,0,0,1,0
219622,9,2,0,0,2,0
219622,4,3,0,0,3,0
20153,10,1,0,0,1,0
20153,9,2,0,0,2,0
20153,5,14,0,0,14,0
20153,3,3,0,0,3,0
1411,10,1,0,0,1,0
1411,9,2,0,0,2,0
1411,3,2,0,0,2,0
199790,10,2,0,0,2,0
199790,9,3,0,0,3,0
199790,8,20,0,0,20,0
199790,5,3,0,0,3,0
199790,3,1,0,0,1,0
118559,5,1,0,0,1,0
118559,2,2,0,0,2,0
118559,1,1,0,0,1,0
10508,4,2,0,0,2,0
35219,3,1,0,0,1,0
35219,2,1,0,0,1,0
15081,2,2,0,0,2,0
15081,1,1,0,0,1,0
59060,10,1,0,0,1,0
59060,4,9,0,0,9,0
59060,3,6,0,0,6,0
59060,2,2,0,0,2,0
21941,7,2,0,0,2,0
21941,2,4,0,0,4,0
21941,1,1,0,0,1,0
6993,10,3,0,0,3,0
6993,5,2,0,0,2,0
6993,3,3,0,0,3,0
30640,10,1,0,0,1,0
30640,5,11,0,0,11,0
30640,4,13,0,0,13,0
201510,4,2,0,0,2,0
201510,3,1,0,0,1,0
201510,2,1,0,0,1,0
6638,10,2,0,0,2,0
6638,5,5,0,0,5,0
6638,3,2,0,0,2,0
40411,5,8,0,0,8,0
219502,8,4,0,0,4,0
219502,4,4,0,0,4,0
219502,3,3,0,0,3,0
245382,9,2,0,0,2,0
105024,7,9,0,0,9,0
229491,5,1,0,0,1,0
229491,4,3,0,0,3,0
229491,3,1,0,0,1,0
229491,2,1,0,0,1,0
229491,1,1,0,0,1,0
174552,10,5,0,0,5,0
174552,4,3,0,0,3,0
174552,2,1,0,0,1,0
15396,9,2,0,0,2,0
15396,3,2,0,0,2,0
13647,10,5,0,0,5,0
13647,5,5,0,0,5,0
5830,5,2,0,0,2,0
5830,4,1,0,0,1,0
5830,3,2,0,0,2,0
148592,2,1,0,0,1,0
178285,10,4,0,0,4,0
178285,7,16,0,0,16,0
178285,1,2,0,0,2,0
194102,5,2,0,0,2,0
194102,4,5,0,0,5,0
6971,10,1,0,0,1,0
6971,9,1,0,0,1,0
6971,7,4,0,0,4,0
20731,5,2,0,0,2,0
244258,10,15,0,0,15,0
244258,6,4,0,0,4,0
244258,5,1,0,0,1,0
244258,2,1,0,0,1,0
42789,3,1,0,0,1,0
6860,9,2,0,0,2,0
6860,3,2,0,0,2,0
2605,10,1,0,0,1,0
9104,10,6,0,0,6,0
9104,5,3,0,0,3,0
68947,9,2,0,0,2,0
68947,4,1,0,0,1,0
12672,10,1,0,0,1,0
12672,4,7,0,0,7,0
12672,1,1,0,0,1,0
3030,8,1,0,0,1,0
3030,3,4,0,0,4,0
3030,2,2,0,0,2,0
9368,10,1,0,0,1,0
9368,7,8,0,0,8,0
198832,4,2,0,0,2,0
5199,10,2,0,0,2,0
5199,8,5,0,0,5,0
5199,3,2,0,0,2,0
5199,2,1,0,0,1,0
217230,9,1,0,0,1,0
217230,8,6,0,0,6,0
217230,7,9,0,0,9,0
217230,1,1,0,0,1,0
182178,2,1,0,0,1,0
182178,1,1,0,0,1,0
36944,4,7,0,0,7,0
36944,3,1,0,0,1,0
36944,2,1,0,0,1,0
36944,1,2,0,0,2,0
25516,2,1,0,0,1,0
206437,10,4,0,0,4,0
206437,9,3,0,0,3,0
206437,4,4,0,0,4,0
206437,2,2,0,0,2,0
235839,6,5,0,0,5,0
235839,5,1,0,0,1,0
235839,2,1,0,0,1,0
147168,10,22,0,0,22,0
147168,9,10,0,0,10,0
147168,6,6,0,0,6,0
147168,5,2,0,0,2,0
147168,4,2,0,0,2,0
147168,2,1,0,0,1,0
147168,1,4,0,0,4,0
6008,10,1,0,0,1,0
6008,3,1,0,0,1,0
224141,7,6,0,0,6,0
224141,5,1,0,0,1,0
2713,10,2,0,0,2,0
2713,4,2,0,0,2,0
18858,10,1,0,0,1,0
18858,9,2,0,0,2,0
18858,8,2,0,0,2,0
18858,4,7,0,0,7,0
18858,3,4,0,0,4,0
18858,2,1,0,0,1,0
33406,9,1,0,0,1,0
33406,7,6,0,0,6,0
33406,2,3,0,0,3,0
33406,1,1,0,0,1,0
76920,10,1,0,0,1,0
32288,4,2,0,0,2,0
32288,2,1,0,0,1,0
176306,3,2,0,0,2,0
176306,1,1,0,0,1,0
7327,10,1,0,0,1,0
21294,9,1,0,0,1,0
21294,3,3,0,0,3,0
39034,2,1,0,0,1,0
93594,10,2,0,0,2,0
93594,9,3,0,0,3,0
93594,8,6,0,0,6,0
93594,1,3,0,0,3,0
1785,9,2,0,0,2,0
1785,3,1,0,0,1,0
232134,7,1,0,0,1,0
232134,6,4,0,0,4,0
232134,5,2,0,0,2,0
4272,9,1,0,0,1,0
4272,3,2,0,0,2,0
4272,1,1,0,0,1,0
42901,9,1,0,0,1,0
22511,4,2,0,0,2,0
22511,3,2,0,0,2,0
22511,2,1,0,0,1,0
209951,7,2,0,0,2,0
209951,4,2,0,0,2,0
1938,9,1,0,0,1,0
1938,7,3,0,0,3,0
1938,4,14,0,0,14,0
208995,9,3,0,0,3,0
208995,1,2,0,0,2,0
6940,10,2,0,0,2,0
6940,3,1,0,0,1,0
188576,7,7,0,0,7,0
188576,4,11,0,0,11,0
253470,5,2,0,0,2,0
253470,4,1,0,0,1,0
253470,1,1,0,0,1,0
22808,3,1,0,0,1,0
25429,7,2,0,0,2,0
25429,6,13,0,0,13,0
25429,1,1,0,0,1,0
5208,3,6,0,0,6,0
2134,8,2,0,0,2,0
2134,4,5,0,0,5,0
140940,9,3,0,0,3,0
140940,2,3,0,0,3,0
13416,8,1,0,0,1,0
13416,7,4,0,0,4,0
207442,9,3,0,0,3,0
207442,5,4,0,0,4,0
207442,4,2,0,0,2,0
8717,4,1,0,0,1,0
138127,8,6,0,0,6,0
138127,5,9,0,0,9,0
138127,2,1,0,0,1,0
138127,1,2,0,0,2,0
221408,5,2,0,0,2,0
221408,3,1,0,0,1,0
221408,2,1,0,0,1,0
15845,9,1,0,0,1,0
15845,8,1,0,0,1,0
15845,1,1,0,0,1,0
114530,10,5,0,0,5,0
114530,9,6,0,0,6,0
149323,9,1,0,0,1,0
25097,7,5,0,0,5,0
6700,3,1,0,0,1,0
6700,1,1,0,0,1,0
5994,10,1,0,0,1,0
5994,9,2,0,0,2,0
7612,10,1,0,0,1,0
7612,7,1,0,0,1,0
7612,1,3,0,0,3,0
243780,5,2,0,0,2,0
243780,4,1,0,0,1,0
20467,9,1,0,0,1,0
20467,3,1,0,0,1,0
223573,9,1,0,0,1,0
223573,4,3,0,0,3,0
223573,2,1,0,0,1,0
223573,1,1,0,0,1,0
11937,8,4,0,0,4,0
11937,4,3,0,0,3,0
9938,9,1,0,0,1,0
9938,8,1,0,0,1,0
9938,7,1,0,0,1,0
1956,8,3,0,0,3,0
1956,3,2,0,0,2,0
1956,1,1,0,0,1,0
17457,10,1,0,0,1,0
17457,1,1,0,0,1,0
11585,9,1,0,0,1,0
11585,3,2,0,0,2,0
11585,1,1,0,0,1,0
8008,2,1,0,0,1,0
62637,1,1,0,0,1,0
209850,9,1,0,0,1,0
209850,4,8,0,0,8,0
209850,3,1,0,0,1,0
96602,1,1,0,0,1,0
11083,1,2,0,0,2,0
13779,10,2,0,0,2,0
13779,9,1,0,0,1,0
13779,3,1,0,0,1,0
100758,8,3,0,0,3,0
100758,3,2,0,0,2,0
11262,9,2,0,0,2,0
11262,2,4,0,0,4,0
11262,1,2,0,0,2,0
158445,10,1,0,0,1,0
158445,4,2,0,0,2,0
73245,10,1,0,0,1,0
73245,3,1,0,0,1,0
8509,10,1,0,0,1,0
8509,3,1,0,0,1,0
10171,9,2,0,0,2,0
10171,5,12,0,0,12,0
10171,2,1,0,0,1,0
55820,8,4,0,0,4,0
55820,7,4,0,0,4,0
55820,2,2,0,0,2,0
15066,9,2,0,0,2,0
155465,6,12,0,0,12,0
5929,9,1,0,0,1,0
5929,5,4,0,0,4,0
5929,4,2,0,0,2,0
127748,5,14,0,0,14,0
90016,8,2,0,0,2,0
107372,9,2,0,0,2,0
5120,10,1,0,0,1,0
37175,7,3,0,0,3,0
4676,9,1,0,0,1,0
4676,1,2,0,0,2,0
168250,5,5,0,0,5,0
168250,4,4,0,0,4,0
168250,3,1,0,0,1,0
2963,4,3,0,0,3,0
2963,3,1,0,0,1,0
21072,8,14,0,0,14,0
21072,4,2,0,0,2,0
21072,2,1,0,0,1,0
26697,9,3,0,0,3,0
104775,9,1,0,0,1,0
104775,2,1,0,0,1,0
209423,6,7,0,0,7,0
209423,4,3,0,0,3,0
209423,3,1,0,0,1,0
15624,9,3,0,0,3,0
15624,1,1,0,0,1,0
186723,5,1,0,0,1,0
186723,1,1,0,0,1,0
4251,5,12,0,0,12,0
4251,1,4,0,0,4,0
5234,8,3,0,0,3,0
5234,7,4,0,0,4,0
8997,8,3,0,0,3,0
8997,2,1,0,0,1,0
8997,1,1,0,0,1,0
3812,10,1,0,0,1,0
3812,4,7,0,0,7,0
39312,1,2,0,0,2,0
9640,10,1,0,0,1,0
9640,4,2,0,0,2,0
8267,10,1,0,0,1,0
8267,8,2,0,0,2,0
226878,8,7,0,0,7,0
226878,5,9,0,0,9,0
226878,3,1,0,0,1,0
7539,2,1,0,0,1,0
209714,7,16,0,0,16,0
99707,8,3,0,0,3,0
99707,3,2,0,0,2,0
26141,9,1,0,0,1,0
26141,4,2,0,0,2,0
26141,3,1,0,0,1,0
12142,10,1,0,0,1,0
12142,4,1,0,0,1,0
12142,2,1,0,0,1,0
157487,5,8,0,0,8,0
575,8,3,0,0,3,0
20432,10,2,0,0,2,0
31711,1,1,0,0,1,0
10673,7,4,0,0,4,0
10673,2,2,0,0,2,0
132203,7,7,0,0,7,0
132203,5,11,0,0,11,0
132203,3,2,0,0,2,0
8132,10,1,0,0,1,0
8132,9,2,0,0,2,0
8132,4,4,0,0,4,0
41148,9,1,0,0,1,0
41148,8,8,0,0,8,0
41148,7,18,0,0,18,0
41148,4,3,0,0,3,0
41148,3,2,0,0,2,0
41148,2,1,0,0,1,0
41148,1,1,0,0,1,0
26122,10,1,0,0,1,0
26122,8,5,0,0,5,0
26122,2,3,0,0,3,0
26620,5,5,0,0,5,0
6374,10,1,0,0,1,0
186442,10,3,0,0,3,0
186442,9,2,0,0,2,0
186442,5,8,0,0,8,0
2858,2,3,0,0,3,0
8728,3,1,0,0,1,0
8728,1,1,0,0,1,0
5449,10,1,0,0,1,0
5449,8,2,0,0,2,0
5449,2,1,0,0,1,0
1735,3,2,0,0,2,0
1735,2,1,0,0,1,0
158895,10,1,0,0,1,0
158895,4,5,0,0,5,0
39189,5,1,0,0,1,0
1650,4,2,0,0,2,0
1650,3,5,0,0,5,0
613,9,2,0,0,2,0
613,8,2,0,0,2,0
6897,10,2,0,0,2,0
6897,1,1,0,0,1,0
143487,5,3,0,0,3,0
143487,3,1,0,0,1,0
237629,10,1,0,0,1,0
237629,5,3,0,0,3,0
237629,2,1,0,0,1,0
237629,1,1,0,0,1,0
35492,10,1,0,0,1,0
35492,9,1,0,0,1,0
35492,6,15,0,0,15,0
35492,2,1,0,0,1,0
6365,7,9,0,0,9,0
25312,10,1,0,0,1,0
25312,9,6,0,0,6,0
25312,2,3,0,0,3,0
25924,9,1,0,0,1,0
25924,8,6,0,0,6,0
25924,4,5,0,0,5,0
25924,2,1,0,0,1,0
182101,10,2,0,0,2,0
182101,7,9,0,0,9,0
182101,4,3,0,0,3,0
182101,2,2,0,0,2,0
126026,10,3,0,0,3,0
126026,9,4,0,0,4,0
25618,10,2,0,0,2,0
15193,10,1,0,0,1,0
250865,9,7,0,0,7,0
250865,6,12,0,0,12,0
7296,9,1,0,0,1,0
7296,4,9,0,0,9,0
7296,2,1,0,0,1,0
7296,1,1,0,0,1,0
162288,10,1,0,0,1,0
148309,10,1,0,0,1,0
21331,10,1,0,0,1,0
21331,8,6,0,0,6,0
21331,3,8,0,0,8,0
21331,1,2,0,0,2,0
627,10,1,0,0,1,0
627,2,1,0,0,1,0
259298,6,4,0,0,4,0
259298,3,1,0,0,1,0
29142,9,1,0,0,1,0
29142,2,1,0,0,1,0
6017,10,1,0,0,1,0
6017,3,2,0,0,2,0
202513,4,2,0,0,2,0
202513,3,1,0,0,1,0
202513,1,1,0,0,1,0
233996,9,9,0,0,9,0
233996,6,4,0,0,4,0
233996,1,1,0,0,1,0
23373,10,1,0,0,1,0
23373,9,1,0,0,1,0
23373,2,1,0,0,1,0
5045,4,1,0,0,1,0
1071,1,1,0,0,1,0
246346,4,2,0,0,2,0
31516,10,1,0,0,1,0
31516,4,2,0,0,2,0
31516,3,1,0,0,1,0
129988,9,1,0,0,1,0
129988,6,23,0,0,23,0
129988,4,4,0,0,4,0
9233,5,8,0,0,8,0
218465,9,3,0,0,3,0
218465,4,3,0,0,3,0
218465,3,3,0,0,3,0
218465,1,1,0,0,1,0
228452,10,7,0,0,7,0
3241,5,4,0,0,4,0
158747,3,4,0,0,4,0
158747,1,1,0,0,1,0
226457,10,3,0,0,3,0
226457,5,6,0,0,6,0
226457,2,2,0,0,2,0
3020,10,3,0,0,3,0
3020,8,2,0,0,2,0
3020,1,2,0,0,2,0
92759,4,1,0,0,1,0
92759,3,1,0,0,1,0
9438,10,1,0,0,1,0
9438,1,1,0,0,1,0
12494,10,1,0,0,1,0
12494,9,1,0,0,1,0
12494,2,2,0,0,2,0
195195,10,1,0,0,1,0
195195,9,1,0,0,1,0
195195,8,4,0,0,4,0
195195,4,1,0,0,1,0
181615,7,12,0,0,12,0
181615,4,8,0,0,8,0
181615,3,1,0,0,1,0
181615,2,1,0,0,1,0
84989,4,3,0,0,3,0
255332,2,1,0,0,1,0
226643,10,2,0,0,2,0
226643,4,2,0,0,2,0
42704,10,3,0,0,3,0
42704,9,1,0,0,1,0
42704,5,4,0,0,4,0
42704,3,2,0,0,2,0
42704,1,2,0,0,2,0
2352,8,1,0,0,1,0
2352,1,2,0,0,2,0
8679,5,1,0,0,1,0
8679,4,1,0,0,1,0
246315,10,2,0,0,2,0
246315,8,5,0,0,5,0
246315,4,2,0,0,2,0
246315,3,2,0,0,2,0
175496,10,1,0,0,1,0
175496,9,2,0,0,2,0
175496,3,1,0,0,1,0
10518,3,5,0,0,5,0
10518,1,1,0,0,1,0
103806,3,3,0,0,3,0
103806,2,1,0,0,1,0
103806,1,2,0,0,2,0
170195,5,4,0,0,4,0
170195,1,1,0,0,1,0
54073,9,1,0,0,1,0
54073,3,1,0,0,1,0
168840,8,3,0,0,3,0
168840,7,6,0,0,6,0
92646,4,10,0,0,10,0
92646,3,4,0,0,4,0
93555,3,3,0,0,3,0
80474,9,1,0,0,1,0
80474,3,1,0,0,1,0
62291,4,1,0,0,1,0
62291,2,1,0,0,1,0
145492,9,1,0,0,1,0
145492,4,5,0,0,5,0
145492,3,1,0,0,1,0
37391,9,2,0,0,2,0
21990,5,7,0,0,7,0
6053,10,3,0,0,3,0
6053,8,2,0,0,2,0
6053,5,8,0,0,8,0
6053,2,2,0,0,2,0
5322,10,1,0,0,1,0
5322,1,2,0,0,2,0
148099,3,2,0,0,2,0
9174,5,8,0,0,8,0
9174,1,1,0,0,1,0
84922,10,1,0,0,1,0
84922,4,2,0,0,2,0
32004,8,2,0,0,2,0
32004,3,2,0,0,2,0
32004,1,1,0,0,1,0
2308,7,1,0,0,1,0
181906,10,2,0,0,2,0
181906,9,2,0,0,2,0
181906,7,17,0,0,17,0
181906,5,7,0,0,7,0
181906,4,3,0,0,3,0
181906,2,2,0,0,2,0
4011,5,3,0,0,3,0
1861,10,2,0,0,2,0
5481,3,1,0,0,1,0
3245,2,1,0,0,1,0
3245,1,1,0,0,1,0
207203,7,3,0,0,3,0
136229,4,4,0,0,4,0
136229,1,1,0,0,1,0
156358,1,1,0,0,1,0
21987,8,3,0,0,3,0
35453,1,1,0,0,1,0
247963,9,2,0,0,2,0
247963,5,6,0,0,6,0
8651,9,3,0,0,3,0
8651,8,8,0,0,8,0
8651,5,5,0,0,5,0
8651,3,4,0,0,4,0
7253,5,4,0,0,4,0
7253,4,2,0,0,2,0
7253,2,2,0,0,2,0
8461,10,1,0,0,1,0
8461,4,4,0,0,4,0
8461,3,3,0,0,3,0
24884,3,1,0,0,1,0
24884,1,1,0,0,1,0
28306,8,7,0,0,7,0
28306,3,1,0,0,1,0
28306,2,2,0,0,2,0
130997,6,8,0,0,8,0
130997,3,2,0,0,2,0
30951,9,1,0,0,1,0
13239,10,1,0,0,1,0
13239,9,1,0,0,1,0
13239,8,2,0,0,2,0
230553,10,4,0,0,4,0
230553,7,9,0,0,9,0
230553,5,1,0,0,1,0
6915,10,1,0,0,1,0
6915,8,2,0,0,2,0
6915,2,2,0,0,2,0
6915,1,1,0,0,1,0
135327,9,1,0,0,1,0
135327,4,3,0,0,3,0
135327,3,3,0,0,3,0
135327,2,1,0,0,1,0
146388,9,2,0,0,2,0
146388,8,3,0,0,3,0
146388,3,1,0,0,1,0
146388,2,1,0,0,1,0
9870,10,4,0,0,4,0
239682,5,4,0,0,4,0
239682,4,3,0,0,3,0
239682,3,1,0,0,1,0
239682,1,1,0,0,1,0
12511,1,2,0,0,2,0
9878,10,1,0,0,1,0
9878,8,1,0,0,1,0
9878,2,4,0,0,4,0
9878,1,3,0,0,3,0
75890,5,1,0,0,1,0
75890,4,1,0,0,1,0
1227,8,4,0,0,4,0
2430,4,12,0,0,12,0
4855,8,3,0,0,3,0
4855,3,1,0,0,1,0
14553,9,3,0,0,3,0
14553,8,9,0,0,9,0
14553,4,5,0,0,5,0
14553,3,1,0,0,1,0
159685,7,9,0,0,9,0
159685,3,3,0,0,3,0
159685,2,4,0,0,4,0
695,9,1,0,0,1,0
695,1,1,0,0,1,0
2545,8,1,0,0,1,0
2545,1,1,0,0,1,0
6003,2,1,0,0,1,0
409,7,3,0,0,3,0
33646,10,1,0,0,1,0
33646,3,3,0,0,3,0
138589,5,4,0,0,4,0
2690,10,1,0,0,1,0
2690,8,3,0,0,3,0
2690,3,2,0,0,2,0
2690,2,1,0,0,1,0
2690,1,1,0,0,1,0
143843,10,1,0,0,1,0
143843,9,2,0,0,2,0
143843,8,8,0,0,8,0
143843,4,2,0,0,2,0
143843,3,2,0,0,2,0
14383,9,1,0,0,1,0
14383,8,2,0,0,2,0
14383,7,5,0,0,5,0
14383,5,5,0,0,5,0
32025,3,2,0,0,2,0
4360,10,1,0,0,1,0
4360,4,4,0,0,4,0
30255,8,1,0,0,1,0
21563,3,3,0,0,3,0
2589,3,3,0,0,3,0
200257,7,10,0,0,10,0
40115,10,2,0,0,2,0
40115,1,2,0,0,2,0
10022,1,2,0,0,2,0
31454,9,2,0,0,2,0
31454,5,6,0,0,6,0
31454,4,2,0,0,2,0
31454,3,1,0,0,1,0
29505,8,4,0,0,4,0
29505,7,5,0,0,5,0
29505,1,1,0,0,1,0
11532,10,2,0,0,2,0
11532,8,3,0,0,3,0
4784,1,1,0,0,1,0
211813,5,2,0,0,2,0
211813,2,1,0,0,1,0
23378,10,2,0,0,2,0
23378,4,2,0,0,2,0
47258,8,5,0,0,5,0
47258,2,1,0,0,1,0
20441,5,3,0,0,3,0
80028,10,1,0,0,1,0
80028,8,6,0,0,6,0
80028,4,8,0,0,8,0
141337,10,1,0,0,1,0
141337,3,6,0,0,6,0
85286,7,7,0,0,7,0
85286,2,3,0,0,3,0
85286,1,1,0,0,1,0
13306,7,3,0,0,3,0
234511,9,3,0,0,3,0
234511,1,1,0,0,1,0
70262,9,1,0,0,1,0
70262,8,5,0,0,5,0
70262,5,13,0,0,13,0
70262,4,3,0,0,3,0
70262,3,3,0,0,3,0
70262,2,2,0,0,2,0
14559,6,8,0,0,8,0
14559,5,1,0,0,1,0
14559,4,2,0,0,2,0
7562,3,1,0,0,1,0
7562,1,1,0,0,1,0
219766,3,1,0,0,1,0
217335,8,4,0,0,4,0
217335,4,3,0,0,3,0
172312,5,9,0,0,9,0
3540,10,1,0,0,1,0
3540,9,2,0,0,2,0
3540,3,2,0,0,2,0
3540,2,2,0,0,2,0
164778,9,1,0,0,1,0
164778,7,11,0,0,11,0
69205,8,1,0,0,1,0
69205,2,2,0,0,2,0
161820,10,2,0,0,2,0
161820,5,2,0,0,2,0
148745,6,3,0,0,3,0
148745,5,1,0,0,1,0
86433,9,1,0,0,1,0
86433,4,1,0,0,1,0
86433,3,3,0,0,3,0
228713,5,4,0,0,4,0
228713,4,5,0,0,5,0
158816,7,2,0,0,2,0
158816,5,1,0,0,1,0
158816,4,1,0,0,1,0
158816,3,1,0,0,1,0
251349,10,1,0,0,1,0
251349,9,2,0,0,2,0
251349,8,11,0,0,11,0
251349,3,1,0,0,1,0
251349,2,3,0,0,3,0
194400,9,4,0,0,4,0
194400,8,14,0,0,14,0
194400,7,21,0,0,21,0
194400,4,1,0,0,1,0
34785,9,1,0,0,1,0
34785,2,2,0,0,2,0
27373,10,2,0,0,2,0
27373,5,7,0,0,7,0
27373,3,1,0,0,1,0
266446,10,2,0,0,2,0
266446,9,7,0,0,7,0
266446,6,12,0,0,12,0
6360,10,2,0,0,2,0
6360,9,1,0,0,1,0
6360,8,1,0,0,1,0
28100,8,2,0,0,2,0
255697,9,1,0,0,1,0
255697,4,2,0,0,2,0
255697,2,1,0,0,1,0
8499,9,1,0,0,1,0
3219,10,1,0,0,1,0
3219,4,1,0,0,1,0
3219,2,1,0,0,1,0
2649,8,2,0,0,2,0
14662,9,1,0,0,1,0
14662,3,2,0,0,2,0
14662,2,1,0,0,1,0
8519,9,1,0,0,1,0
8519,4,4,0,0,4,0
20054,10,1,0,0,1,0
20054,5,3,0,0,3,0
20054,1,1,0,0,1,0
72373,1,1,0,0,1,0
194992,6,10,0,0,10,0
194992,5,2,0,0,2,0
194992,4,2,0,0,2,0
194992,2,1,0,0,1,0
194992,1,1,0,0,1,0
168653,3,1,0,0,1,0
4790,10,2,0,0,2,0
4790,9,1,0,0,1,0
4790,8,6,0,0,6,0
4790,1,2,0,0,2,0
146384,9,1,0,0,1,0
146384,3,4,0,0,4,0
146384,2,2,0,0,2,0
28861,8,3,0,0,3,0
28861,3,3,0,0,3,0
94116,9,5,0,0,5,0
94116,5,9,0,0,9,0
94116,3,1,0,0,1,0
94116,2,2,0,0,2,0
94116,1,1,0,0,1,0
11701,9,3,0,0,3,0
11701,3,2,0,0,2,0
176631,6,6,0,0,6,0
176631,5,4,0,0,4,0
176631,4,2,0,0,2,0
176631,3,4,0,0,4,0
43340,10,1,0,0,1,0
43340,8,1,0,0,1,0
43340,4,18,0,0,18,0
43340,3,4,0,0,4,0
12679,9,4,0,0,4,0
14130,1,2,0,0,2,0
174618,10,2,0,0,2,0
174618,5,8,0,0,8,0
174618,3,1,0,0,1,0
174618,2,1,0,0,1,0
4232,10,1,0,0,1,0
4232,9,1,0,0,1,0
4232,2,1,0,0,1,0
4232,1,1,0,0,1,0
10355,2,6,0,0,6,0
189610,10,7,0,0,7,0
189610,9,6,0,0,6,0
189610,6,6,0,0,6,0
189610,5,3,0,0,3,0
12699,4,2,0,0,2,0
197069,8,7,0,0,7,0
197069,3,1,0,0,1,0
23812,10,1,0,0,1,0
23812,3,2,0,0,2,0
16253,8,1,0,0,1,0
16253,2,1,0,0,1,0
5377,2,2,0,0,2,0
171431,10,1,0,0,1,0
188124,1,2,0,0,2,0
32429,10,1,0,0,1,0
32429,9,2,0,0,2,0
32429,3,2,0,0,2,0
169256,5,12,0,0,12,0
169256,1,1,0,0,1,0
134283,5,2,0,0,2,0
24264,10,6,0,0,6,0
24264,4,1,0,0,1,0
24264,1,1,0,0,1,0
205961,5,3,0,0,3,0
205961,3,2,0,0,2,0
205961,2,2,0,0,2,0
205961,1,1,0,0,1,0
30248,10,1,0,0,1,0
30248,8,2,0,0,2,0
31909,7,10,0,0,10,0
31909,2,1,0,0,1,0
228101,10,3,0,0,3,0
228101,5,6,0,0,6,0
228101,4,3,0,0,3,0
34139,5,1,0,0,1,0
1433,8,2,0,0,2,0
1433,3,2,0,0,2,0
1433,2,1,0,0,1,0
146161,8,2,0,0,2,0
39940,5,1,0,0,1,0
39940,1,1,0,0,1,0
4570,10,1,0,0,1,0
4570,9,1,0,0,1,0
6710,1,1,0,0,1,0
28944,2,1,0,0,1,0
119872,9,2,0,0,2,0
119872,8,1,0,0,1,0
119872,3,2,0,0,2,0
119872,2,2,0,0,2,0
6847,10,1,0,0,1,0
6847,5,3,0,0,3,0
6847,4,1,0,0,1,0
6847,2,3,0,0,3,0
42352,9,1,0,0,1,0
42352,3,2,0,0,2,0
22379,9,1,0,0,1,0
22379,8,1,0,0,1,0
32340,8,1,0,0,1,0
32340,7,5,0,0,5,0
32340,5,11,0,0,11,0
32340,3,11,0,0,11,0
32340,1,2,0,0,2,0
5924,10,1,0,0,1,0
129310,1,1,0,0,1,0
66416,9,1,0,0,1,0
66416,4,2,0,0,2,0
12788,10,1,0,0,1,0
7142,10,2,0,0,2,0
7142,9,1,0,0,1,0
7142,4,2,0,0,2,0
7142,2,1,0,0,1,0
7142,1,1,0,0,1,0
6044,3,1,0,0,1,0
6044,2,1,0,0,1,0
6044,1,1,0,0,1,0
169925,10,1,0,0,1,0
169925,9,3,0,0,3,0
169925,4,1,0,0,1,0
169925,3,1,0,0,1,0
156599,8,3,0,0,3,0
156599,2,6,0,0,6,0
197071,9,3,0,0,3,0
143131,5,2,0,0,2,0
18857,3,2,0,0,2,0
22265,9,1,0,0,1,0
22265,8,1,0,0,1,0
13978,2,1,0,0,1,0
4866,10,1,0,0,1,0
4866,9,1,0,0,1,0
4866,1,1,0,0,1,0
130597,6,8,0,0,8,0
130597,1,1,0,0,1,0
134009,5,4,0,0,4,0
134009,4,1,0,0,1,0
183452,5,5,0,0,5,0
183452,4,3,0,0,3,0
8295,7,2,0,0,2,0
8295,2,2,0,0,2,0
4120,5,8,0,0,8,0
122435,5,1,0,0,1,0
122435,4,2,0,0,2,0
13982,8,1,0,0,1,0
13982,3,6,0,0,6,0
13982,2,5,0,0,5,0
23642,10,2,0,0,2,0
248226,2,1,0,0,1,0
248226,1,1,0,0,1,0
15791,8,3,0,0,3,0
15791,7,5,0,0,5,0
15791,2,1,0,0,1,0
13039,10,2,0,0,2,0
13039,4,6,0,0,6,0
13039,1,2,0,0,2,0
1884,8,3,0,0,3,0
1884,2,2,0,0,2,0
1878,3,3,0,0,3,0
3001,10,1,0,0,1,0
3001,9,1,0,0,1,0
3001,8,1,0,0,1,0
3001,3,1,0,0,1,0
3001,2,1,0,0,1,0
16105,4,1,0,0,1,0
16105,3,1,0,0,1,0
16105,2,1,0,0,1,0
16105,1,1,0,0,1,0
5661,10,2,0,0,2,0
5661,8,2,0,0,2,0
5661,1,1,0,0,1,0
36598,4,2,0,0,2,0
36598,3,1,0,0,1,0
126255,3,2,0,0,2,0
100104,10,2,0,0,2,0
100104,9,2,0,0,2,0
100104,8,8,0,0,8,0
100104,5,2,0,0,2,0
100104,4,2,0,0,2,0
18695,1,2,0,0,2,0
31605,3,2,0,0,2,0
31605,1,1,0,0,1,0
143200,9,1,0,0,1,0
143200,5,6,0,0,6,0
143200,2,1,0,0,1,0
143200,1,2,0,0,2,0
55250,10,2,0,0,2,0
55250,4,1,0,0,1,0
55250,2,1,0,0,1,0
4778,6,19,0,0,19,0
8705,10,1,0,0,1,0
8705,2,1,0,0,1,0
86025,9,1,0,0,1,0
41107,10,2,0,0,2,0
41107,2,1,0,0,1,0
5380,9,1,0,0,1,0
5380,5,12,0,0,12,0
5380,4,4,0,0,4,0
5380,2,1,0,0,1,0
5380,1,1,0,0,1,0
890,5,3,0,0,3,0
890,2,1,0,0,1,0
6005,10,2,0,0,2,0
6005,9,1,0,0,1,0
6005,4,1,0,0,1,0
6005,3,4,0,0,4,0
6005,2,1,0,0,1,0
6005,1,1,0,0,1,0
164645,5,6,0,0,6,0
164645,3,1,0,0,1,0
164645,2,1,0,0,1,0
244333,10,2,0,0,2,0
244333,5,5,0,0,5,0
244333,3,1,0,0,1,0
244333,1,1,0,0,1,0
75809,10,1,0,0,1,0
75809,9,2,0,0,2,0
75809,5,4,0,0,4,0
10968,3,1,0,0,1,0
15212,9,3,0,0,3,0
15212,5,5,0,0,5,0
15212,4,3,0,0,3,0
15212,3,1,0,0,1,0
15212,2,1,0,0,1,0
184287,6,5,0,0,5,0
184287,4,4,0,0,4,0
184287,2,2,0,0,2,0
28257,4,1,0,0,1,0
148528,10,1,0,0,1,0
148528,9,1,0,0,1,0
148528,4,4,0,0,4,0
148528,3,2,0,0,2,0
174128,5,5,0,0,5,0
174128,3,3,0,0,3,0
174128,2,2,0,0,2,0
182869,8,10,0,0,10,0
182869,4,9,0,0,9,0
182869,3,2,0,0,2,0
182869,2,1,0,0,1,0
23613,9,1,0,0,1,0
34245,10,6,0,0,6,0
34245,7,9,0,0,9,0
34245,3,1,0,0,1,0
194688,10,1,0,0,1,0
194688,9,1,0,0,1,0
194688,4,8,0,0,8,0
194688,3,3,0,0,3,0
194688,2,3,0,0,3,0
194688,1,1,0,0,1,0
6921,10,1,0,0,1,0
4256,10,1,0,0,1,0
4256,5,4,0,0,4,0
4256,4,3,0,0,3,0
4256,3,1,0,0,1,0
225526,4,1,0,0,1,0
225526,1,1,0,0,1,0
4933,10,1,0,0,1,0
4933,8,1,0,0,1,0
3848,9,2,0,0,2,0
3848,2,2,0,0,2,0
143703,7,7,0,0,7,0
143703,3,1,0,0,1,0
143703,2,1,0,0,1,0
11127,2,1,0,0,1,0
11127,1,1,0,0,1,0
231878,5,5,0,0,5,0
231878,4,2,0,0,2,0
231878,2,1,0,0,1,0
80833,2,4,0,0,4,0
157449,5,4,0,0,4,0
35054,3,1,0,0,1,0
28444,8,6,0,0,6,0
28444,1,1,0,0,1,0
9673,5,1,0,0,1,0
9673,3,1,0,0,1,0
24820,3,1,0,0,1,0
184443,1,2,0,0,2,0
158198,8,4,0,0,4,0
158198,7,7,0,0,7,0
33225,10,4,0,0,4,0
33225,9,1,0,0,1,0
33225,4,3,0,0,3,0
4473,8,3,0,0,3,0
2186,8,2,0,0,2,0
2186,7,6,0,0,6,0
2186,6,17,0,0,17,0
2186,3,3,0,0,3,0
86538,8,9,0,0,9,0
86538,6,20,0,0,20,0
86538,5,3,0,0,3,0
128885,10,1,0,0,1,0
128885,2,1,0,0,1,0
266810,7,9,0,0,9,0
266810,5,1,0,0,1,0
266810,3,1,0,0,1,0
57691,10,1,0,0,1,0
57691,9,3,0,0,3,0
57691,4,1,0,0,1,0
57691,1,1,0,0,1,0
20117,3,2,0,0,2,0
20117,1,1,0,0,1,0
2417,9,1,0,0,1,0
2417,2,1,0,0,1,0
204055,5,1,0,0,1,0
204055,1,1,0,0,1,0
259005,10,1,0,0,1,0
259005,9,3,0,0,3,0
259005,6,15,0,0,15,0
259005,4,5,0,0,5,0
259005,1,1,0,0,1,0
249095,5,6,0,0,6,0
249095,3,1,0,0,1,0
2044,6,1,0,0,1,0
4675,10,1,0,0,1,0
6466,8,2,0,0,2,0
6466,3,2,0,0,2,0
3645,9,1,0,0,1,0
257707,10,1,0,0,1,0
257707,9,3,0,0,3,0
257707,3,2,0,0,2,0
257955,3,2,0,0,2,0
228372,9,4,0,0,4,0
228372,3,1,0,0,1,0
192635,9,1,0,0,1,0
192635,8,2,0,0,2,0
192635,4,2,0,0,2,0
192635,3,6,0,0,6,0
4319,8,1,0,0,1,0
947,10,1,0,0,1,0
947,8,3,0,0,3,0
947,3,3,0,0,3,0
947,1,1,0,0,1,0
8408,3,1,0,0,1,0
8408,1,1,0,0,1,0
500,3,2,0,0,2,0
500,2,1,0,0,1,0
30684,9,2,0,0,2,0
41198,10,2,0,0,2,0
9376,10,2,0,0,2,0
9376,9,1,0,0,1,0
9376,3,2,0,0,2,0
9376,2,1,0,0,1,0
177477,5,4,0,0,4,0
177477,3,2,0,0,2,0
177477,2,1,0,0,1,0
177477,1,1,0,0,1,0
11465,10,1,0,0,1,0
11465,4,2,0,0,2,0
11465,1,2,0,0,2,0
8998,9,1,0,0,1,0
8998,8,1,0,0,1,0
8998,3,2,0,0,2,0
8998,2,1,0,0,1,0
195477,9,1,0,0,1,0
195477,5,6,0,0,6,0
195477,1,2,0,0,2,0
124393,10,3,0,0,3,0
124393,3,3,0,0,3,0
3374,10,1,0,0,1,0
3374,9,2,0,0,2,0
3374,1,1,0,0,1,0
205873,5,12,0,0,12,0
9041,10,3,0,0,3,0
9041,5,4,0,0,4,0
9041,4,3,0,0,3,0
9041,3,4,0,0,4,0
35961,3,1,0,0,1,0
143674,10,3,0,0,3,0
143674,9,5,0,0,5,0
143674,8,8,0,0,8,0
143674,4,7,0,0,7,0
164449,10,1,0,0,1,0
164449,9,3,0,0,3,0
164449,8,3,0,0,3,0
164449,3,2,0,0,2,0
129308,8,2,0,0,2,0
236108,5,1,0,0,1,0
236108,2,1,0,0,1,0
183963,4,2,0,0,2,0
183963,1,1,0,0,1,0
131017,1,1,0,0,1,0
5727,3,1,0,0,1,0
87876,10,2,0,0,2,0
87876,4,5,0,0,5,0
4087,9,3,0,0,3,0
156077,9,2,0,0,2,0
156077,2,2,0,0,2,0
2927,2,1,0,0,1,0
2927,1,1,0,0,1,0
15090,8,1,0,0,1,0
15090,7,2,0,0,2,0
15090,2,1,0,0,1,0
15090,1,1,0,0,1,0
267127,1,1,0,0,1,0
11790,9,1,0,0,1,0
10256,10,1,0,0,1,0
10256,9,1,0,0,1,0
6615,10,1,0,0,1,0
168457,10,1,0,0,1,0
168457,4,1,0,0,1,0
13169,1,1,0,0,1,0
110260,8,9,0,0,9,0
110260,5,4,0,0,4,0
93044,2,1,0,0,1,0
1853,2,4,0,0,4,0
1560,9,1,0,0,1,0
1560,8,3,0,0,3,0
36230,9,1,0,0,1,0
36230,1,1,0,0,1,0
8806,4,6,0,0,6,0
8806,2,3,0,0,3,0
104012,5,5,0,0,5,0
104012,4,3,0,0,3,0
104012,3,1,0,0,1,0
104012,2,2,0,0,2,0
94596,10,2,0,0,2,0
94596,9,1,0,0,1,0
155113,5,9,0,0,9,0
155113,4,2,0,0,2,0
155113,3,2,0,0,2,0
3984,8,8,0,0,8,0
3984,4,1,0,0,1,0
3984,3,1,0,0,1,0
28834,8,3,0,0,3,0
166767,9,3,0,0,3,0
5198,3,1,0,0,1,0
255249,6,1,0,0,1,0
6582,7,9,0,0,9,0
6582,1,1,0,0,1,0
32702,8,3,0,0,3,0
32702,2,2,0,0,2,0
103830,5,2,0,0,2,0
103830,1,1,0,0,1,0
88167,9,1,0,0,1,0
88167,8,5,0,0,5,0
88167,4,8,0,0,8,0
88167,2,2,0,0,2,0
67948,9,1,0,0,1,0
67948,8,2,0,0,2,0
8904,10,1,0,0,1,0
8904,9,1,0,0,1,0
8904,6,14,0,0,14,0
8904,1,2,0,0,2,0
36237,10,2,0,0,2,0
36237,9,1,0,0,1,0
36237,5,11,0,0,11,0
36237,1,2,0,0,2,0
246532,5,3,0,0,3,0
9173,10,1,0,0,1,0
3571,10,2,0,0,2,0
3571,2,2,0,0,2,0
204138,9,3,0,0,3,0
204138,8,7,0,0,7,0
204138,7,10,0,0,10,0
204138,5,16,0,0,16,0
204138,4,6,0,0,6,0
204138,3,1,0,0,1,0
204138,2,1,0,0,1,0
10308,9,2,0,0,2,0
30102,10,1,0,0,1,0
5284,7,1,0,0,1,0
29408,10,1,0,0,1,0
29408,3,10,0,0,10,0
191473,10,1,0,0,1,0
191473,9,1,0,0,1,0
191473,3,1,0,0,1,0
6006,10,1,0,0,1,0
6006,8,1,0,0,1,0
6006,1,1,0,0,1,0
26446,10,1,0,0,1,0
26446,3,2,0,0,2,0
4299,9,1,0,0,1,0
4299,1,1,0,0,1,0
6470,10,1,0,0,1,0
6470,4,2,0,0,2,0
6470,3,1,0,0,1,0
26976,9,4,0,0,4,0
26976,8,5,0,0,5,0
22297,9,3,0,0,3,0
22297,4,2,0,0,2,0
19009,4,1,0,0,1,0
11708,8,9,0,0,9,0
1400,8,2,0,0,2,0
1400,3,2,0,0,2,0
3319,9,1,0,0,1,0
3319,3,1,0,0,1,0
3319,2,1,0,0,1,0
248075,10,5,0,0,5,0
248075,8,12,0,0,12,0
248075,6,9,0,0,9,0
248075,5,2,0,0,2,0
248075,1,1,0,0,1,0
6088,10,1,0,0,1,0
6088,9,1,0,0,1,0
6088,4,2,0,0,2,0
745,5,2,0,0,2,0
745,3,3,0,0,3,0
3175,10,2,0,0,2,0
3175,9,1,0,0,1,0
3175,8,2,0,0,2,0
61916,10,1,0,0,1,0
61916,8,1,0,0,1,0
61916,7,3,0,0,3,0
61916,4,10,0,0,10,0
61916,2,3,0,0,3,0
61916,1,2,0,0,2,0
186974,10,1,0,0,1,0
103402,8,3,0,0,3,0
6342,10,1,0,0,1,0
6342,9,2,0,0,2,0
10995,4,1,0,0,1,0
10995,2,1,0,0,1,0
150012,4,1,0,0,1,0
165095,9,2,0,0,2,0
165095,8,3,0,0,3,0
165095,4,4,0,0,4,0
134596,10,2,0,0,2,0
134596,9,3,0,0,3,0
134596,3,1,0,0,1,0
11132,2,1,0,0,1,0
6036,10,1,0,0,1,0
6036,7,10,0,0,10,0
6036,4,2,0,0,2,0
4393,10,1,0,0,1,0
4393,4,6,0,0,6,0
4393,3,1,0,0,1,0
23421,10,2,0,0,2,0
23421,4,1,0,0,1,0
23421,2,1,0,0,1,0
204069,8,4,0,0,4,0
204069,7,5,0,0,5,0
204069,1,1,0,0,1,0
186142,6,13,0,0,13,0
186142,3,1,0,0,1,0
26840,9,1,0,0,1,0
217404,9,1,0,0,1,0
217404,4,5,0,0,5,0
217404,3,1,0,0,1,0
23684,3,4,0,0,4,0
7552,8,2,0,0,2,0
24209,10,1,0,0,1,0
24209,9,3,0,0,3,0
24209,6,16,0,0,16,0
24209,5,4,0,0,4,0
24209,4,4,0,0,4,0
20624,10,1,0,0,1,0
181670,9,4,0,0,4,0
181670,3,3,0,0,3,0
181670,2,1,0,0,1,0
20617,3,1,0,0,1,0
150831,9,3,0,0,3,0
150831,5,2,0,0,2,0
209220,10,1,0,0,1,0
209220,9,1,0,0,1,0
209220,2,1,0,0,1,0
42279,10,1,0,0,1,0
42279,2,1,0,0,1,0
2701,2,2,0,0,2,0
21015,5,3,0,0,3,0
21015,1,3,0,0,3,0
10573,4,1,0,0,1,0
6879,9,1,0,0,1,0
6879,4,2,0,0,2,0
2373,7,10,0,0,10,0
2373,3,2,0,0,2,0
3908,7,1,0,0,1,0
184207,3,1,0,0,1,0
169393,4,5,0,0,5,0
169393,3,2,0,0,2,0
169393,2,2,0,0,2,0
169393,1,2,0,0,2,0
6052,10,1,0,0,1,0
6052,9,1,0,0,1,0
6052,8,2,0,0,2,0
6052,4,8,0,0,8,0
129851,3,3,0,0,3,0
129851,2,2,0,0,2,0
230240,6,16,0,0,16,0
181492,9,1,0,0,1,0
181492,3,5,0,0,5,0
6402,10,1,0,0,1,0
6402,1,1,0,0,1,0
224011,3,4,0,0,4,0
37382,8,4,0,0,4,0
37382,2,5,0,0,5,0
197911,9,4,0,0,4,0
197911,3,1,0,0,1,0
9514,7,2,0,0,2,0
18843,5,8,0,0,8,0
18843,3,2,0,0,2,0
249677,6,1,0,0,1,0
151947,10,1,0,0,1,0
151947,9,1,0,0,1,0
151947,8,3,0,0,3,0
151947,3,4,0,0,4,0
151947,2,1,0,0,1,0
239930,10,3,0,0,3,0
239930,9,1,0,0,1,0
239930,7,18,0,0,18,0
239930,4,2,0,0,2,0
88608,10,1,0,0,1,0
88608,3,3,0,0,3,0
103807,9,1,0,0,1,0
103807,8,7,0,0,7,0
103807,4,2,0,0,2,0
23374,10,1,0,0,1,0
23374,8,2,0,0,2,0
22753,10,2,0,0,2,0
22753,1,1,0,0,1,0
198044,5,6,0,0,6,0
198044,4,3,0,0,3,0
198044,3,3,0,0,3,0
198044,2,1,0,0,1,0
70096,8,8,0,0,8,0
70096,5,7,0,0,7,0
70096,4,1,0,0,1,0
70096,3,4,0,0,4,0
254135,10,1,0,0,1,0
254135,5,2,0,0,2,0
139728,10,8,0,0,8,0
139728,9,5,0,0,5,0
139728,8,14,0,0,14,0
139728,7,9,0,0,9,0
139728,6,13,0,0,13,0
139728,5,3,0,0,3,0
139728,4,1,0,0,1,0
139728,1,1,0,0,1,0
200886,5,7,0,0,7,0
200886,1,2,0,0,2,0
10265,9,1,0,0,1,0
10265,8,5,0,0,5,0
10265,2,1,0,0,1,0
2263,5,5,0,0,5,0
2263,4,4,0,0,4,0
2263,3,1,0,0,1,0
2263,1,2,0,0,2,0
209284,9,1,0,0,1,0
209284,2,1,0,0,1,0
6024,10,1,0,0,1,0
6024,9,2,0,0,2,0
6024,3,1,0,0,1,0
6024,2,1,0,0,1,0
15806,3,3,0,0,3,0
15806,1,3,0,0,3,0
3049,10,1,0,0,1,0
220675,3,2,0,0,2,0
5303,4,3,0,0,3,0
63951,5,2,0,0,2,0
203408,6,14,0,0,14,0
203408,3,1,0,0,1,0
203408,2,1,0,0,1,0
7145,9,1,0,0,1,0
244153,9,3,0,0,3,0
25253,10,2,0,0,2,0
25253,1,1,0,0,1,0
250481,7,7,0,0,7,0
250481,5,1,0,0,1,0
10168,5,2,0,0,2,0
10168,4,1,0,0,1,0
10168,3,1,0,0,1,0
94493,5,1,0,0,1,0
94493,3,1,0,0,1,0
28096,1,2,0,0,2,0
173462,5,3,0,0,3,0
173462,4,2,0,0,2,0
173462,1,1,0,0,1,0
1947,4,4,0,0,4,0
3046,10,1,0,0,1,0
3046,4,3,0,0,3,0
127433,5,4,0,0,4,0
127433,4,4,0,0,4,0
181005,9,1,0,0,1,0
181005,4,2,0,0,2,0
130624,4,11,0,0,11,0
130624,3,3,0,0,3,0
130624,1,1,0,0,1,0
97332,10,9,0,0,9,0
97332,5,1,0,0,1,0
97332,1,1,0,0,1,0
10884,10,4,0,0,4,0
10884,4,2,0,0,2,0
197068,7,4,0,0,4,0
197068,1,1,0,0,1,0
165587,5,8,0,0,8,0
165587,2,2,0,0,2,0
3631,9,1,0,0,1,0
37912,4,1,0,0,1,0
37912,1,2,0,0,2,0
205884,8,4,0,0,4,0
205884,3,2,0,0,2,0
685,3,1,0,0,1,0
65557,9,1,0,0,1,0
65557,8,2,0,0,2,0
65557,3,2,0,0,2,0
65557,2,1,0,0,1,0
206681,7,4,0,0,4,0
206681,3,3,0,0,3,0
206681,2,1,0,0,1,0
206681,1,1,0,0,1,0
212348,3,2,0,0,2,0
2625,9,1,0,0,1,0
2625,8,2,0,0,2,0
33906,10,3,0,0,3,0
33906,8,2,0,0,2,0
33906,7,4,0,0,4,0
33906,4,15,0,0,15,0
33906,3,4,0,0,4,0
33906,2,1,0,0,1,0
33906,1,2,0,0,2,0
49400,10,4,0,0,4,0
49400,5,4,0,0,4,0
49400,1,1,0,0,1,0
247585,8,10,0,0,10,0
247585,6,1,0,0,1,0
251538,9,1,0,0,1,0
251538,5,6,0,0,6,0
251538,4,6,0,0,6,0
71569,10,1,0,0,1,0
71569,9,5,0,0,5,0
71569,6,10,0,0,10,0
43801,10,3,0,0,3,0
43801,6,6,0,0,6,0
43801,4,1,0,0,1,0
220975,6,1,0,0,1,0
6023,10,1,0,0,1,0
251442,10,2,0,0,2,0
251442,5,2,0,0,2,0
236459,9,1,0,0,1,0
236459,6,17,0,0,17,0
236459,5,4,0,0,4,0
113436,5,5,0,0,5,0
158793,1,1,0,0,1,0
112844,9,3,0,0,3,0
112844,8,3,0,0,3,0
112844,7,9,0,0,9,0
112844,5,12,0,0,12,0
112844,4,7,0,0,7,0
112844,3,3,0,0,3,0
112844,2,2,0,0,2,0
112844,1,1,0,0,1,0
2137,10,1,0,0,1,0
2137,2,2,0,0,2,0
198881,4,1,0,0,1,0
198881,1,1,0,0,1,0
125765,10,2,0,0,2,0
125765,9,1,0,0,1,0
125765,7,1,0,0,1,0
125765,3,4,0,0,4,0
125765,1,6,0,0,6,0
137016,9,1,0,0,1,0
137016,8,1,0,0,1,0
137016,2,1,0,0,1,0
137016,1,1,0,0,1,0
122236,6,5,0,0,5,0
122236,1,1,0,0,1,0
10578,10,1,0,0,1,0
10578,8,3,0,0,3,0
10578,3,4,0,0,4,0
10578,2,1,0,0,1,0
134815,8,1,0,0,1,0
4124,10,1,0,0,1,0
140317,8,1,0,0,1,0
140317,6,17,0,0,17,0
255029,10,1,0,0,1,0
255029,8,14,0,0,14,0
255029,5,2,0,0,2,0
255029,1,1,0,0,1,0
4118,8,1,0,0,1,0
4118,3,1,0,0,1,0
260335,10,1,0,0,1,0
260335,8,4,0,0,4,0
260335,7,13,0,0,13,0
260335,4,5,0,0,5,0
260335,3,1,0,0,1,0
260335,2,1,0,0,1,0
260335,1,1,0,0,1,0
212839,5,2,0,0,2,0
212839,4,1,0,0,1,0
5701,9,2,0,0,2,0
5701,4,2,0,0,2,0
86458,10,3,0,0,3,0
31358,10,1,0,0,1,0
31358,8,3,0,0,3,0
38747,10,1,0,0,1,0
38747,9,3,0,0,3,0
264637,10,1,0,0,1,0
264637,6,4,0,0,4,0
207848,4,4,0,0,4,0
139390,9,6,0,0,6,0
139390,5,4,0,0,4,0
139390,4,1,0,0,1,0
69687,9,3,0,0,3,0
69687,2,1,0,0,1,0
11248,8,1,0,0,1,0
11248,1,2,0,0,2,0
210113,4,2,0,0,2,0
705,10,2,0,0,2,0
705,9,1,0,0,1,0
146151,3,2,0,0,2,0
2875,9,3,0,0,3,0
5786,10,3,0,0,3,0
5786,2,1,0,0,1,0
106113,6,1,0,0,1,0
106113,1,1,0,0,1,0
18776,9,3,0,0,3,0
18776,5,3,0,0,3,0
18776,3,1,0,0,1,0
18776,2,1,0,0,1,0
365,7,8,0,0,8,0
365,2,1,0,0,1,0
68816,10,1,0,0,1,0
191687,10,1,0,0,1,0
191687,9,1,0,0,1,0
191687,8,5,0,0,5,0
191687,4,2,0,0,2,0
191687,2,1,0,0,1,0
2907,3,1,0,0,1,0
2907,2,2,0,0,2,0
3578,7,2,0,0,2,0
1616,10,1,0,0,1,0
1616,8,3,0,0,3,0
1616,2,1,0,0,1,0
227326,7,6,0,0,6,0
227326,5,1,0,0,1,0
1857,8,1,0,0,1,0
1857,7,2,0,0,2,0
7750,5,1,0,0,1,0
7750,3,1,0,0,1,0
107917,4,2,0,0,2,0
107917,1,1,0,0,1,0
89926,10,1,0,0,1,0
89926,8,2,0,0,2,0
89926,6,11,0,0,11,0
89926,3,2,0,0,2,0
170043,4,1,0,0,1,0
25758,4,2,0,0,2,0
25758,3,1,0,0,1,0
157696,9,3,0,0,3,0
157696,8,6,0,0,6,0
157696,5,8,0,0,8,0
157696,3,3,0,0,3,0
157696,1,3,0,0,3,0
135270,10,7,0,0,7,0
135270,5,1,0,0,1,0
135270,1,1,0,0,1,0
8246,10,2,0,0,2,0
8246,9,1,0,0,1,0
8246,3,1,0,0,1,0
8246,2,2,0,0,2,0
3835,2,1,0,0,1,0
158751,10,20,0,0,20,0
158751,9,12,0,0,12,0
158751,6,1,0,0,1,0
158751,5,1,0,0,1,0
158751,4,2,0,0,2,0
158751,2,1,0,0,1,0
158751,1,4,0,0,4,0
257722,8,12,0,0,12,0
257722,4,2,0,0,2,0
257722,3,1,0,0,1,0
257722,1,1,0,0,1,0
204802,10,2,0,0,2,0
204802,9,8,0,0,8,0
204802,8,12,0,0,12,0
204802,5,4,0,0,4,0
204802,4,3,0,0,3,0
204802,2,1,0,0,1,0
153077,10,2,0,0,2,0
153077,8,3,0,0,3,0
153077,3,1,0,0,1,0
153077,1,1,0,0,1,0
3643,10,3,0,0,3,0
3643,9,2,0,0,2,0
231038,7,2,0,0,2,0
231038,5,2,0,0,2,0
231038,4,2,0,0,2,0
222462,9,4,0,0,4,0
222462,5,3,0,0,3,0
3840,10,1,0,0,1,0
3840,9,1,0,0,1,0
3840,7,3,0,0,3,0
103922,9,1,0,0,1,0
103922,2,1,0,0,1,0
103922,1,2,0,0,2,0
7278,4,1,0,0,1,0
7278,2,1,0,0,1,0
7278,1,1,0,0,1,0
253149,4,1,0,0,1,0
253149,2,1,0,0,1,0
40001,5,15,0,0,15,0
40001,3,2,0,0,2,0
24803,9,1,0,0,1,0
24803,8,4,0,0,4,0
24803,6,22,0,0,22,0
24803,4,4,0,0,4,0
24803,3,2,0,0,2,0
192345,10,4,0,0,4,0
192345,7,9,0,0,9,0
192345,4,5,0,0,5,0
192345,3,3,0,0,3,0
192345,1,3,0,0,3,0
91653,9,1,0,0,1,0
91653,7,4,0,0,4,0
91653,6,24,0,0,24,0
91653,4,4,0,0,4,0
91653,3,1,0,0,1,0
220741,9,3,0,0,3,0
220741,4,6,0,0,6,0
220741,2,2,0,0,2,0
220741,1,1,0,0,1,0
203788,9,2,0,0,2,0
203788,8,9,0,0,9,0
149885,1,1,0,0,1,0
133862,5,7,0,0,7,0
133862,4,3,0,0,3,0
1946,8,1,0,0,1,0
1946,6,12,0,0,12,0
186089,10,1,0,0,1,0
186089,9,2,0,0,2,0
186089,5,5,0,0,5,0
186089,3,1,0,0,1,0
186089,2,1,0,0,1,0
186089,1,1,0,0,1,0
130603,10,1,0,0,1,0
130603,9,1,0,0,1,0
130603,8,6,0,0,6,0
130603,4,2,0,0,2,0
130603,1,1,0,0,1,0
9791,10,2,0,0,2,0
2140,10,1,0,0,1,0
42188,4,4,0,0,4,0
42188,3,2,0,0,2,0
42188,2,1,0,0,1,0
5752,10,2,0,0,2,0
5752,9,6,0,0,6,0
5752,4,2,0,0,2,0
3359,5,3,0,0,3,0
3359,3,1,0,0,1,0
3359,2,1,0,0,1,0
3359,1,1,0,0,1,0
144236,8,1,0,0,1,0
2160,10,1,0,0,1,0
2160,4,1,0,0,1,0
2160,3,2,0,0,2,0
8787,10,2,0,0,2,0
8787,9,2,0,0,2,0
8787,8,5,0,0,5,0
8787,2,1,0,0,1,0
8787,1,1,0,0,1,0
31401,10,1,0,0,1,0
31401,9,1,0,0,1,0
31401,5,6,0,0,6,0
31401,3,2,0,0,2,0
202265,10,1,0,0,1,0
202265,5,1,0,0,1,0
13477,8,3,0,0,3,0
13477,3,4,0,0,4,0
177062,4,1,0,0,1,0
49396,10,4,0,0,4,0
49396,7,19,0,0,19,0
49396,5,1,0,0,1,0
49396,1,1,0,0,1,0
11988,9,5,0,0,5,0
11988,5,2,0,0,2,0
11988,4,2,0,0,2,0
258074,7,5,0,0,5,0
258074,6,2,0,0,2,0
214213,7,8,0,0,8,0
5860,10,2,0,0,2,0
64657,9,1,0,0,1,0
64657,3,1,0,0,1,0
64657,1,1,0,0,1,0
244948,10,1,0,0,1,0
244948,8,3,0,0,3,0
244948,3,1,0,0,1,0
244948,1,1,0,0,1,0
157291,9,1,0,0,1,0
157291,3,1,0,0,1,0
157291,2,1,0,0,1,0
29055,3,1,0,0,1,0
29055,1,1,0,0,1,0
39787,2,1,0,0,1,0
179606,10,2,0,0,2,0
179606,4,4,0,0,4,0
209511,6,1,0,0,1,0
209511,5,1,0,0,1,0
16197,6,2,0,0,2,0
16197,1,1,0,0,1,0
7830,10,1,0,0,1,0
7830,4,3,0,0,3,0
21149,4,1,0,0,1,0
26687,9,1,0,0,1,0
26687,1,1,0,0,1,0
216301,9,1,0,0,1,0
216301,8,4,0,0,4,0
216301,4,4,0,0,4,0
216301,1,1,0,0,1,0
182544,9,13,0,0,13,0
182544,7,5,0,0,5,0
182544,5,1,0,0,1,0
182544,3,1,0,0,1,0
182544,1,1,0,0,1,0
128252,5,3,0,0,3,0
11357,10,1,0,0,1,0
11357,9,2,0,0,2,0
11357,3,1,0,0,1,0
11357,1,1,0,0,1,0
2606,1,1,0,0,1,0
13350,4,9,0,0,9,0
13350,3,4,0,0,4,0
76551,9,2,0,0,2,0
76551,4,4,0,0,4,0
159536,8,2,0,0,2,0
159536,5,10,0,0,10,0
159536,3,3,0,0,3,0
159536,1,1,0,0,1,0
257962,4,10,0,0,10,0
191081,10,1,0,0,1,0
191081,9,1,0,0,1,0
191081,5,14,0,0,14,0
191081,1,1,0,0,1,0
5274,4,2,0,0,2,0
77548,3,1,0,0,1,0
2037,8,2,0,0,2,0
177680,1,2,0,0,2,0
8204,2,1,0,0,1,0
8204,1,3,0,0,3,0
2971,8,1,0,0,1,0
2971,7,2,0,0,2,0
2971,5,8,0,0,8,0
155484,5,6,0,0,6,0
155484,4,2,0,0,2,0
8254,10,1,0,0,1,0
8254,2,1,0,0,1,0
254846,10,2,0,0,2,0
254846,7,18,0,0,18,0
254846,5,4,0,0,4,0
254846,3,1,0,0,1,0
69819,2,1,0,0,1,0
193981,4,3,0,0,3,0
3867,10,1,0,0,1,0
36603,9,3,0,0,3,0
36603,5,6,0,0,6,0
36603,3,2,0,0,2,0
206686,10,2,0,0,2,0
206686,7,8,0,0,8,0
206686,3,1,0,0,1,0
78647,4,9,0,0,9,0
78647,1,1,0,0,1,0
27495,7,1,0,0,1,0
125318,5,2,0,0,2,0
7723,9,2,0,0,2,0
742,10,1,0,0,1,0
742,9,1,0,0,1,0
742,5,4,0,0,4,0
742,4,1,0,0,1,0
742,3,1,0,0,1,0
42748,2,1,0,0,1,0
600,8,1,0,0,1,0
600,1,1,0,0,1,0
16461,10,2,0,0,2,0
16461,9,1,0,0,1,0
16461,8,1,0,0,1,0
26292,10,1,0,0,1,0
26292,7,7,0,0,7,0
26292,2,1,0,0,1,0
9044,4,1,0,0,1,0
3674,9,1,0,0,1,0
3674,3,1,0,0,1,0
3674,1,1,0,0,1,0
14024,9,3,0,0,3,0
14024,4,4,0,0,4,0
14024,1,2,0,0,2,0
7367,4,3,0,0,3,0
183976,10,1,0,0,1,0
7269,9,1,0,0,1,0
7269,2,4,0,0,4,0
127883,4,2,0,0,2,0
155023,5,1,0,0,1,0
155023,3,1,0,0,1,0
158876,4,1,0,0,1,0
158876,2,1,0,0,1,0
255,10,2,0,0,2,0
255,9,1,0,0,1,0
183532,9,2,0,0,2,0
183532,2,1,0,0,1,0
183532,1,3,0,0,3,0
38437,10,1,0,0,1,0
38437,9,2,0,0,2,0
38437,4,1,0,0,1,0
117997,10,1,0,0,1,0
117997,9,3,0,0,3,0
117997,4,1,0,0,1,0
154394,6,4,0,0,4,0
154394,3,1,0,0,1,0
154394,1,1,0,0,1,0
202896,4,5,0,0,5,0
202896,3,2,0,0,2,0
202896,2,2,0,0,2,0
5870,1,1,0,0,1,0
37724,9,2,0,0,2,0
27471,7,3,0,0,3,0
27471,1,1,0,0,1,0
172237,8,3,0,0,3,0
172237,5,9,0,0,9,0
5619,10,1,0,0,1,0
182510,10,4,0,0,4,0
182510,5,1,0,0,1,0
182510,4,1,0,0,1,0
3622,8,4,0,0,4,0
166248,7,10,0,0,10,0
12414,6,3,0,0,3,0
12414,5,1,0,0,1,0
12414,3,1,0,0,1,0
12414,2,1,0,0,1,0
12414,1,1,0,0,1,0
157014,4,4,0,0,4,0
157014,2,2,0,0,2,0
55841,9,2,0,0,2,0
55841,5,1,0,0,1,0
55841,3,1,0,0,1,0
179956,7,6,0,0,6,0
178053,9,1,0,0,1,0
178053,4,5,0,0,5,0
178053,3,1,0,0,1,0
178053,2,2,0,0,2,0
193592,10,2,0,0,2,0
193592,5,7,0,0,7,0
193592,1,2,0,0,2,0
22445,3,2,0,0,2,0
105004,4,5,0,0,5,0
105004,2,1,0,0,1,0
24475,9,2,0,0,2,0
24475,4,2,0,0,2,0
245136,10,1,0,0,1,0
245136,4,2,0,0,2,0
227837,10,2,0,0,2,0
227837,8,4,0,0,4,0
11753,7,3,0,0,3,0
171087,10,1,0,0,1,0
171087,9,1,0,0,1,0
171087,5,8,0,0,8,0
55131,10,1,0,0,1,0
55131,5,2,0,0,2,0
55131,4,1,0,0,1,0
160592,4,2,0,0,2,0
6339,9,3,0,0,3,0
6339,1,1,0,0,1,0
22407,5,8,0,0,8,0
22407,1,1,0,0,1,0
49397,10,3,0,0,3,0
49397,7,15,0,0,15,0
49397,5,3,0,0,3,0
49397,4,3,0,0,3,0
49397,2,1,0,0,1,0
141997,10,2,0,0,2,0
141997,9,2,0,0,2,0
141997,8,7,0,0,7,0
141997,7,11,0,0,11,0
141997,5,8,0,0,8,0
195205,5,7,0,0,7,0
195205,4,3,0,0,3,0
195205,2,1,0,0,1,0
990,2,2,0,0,2,0
205478,9,3,0,0,3,0
205478,5,6,0,0,6,0
205478,4,1,0,0,1,0
205478,3,3,0,0,3,0
234673,10,1,0,0,1,0
234673,5,2,0,0,2,0
245371,1,1,0,0,1,0
11766,5,8,0,0,8,0
11766,3,1,0,0,1,0
11766,1,2,0,0,2,0
10248,5,2,0,0,2,0
195545,9,1,0,0,1,0
24743,5,13,0,0,13,0
24743,2,1,0,0,1,0
1003,9,1,0,0,1,0
1003,4,1,0,0,1,0
26621,10,2,0,0,2,0
26621,9,1,0,0,1,0
26621,5,8,0,0,8,0
26621,4,2,0,0,2,0
26621,3,1,0,0,1,0
2540,8,1,0,0,1,0
164284,4,1,0,0,1,0
164284,3,1,0,0,1,0
164284,2,1,0,0,1,0
194078,7,2,0,0,2,0
194078,6,5,0,0,5,0
194078,2,1,0,0,1,0
7963,10,2,0,0,2,0
7963,8,1,0,0,1,0
7963,3,1,0,0,1,0
7963,1,1,0,0,1,0
5854,10,1,0,0,1,0
5854,9,1,0,0,1,0
5854,4,2,0,0,2,0
5854,3,3,0,0,3,0
33959,10,1,0,0,1,0
33959,2,1,0,0,1,0
145106,4,14,0,0,14,0
145106,2,3,0,0,3,0
145106,1,2,0,0,2,0
179537,8,3,0,0,3,0
179537,7,4,0,0,4,0
179537,5,10,0,0,10,0
179537,3,4,0,0,4,0
4239,10,1,0,0,1,0
4239,9,2,0,0,2,0
4239,8,1,0,0,1,0
176850,4,1,0,0,1,0
176850,2,1,0,0,1,0
176850,1,1,0,0,1,0
5527,10,1,0,0,1,0
29860,10,4,0,0,4,0
5285,7,4,0,0,4,0
1303,9,1,0,0,1,0
1303,7,5,0,0,5,0
1303,2,2,0,0,2,0
1148,8,1,0,0,1,0
112233,1,1,0,0,1,0
180157,8,7,0,0,7,0
180157,3,5,0,0,5,0
166556,9,1,0,0,1,0
166556,8,4,0,0,4,0
166556,3,1,0,0,1,0
166556,2,1,0,0,1,0
246693,10,2,0,0,2,0
246693,9,1,0,0,1,0
246693,5,5,0,0,5,0
246693,4,1,0,0,1,0
246693,1,2,0,0,2,0
18262,2,1,0,0,1,0
240100,10,1,0,0,1,0
240100,5,5,0,0,5,0
5810,10,1,0,0,1,0
5810,7,7,0,0,7,0
5810,4,7,0,0,7,0
5810,1,2,0,0,2,0
25158,3,2,0,0,2,0
1488,8,1,0,0,1,0
1488,1,2,0,0,2,0
209283,10,1,0,0,1,0
209283,9,1,0,0,1,0
209283,4,3,0,0,3,0
137780,8,8,0,0,8,0
137780,4,4,0,0,4,0
137780,3,2,0,0,2,0
145344,7,11,0,0,11,0
145344,6,14,0,0,14,0
145344,5,2,0,0,2,0
145344,3,1,0,0,1,0
4460,1,4,0,0,4,0
25967,9,1,0,0,1,0
25967,2,1,0,0,1,0
4372,9,1,0,0,1,0
4372,2,1,0,0,1,0
51250,10,1,0,0,1,0
51250,5,2,0,0,2,0
51250,4,1,0,0,1,0
51250,1,1,0,0,1,0
92591,5,4,0,0,4,0
92591,4,1,0,0,1,0
92591,3,2,0,0,2,0
156557,9,1,0,0,1,0
156557,3,5,0,0,5,0
156557,2,1,0,0,1,0
156557,1,1,0,0,1,0
194532,10,8,0,0,8,0
194532,9,7,0,0,7,0
194532,8,13,0,0,13,0
194532,6,6,0,0,6,0
194532,5,2,0,0,2,0
99042,5,2,0,0,2,0
99042,2,1,0,0,1,0
7344,8,2,0,0,2,0
7344,7,6,0,0,6,0
7344,3,3,0,0,3,0
7344,2,1,0,0,1,0
6770,5,3,0,0,3,0
6770,4,1,0,0,1,0
154682,9,1,0,0,1,0
154682,8,4,0,0,4,0
154682,3,3,0,0,3,0
212404,9,3,0,0,3,0
212404,4,1,0,0,1,0
212404,3,1,0,0,1,0
82223,9,2,0,0,2,0
82223,4,1,0,0,1,0
82223,3,2,0,0,2,0
82223,2,1,0,0,1,0
11428,5,3,0,0,3,0
11428,1,1,0,0,1,0
260934,6,2,0,0,2,0
30009,10,1,0,0,1,0
30009,8,1,0,0,1,0
30009,7,4,0,0,4,0
165600,9,1,0,0,1,0
10471,4,2,0,0,2,0
158059,5,7,0,0,7,0
158059,4,1,0,0,1,0
158059,2,1,0,0,1,0
158059,1,1,0,0,1,0
9415,9,1,0,0,1,0
9415,3,1,0,0,1,0
5028,7,4,0,0,4,0
5028,5,14,0,0,14,0
12532,7,2,0,0,2,0
12532,1,1,0,0,1,0
150323,10,1,0,0,1,0
4017,10,2,0,0,2,0
4017,2,1,0,0,1,0
150033,10,1,0,0,1,0
150033,6,19,0,0,19,0
150033,5,10,0,0,10,0
150033,4,3,0,0,3,0
150033,3,2,0,0,2,0
125547,9,1,0,0,1,0
125547,2,2,0,0,2,0
228371,9,2,0,0,2,0
228371,4,2,0,0,2,0
25973,2,1,0,0,1,0
2917,8,1,0,0,1,0
2917,4,3,0,0,3,0
1542,1,1,0,0,1,0
260348,4,3,0,0,3,0
215154,5,7,0,0,7,0
215154,3,3,0,0,3,0
215154,1,1,0,0,1,0
7978,10,2,0,0,2,0
7978,9,1,0,0,1,0
7978,3,1,0,0,1,0
26947,1,1,0,0,1,0
209447,9,1,0,0,1,0
209447,4,3,0,0,3,0
209447,3,4,0,0,4,0
209447,1,1,0,0,1,0
237106,4,1,0,0,1,0
192324,5,2,0,0,2,0
192324,4,2,0,0,2,0
271693,9,3,0,0,3,0
271693,6,13,0,0,13,0
271693,5,5,0,0,5,0
271693,4,1,0,0,1,0
271693,2,1,0,0,1,0
216630,5,2,0,0,2,0
234949,10,1,0,0,1,0
234949,5,2,0,0,2,0
200115,9,1,0,0,1,0
200115,2,1,0,0,1,0
3535,9,2,0,0,2,0
182593,9,4,0,0,4,0
182593,6,14,0,0,14,0
182593,4,3,0,0,3,0
12067,4,1,0,0,1,0
2075,5,11,0,0,11,0
2075,3,3,0,0,3,0
2075,2,4,0,0,4,0
2075,1,1,0,0,1,0
225610,6,3,0,0,3,0
225610,5,1,0,0,1,0
199882,6,11,0,0,11,0
199882,2,1,0,0,1,0
131200,9,4,0,0,4,0
131200,3,4,0,0,4,0
8758,10,4,0,0,4,0
8758,4,1,0,0,1,0
8758,3,1,0,0,1,0
8758,2,1,0,0,1,0
10325,1,2,0,0,2,0
11292,10,2,0,0,2,0
230316,9,1,0,0,1,0
230316,3,1,0,0,1,0
230316,2,1,0,0,1,0
25344,9,1,0,0,1,0
25344,2,1,0,0,1,0
190264,9,2,0,0,2,0
93094,8,4,0,0,4,0
93094,7,16,0,0,16,0
93094,4,10,0,0,10,0
93094,1,1,0,0,1,0
214758,5,1,0,0,1,0
242317,4,1,0,0,1,0
242317,1,1,0,0,1,0
184351,9,1,0,0,1,0
184351,2,1,0,0,1,0
24483,10,1,0,0,1,0
24483,9,1,0,0,1,0
24483,4,4,0,0,4,0
24483,3,2,0,0,2,0
24483,2,1,0,0,1,0
24483,1,1,0,0,1,0
147418,10,2,0,0,2,0
147418,9,2,0,0,2,0
147418,6,20,0,0,20,0
147418,3,2,0,0,2,0
203739,10,5,0,0,5,0
203739,9,1,0,0,1,0
203739,8,1,0,0,1,0
203739,5,2,0,0,2,0
2720,4,3,0,0,3,0
2720,3,2,0,0,2,0
177411,4,5,0,0,5,0
177411,1,2,0,0,2,0
256643,5,8,0,0,8,0
256643,2,1,0,0,1,0
5843,10,1,0,0,1,0
5843,9,3,0,0,3,0
5843,4,1,0,0,1,0
148138,10,2,0,0,2,0
148138,4,1,0,0,1,0
248918,7,1,0,0,1,0
124395,10,1,0,0,1,0
124395,9,2,0,0,2,0
124395,8,2,0,0,2,0
124395,5,5,0,0,5,0
124395,2,5,0,0,5,0
129287,9,1,0,0,1,0
129287,5,5,0,0,5,0
129287,3,3,0,0,3,0
1896,3,1,0,0,1,0
30771,3,1,0,0,1,0
30771,2,1,0,0,1,0
2128,9,1,0,0,1,0
2128,8,3,0,0,3,0
2128,7,1,0,0,1,0
84776,9,1,0,0,1,0
84776,3,1,0,0,1,0
160488,10,1,0,0,1,0
160488,5,9,0,0,9,0
160488,3,1,0,0,1,0
160488,2,1,0,0,1,0
10557,4,1,0,0,1,0
243599,10,1,0,0,1,0
243599,6,13,0,0,13,0
243599,5,2,0,0,2,0
243599,2,1,0,0,1,0
256915,10,1,0,0,1,0
27730,10,3,0,0,3,0
27730,9,4,0,0,4,0
27730,3,3,0,0,3,0
11129,10,1,0,0,1,0
1637,10,2,0,0,2,0
1637,3,1,0,0,1,0
7862,8,1,0,0,1,0
7862,3,4,0,0,4,0
220541,10,1,0,0,1,0
220541,4,3,0,0,3,0
220541,1,1,0,0,1,0
209642,1,1,0,0,1,0
73363,9,3,0,0,3,0
73363,5,2,0,0,2,0
73363,4,1,0,0,1,0
73363,3,1,0,0,1,0
73363,2,1,0,0,1,0
233969,7,8,0,0,8,0
233969,5,1,0,0,1,0
233969,4,1,0,0,1,0
174431,9,3,0,0,3,0
2400,4,4,0,0,4,0
2400,3,1,0,0,1,0
11863,6,1,0,0,1,0
198456,9,2,0,0,2,0
198456,5,3,0,0,3,0
198456,4,3,0,0,3,0
153479,4,2,0,0,2,0
46925,3,1,0,0,1,0
251854,9,3,0,0,3,0
251854,3,1,0,0,1,0
251854,2,1,0,0,1,0
171543,10,1,0,0,1,0
171543,2,1,0,0,1,0
171543,1,1,0,0,1,0
5961,10,1,0,0,1,0
5961,9,1,0,0,1,0
5961,8,1,0,0,1,0
5961,1,1,0,0,1,0
109936,2,1,0,0,1,0
109936,1,1,0,0,1,0
38679,9,1,0,0,1,0
38679,3,1,0,0,1,0
235653,10,6,0,0,6,0
235653,1,1,0,0,1,0
69632,9,3,0,0,3,0
69632,3,1,0,0,1,0
36412,10,1,0,0,1,0
36412,9,2,0,0,2,0
36412,3,1,0,0,1,0
36412,2,1,0,0,1,0
5890,10,1,0,0,1,0
33950,10,1,0,0,1,0
33950,9,2,0,0,2,0
33950,8,1,0,0,1,0
182198,10,2,0,0,2,0
182198,9,2,0,0,2,0
182198,8,11,0,0,11,0
182198,7,14,0,0,14,0
182198,5,5,0,0,5,0
182198,4,4,0,0,4,0
182198,3,1,0,0,1,0
182198,2,1,0,0,1,0
137969,4,6,0,0,6,0
137969,1,1,0,0,1,0
6708,9,1,0,0,1,0
38197,9,1,0,0,1,0
215065,10,1,0,0,1,0
215065,9,2,0,0,2,0
215065,8,5,0,0,5,0
215065,7,13,0,0,13,0
215065,5,4,0,0,4,0
208543,10,4,0,0,4,0
208543,5,3,0,0,3,0
208543,4,2,0,0,2,0
208543,3,2,0,0,2,0
208543,1,1,0,0,1,0
40964,9,1,0,0,1,0
40964,3,4,0,0,4,0
3543,3,1,0,0,1,0
2159,10,1,0,0,1,0
2159,3,1,0,0,1,0
3617,10,2,0,0,2,0
3617,9,1,0,0,1,0
3617,4,2,0,0,2,0
11974,8,1,0,0,1,0
11974,3,1,0,0,1,0
11974,2,1,0,0,1,0
26795,10,2,0,0,2,0
16727,7,9,0,0,9,0
16727,4,3,0,0,3,0
16727,2,1,0,0,1,0
16727,1,1,0,0,1,0
170867,4,1,0,0,1,0
170867,3,1,0,0,1,0
21479,9,1,0,0,1,0
21479,3,1,0,0,1,0
2515,8,2,0,0,2,0
2515,7,1,0,0,1,0
2515,2,1,0,0,1,0
19246,10,1,0,0,1,0
158343,10,1,0,0,1,0
158343,9,2,0,0,2,0
158343,5,8,0,0,8,0
158343,4,6,0,0,6,0
158343,2,3,0,0,3,0
158343,1,2,0,0,2,0
11648,9,5,0,0,5,0
186990,5,1,0,0,1,0
85474,10,1,0,0,1,0
85474,9,1,0,0,1,0
85474,5,5,0,0,5,0
85474,2,1,0,0,1,0
86768,4,7,0,0,7,0
13356,8,1,0,0,1,0
13356,7,2,0,0,2,0
13356,2,5,0,0,5,0
126941,5,6,0,0,6,0
126941,2,1,0,0,1,0
88190,10,9,0,0,9,0
88190,6,1,0,0,1,0
88190,5,1,0,0,1,0
25642,9,2,0,0,2,0
25642,1,1,0,0,1,0
142517,4,5,0,0,5,0
75674,10,1,0,0,1,0
75674,9,4,0,0,4,0
75674,5,1,0,0,1,0
235247,10,3,0,0,3,0
235247,9,1,0,0,1,0
235247,8,4,0,0,4,0
2681,10,1,0,0,1,0
2681,8,3,0,0,3,0
2681,1,1,0,0,1,0
160664,5,3,0,0,3,0
160664,4,2,0,0,2,0
9908,10,4,0,0,4,0
236205,2,1,0,0,1,0
15278,7,1,0,0,1,0
15278,5,5,0,0,5,0
15278,4,6,0,0,6,0
3566,9,2,0,0,2,0
3566,8,2,0,0,2,0
160524,6,3,0,0,3,0
160524,4,1,0,0,1,0
160524,1,1,0,0,1,0
144066,2,1,0,0,1,0
182284,7,11,0,0,11,0
39192,10,1,0,0,1,0
39192,8,3,0,0,3,0
39192,7,5,0,0,5,0
39192,4,7,0,0,7,0
39192,2,2,0,0,2,0
12057,1,1,0,0,1,0
6768,5,4,0,0,4,0
6768,4,3,0,0,3,0
13126,9,1,0,0,1,0
13126,8,3,0,0,3,0
13126,7,4,0,0,4,0
13126,2,2,0,0,2,0
3883,9,1,0,0,1,0
3883,8,1,0,0,1,0
2271,4,1,0,0,1,0
169368,4,2,0,0,2,0
34009,10,2,0,0,2,0
34009,3,2,0,0,2,0
8624,9,2,0,0,2,0
8624,3,3,0,0,3,0
8624,2,2,0,0,2,0
8624,1,3,0,0,3,0
248224,9,1,0,0,1,0
248224,8,14,0,0,14,0
248224,4,4,0,0,4,0
248224,3,1,0,0,1,0
248224,2,1,0,0,1,0
12676,8,5,0,0,5,0
12676,5,6,0,0,6,0
12676,2,2,0,0,2,0
39245,5,9,0,0,9,0
39245,4,4,0,0,4,0
39245,3,2,0,0,2,0
237828,7,2,0,0,2,0
237828,6,1,0,0,1,0
237828,5,2,0,0,2,0
124387,10,2,0,0,2,0
22209,8,1,0,0,1,0
147931,10,1,0,0,1,0
147931,9,1,0,0,1,0
147931,3,1,0,0,1,0
147931,2,1,0,0,1,0
26869,10,2,0,0,2,0
22758,10,2,0,0,2,0
22758,5,1,0,0,1,0
198608,3,1,0,0,1,0
198608,1,1,0,0,1,0
6803,2,1,0,0,1,0
191681,9,2,0,0,2,0
191681,5,8,0,0,8,0
191681,4,3,0,0,3,0
191681,3,1,0,0,1,0
2196,2,1,0,0,1,0
2463,8,1,0,0,1,0
2463,2,3,0,0,3,0
7829,10,2,0,0,2,0
7829,5,6,0,0,6,0
249730,4,2,0,0,2,0
4554,2,2,0,0,2,0
36415,7,1,0,0,1,0
36415,6,1,0,0,1,0
20630,3,2,0,0,2,0
4069,8,2,0,0,2,0
4069,7,5,0,0,5,0
4069,3,4,0,0,4,0
8252,10,1,0,0,1,0
8252,3,1,0,0,1,0
233848,9,3,0,0,3,0
233848,8,9,0,0,9,0
233848,7,12,0,0,12,0
233848,5,3,0,0,3,0
233848,4,4,0,0,4,0
233848,3,2,0,0,2,0
103783,9,4,0,0,4,0
103783,5,3,0,0,3,0
103783,4,2,0,0,2,0
61383,8,3,0,0,3,0
61383,4,5,0,0,5,0
61383,3,2,0,0,2,0
61383,2,1,0,0,1,0
148204,1,1,0,0,1,0
89610,7,10,0,0,10,0
253635,10,3,0,0,3,0
105123,10,1,0,0,1,0
105123,9,1,0,0,1,0
105123,7,3,0,0,3,0
105123,2,1,0,0,1,0
105123,1,7,0,0,7,0
225908,10,2,0,0,2,0
225908,5,2,0,0,2,0
225908,3,3,0,0,3,0
216740,7,4,0,0,4,0
216740,6,1,0,0,1,0
216740,4,2,0,0,2,0
216740,2,2,0,0,2,0
264282,10,1,0,0,1,0
264282,6,15,0,0,15,0
264282,5,4,0,0,4,0
264282,4,4,0,0,4,0
10261,10,1,0,0,1,0
10261,3,1,0,0,1,0
173408,10,2,0,0,2,0
173408,8,6,0,0,6,0
173408,6,12,0,0,12,0
173408,5,4,0,0,4,0
173408,3,2,0,0,2,0
8352,10,2,0,0,2,0
6689,2,2,0,0,2,0
32639,10,2,0,0,2,0
32639,3,1,0,0,1,0
1725,8,2,0,0,2,0
1725,6,6,0,0,6,0
192288,10,2,0,0,2,0
192288,9,2,0,0,2,0
192288,2,1,0,0,1,0
7243,5,6,0,0,6,0
126213,6,12,0,0,12,0
126213,1,1,0,0,1,0
8220,3,3,0,0,3,0
2943,8,1,0,0,1,0
2943,3,1,0,0,1,0
2943,1,1,0,0,1,0
10450,8,3,0,0,3,0
10450,7,4,0,0,4,0
3203,1,1,0,0,1,0
1091,1,1,0,0,1,0
23030,2,1,0,0,1,0
23030,1,1,0,0,1,0
220624,9,2,0,0,2,0
220624,8,6,0,0,6,0
220624,4,3,0,0,3,0
220624,3,3,0,0,3,0
220624,1,2,0,0,2,0
26539,5,3,0,0,3,0
26539,4,2,0,0,2,0
22616,9,1,0,0,1,0
22616,4,5,0,0,5,0
13792,7,1,0,0,1,0
13792,1,1,0,0,1,0
33569,10,1,0,0,1,0
33569,9,2,0,0,2,0
33569,2,2,0,0,2,0
147136,3,2,0,0,2,0
4620,3,1,0,0,1,0
9426,8,1,0,0,1,0
9426,7,5,0,0,5,0
9426,5,8,0,0,8,0
9426,2,2,0,0,2,0
262818,10,2,0,0,2,0
262818,5,1,0,0,1,0
255651,9,1,0,0,1,0
255651,4,2,0,0,2,0
42470,9,4,0,0,4,0
42470,8,6,0,0,6,0
42470,4,3,0,0,3,0
175464,1,1,0,0,1,0
40247,8,2,0,0,2,0
40247,2,1,0,0,1,0
11547,10,1,0,0,1,0
11547,8,5,0,0,5,0
207290,4,1,0,0,1,0
207290,2,1,0,0,1,0
18564,10,1,0,0,1,0
18564,9,1,0,0,1,0
232300,10,2,0,0,2,0
232300,9,1,0,0,1,0
232300,5,9,0,0,9,0
232300,3,3,0,0,3,0
232300,2,1,0,0,1,0
179813,10,1,0,0,1,0
179813,7,10,0,0,10,0
177751,9,1,0,0,1,0
177751,2,5,0,0,5,0
101644,9,11,0,0,11,0
101644,6,1,0,0,1,0
101644,5,3,0,0,3,0
101644,4,1,0,0,1,0
101644,1,1,0,0,1,0
172325,9,1,0,0,1,0
740,10,1,0,0,1,0
740,8,1,0,0,1,0
18164,10,1,0,0,1,0
18164,2,2,0,0,2,0
18164,1,1,0,0,1,0
72957,9,1,0,0,1,0
72957,3,4,0,0,4,0
72957,2,3,0,0,3,0
7992,5,1,0,0,1,0
7992,4,2,0,0,2,0
7992,2,3,0,0,3,0
266964,8,12,0,0,12,0
266964,6,6,0,0,6,0
266964,5,2,0,0,2,0
26474,10,4,0,0,4,0
26474,7,9,0,0,9,0
26474,6,7,0,0,7,0
180570,9,1,0,0,1,0
180570,7,14,0,0,14,0
180570,3,2,0,0,2,0
180570,1,1,0,0,1,0
2380,10,2,0,0,2,0
2380,3,3,0,0,3,0
181031,4,2,0,0,2,0
181031,3,1,0,0,1,0
181031,1,1,0,0,1,0
154085,5,5,0,0,5,0
245384,9,2,0,0,2,0
245384,3,1,0,0,1,0
253861,10,1,0,0,1,0
253861,9,1,0,0,1,0
253861,7,6,0,0,6,0
253861,5,9,0,0,9,0
253861,3,5,0,0,5,0
253861,2,3,0,0,3,0
10906,10,1,0,0,1,0
58192,4,5,0,0,5,0
2435,8,2,0,0,2,0
2435,7,1,0,0,1,0
254617,10,1,0,0,1,0
254617,9,3,0,0,3,0
254617,6,12,0,0,12,0
254617,5,10,0,0,10,0
254617,3,8,0,0,8,0
254617,1,2,0,0,2,0
218610,10,1,0,0,1,0
218610,6,10,0,0,10,0
218610,3,1,0,0,1,0
6230,2,1,0,0,1,0
130286,4,4,0,0,4,0
130286,1,1,0,0,1,0
174925,5,1,0,0,1,0
174925,4,1,0,0,1,0
18422,10,4,0,0,4,0
18422,8,9,0,0,9,0
18422,6,10,0,0,10,0
18422,4,2,0,0,2,0
18422,3,1,0,0,1,0
192344,3,1,0,0,1,0
12819,10,1,0,0,1,0
151936,9,2,0,0,2,0
151936,1,1,0,0,1,0
20525,10,1,0,0,1,0
20525,9,1,0,0,1,0
20525,8,2,0,0,2,0
107181,9,4,0,0,4,0
107181,4,2,0,0,2,0
107181,3,1,0,0,1,0
11889,10,1,0,0,1,0
11889,4,1,0,0,1,0
11889,3,1,0,0,1,0
66044,4,3,0,0,3,0
66044,2,1,0,0,1,0
150018,9,1,0,0,1,0
150018,8,2,0,0,2,0
150018,7,6,0,0,6,0
150018,4,14,0,0,14,0
10683,6,2,0,0,2,0
10683,5,4,0,0,4,0
10683,3,1,0,0,1,0
10683,2,1,0,0,1,0
10683,1,1,0,0,1,0
22048,10,2,0,0,2,0
22048,9,1,0,0,1,0
22048,6,20,0,0,20,0
22048,2,3,0,0,3,0
235451,6,4,0,0,4,0
235451,4,2,0,0,2,0
153432,9,1,0,0,1,0
153432,8,5,0,0,5,0
153432,4,3,0,0,3,0
153432,3,3,0,0,3,0
31527,6,14,0,0,14,0
31527,4,6,0,0,6,0
187834,2,1,0,0,1,0
145649,10,1,0,0,1,0
145649,7,13,0,0,13,0
145649,2,1,0,0,1,0
1819,10,1,0,0,1,0
1819,1,2,0,0,2,0
20824,8,1,0,0,1,0
20824,5,8,0,0,8,0
116972,10,1,0,0,1,0
116972,3,2,0,0,2,0
6954,3,3,0,0,3,0
6954,2,1,0,0,1,0
8620,8,1,0,0,1,0
8620,2,1,0,0,1,0
37351,10,1,0,0,1,0
37351,9,5,0,0,5,0
37351,8,9,0,0,9,0
37351,6,21,0,0,21,0
37351,2,2,0,0,2,0
35548,3,3,0,0,3,0
113780,9,2,0,0,2,0
207764,10,2,0,0,2,0
207764,9,2,0,0,2,0
207764,7,7,0,0,7,0
207764,2,1,0,0,1,0
207764,1,1,0,0,1,0
90467,9,1,0,0,1,0
90467,8,4,0,0,4,0
89880,4,1,0,0,1,0
140861,9,15,0,0,15,0
140861,3,1,0,0,1,0
123514,10,1,0,0,1,0
123514,8,1,0,0,1,0
123514,3,2,0,0,2,0
158752,10,19,0,0,19,0
158752,9,11,0,0,11,0
158752,8,6,0,0,6,0
158752,6,5,0,0,5,0
158752,4,1,0,0,1,0
158752,1,5,0,0,5,0
257839,10,3,0,0,3,0
257839,9,3,0,0,3,0
257839,8,19,0,0,19,0
257839,5,1,0,0,1,0
257839,4,1,0,0,1,0
14151,4,2,0,0,2,0
85332,10,1,0,0,1,0
85332,5,3,0,0,3,0
188997,10,4,0,0,4,0
188997,5,6,0,0,6,0
188997,4,3,0,0,3,0
188997,3,1,0,0,1,0
1623,10,1,0,0,1,0
149927,5,1,0,0,1,0
147681,10,1,0,0,1,0
117986,10,7,0,0,7,0
117986,9,2,0,0,2,0
117986,8,6,0,0,6,0
117986,7,6,0,0,6,0
117986,5,7,0,0,7,0
8093,3,1,0,0,1,0
150827,9,1,0,0,1,0
150827,4,3,0,0,3,0
150827,2,1,0,0,1,0
19379,10,2,0,0,2,0
19379,9,1,0,0,1,0
19379,5,7,0,0,7,0
11113,10,3,0,0,3,0
11113,9,3,0,0,3,0
11113,5,2,0,0,2,0
11113,3,2,0,0,2,0
11113,2,1,0,0,1,0
25841,5,5,0,0,5,0
25841,4,2,0,0,2,0
25841,3,2,0,0,2,0
19634,4,4,0,0,4,0
6404,9,2,0,0,2,0
6404,2,2,0,0,2,0
86165,9,1,0,0,1,0
86165,3,1,0,0,1,0
38830,10,1,0,0,1,0
38830,5,2,0,0,2,0
38830,2,1,0,0,1,0
29447,10,1,0,0,1,0
17464,1,1,0,0,1,0
11188,3,1,0,0,1,0
192275,10,1,0,0,1,0
192275,9,2,0,0,2,0
192275,3,2,0,0,2,0
192275,2,1,0,0,1,0
192275,1,2,0,0,2,0
4271,8,3,0,0,3,0
218503,10,7,0,0,7,0
256397,10,1,0,0,1,0
256397,5,11,0,0,11,0
256397,4,6,0,0,6,0
256397,3,1,0,0,1,0
256397,2,3,0,0,3,0
5828,10,3,0,0,3,0
5828,5,6,0,0,6,0
5828,3,1,0,0,1,0
186624,5,3,0,0,3,0
186624,4,2,0,0,2,0
186624,3,1,0,0,1,0
220331,7,10,0,0,10,0
220331,6,1,0,0,1,0
73240,10,1,0,0,1,0
73240,9,1,0,0,1,0
73240,3,2,0,0,2,0
73240,2,1,0,0,1,0
73240,1,1,0,0,1,0
11435,8,6,0,0,6,0
11435,4,2,0,0,2,0
11435,2,1,0,0,1,0
11435,1,1,0,0,1,0
20851,4,4,0,0,4,0
200957,5,1,0,0,1,0
200957,3,4,0,0,4,0
73288,5,14,0,0,14,0
73288,3,1,0,0,1,0
73288,2,1,0,0,1,0
120033,7,10,0,0,10,0
9379,10,1,0,0,1,0
9379,3,2,0,0,2,0
7623,1,1,0,0,1,0
35354,3,1,0,0,1,0
767,10,2,0,0,2,0
767,4,2,0,0,2,0
159502,5,6,0,0,6,0
159502,3,2,0,0,2,0
159502,2,1,0,0,1,0
169755,8,3,0,0,3,0
169755,7,5,0,0,5,0
169755,3,2,0,0,2,0
169755,1,2,0,0,2,0
8351,10,1,0,0,1,0
8351,5,2,0,0,2,0
8351,1,1,0,0,1,0
12267,3,2,0,0,2,0
260238,9,1,0,0,1,0
260238,5,6,0,0,6,0
260238,1,1,0,0,1,0
190758,6,3,0,0,3,0
190758,5,2,0,0,2,0
190758,4,1,0,0,1,0
190758,1,1,0,0,1,0
17869,10,1,0,0,1,0
17869,8,3,0,0,3,0
4797,2,2,0,0,2,0
10688,10,1,0,0,1,0
10688,8,3,0,0,3,0
10688,3,3,0,0,3,0
10688,1,1,0,0,1,0
20000,10,1,0,0,1,0
20000,9,1,0,0,1,0
20000,5,2,0,0,2,0
20000,4,1,0,0,1,0
14355,10,1,0,0,1,0
2131,2,1,0,0,1,0
5955,10,1,0,0,1,0
5955,5,4,0,0,4,0
5955,3,1,0,0,1,0
217322,10,2,0,0,2,0
217322,9,1,0,0,1,0
217322,8,5,0,0,5,0
161773,2,1,0,0,1,0
161773,1,1,0,0,1,0
136910,10,1,0,0,1,0
136910,2,1,0,0,1,0
319,10,1,0,0,1,0
319,2,1,0,0,1,0
72340,10,3,0,0,3,0
72340,4,2,0,0,2,0
72340,3,1,0,0,1,0
8741,10,1,0,0,1,0
8741,9,1,0,0,1,0
8741,3,1,0,0,1,0
69703,7,7,0,0,7,0
69703,1,2,0,0,2,0
205419,5,3,0,0,3,0
205419,3,2,0,0,2,0
205419,1,1,0,0,1,0
234972,10,1,0,0,1,0
25001,4,6,0,0,6,0
25001,3,1,0,0,1,0
21040,5,3,0,0,3,0
21040,2,1,0,0,1,0
5026,2,1,0,0,1,0
223971,10,1,0,0,1,0
223971,9,2,0,0,2,0
223971,4,4,0,0,4,0
223971,3,4,0,0,4,0
223971,2,1,0,0,1,0
39662,8,1,0,0,1,0
39662,7,1,0,0,1,0
178098,3,1,0,0,1,0
5841,10,1,0,0,1,0
5841,8,1,0,0,1,0
5841,2,3,0,0,3,0
211364,5,2,0,0,2,0
211364,1,1,0,0,1,0
171721,6,7,0,0,7,0
171721,4,1,0,0,1,0
180133,3,3,0,0,3,0
208700,1,1,0,0,1,0
3620,8,6,0,0,6,0
3620,3,1,0,0,1,0
136494,8,1,0,0,1,0
136494,2,4,0,0,4,0
136494,1,1,0,0,1,0
4964,4,1,0,0,1,0
203029,5,4,0,0,4,0
203029,1,1,0,0,1,0
142205,10,3,0,0,3,0
142205,9,3,0,0,3,0
142205,5,2,0,0,2,0
142205,3,1,0,0,1,0
2941,7,4,0,0,4,0
4070,8,1,0,0,1,0
8334,10,2,0,0,2,0
8334,9,2,0,0,2,0
210937,5,8,0,0,8,0
7249,10,1,0,0,1,0
7249,1,2,0,0,2,0
144383,1,1,0,0,1,0
31111,1,2,0,0,2,0
1156,10,1,0,0,1,0
1156,5,11,0,0,11,0
1156,2,2,0,0,2,0
1156,1,3,0,0,3,0
82577,5,5,0,0,5,0
82577,3,3,0,0,3,0
82577,2,1,0,0,1,0
21635,9,1,0,0,1,0
21635,8,3,0,0,3,0
32150,10,5,0,0,5,0
32150,6,3,0,0,3,0
32150,5,1,0,0,1,0
167975,6,4,0,0,4,0
167975,5,2,0,0,2,0
173253,9,3,0,0,3,0
173253,4,4,0,0,4,0
173253,3,1,0,0,1,0
10236,10,2,0,0,2,0
10236,9,1,0,0,1,0
10236,5,2,0,0,2,0
10236,1,1,0,0,1,0
191351,5,1,0,0,1,0
191351,1,1,0,0,1,0
4843,8,7,0,0,7,0
4843,3,1,0,0,1,0
21622,8,2,0,0,2,0
21622,7,5,0,0,5,0
21622,6,14,0,0,14,0
21622,1,3,0,0,3,0
72050,6,1,0,0,1,0
72050,1,1,0,0,1,0
47158,4,1,0,0,1,0
9293,2,1,0,0,1,0
9293,1,2,0,0,2,0
36789,8,16,0,0,16,0
36789,5,2,0,0,2,0
2554,10,1,0,0,1,0
2554,9,3,0,0,3,0
3008,10,2,0,0,2,0
3008,9,2,0,0,2,0
32922,8,2,0,0,2,0
32922,3,5,0,0,5,0
35468,6,13,0,0,13,0
35468,3,4,0,0,4,0
41624,5,2,0,0,2,0
159525,4,3,0,0,3,0
159525,3,3,0,0,3,0
159525,2,1,0,0,1,0
159525,1,1,0,0,1,0
52827,3,1,0,0,1,0
215455,10,2,0,0,2,0
215455,9,1,0,0,1,0
215455,4,1,0,0,1,0
215455,3,1,0,0,1,0
199907,10,1,0,0,1,0
199907,9,2,0,0,2,0
199907,5,1,0,0,1,0
199907,1,1,0,0,1,0
56889,8,3,0,0,3,0
56889,4,6,0,0,6,0
56889,3,3,0,0,3,0
29080,9,1,0,0,1,0
119165,10,1,0,0,1,0
119165,9,2,0,0,2,0
119165,2,3,0,0,3,0
119165,1,1,0,0,1,0
7399,10,2,0,0,2,0
7399,1,3,0,0,3,0
258302,9,1,0,0,1,0
258302,8,3,0,0,3,0
258302,6,4,0,0,4,0
258302,5,1,0,0,1,0
25593,9,1,0,0,1,0
25593,3,1,0,0,1,0
65333,8,5,0,0,5,0
65333,7,8,0,0,8,0
65333,5,14,0,0,14,0
65333,4,4,0,0,4,0
65333,3,2,0,0,2,0
65333,2,1,0,0,1,0
35414,2,1,0,0,1,0
113700,9,2,0,0,2,0
176193,9,1,0,0,1,0
176193,6,12,0,0,12,0
13921,10,1,0,0,1,0
133689,1,1,0,0,1,0
3701,2,1,0,0,1,0
220199,10,1,0,0,1,0
220199,2,1,0,0,1,0
24525,1,1,0,0,1,0
208170,8,4,0,0,4,0
177641,5,7,0,0,7,0
177641,4,2,0,0,2,0
177641,3,1,0,0,1,0
8979,9,1,0,0,1,0
8979,3,1,0,0,1,0
8979,2,1,0,0,1,0
4245,10,2,0,0,2,0
4245,3,2,0,0,2,0
25168,9,2,0,0,2,0
25168,3,1,0,0,1,0
25168,2,1,0,0,1,0
207899,10,1,0,0,1,0
207899,9,1,0,0,1,0
207899,7,22,0,0,22,0
207899,5,1,0,0,1,0
3483,10,3,0,0,3,0
3483,4,7,0,0,7,0
3483,3,2,0,0,2,0
3483,2,2,0,0,2,0
3483,1,1,0,0,1,0
237009,5,2,0,0,2,0
123828,10,4,0,0,4,0
123828,4,1,0,0,1,0
12715,10,1,0,0,1,0
12715,9,2,0,0,2,0
12715,5,6,0,0,6,0
12715,4,1,0,0,1,0
29489,5,7,0,0,7,0
29489,2,2,0,0,2,0
1603,7,4,0,0,4,0
1603,5,8,0,0,8,0
1603,2,5,0,0,5,0
784,10,1,0,0,1,0
784,9,4,0,0,4,0
784,4,2,0,0,2,0
784,3,1,0,0,1,0
202581,5,7,0,0,7,0
149078,8,2,0,0,2,0
149078,3,1,0,0,1,0
149078,2,1,0,0,1,0
198005,6,1,0,0,1,0
198005,5,1,0,0,1,0
198005,4,1,0,0,1,0
198005,1,1,0,0,1,0
8911,5,4,0,0,4,0
488,3,1,0,0,1,0
488,1,1,0,0,1,0
5875,10,2,0,0,2,0
5875,9,1,0,0,1,0
5875,8,1,0,0,1,0
252265,10,1,0,0,1,0
252265,4,1,0,0,1,0
6087,10,1,0,0,1,0
6087,2,1,0,0,1,0
14012,10,1,0,0,1,0
14012,5,4,0,0,4,0
14012,3,2,0,0,2,0
14012,2,1,0,0,1,0
14012,1,1,0,0,1,0
22305,1,1,0,0,1,0
2643,10,1,0,0,1,0
2643,2,2,0,0,2,0
220478,8,2,0,0,2,0
220478,5,5,0,0,5,0
220478,3,3,0,0,3,0
4450,10,1,0,0,1,0
194388,10,3,0,0,3,0
194388,9,3,0,0,3,0
194388,7,11,0,0,11,0
194388,4,1,0,0,1,0
22724,9,1,0,0,1,0
22724,1,2,0,0,2,0
15990,10,3,0,0,3,0
15990,6,8,0,0,8,0
15990,5,4,0,0,4,0
17693,2,1,0,0,1,0
17693,1,1,0,0,1,0
24151,7,7,0,0,7,0
24151,6,16,0,0,16,0
24151,2,2,0,0,2,0
28511,10,1,0,0,1,0
28511,8,1,0,0,1,0
28511,2,2,0,0,2,0
7607,10,1,0,0,1,0
7607,9,2,0,0,2,0
7607,5,3,0,0,3,0
7607,4,2,0,0,2,0
6885,10,1,0,0,1,0
6885,3,1,0,0,1,0
7241,10,1,0,0,1,0
7241,5,6,0,0,6,0
7241,2,1,0,0,1,0
203087,4,1,0,0,1,0
135077,9,1,0,0,1,0
135077,7,4,0,0,4,0
135077,1,1,0,0,1,0
19378,9,1,0,0,1,0
19378,8,2,0,0,2,0
19378,7,2,0,0,2,0
223167,7,5,0,0,5,0
223167,6,1,0,0,1,0
226454,10,1,0,0,1,0
226454,9,1,0,0,1,0
226454,4,1,0,0,1,0
226454,1,1,0,0,1,0
237153,4,2,0,0,2,0
237153,3,3,0,0,3,0
237153,2,1,0,0,1,0
237153,1,1,0,0,1,0
125634,4,1,0,0,1,0
24779,10,1,0,0,1,0
24779,7,6,0,0,6,0
24779,2,2,0,0,2,0
42255,2,1,0,0,1,0
6507,4,1,0,0,1,0
233070,10,1,0,0,1,0
233070,9,1,0,0,1,0
233070,5,4,0,0,4,0
269595,9,3,0,0,3,0
269595,6,5,0,0,5,0
269595,5,2,0,0,2,0
269595,4,1,0,0,1,0
97582,9,2,0,0,2,0
97582,4,2,0,0,2,0
97582,2,2,0,0,2,0
265249,7,9,0,0,9,0
265249,5,2,0,0,2,0
265249,4,1,0,0,1,0
265249,2,1,0,0,1,0
39789,8,4,0,0,4,0
7754,9,2,0,0,2,0
7754,5,4,0,0,4,0
7754,4,2,0,0,2,0
121322,3,1,0,0,1,0
121322,2,1,0,0,1,0
53373,8,2,0,0,2,0
53373,2,4,0,0,4,0
139690,6,6,0,0,6,0
139690,1,1,0,0,1,0
219988,6,9,0,0,9,0
3229,10,1,0,0,1,0
3229,5,4,0,0,4,0
5254,10,1,0,0,1,0
5254,8,1,0,0,1,0
5254,7,2,0,0,2,0
5254,6,5,0,0,5,0
5019,3,1,0,0,1,0
5019,2,1,0,0,1,0
254546,8,8,0,0,8,0
254546,7,7,0,0,7,0
254546,4,3,0,0,3,0
254546,2,1,0,0,1,0
254546,1,1,0,0,1,0
229408,2,1,0,0,1,0
229408,1,2,0,0,2,0
192409,10,1,0,0,1,0
192409,4,12,0,0,12,0
192409,3,2,0,0,2,0
192409,1,1,0,0,1,0
11011,9,1,0,0,1,0
147919,6,2,0,0,2,0
147919,1,1,0,0,1,0
96342,10,2,0,0,2,0
96342,8,9,0,0,9,0
96342,5,9,0,0,9,0
96342,4,3,0,0,3,0
96342,2,1,0,0,1,0
36777,8,1,0,0,1,0
36777,7,3,0,0,3,0
36777,2,1,0,0,1,0
15269,9,1,0,0,1,0
15269,3,2,0,0,2,0
176936,10,2,0,0,2,0
176936,4,1,0,0,1,0
179718,10,1,0,0,1,0
179718,7,6,0,0,6,0
179718,5,6,0,0,6,0
33701,10,1,0,0,1,0
33701,9,2,0,0,2,0
33701,8,3,0,0,3,0
5463,7,5,0,0,5,0
106523,9,5,0,0,5,0
106523,4,2,0,0,2,0
106523,3,2,0,0,2,0
231315,10,2,0,0,2,0
231315,9,2,0,0,2,0
231315,3,1,0,0,1,0
5231,8,3,0,0,3,0
148522,9,2,0,0,2,0
148522,8,6,0,0,6,0
148522,1,2,0,0,2,0
2532,9,2,0,0,2,0
2532,5,3,0,0,3,0
131304,9,1,0,0,1,0
131304,8,3,0,0,3,0
131304,5,10,0,0,10,0
131304,3,2,0,0,2,0
44125,4,1,0,0,1,0
165283,10,1,0,0,1,0
165283,8,1,0,0,1,0
165283,4,8,0,0,8,0
165283,3,4,0,0,4,0
4834,10,1,0,0,1,0
126119,10,4,0,0,4,0
126119,9,14,0,0,14,0
126119,1,1,0,0,1,0
117975,10,1,0,0,1,0
117975,9,2,0,0,2,0
1045,4,4,0,0,4,0
175497,2,2,0,0,2,0
140988,10,2,0,0,2,0
140988,8,2,0,0,2,0
140988,5,5,0,0,5,0
144417,10,2,0,0,2,0
144417,8,6,0,0,6,0
144417,4,3,0,0,3,0
144417,2,2,0,0,2,0
88556,10,2,0,0,2,0
15195,10,1,0,0,1,0
15195,9,1,0,0,1,0
15195,7,3,0,0,3,0
15195,1,1,0,0,1,0
180205,10,1,0,0,1,0
180205,9,2,0,0,2,0
36339,7,9,0,0,9,0
36339,1,1,0,0,1,0
14253,10,1,0,0,1,0
149286,7,11,0,0,11,0
149286,1,1,0,0,1,0
40654,2,1,0,0,1,0
138206,10,1,0,0,1,0
138206,8,6,0,0,6,0
138206,7,8,0,0,8,0
152345,10,6,0,0,6,0
152345,1,1,0,0,1,0
19127,10,3,0,0,3,0
32907,10,3,0,0,3,0
189520,10,1,0,0,1,0
189520,9,1,0,0,1,0
189520,8,4,0,0,4,0
189520,3,4,0,0,4,0
189520,2,2,0,0,2,0
189520,1,1,0,0,1,0
182214,8,11,0,0,11,0
182214,5,3,0,0,3,0
182214,1,1,0,0,1,0
163798,5,5,0,0,5,0
163798,4,1,0,0,1,0
1401,2,1,0,0,1,0
15527,7,7,0,0,7,0
15527,4,4,0,0,4,0
15527,3,2,0,0,2,0
15527,2,1,0,0,1,0
15527,1,1,0,0,1,0
90972,10,2,0,0,2,0
90972,2,1,0,0,1,0
14705,8,1,0,0,1,0
14705,7,5,0,0,5,0
14705,2,3,0,0,3,0
226170,10,2,0,0,2,0
226170,9,8,0,0,8,0
226170,6,2,0,0,2,0
226170,5,3,0,0,3,0
34377,6,10,0,0,10,0
34377,1,1,0,0,1,0
194234,10,4,0,0,4,0
194234,4,2,0,0,2,0
178028,9,1,0,0,1,0
178028,8,2,0,0,2,0
178028,2,1,0,0,1,0
155943,7,5,0,0,5,0
109827,9,1,0,0,1,0
109827,4,1,0,0,1,0
2178,7,6,0,0,6,0
2178,5,13,0,0,13,0
2178,4,8,0,0,8,0
177861,6,3,0,0,3,0
177861,2,1,0,0,1,0
177861,1,1,0,0,1,0
18531,5,5,0,0,5,0
18531,3,1,0,0,1,0
16793,6,5,0,0,5,0
16793,5,2,0,0,2,0
158604,10,1,0,0,1,0
158604,5,5,0,0,5,0
150162,10,1,0,0,1,0
150162,8,3,0,0,3,0
150162,7,1,0,0,1,0
150162,4,6,0,0,6,0
150162,1,1,0,0,1,0
3693,9,1,0,0,1,0
3693,5,10,0,0,10,0
233932,5,1,0,0,1,0
233932,4,1,0,0,1,0
233932,3,1,0,0,1,0
21788,8,1,0,0,1,0
21788,4,7,0,0,7,0
21788,3,3,0,0,3,0
21788,2,1,0,0,1,0
136085,4,4,0,0,4,0
3514,10,1,0,0,1,0
3514,9,1,0,0,1,0
3514,2,2,0,0,2,0
8033,4,1,0,0,1,0
225313,9,1,0,0,1,0
225313,8,1,0,0,1,0
225313,6,15,0,0,15,0
225313,3,7,0,0,7,0
225313,2,1,0,0,1,0
137912,10,1,0,0,1,0
137912,5,4,0,0,4,0
137912,4,1,0,0,1,0
131956,10,2,0,0,2,0
131956,9,1,0,0,1,0
131956,7,2,0,0,2,0
131956,4,6,0,0,6,0
3759,8,1,0,0,1,0
3753,4,5,0,0,5,0
10104,9,1,0,0,1,0
1242,9,2,0,0,2,0
8024,8,1,0,0,1,0
147352,10,1,0,0,1,0
147352,9,3,0,0,3,0
147352,8,7,0,0,7,0
147352,4,1,0,0,1,0
147352,3,2,0,0,2,0
261145,10,5,0,0,5,0
261145,7,8,0,0,8,0
261145,6,1,0,0,1,0
261145,5,3,0,0,3,0
39663,5,2,0,0,2,0
860,10,2,0,0,2,0
860,8,3,0,0,3,0
860,3,1,0,0,1,0
207378,4,1,0,0,1,0
19842,7,4,0,0,4,0
154009,1,2,0,0,2,0
62633,8,7,0,0,7,0
62633,1,2,0,0,2,0
3745,3,3,0,0,3,0
3745,1,1,0,0,1,0
21866,1,1,0,0,1,0
128635,9,1,0,0,1,0
128635,8,4,0,0,4,0
128635,5,4,0,0,4,0
128635,1,1,0,0,1,0
191178,10,3,0,0,3,0
191178,8,8,0,0,8,0
191178,5,3,0,0,3,0
191178,4,1,0,0,1,0
191178,3,1,0,0,1,0
191178,2,1,0,0,1,0
10718,10,3,0,0,3,0
10718,1,1,0,0,1,0
6869,9,2,0,0,2,0
6869,3,1,0,0,1,0
6869,2,2,0,0,2,0
28565,9,2,0,0,2,0
28565,5,6,0,0,6,0
28565,4,3,0,0,3,0
254188,9,3,0,0,3,0
254188,5,4,0,0,4,0
254188,4,1,0,0,1,0
254188,2,1,0,0,1,0
3894,10,1,0,0,1,0
3894,8,5,0,0,5,0
3894,3,1,0,0,1,0
3894,2,1,0,0,1,0
1909,7,7,0,0,7,0
1909,5,9,0,0,9,0
127650,10,2,0,0,2,0
127650,3,1,0,0,1,0
136813,10,4,0,0,4,0
136813,9,3,0,0,3,0
136813,8,14,0,0,14,0
136813,7,10,0,0,10,0
136813,6,13,0,0,13,0
136813,5,2,0,0,2,0
136813,3,1,0,0,1,0
136813,2,1,0,0,1,0
6978,10,2,0,0,2,0
6447,7,1,0,0,1,0
6447,6,2,0,0,2,0
6447,5,1,0,0,1,0
153470,2,1,0,0,1,0
195163,4,1,0,0,1,0
195163,3,1,0,0,1,0
195163,1,1,0,0,1,0
2527,8,3,0,0,3,0
3552,8,2,0,0,2,0
3552,5,6,0,0,6,0
3552,2,1,0,0,1,0
11135,10,1,0,0,1,0
11407,8,2,0,0,2,0
11407,3,4,0,0,4,0
173931,9,1,0,0,1,0
173931,5,4,0,0,4,0
223454,4,2,0,0,2,0
223454,3,1,0,0,1,0
13614,10,2,0,0,2,0
13614,2,1,0,0,1,0
178038,9,1,0,0,1,0
178038,8,2,0,0,2,0
178038,7,12,0,0,12,0
178038,5,6,0,0,6,0
178038,4,4,0,0,4,0
178038,1,1,0,0,1,0
118325,9,1,0,0,1,0
118325,8,6,0,0,6,0
118325,4,7,0,0,7,0
88521,8,1,0,0,1,0
776,3,1,0,0,1,0
776,1,2,0,0,2,0
8788,10,1,0,0,1,0
8788,9,2,0,0,2,0
8788,8,2,0,0,2,0
14387,4,1,0,0,1,0
21036,4,2,0,0,2,0
21036,1,2,0,0,2,0
132261,5,4,0,0,4,0
132261,3,1,0,0,1,0
132261,2,1,0,0,1,0
13495,6,11,0,0,11,0
13495,3,5,0,0,5,0
13495,2,1,0,0,1,0
10533,10,1,0,0,1,0
137047,4,1,0,0,1,0
137047,2,1,0,0,1,0
230570,9,2,0,0,2,0
230570,3,1,0,0,1,0
230570,2,1,0,0,1,0
6476,9,1,0,0,1,0
6476,5,2,0,0,2,0
6476,3,1,0,0,1,0
244584,10,1,0,0,1,0
244584,9,1,0,0,1,0
244584,3,2,0,0,2,0
244584,2,1,0,0,1,0
6939,10,1,0,0,1,0
6939,9,1,0,0,1,0
6939,4,1,0,0,1,0
120444,10,1,0,0,1,0
39067,10,2,0,0,2,0
5515,9,1,0,0,1,0
16719,9,1,0,0,1,0
16719,8,3,0,0,3,0
16719,7,15,0,0,15,0
16719,5,2,0,0,2,0
16719,4,1,0,0,1,0
239621,10,2,0,0,2,0
239621,7,7,0,0,7,0
239621,2,1,0,0,1,0
146762,1,1,0,0,1,0
11581,3,1,0,0,1,0
36510,10,3,0,0,3,0
36510,1,1,0,0,1,0
105550,8,2,0,0,2,0
105550,5,9,0,0,9,0
105550,4,3,0,0,3,0
234052,10,5,0,0,5,0
234052,9,1,0,0,1,0
234052,3,3,0,0,3,0
171665,9,1,0,0,1,0
171665,5,6,0,0,6,0
171665,3,2,0,0,2,0
110570,8,9,0,0,9,0
110570,5,5,0,0,5,0
183716,9,2,0,0,2,0
183716,5,3,0,0,3,0
183716,3,1,0,0,1,0
7795,10,2,0,0,2,0
241731,3,2,0,0,2,0
241731,2,1,0,0,1,0
218905,5,3,0,0,3,0
218905,4,1,0,0,1,0
218905,3,2,0,0,2,0
42336,10,1,0,0,1,0
42336,9,2,0,0,2,0
5343,10,1,0,0,1,0
5343,4,3,0,0,3,0
5343,3,1,0,0,1,0
5343,2,1,0,0,1,0
7230,8,1,0,0,1,0
7230,4,3,0,0,3,0
7230,3,2,0,0,2,0
7230,1,1,0,0,1,0
147251,10,1,0,0,1,0
147251,3,1,0,0,1,0
147251,2,1,0,0,1,0
167723,3,1,0,0,1,0
167723,2,3,0,0,3,0
125436,8,5,0,0,5,0
125436,4,4,0,0,4,0
125436,3,1,0,0,1,0
125436,2,1,0,0,1,0
129314,10,1,0,0,1,0
129314,4,2,0,0,2,0
9062,10,1,0,0,1,0
9062,9,1,0,0,1,0
9062,5,5,0,0,5,0
36612,10,1,0,0,1,0
100275,5,2,0,0,2,0
10221,8,5,0,0,5,0
10221,4,2,0,0,2,0
8990,10,1,0,0,1,0
8990,9,5,0,0,5,0
8754,10,2,0,0,2,0
151191,4,7,0,0,7,0
155836,10,1,0,0,1,0
155836,5,13,0,0,13,0
155836,3,1,0,0,1,0
210065,9,2,0,0,2,0
210065,4,5,0,0,5,0
5279,10,2,0,0,2,0
5279,5,4,0,0,4,0
12319,3,1,0,0,1,0
164600,7,2,0,0,2,0
164600,5,5,0,0,5,0
164600,3,1,0,0,1,0
123930,10,1,0,0,1,0
123930,9,1,0,0,1,0
123930,4,4,0,0,4,0
123930,2,2,0,0,2,0
246689,10,3,0,0,3,0
246689,5,2,0,0,2,0
246689,2,1,0,0,1,0
246689,1,1,0,0,1,0
172509,10,2,0,0,2,0
172509,5,6,0,0,6,0
172509,4,1,0,0,1,0
166341,4,1,0,0,1,0
166341,1,1,0,0,1,0
229736,10,3,0,0,3,0
229736,9,2,0,0,2,0
229736,8,4,0,0,4,0
229736,5,7,0,0,7,0
229736,3,2,0,0,2,0
229736,2,1,0,0,1,0
170568,10,2,0,0,2,0
170568,9,4,0,0,4,0
170568,7,13,0,0,13,0
170568,4,1,0,0,1,0
111327,8,5,0,0,5,0
111327,7,4,0,0,4,0
111327,4,3,0,0,3,0
76444,10,1,0,0,1,0
76444,9,1,0,0,1,0
76444,8,1,0,0,1,0
76444,7,2,0,0,2,0
205604,7,7,0,0,7,0
205604,2,1,0,0,1,0
205604,1,1,0,0,1,0
18590,5,1,0,0,1,0
18590,2,1,0,0,1,0
252576,10,2,0,0,2,0
252576,3,1,0,0,1,0
7488,8,1,0,0,1,0
7488,3,3,0,0,3,0
187347,5,4,0,0,4,0
187347,3,2,0,0,2,0
187347,1,2,0,0,2,0
147581,2,2,0,0,2,0
147581,1,2,0,0,2,0
101954,8,2,0,0,2,0
101954,3,3,0,0,3,0
91197,8,3,0,0,3,0
91197,4,3,0,0,3,0
247199,10,1,0,0,1,0
247199,9,3,0,0,3,0
247199,8,6,0,0,6,0
247199,7,14,0,0,14,0
247199,5,3,0,0,3,0
247199,3,2,0,0,2,0
247199,2,1,0,0,1,0
232950,4,2,0,0,2,0
232950,2,2,0,0,2,0
9345,9,1,0,0,1,0
9345,4,3,0,0,3,0
9345,2,1,0,0,1,0
13010,8,4,0,0,4,0
113971,1,1,0,0,1,0
49399,10,3,0,0,3,0
49399,8,9,0,0,9,0
49399,5,3,0,0,3,0
49399,4,2,0,0,2,0
111802,10,2,0,0,2,0
173302,9,5,0,0,5,0
173302,5,4,0,0,4,0
173302,3,2,0,0,2,0
15613,9,3,0,0,3,0
15613,8,2,0,0,2,0
198825,10,2,0,0,2,0
198825,7,8,0,0,8,0
198825,2,1,0,0,1,0
178937,10,1,0,0,1,0
178937,9,1,0,0,1,0
178937,8,3,0,0,3,0
178937,3,2,0,0,2,0
178937,1,2,0,0,2,0
65087,10,3,0,0,3,0
65087,9,3,0,0,3,0
98931,10,2,0,0,2,0
98931,3,1,0,0,1,0
2920,6,5,0,0,5,0
8852,10,1,0,0,1,0
8852,7,3,0,0,3,0
30760,10,1,0,0,1,0
30760,8,1,0,0,1,0
257283,8,6,0,0,6,0
257283,6,3,0,0,3,0
257283,4,1,0,0,1,0
255680,10,3,0,0,3,0
255680,3,1,0,0,1,0
24069,9,1,0,0,1,0
24069,8,5,0,0,5,0
24069,2,2,0,0,2,0
24069,1,1,0,0,1,0
11413,8,1,0,0,1,0
11413,3,1,0,0,1,0
11413,2,1,0,0,1,0
147396,9,1,0,0,1,0
147396,4,2,0,0,2,0
147396,2,2,0,0,2,0
113311,7,5,0,0,5,0
113311,2,2,0,0,2,0
17482,5,3,0,0,3,0
17482,3,2,0,0,2,0
17482,1,1,0,0,1,0
9589,2,1,0,0,1,0
234920,10,1,0,0,1,0
5517,9,1,0,0,1,0
5517,8,2,0,0,2,0
5517,3,3,0,0,3,0
5517,2,1,0,0,1,0
21095,7,2,0,0,2,0
21095,1,1,0,0,1,0
10033,10,5,0,0,5,0
10033,2,1,0,0,1,0
2415,10,1,0,0,1,0
173899,9,1,0,0,1,0
173899,7,4,0,0,4,0
173899,2,3,0,0,3,0
231573,5,1,0,0,1,0
5433,10,1,0,0,1,0
5433,7,1,0,0,1,0
5433,2,1,0,0,1,0
121715,10,4,0,0,4,0
121715,9,3,0,0,3,0
121715,5,5,0,0,5,0
135598,9,1,0,0,1,0
135598,8,6,0,0,6,0
135598,7,11,0,0,11,0
135598,3,2,0,0,2,0
135598,2,1,0,0,1,0
4894,10,1,0,0,1,0
4894,4,3,0,0,3,0
63868,5,2,0,0,2,0
63868,3,1,0,0,1,0
205039,10,4,0,0,4,0
205039,5,3,0,0,3,0
205039,4,1,0,0,1,0
205039,1,1,0,0,1,0
206591,6,6,0,0,6,0
206591,4,1,0,0,1,0
203265,10,1,0,0,1,0
203265,8,5,0,0,5,0
203265,1,2,0,0,2,0
103327,3,2,0,0,2,0
99310,10,3,0,0,3,0
99310,4,2,0,0,2,0
24024,10,2,0,0,2,0
243707,10,1,0,0,1,0
243707,8,4,0,0,4,0
207653,7,9,0,0,9,0
207653,4,1,0,0,1,0
172580,9,1,0,0,1,0
172580,6,7,0,0,7,0
172580,5,4,0,0,4,0
37103,4,3,0,0,3,0
11862,7,2,0,0,2,0
11862,5,2,0,0,2,0
5566,7,3,0,0,3,0
249289,9,2,0,0,2,0
249289,3,1,0,0,1,0
249289,2,2,0,0,2,0
32410,8,5,0,0,5,0
32410,7,9,0,0,9,0
32410,4,3,0,0,3,0
32410,2,1,0,0,1,0
40198,9,1,0,0,1,0
40198,5,4,0,0,4,0
40198,3,5,0,0,5,0
40198,2,1,0,0,1,0
40198,1,1,0,0,1,0
110643,6,2,0,0,2,0
110643,3,1,0,0,1,0
260799,9,3,0,0,3,0
260799,5,4,0,0,4,0
260799,4,2,0,0,2,0
38464,8,3,0,0,3,0
18613,4,4,0,0,4,0
66809,5,2,0,0,2,0
66809,4,1,0,0,1,0
3016,10,2,0,0,2,0
3016,2,1,0,0,1,0
172506,10,1,0,0,1,0
172506,8,1,0,0,1,0
172506,2,1,0,0,1,0
172506,1,2,0,0,2,0
30022,4,1,0,0,1,0
10880,4,3,0,0,3,0
10880,3,1,0,0,1,0
10880,2,1,0,0,1,0
138091,10,1,0,0,1,0
138091,4,4,0,0,4,0
138091,1,1,0,0,1,0
180050,8,17,0,0,17,0
180050,1,2,0,0,2,0
1640,8,1,0,0,1,0
1640,2,2,0,0,2,0
20224,10,1,0,0,1,0
20224,9,1,0,0,1,0
20224,7,5,0,0,5,0
142277,7,13,0,0,13,0
142277,5,4,0,0,4,0
142277,2,1,0,0,1,0
26372,10,3,0,0,3,0
26372,5,1,0,0,1,0
11452,9,1,0,0,1,0
11452,4,1,0,0,1,0
3302,9,2,0,0,2,0
3302,8,3,0,0,3,0
3302,7,3,0,0,3,0
3302,5,8,0,0,8,0
3302,1,2,0,0,2,0
209095,9,1,0,0,1,0
209095,7,6,0,0,6,0
209095,4,2,0,0,2,0
209095,3,1,0,0,1,0
209095,2,1,0,0,1,0
373,9,2,0,0,2,0
140702,9,2,0,0,2,0
140702,7,7,0,0,7,0
140702,5,6,0,0,6,0
140702,3,5,0,0,5,0
140702,2,1,0,0,1,0
261393,8,3,0,0,3,0
261393,5,1,0,0,1,0
261393,2,1,0,0,1,0
10811,2,1,0,0,1,0
177502,7,5,0,0,5,0
177502,3,3,0,0,3,0
177502,2,2,0,0,2,0
192203,9,4,0,0,4,0
192203,3,2,0,0,2,0
36751,10,2,0,0,2,0
36751,9,2,0,0,2,0
36751,8,3,0,0,3,0
36751,4,3,0,0,3,0
36751,2,1,0,0,1,0
184688,10,1,0,0,1,0
184688,9,3,0,0,3,0
184688,5,6,0,0,6,0
184688,3,1,0,0,1,0
184688,2,1,0,0,1,0
14897,10,1,0,0,1,0
14897,9,1,0,0,1,0
14897,2,1,0,0,1,0
5818,4,1,0,0,1,0
11673,10,1,0,0,1,0
129315,10,2,0,0,2,0
129315,3,2,0,0,2,0
217261,9,5,0,0,5,0
217261,7,21,0,0,21,0
192858,2,1,0,0,1,0
192858,1,1,0,0,1,0
11126,9,1,0,0,1,0
11126,4,2,0,0,2,0
256536,3,1,0,0,1,0
3130,3,1,0,0,1,0
3130,2,1,0,0,1,0
7143,9,2,0,0,2,0
18780,8,5,0,0,5,0
18780,4,5,0,0,5,0
8366,2,1,0,0,1,0
250309,9,5,0,0,5,0
250309,3,1,0,0,1,0
136086,9,1,0,0,1,0
136086,8,5,0,0,5,0
136086,6,21,0,0,21,0
136086,4,3,0,0,3,0
136086,3,1,0,0,1,0
136086,1,1,0,0,1,0
154098,4,1,0,0,1,0
154098,1,1,0,0,1,0
11616,10,1,0,0,1,0
11616,2,3,0,0,3,0
11873,10,1,0,0,1,0
4171,10,2,0,0,2,0
4171,8,5,0,0,5,0
4171,2,1,0,0,1,0
4171,1,1,0,0,1,0
170984,10,2,0,0,2,0
170984,5,4,0,0,4,0
170984,3,1,0,0,1,0
170984,1,2,0,0,2,0
10544,8,1,0,0,1,0
10544,7,6,0,0,6,0
31067,5,4,0,0,4,0
31067,4,1,0,0,1,0
31067,1,1,0,0,1,0
179227,10,2,0,0,2,0
179227,9,1,0,0,1,0
179227,3,4,0,0,4,0
135213,9,3,0,0,3,0
135213,8,1,0,0,1,0
135213,5,5,0,0,5,0
135213,4,2,0,0,2,0
135213,3,2,0,0,2,0
135213,2,2,0,0,2,0
109635,10,3,0,0,3,0
109635,5,1,0,0,1,0
98780,9,2,0,0,2,0
98780,2,1,0,0,1,0
23285,10,1,0,0,1,0
23285,1,1,0,0,1,0
27949,2,2,0,0,2,0
37444,5,2,0,0,2,0
37444,4,2,0,0,2,0
133687,8,4,0,0,4,0
133687,7,5,0,0,5,0
133687,2,2,0,0,2,0
195161,3,6,0,0,6,0
195161,2,2,0,0,2,0
195161,1,1,0,0,1,0
22469,8,1,0,0,1,0
22469,3,1,0,0,1,0
137332,4,2,0,0,2,0
137332,3,1,0,0,1,0
137332,2,1,0,0,1,0
137332,1,1,0,0,1,0
20514,4,1,0,0,1,0
13165,9,1,0,0,1,0
13165,8,1,0,0,1,0
13165,3,6,0,0,6,0
227468,10,1,0,0,1,0
227468,9,3,0,0,3,0
227468,7,8,0,0,8,0
227468,1,1,0,0,1,0
191714,9,1,0,0,1,0
191714,3,5,0,0,5,0
191714,2,1,0,0,1,0
191714,1,1,0,0,1,0
10246,4,2,0,0,2,0
7808,4,5,0,0,5,0
7808,3,1,0,0,1,0
7808,2,1,0,0,1,0
6233,2,2,0,0,2,0
11030,4,3,0,0,3,0
206753,8,2,0,0,2,0
206753,4,5,0,0,5,0
206753,3,1,0,0,1,0
206753,1,1,0,0,1,0
126234,8,3,0,0,3,0
144378,6,11,0,0,11,0
144378,3,1,0,0,1,0
238182,6,3,0,0,3,0
238182,5,1,0,0,1,0
3109,10,2,0,0,2,0
3109,3,1,0,0,1,0
5276,9,2,0,0,2,0
22931,9,1,0,0,1,0
22931,8,1,0,0,1,0
22931,1,3,0,0,3,0
196328,10,1,0,0,1,0
196328,3,1,0,0,1,0
57276,10,1,0,0,1,0
57276,9,1,0,0,1,0
57276,8,2,0,0,2,0
57276,4,4,0,0,4,0
57276,3,4,0,0,4,0
57276,2,1,0,0,1,0
57276,1,2,0,0,2,0
39320,9,1,0,0,1,0
39320,7,3,0,0,3,0
39320,1,1,0,0,1,0
220730,10,2,0,0,2,0
220730,9,2,0,0,2,0
220730,3,1,0,0,1,0
198886,1,1,0,0,1,0
195508,9,4,0,0,4,0
195508,6,3,0,0,3,0
5435,3,1,0,0,1,0
229496,7,7,0,0,7,0
2299,5,2,0,0,2,0
2299,4,4,0,0,4,0
2299,1,2,0,0,2,0
6949,9,2,0,0,2,0
33198,8,1,0,0,1,0
33198,6,6,0,0,6,0
33198,4,12,0,0,12,0
33198,2,8,0,0,8,0
33198,1,4,0,0,4,0
200396,10,1,0,0,1,0
200396,8,4,0,0,4,0
200396,4,2,0,0,2,0
200396,3,1,0,0,1,0
93463,9,2,0,0,2,0
93463,8,3,0,0,3,0
93463,4,3,0,0,3,0
93463,2,3,0,0,3,0
61996,3,1,0,0,1,0
28596,2,1,0,0,1,0
5389,10,1,0,0,1,0
5389,5,4,0,0,4,0
9507,10,1,0,0,1,0
9507,7,7,0,0,7,0
43233,3,5,0,0,5,0
43233,2,4,0,0,4,0
183677,5,2,0,0,2,0
183677,1,1,0,0,1,0
12624,9,1,0,0,1,0
12624,2,5,0,0,5,0
9356,10,4,0,0,4,0
9356,4,2,0,0,2,0
40617,8,5,0,0,5,0
40617,5,9,0,0,9,0
40617,3,3,0,0,3,0
242616,9,3,0,0,3,0
242616,4,1,0,0,1,0
137014,7,7,0,0,7,0
137014,6,11,0,0,11,0
137014,2,3,0,0,3,0
158341,10,2,0,0,2,0
158341,5,6,0,0,6,0
158341,4,3,0,0,3,0
158341,2,1,0,0,1,0
18618,8,1,0,0,1,0
18618,7,6,0,0,6,0
18618,3,4,0,0,4,0
18618,2,2,0,0,2,0
8834,10,1,0,0,1,0
8834,6,6,0,0,6,0
8834,4,1,0,0,1,0
63823,10,3,0,0,3,0
63823,7,12,0,0,12,0
17529,2,1,0,0,1,0
18908,10,1,0,0,1,0
18908,7,9,0,0,9,0
137958,9,9,0,0,9,0
137958,7,3,0,0,3,0
137958,6,4,0,0,4,0
137958,4,1,0,0,1,0
137958,3,1,0,0,1,0
35425,10,2,0,0,2,0
88113,7,12,0,0,12,0
3425,9,1,0,0,1,0
3425,8,1,0,0,1,0
3425,7,4,0,0,4,0
3425,1,1,0,0,1,0
127505,10,2,0,0,2,0
127505,8,4,0,0,4,0
127505,2,2,0,0,2,0
42591,10,1,0,0,1,0
42591,3,1,0,0,1,0
4885,2,2,0,0,2,0
244327,10,1,0,0,1,0
244327,3,1,0,0,1,0
125400,10,1,0,0,1,0
125400,9,1,0,0,1,0
159573,5,9,0,0,9,0
159573,3,1,0,0,1,0
28050,8,1,0,0,1,0
179560,10,2,0,0,2,0
179560,9,2,0,0,2,0
179560,8,10,0,0,10,0
179560,7,5,0,0,5,0
179560,5,2,0,0,2,0
179560,4,6,0,0,6,0
9646,8,2,0,0,2,0
9022,8,2,0,0,2,0
247578,10,2,0,0,2,0
247578,7,11,0,0,11,0
247578,5,1,0,0,1,0
90004,9,2,0,0,2,0
90004,7,10,0,0,10,0
90004,5,7,0,0,7,0
9153,10,3,0,0,3,0
9153,7,2,0,0,2,0
9153,2,1,0,0,1,0
4654,2,1,0,0,1,0
19272,8,1,0,0,1,0
19272,7,1,0,0,1,0
19272,6,3,0,0,3,0
19272,1,3,0,0,3,0
143238,9,1,0,0,1,0
143238,2,1,0,0,1,0
24706,9,2,0,0,2,0
174404,9,1,0,0,1,0
174404,8,2,0,0,2,0
174404,7,9,0,0,9,0
174404,3,1,0,0,1,0
19253,10,3,0,0,3,0
166443,10,1,0,0,1,0
166443,9,3,0,0,3,0
37379,4,6,0,0,6,0
37379,2,2,0,0,2,0
254145,9,2,0,0,2,0
254145,8,7,0,0,7,0
254145,5,12,0,0,12,0
254145,3,1,0,0,1,0
254145,2,1,0,0,1,0
156015,9,1,0,0,1,0
156015,5,10,0,0,10,0
156015,3,2,0,0,2,0
156015,2,2,0,0,2,0
186510,10,4,0,0,4,0
186510,4,4,0,0,4,0
186510,3,1,0,0,1,0
186510,2,2,0,0,2,0
88996,3,3,0,0,3,0
17538,10,5,0,0,5,0
17538,4,2,0,0,2,0
238700,8,10,0,0,10,0
238700,6,9,0,0,9,0
238700,5,5,0,0,5,0
238700,4,1,0,0,1,0
238700,2,1,0,0,1,0
3018,10,1,0,0,1,0
3018,9,1,0,0,1,0
11476,10,1,0,0,1,0
11476,9,1,0,0,1,0
24189,8,3,0,0,3,0
64769,4,4,0,0,4,0
54501,10,2,0,0,2,0
54501,8,8,0,0,8,0
54501,4,2,0,0,2,0
54501,3,3,0,0,3,0
22042,7,1,0,0,1,0
13771,10,1,0,0,1,0
13771,9,1,0,0,1,0
13771,4,4,0,0,4,0
150659,10,3,0,0,3,0
150659,9,1,0,0,1,0
150659,8,3,0,0,3,0
150659,1,2,0,0,2,0
15275,10,2,0,0,2,0
10836,2,2,0,0,2,0
271869,10,1,0,0,1,0
271869,2,1,0,0,1,0
5204,8,1,0,0,1,0
1500,9,1,0,0,1,0
1500,8,4,0,0,4,0
168662,5,1,0,0,1,0
8363,10,2,0,0,2,0
4022,3,3,0,0,3,0
139374,10,1,0,0,1,0
139374,9,1,0,0,1,0
139374,7,12,0,0,12,0
139374,4,3,0,0,3,0
139374,3,2,0,0,2,0
139374,2,2,0,0,2,0
26540,3,3,0,0,3,0
134419,10,2,0,0,2,0
134419,9,5,0,0,5,0
134419,5,1,0,0,1,0
154645,10,1,0,0,1,0
154645,9,2,0,0,2,0
30020,9,3,0,0,3,0
30020,3,1,0,0,1,0
171124,5,1,0,0,1,0
171124,3,2,0,0,2,0
2232,4,1,0,0,1,0
143663,3,1,0,0,1,0
203266,9,2,0,0,2,0
203266,7,9,0,0,9,0
203266,4,5,0,0,5,0
203266,1,1,0,0,1,0
41305,9,2,0,0,2,0
41305,4,2,0,0,2,0
41305,2,1,0,0,1,0
262899,10,1,0,0,1,0
262899,5,4,0,0,4,0
262899,3,2,0,0,2,0
262899,1,2,0,0,2,0
1226,9,1,0,0,1,0
10890,7,15,0,0,15,0
10890,5,3,0,0,3,0
10890,3,1,0,0,1,0
10890,1,1,0,0,1,0
33125,9,1,0,0,1,0
33125,7,5,0,0,5,0
33125,5,3,0,0,3,0
25866,10,1,0,0,1,0
25866,3,1,0,0,1,0
4579,10,1,0,0,1,0
4579,9,1,0,0,1,0
4579,8,3,0,0,3,0
33421,9,3,0,0,3,0
33421,8,5,0,0,5,0
33421,5,4,0,0,4,0
194231,10,1,0,0,1,0
194231,9,5,0,0,5,0
194231,8,4,0,0,4,0
194231,7,12,0,0,12,0
194231,3,3,0,0,3,0
11258,8,2,0,0,2,0
11258,1,1,0,0,1,0
22123,9,1,0,0,1,0
22123,4,1,0,0,1,0
22123,2,2,0,0,2,0
231620,7,7,0,0,7,0
231620,4,4,0,0,4,0
231620,3,3,0,0,3,0
231620,2,1,0,0,1,0
66969,4,3,0,0,3,0
66969,3,2,0,0,2,0
66969,2,1,0,0,1,0
1368,3,2,0,0,2,0
1368,1,1,0,0,1,0
11200,10,1,0,0,1,0
11200,8,1,0,0,1,0
11200,2,1,0,0,1,0
152245,10,1,0,0,1,0
152245,1,2,0,0,2,0
246,1,2,0,0,2,0
9082,9,2,0,0,2,0
29694,9,1,0,0,1,0
173269,10,2,0,0,2,0
173269,9,2,0,0,2,0
173269,6,3,0,0,3,0
173269,5,1,0,0,1,0
98978,10,1,0,0,1,0
98978,8,3,0,0,3,0
98978,3,1,0,0,1,0
98978,1,1,0,0,1,0
125013,8,2,0,0,2,0
125013,3,3,0,0,3,0
125013,2,2,0,0,2,0
90274,3,1,0,0,1,0
184490,6,14,0,0,14,0
110245,9,3,0,0,3,0
110245,5,5,0,0,5,0
103752,10,4,0,0,4,0
103752,5,4,0,0,4,0
10889,4,1,0,0,1,0
34395,9,1,0,0,1,0
34395,7,3,0,0,3,0
34395,6,7,0,0,7,0
34395,1,2,0,0,2,0
173514,9,2,0,0,2,0
173514,8,4,0,0,4,0
173514,7,1,0,0,1,0
173514,6,1,0,0,1,0
6759,2,1,0,0,1,0
601,4,6,0,0,6,0
6842,10,1,0,0,1,0
6842,9,1,0,0,1,0
6842,2,1,0,0,1,0
247526,10,1,0,0,1,0
247526,3,1,0,0,1,0
247526,2,1,0,0,1,0
31360,9,2,0,0,2,0
31360,1,1,0,0,1,0
5798,8,1,0,0,1,0
5798,1,1,0,0,1,0
54707,6,17,0,0,17,0
54707,3,1,0,0,1,0
54707,2,1,0,0,1,0
9249,9,1,0,0,1,0
9249,8,2,0,0,2,0
9249,7,4,0,0,4,0
9249,4,9,0,0,9,0
13979,10,1,0,0,1,0
13979,4,3,0,0,3,0
13979,3,1,0,0,1,0
34692,4,1,0,0,1,0
34692,3,1,0,0,1,0
262621,6,6,0,0,6,0
262621,3,1,0,0,1,0
61475,5,13,0,0,13,0
61475,2,1,0,0,1,0
165414,8,3,0,0,3,0
165414,7,8,0,0,8,0
165414,5,9,0,0,9,0
165414,2,1,0,0,1,0
123417,8,2,0,0,2,0
123417,5,10,0,0,10,0
123417,2,3,0,0,3,0
52276,4,6,0,0,6,0
52276,3,2,0,0,2,0
175864,3,1,0,0,1,0
175864,1,1,0,0,1,0
236905,3,1,0,0,1,0
39515,8,13,0,0,13,0
39515,5,2,0,0,2,0
4693,8,1,0,0,1,0
4693,5,6,0,0,6,0
4693,1,2,0,0,2,0
217609,1,1,0,0,1,0
27751,4,3,0,0,3,0
27751,1,1,0,0,1,0
35262,8,4,0,0,4,0
35262,7,6,0,0,6,0
35262,4,5,0,0,5,0
35262,2,1,0,0,1,0
35262,1,1,0,0,1,0
129031,9,6,0,0,6,0
129031,8,6,0,0,6,0
129031,5,4,0,0,4,0
129031,4,1,0,0,1,0
129031,3,2,0,0,2,0
226997,10,3,0,0,3,0
177566,5,3,0,0,3,0
8249,10,1,0,0,1,0
8249,8,1,0,0,1,0
4456,8,1,0,0,1,0
167185,9,1,0,0,1,0
167185,8,6,0,0,6,0
167185,5,3,0,0,3,0
167185,4,3,0,0,3,0
12280,5,10,0,0,10,0
12280,4,3,0,0,3,0
12280,3,2,0,0,2,0
5804,10,1,0,0,1,0
11477,10,2,0,0,2,0
33875,7,13,0,0,13,0
33875,5,6,0,0,6,0
230542,9,1,0,0,1,0
230542,7,4,0,0,4,0
230542,5,8,0,0,8,0
230542,2,3,0,0,3,0
230542,1,1,0,0,1,0
157451,5,2,0,0,2,0
157451,4,1,0,0,1,0
215806,7,2,0,0,2,0
215806,3,2,0,0,2,0
215806,2,3,0,0,3,0
5464,9,2,0,0,2,0
5464,4,1,0,0,1,0
5464,1,1,0,0,1,0
4093,10,2,0,0,2,0
4093,4,4,0,0,4,0
4093,3,1,0,0,1,0
20643,3,1,0,0,1,0
7713,9,1,0,0,1,0
7713,7,5,0,0,5,0
7713,3,4,0,0,4,0
73242,3,2,0,0,2,0
188885,7,7,0,0,7,0
188885,6,2,0,0,2,0
188885,1,1,0,0,1,0
11707,10,1,0,0,1,0
11707,5,5,0,0,5,0
11707,1,1,0,0,1,0
6712,10,2,0,0,2,0
6712,9,1,0,0,1,0
22342,8,1,0,0,1,0
74678,10,1,0,0,1,0
74678,9,2,0,0,2,0
193272,8,2,0,0,2,0
193272,2,1,0,0,1,0
5349,10,1,0,0,1,0
5349,9,2,0,0,2,0
173673,9,1,0,0,1,0
173673,8,6,0,0,6,0
173673,5,7,0,0,7,0
173673,3,2,0,0,2,0
173673,2,1,0,0,1,0
81100,10,1,0,0,1,0
81100,9,2,0,0,2,0
81100,5,5,0,0,5,0
81100,4,1,0,0,1,0
81100,3,2,0,0,2,0
81100,2,1,0,0,1,0
727,10,1,0,0,1,0
727,9,1,0,0,1,0
727,8,5,0,0,5,0
192355,8,6,0,0,6,0
192355,5,4,0,0,4,0
192355,4,1,0,0,1,0
13182,6,6,0,0,6,0
13182,4,2,0,0,2,0
13182,3,1,0,0,1,0
218854,9,1,0,0,1,0
218854,8,2,0,0,2,0
218854,4,2,0,0,2,0
218854,3,1,0,0,1,0
218854,2,1,0,0,1,0
167463,5,7,0,0,7,0
167463,4,1,0,0,1,0
167463,2,2,0,0,2,0
7980,9,3,0,0,3,0
7980,3,1,0,0,1,0
1127,8,3,0,0,3,0
1127,1,1,0,0,1,0
183340,10,1,0,0,1,0
183340,9,1,0,0,1,0
183340,4,1,0,0,1,0
183340,3,1,0,0,1,0
36238,10,2,0,0,2,0
36238,9,1,0,0,1,0
36238,7,10,0,0,10,0
36238,5,9,0,0,9,0
36238,2,1,0,0,1,0
36238,1,2,0,0,2,0
194040,9,1,0,0,1,0
194040,8,1,0,0,1,0
194040,6,19,0,0,19,0
194040,4,5,0,0,5,0
194040,3,1,0,0,1,0
194040,1,1,0,0,1,0
254419,8,6,0,0,6,0
254419,2,2,0,0,2,0
162141,3,1,0,0,1,0
165208,7,9,0,0,9,0
165208,5,12,0,0,12,0
165208,3,1,0,0,1,0
165208,2,2,0,0,2,0
197433,9,1,0,0,1,0
181928,4,4,0,0,4,0
238012,7,3,0,0,3,0
238012,1,3,0,0,3,0
4082,7,6,0,0,6,0
192226,10,1,0,0,1,0
192226,9,2,0,0,2,0
192226,6,10,0,0,10,0
192226,4,3,0,0,3,0
192226,2,2,0,0,2,0
6054,10,1,0,0,1,0
6054,9,1,0,0,1,0
63443,10,1,0,0,1,0
63443,3,2,0,0,2,0
17430,10,1,0,0,1,0
17430,9,1,0,0,1,0
17430,5,2,0,0,2,0
17430,4,1,0,0,1,0
11970,1,1,0,0,1,0
176678,10,2,0,0,2,0
176678,4,1,0,0,1,0
176678,3,1,0,0,1,0
20136,9,2,0,0,2,0
20136,7,16,0,0,16,0
20136,3,1,0,0,1,0
187959,9,3,0,0,3,0
187959,5,4,0,0,4,0
9959,9,1,0,0,1,0
5609,10,1,0,0,1,0
5609,7,4,0,0,4,0
237329,1,1,0,0,1,0
12252,1,1,0,0,1,0
255712,4,1,0,0,1,0
88088,8,2,0,0,2,0
88088,7,4,0,0,4,0
74203,6,13,0,0,13,0
74203,5,9,0,0,9,0
40908,10,1,0,0,1,0
40908,9,1,0,0,1,0
40908,8,2,0,0,2,0
40908,6,9,0,0,9,0
40908,5,8,0,0,8,0
172465,8,10,0,0,10,0
172465,6,8,0,0,8,0
172465,5,4,0,0,4,0
172465,2,2,0,0,2,0
16268,5,4,0,0,4,0
16268,3,1,0,0,1,0
133940,1,3,0,0,3,0
210152,5,2,0,0,2,0
210152,1,1,0,0,1,0
15236,3,2,0,0,2,0
15236,2,1,0,0,1,0
227794,7,6,0,0,6,0
248567,10,1,0,0,1,0
248567,9,2,0,0,2,0
248567,6,10,0,0,10,0
248567,5,5,0,0,5,0
248567,1,1,0,0,1,0
97469,5,6,0,0,6,0
260561,7,5,0,0,5,0
260561,5,2,0,0,2,0
185987,10,2,0,0,2,0
185987,9,3,0,0,3,0
185987,3,1,0,0,1,0
26861,7,5,0,0,5,0
26861,1,1,0,0,1,0
24323,10,1,0,0,1,0
24323,8,3,0,0,3,0
211146,10,1,0,0,1,0
211146,9,2,0,0,2,0
211146,8,6,0,0,6,0
211146,5,4,0,0,4,0
205876,5,7,0,0,7,0
205876,2,3,0,0,3,0
205876,1,3,0,0,3,0
5927,10,1,0,0,1,0
5927,3,3,0,0,3,0
51624,10,1,0,0,1,0
51624,9,1,0,0,1,0
145549,4,1,0,0,1,0
191880,8,2,0,0,2,0
191880,6,9,0,0,9,0
191880,2,4,0,0,4,0
213421,10,5,0,0,5,0
213421,9,5,0,0,5,0
213421,7,9,0,0,9,0
213421,6,9,0,0,9,0
213421,5,4,0,0,4,0
213421,3,2,0,0,2,0
213421,1,1,0,0,1,0
93578,10,1,0,0,1,0
93578,4,3,0,0,3,0
203312,5,1,0,0,1,0
66457,3,5,0,0,5,0
66457,2,1,0,0,1,0
200672,10,7,0,0,7,0
200672,9,2,0,0,2,0
200672,5,2,0,0,2,0
200672,4,1,0,0,1,0
200672,1,1,0,0,1,0
18061,9,1,0,0,1,0
88006,5,3,0,0,3,0
88006,4,1,0,0,1,0
4320,5,6,0,0,6,0
4320,3,2,0,0,2,0
257395,10,3,0,0,3,0
257395,7,9,0,0,9,0
257395,6,4,0,0,4,0
257395,5,2,0,0,2,0
391,8,1,0,0,1,0
391,4,11,0,0,11,0
391,3,1,0,0,1,0
391,1,1,0,0,1,0
2958,10,1,0,0,1,0
2958,9,1,0,0,1,0
2958,3,2,0,0,2,0
2958,2,1,0,0,1,0
22336,10,1,0,0,1,0
22336,9,3,0,0,3,0
22336,3,2,0,0,2,0
1175,7,1,0,0,1,0
1175,6,4,0,0,4,0
1175,5,5,0,0,5,0
1175,2,7,0,0,7,0
11527,10,1,0,0,1,0
11527,4,2,0,0,2,0
119474,8,1,0,0,1,0
119474,7,6,0,0,6,0
119474,6,18,0,0,18,0
119474,4,3,0,0,3,0
119474,3,3,0,0,3,0
7578,3,1,0,0,1,0
2440,8,1,0,0,1,0
2440,3,1,0,0,1,0
158098,5,2,0,0,2,0
158098,4,1,0,0,1,0
158098,1,1,0,0,1,0
192904,8,5,0,0,5,0
192904,7,8,0,0,8,0
192904,5,7,0,0,7,0
192904,4,1,0,0,1,0
192904,1,1,0,0,1,0
23614,10,1,0,0,1,0
23614,8,5,0,0,5,0
248157,10,2,0,0,2,0
248157,4,4,0,0,4,0
248157,2,2,0,0,2,0
133992,10,1,0,0,1,0
133992,9,1,0,0,1,0
133992,3,2,0,0,2,0
133992,2,1,0,0,1,0
133992,1,1,0,0,1,0
56886,7,7,0,0,7,0
56886,6,3,0,0,3,0
56886,5,1,0,0,1,0
56886,2,1,0,0,1,0
23404,5,3,0,0,3,0
23404,4,5,0,0,5,0
23404,3,1,0,0,1,0
10094,8,2,0,0,2,0
10094,7,3,0,0,3,0
10094,1,2,0,0,2,0
193105,5,2,0,0,2,0
28860,10,1,0,0,1,0
28860,8,2,0,0,2,0
197788,5,6,0,0,6,0
113513,8,2,0,0,2,0
113513,7,13,0,0,13,0
166246,9,2,0,0,2,0
166246,5,7,0,0,7,0
166246,3,1,0,0,1,0
20036,5,5,0,0,5,0
181376,10,1,0,0,1,0
181376,4,3,0,0,3,0
181376,2,2,0,0,2,0
166509,8,3,0,0,3,0
166509,2,3,0,0,3,0
198898,9,2,0,0,2,0
198898,8,9,0,0,9,0
198898,4,2,0,0,2,0
198898,3,1,0,0,1,0
172088,4,1,0,0,1,0
118627,9,2,0,0,2,0
118627,4,1,0,0,1,0
118627,2,1,0,0,1,0
6125,4,1,0,0,1,0
6125,3,1,0,0,1,0
88246,9,8,0,0,8,0
88246,1,1,0,0,1,0
183305,10,1,0,0,1,0
153624,8,2,0,0,2,0
153624,3,1,0,0,1,0
176898,4,3,0,0,3,0
252684,9,2,0,0,2,0
162120,9,2,0,0,2,0
162120,8,3,0,0,3,0
162120,5,12,0,0,12,0
91313,1,1,0,0,1,0
151981,7,8,0,0,8,0
151981,6,14,0,0,14,0
151981,2,1,0,0,1,0
13447,9,1,0,0,1,0
1567,3,3,0,0,3,0
238912,10,1,0,0,1,0
238912,1,1,0,0,1,0
2349,4,5,0,0,5,0
18704,10,5,0,0,5,0
18704,5,2,0,0,2,0
5275,10,3,0,0,3,0
5275,5,3,0,0,3,0
5275,4,2,0,0,2,0
6963,10,4,0,0,4,0
6963,2,3,0,0,3,0
6963,1,3,0,0,3,0
64706,8,1,0,0,1,0
64706,2,2,0,0,2,0
7185,8,2,0,0,2,0
7185,3,2,0,0,2,0
38795,10,1,0,0,1,0
38795,8,2,0,0,2,0
38795,3,3,0,0,3,0
38795,1,2,0,0,2,0
66537,10,2,0,0,2,0
66537,5,8,0,0,8,0
66537,1,1,0,0,1,0
136177,9,1,0,0,1,0
136177,5,9,0,0,9,0
136177,3,2,0,0,2,0
203421,10,1,0,0,1,0
203421,9,1,0,0,1,0
203421,8,1,0,0,1,0
203421,4,2,0,0,2,0
203421,2,1,0,0,1,0
4849,7,7,0,0,7,0
4849,6,8,0,0,8,0
4849,1,2,0,0,2,0
18247,10,1,0,0,1,0
18247,2,1,0,0,1,0
222401,7,14,0,0,14,0
222401,6,6,0,0,6,0
222401,5,2,0,0,2,0
222401,3,1,0,0,1,0
222401,2,1,0,0,1,0
17691,1,1,0,0,1,0
41329,4,1,0,0,1,0
41329,3,1,0,0,1,0
177437,8,4,0,0,4,0
177437,7,7,0,0,7,0
177437,2,1,0,0,1,0
1084,2,1,0,0,1,0
160541,1,2,0,0,2,0
16987,8,1,0,0,1,0
47125,9,5,0,0,5,0
47125,8,5,0,0,5,0
47125,7,13,0,0,13,0
47125,4,3,0,0,3,0
125585,9,1,0,0,1,0
125585,3,4,0,0,4,0
125585,2,2,0,0,2,0
125585,1,1,0,0,1,0
93402,9,2,0,0,2,0
93402,8,6,0,0,6,0
93402,5,9,0,0,9,0
93402,4,3,0,0,3,0
56641,3,1,0,0,1,0
175086,10,4,0,0,4,0
175086,7,7,0,0,7,0
175086,4,4,0,0,4,0
175086,2,2,0,0,2,0
175086,1,1,0,0,1,0
1934,7,4,0,0,4,0
1934,6,9,0,0,9,0
1934,4,10,0,0,10,0
1934,3,5,0,0,5,0
1934,1,2,0,0,2,0
257204,5,4,0,0,4,0
257204,3,2,0,0,2,0
128154,7,5,0,0,5,0
128154,5,1,0,0,1,0
128154,2,1,0,0,1,0
128154,1,1,0,0,1,0
72751,5,8,0,0,8,0
72751,3,1,0,0,1,0
13912,10,1,0,0,1,0
13912,9,1,0,0,1,0
20414,8,4,0,0,4,0
20414,7,1,0,0,1,0
20414,6,1,0,0,1,0
20414,5,1,0,0,1,0
20414,2,1,0,0,1,0
225062,5,1,0,0,1,0
225062,4,1,0,0,1,0
225062,3,1,0,0,1,0
225062,2,2,0,0,2,0
18574,8,1,0,0,1,0
175627,10,1,0,0,1,0
175627,4,1,0,0,1,0
175627,2,1,0,0,1,0
73253,10,1,0,0,1,0
8863,10,1,0,0,1,0
8863,2,1,0,0,1,0
8863,1,2,0,0,2,0
231392,9,5,0,0,5,0
193854,4,3,0,0,3,0
175778,9,2,0,0,2,0
175778,6,14,0,0,14,0
175778,1,2,0,0,2,0
107435,10,4,0,0,4,0
107435,2,2,0,0,2,0
237217,9,2,0,0,2,0
237217,4,1,0,0,1,0
237217,3,2,0,0,2,0
145621,10,2,0,0,2,0
145621,4,4,0,0,4,0
145621,3,3,0,0,3,0
145621,2,3,0,0,3,0
145621,1,3,0,0,3,0
6346,7,7,0,0,7,0
6346,4,1,0,0,1,0
6346,3,1,0,0,1,0
132601,10,3,0,0,3,0
206410,9,2,0,0,2,0
167468,9,1,0,0,1,0
167468,7,8,0,0,8,0
167468,5,7,0,0,7,0
167468,4,1,0,0,1,0
167468,3,1,0,0,1,0
167468,2,1,0,0,1,0
96626,10,1,0,0,1,0
96626,5,4,0,0,4,0
36373,4,3,0,0,3,0
173752,7,7,0,0,7,0
173752,5,10,0,0,10,0
173752,4,1,0,0,1,0
260704,4,1,0,0,1,0
260704,3,2,0,0,2,0
8067,9,1,0,0,1,0
8067,5,2,0,0,2,0
8067,3,2,0,0,2,0
8067,1,1,0,0,1,0
49392,10,3,0,0,3,0
49392,5,1,0,0,1,0
49392,1,1,0,0,1,0
223455,7,10,0,0,10,0
223455,6,3,0,0,3,0
223455,5,4,0,0,4,0
31477,8,7,0,0,7,0
31477,7,9,0,0,9,0
31477,6,13,0,0,13,0
31477,5,5,0,0,5,0
31477,4,5,0,0,5,0
31477,3,3,0,0,3,0
7749,5,2,0,0,2,0
148215,9,1,0,0,1,0
148215,4,2,0,0,2,0
205776,10,2,0,0,2,0
205776,9,3,0,0,3,0
205776,6,19,0,0,19,0
8748,10,1,0,0,1,0
8748,9,3,0,0,3,0
8748,3,1,0,0,1,0
4948,1,1,0,0,1,0
179433,9,3,0,0,3,0
179433,3,1,0,0,1,0
3814,10,2,0,0,2,0
3814,9,1,0,0,1,0
3814,3,3,0,0,3,0
175879,9,1,0,0,1,0
175879,8,3,0,0,3,0
175879,2,2,0,0,2,0
25992,9,1,0,0,1,0
60872,10,1,0,0,1,0
60872,8,3,0,0,3,0
60872,4,2,0,0,2,0
60872,2,1,0,0,1,0
5935,9,1,0,0,1,0
5935,5,4,0,0,4,0
5935,3,1,0,0,1,0
238972,10,3,0,0,3,0
238972,8,7,0,0,7,0
238972,5,1,0,0,1,0
238972,3,4,0,0,4,0
238972,2,1,0,0,1,0
238972,1,1,0,0,1,0
31378,10,2,0,0,2,0
31378,5,2,0,0,2,0
210966,10,1,0,0,1,0
210966,9,2,0,0,2,0
210966,4,2,0,0,2,0
210966,3,1,0,0,1,0
19908,5,4,0,0,4,0
19908,4,2,0,0,2,0
19908,3,1,0,0,1,0
19908,2,1,0,0,1,0
12505,5,6,0,0,6,0
183665,8,4,0,0,4,0
183665,5,12,0,0,12,0
183665,4,4,0,0,4,0
183665,3,1,0,0,1,0
158774,4,2,0,0,2,0
158774,3,2,0,0,2,0
7870,4,1,0,0,1,0
218453,10,1,0,0,1,0
218453,5,2,0,0,2,0
218453,3,1,0,0,1,0
42498,3,2,0,0,2,0
42498,2,1,0,0,1,0
97339,8,1,0,0,1,0
16972,10,3,0,0,3,0
16972,5,3,0,0,3,0
6364,9,1,0,0,1,0
6364,7,5,0,0,5,0
6364,1,1,0,0,1,0
27336,9,1,0,0,1,0
27336,3,1,0,0,1,0
27336,2,1,0,0,1,0
27336,1,1,0,0,1,0
250467,6,1,0,0,1,0
215058,10,2,0,0,2,0
215058,7,12,0,0,12,0
215058,5,1,0,0,1,0
215058,3,1,0,0,1,0
8133,10,1,0,0,1,0
8133,7,2,0,0,2,0
1290,8,1,0,0,1,0
1290,7,1,0,0,1,0
228526,10,3,0,0,3,0
228526,5,2,0,0,2,0
228526,4,1,0,0,1,0
228526,3,1,0,0,1,0
4016,10,2,0,0,2,0
4016,5,1,0,0,1,0
223034,9,2,0,0,2,0
223034,7,8,0,0,8,0
223034,3,2,0,0,2,0
223034,1,1,0,0,1,0
133063,7,1,0,0,1,0
2676,4,1,0,0,1,0
2676,3,2,0,0,2,0
2676,2,1,0,0,1,0
11136,10,1,0,0,1,0
11136,9,2,0,0,2,0
11136,8,5,0,0,5,0
11136,3,1,0,0,1,0
11136,1,1,0,0,1,0
1996,9,3,0,0,3,0
1996,8,3,0,0,3,0
1996,4,3,0,0,3,0
1996,2,2,0,0,2,0
35877,1,1,0,0,1,0
101463,9,5,0,0,5,0
108156,8,3,0,0,3,0
108156,7,3,0,0,3,0
108156,2,1,0,0,1,0
4117,1,1,0,0,1,0
10805,9,1,0,0,1,0
10805,8,2,0,0,2,0
10805,2,1,0,0,1,0
200096,10,3,0,0,3,0
200096,9,3,0,0,3,0
200096,7,9,0,0,9,0
200096,4,2,0,0,2,0
200096,1,1,0,0,1,0
4404,4,5,0,0,5,0
4404,2,1,0,0,1,0
11373,5,3,0,0,3,0
11373,4,1,0,0,1,0
22062,2,1,0,0,1,0
22062,1,1,0,0,1,0
13212,9,5,0,0,5,0
13212,4,1,0,0,1,0
251987,8,5,0,0,5,0
251987,4,1,0,0,1,0
251987,3,3,0,0,3,0
251987,2,1,0,0,1,0
251987,1,2,0,0,2,0
19417,3,2,0,0,2,0
19417,1,1,0,0,1,0
184712,9,1,0,0,1,0
184712,6,11,0,0,11,0
184712,5,5,0,0,5,0
15372,10,1,0,0,1,0
15372,8,2,0,0,2,0
15372,4,8,0,0,8,0
15372,3,2,0,0,2,0
15372,2,1,0,0,1,0
187033,7,4,0,0,4,0
26349,8,3,0,0,3,0
26349,7,7,0,0,7,0
26349,2,1,0,0,1,0
29375,10,2,0,0,2,0
29375,4,1,0,0,1,0
29375,2,1,0,0,1,0
29375,1,1,0,0,1,0
197435,10,1,0,0,1,0
197435,4,5,0,0,5,0
197435,1,3,0,0,3,0
19349,10,2,0,0,2,0
19349,8,2,0,0,2,0
19349,3,4,0,0,4,0
131735,8,1,0,0,1,0
131735,7,4,0,0,4,0
131735,4,7,0,0,7,0
9866,10,1,0,0,1,0
9866,1,1,0,0,1,0
174927,10,1,0,0,1,0
174927,5,7,0,0,7,0
174927,2,1,0,0,1,0
36698,5,5,0,0,5,0
36698,4,1,0,0,1,0
171862,10,3,0,0,3,0
171862,9,1,0,0,1,0
171862,5,5,0,0,5,0
171862,4,2,0,0,2,0
3700,10,1,0,0,1,0
3700,4,2,0,0,2,0
29939,2,3,0,0,3,0
7250,3,5,0,0,5,0
88011,1,1,0,0,1,0
8693,10,1,0,0,1,0
8693,9,2,0,0,2,0
8693,8,2,0,0,2,0
8693,4,2,0,0,2,0
8693,1,1,0,0,1,0
124757,5,4,0,0,4,0
17597,8,1,0,0,1,0
17597,7,2,0,0,2,0
17597,5,4,0,0,4,0
171579,4,3,0,0,3,0
129313,5,4,0,0,4,0
129313,3,1,0,0,1,0
721,9,2,0,0,2,0
721,8,1,0,0,1,0
721,2,1,0,0,1,0
256620,10,1,0,0,1,0
256620,9,2,0,0,2,0
23920,9,1,0,0,1,0
23920,8,4,0,0,4,0
23920,3,1,0,0,1,0
244428,5,4,0,0,4,0
10414,10,1,0,0,1,0
10414,9,1,0,0,1,0
129944,10,1,0,0,1,0
129944,9,1,0,0,1,0
129944,4,3,0,0,3,0
129944,3,4,0,0,4,0
129944,2,3,0,0,3,0
2925,10,1,0,0,1,0
2925,8,2,0,0,2,0
2925,7,3,0,0,3,0
6944,10,2,0,0,2,0
256730,6,3,0,0,3,0
122524,8,1,0,0,1,0
122524,7,2,0,0,2,0
85389,10,4,0,0,4,0
85389,9,1,0,0,1,0
85389,8,3,0,0,3,0
85389,7,6,0,0,6,0
85389,3,1,0,0,1,0
85389,2,2,0,0,2,0
85389,1,1,0,0,1,0
39898,8,3,0,0,3,0
10470,5,1,0,0,1,0
10470,3,1,0,0,1,0
10470,1,1,0,0,1,0
231368,10,1,0,0,1,0
231368,7,14,0,0,14,0
231368,4,2,0,0,2,0
231368,3,1,0,0,1,0
5387,4,9,0,0,9,0
19475,8,2,0,0,2,0
19475,3,5,0,0,5,0
255272,10,3,0,0,3,0
255272,9,1,0,0,1,0
255272,8,9,0,0,9,0
255272,3,1,0,0,1,0
255272,1,1,0,0,1,0
204578,9,2,0,0,2,0
13269,4,2,0,0,2,0
13827,8,4,0,0,4,0
13827,7,5,0,0,5,0
13827,3,3,0,0,3,0
13827,2,2,0,0,2,0
169574,9,2,0,0,2,0
169574,5,9,0,0,9,0
169574,1,1,0,0,1,0
147457,10,1,0,0,1,0
147457,9,2,0,0,2,0
147457,8,4,0,0,4,0
147457,7,12,0,0,12,0
147457,5,8,0,0,8,0
147457,2,1,0,0,1,0
147457,1,1,0,0,1,0
139401,10,2,0,0,2,0
139401,9,1,0,0,1,0
139401,7,5,0,0,5,0
139401,3,1,0,0,1,0
97888,10,2,0,0,2,0
97888,8,3,0,0,3,0
97888,7,4,0,0,4,0
97888,4,5,0,0,5,0
97888,3,4,0,0,4,0
97888,2,1,0,0,1,0
97888,1,1,0,0,1,0
128388,10,2,0,0,2,0
128388,3,1,0,0,1,0
136029,7,9,0,0,9,0
136029,4,3,0,0,3,0
136029,2,1,0,0,1,0
107604,3,2,0,0,2,0
107604,2,1,0,0,1,0
169462,10,1,0,0,1,0
169462,7,6,0,0,6,0
169462,6,20,0,0,20,0
2733,5,3,0,0,3,0
2733,4,3,0,0,3,0
2733,3,2,0,0,2,0
4878,2,1,0,0,1,0
125059,9,1,0,0,1,0
125059,8,2,0,0,2,0
125059,7,3,0,0,3,0
125059,1,1,0,0,1,0
8097,9,1,0,0,1,0
8097,1,2,0,0,2,0
9192,10,2,0,0,2,0
9192,5,4,0,0,4,0
238221,9,3,0,0,3,0
238221,6,7,0,0,7,0
238221,4,1,0,0,1,0
238221,3,2,0,0,2,0
1065,4,3,0,0,3,0
3024,4,1,0,0,1,0
146247,10,3,0,0,3,0
146247,9,1,0,0,1,0
146247,7,10,0,0,10,0
146247,5,7,0,0,7,0
5043,9,1,0,0,1,0
5043,7,4,0,0,4,0
4649,3,3,0,0,3,0
4649,2,2,0,0,2,0
41065,10,1,0,0,1,0
41065,4,7,0,0,7,0
22594,10,2,0,0,2,0
22594,4,1,0,0,1,0
22594,2,1,0,0,1,0
256569,9,1,0,0,1,0
256569,5,7,0,0,7,0
256569,4,3,0,0,3,0
208323,10,1,0,0,1,0
208323,2,1,0,0,1,0
18330,10,1,0,0,1,0
18330,8,9,0,0,9,0
18330,6,13,0,0,13,0
38829,10,2,0,0,2,0
38829,5,1,0,0,1,0
5723,4,3,0,0,3,0
5723,3,1,0,0,1,0
4503,9,1,0,0,1,0
4503,5,3,0,0,3,0
4503,3,1,0,0,1,0
179912,10,3,0,0,3,0
179912,4,2,0,0,2,0
34118,10,2,0,0,2,0
34118,4,2,0,0,2,0
12539,8,5,0,0,5,0
12539,5,5,0,0,5,0
12539,4,8,0,0,8,0
159774,9,1,0,0,1,0
162038,4,2,0,0,2,0
90471,5,11,0,0,11,0
90471,4,6,0,0,6,0
90471,2,1,0,0,1,0
104858,9,2,0,0,2,0
104858,7,9,0,0,9,0
104858,6,8,0,0,8,0
104858,5,8,0,0,8,0
104858,3,3,0,0,3,0
104858,2,1,0,0,1,0
243636,7,9,0,0,9,0
243636,5,4,0,0,4,0
243636,3,1,0,0,1,0
9565,9,1,0,0,1,0
9565,2,1,0,0,1,0
23643,9,1,0,0,1,0
4332,5,1,0,0,1,0
4332,4,2,0,0,2,0
31412,10,1,0,0,1,0
31412,9,4,0,0,4,0
31412,3,1,0,0,1,0
4925,4,9,0,0,9,0
4925,3,5,0,0,5,0
3564,8,4,0,0,4,0
190700,7,8,0,0,8,0
190700,3,1,0,0,1,0
190700,1,1,0,0,1,0
169550,4,3,0,0,3,0
169550,3,1,0,0,1,0
169550,2,1,0,0,1,0
13378,10,1,0,0,1,0
13378,2,1,0,0,1,0
22406,10,3,0,0,3,0
22406,4,1,0,0,1,0
153802,8,5,0,0,5,0
153802,7,13,0,0,13,0
153802,6,8,0,0,8,0
153802,1,1,0,0,1,0
23733,10,2,0,0,2,0
23733,5,1,0,0,1,0
23733,2,1,0,0,1,0
12900,10,3,0,0,3,0
243752,10,1,0,0,1,0
243752,7,14,0,0,14,0
243752,6,10,0,0,10,0
30023,4,1,0,0,1,0
145915,5,1,0,0,1,0
145915,1,1,0,0,1,0
4969,10,1,0,0,1,0
4969,9,1,0,0,1,0
4969,8,1,0,0,1,0
4969,7,3,0,0,3,0
13919,10,1,0,0,1,0
13919,9,1,0,0,1,0
7579,3,1,0,0,1,0
104553,10,2,0,0,2,0
104553,2,1,0,0,1,0
11149,2,2,0,0,2,0
7183,9,2,0,0,2,0
7183,7,8,0,0,8,0
7183,3,2,0,0,2,0
99286,5,2,0,0,2,0
99286,1,1,0,0,1,0
66256,3,3,0,0,3,0
192729,8,1,0,0,1,0
192729,4,2,0,0,2,0
192729,3,2,0,0,2,0
192729,2,1,0,0,1,0
76416,10,1,0,0,1,0
76416,9,1,0,0,1,0
76416,5,7,0,0,7,0
76416,3,2,0,0,2,0
76416,2,2,0,0,2,0
76416,1,1,0,0,1,0
24969,2,1,0,0,1,0
209863,1,1,0,0,1,0
54743,7,6,0,0,6,0
54743,3,4,0,0,4,0
54743,2,2,0,0,2,0
54743,1,1,0,0,1,0
129272,4,3,0,0,3,0
123923,9,1,0,0,1,0
11393,10,1,0,0,1,0
11393,2,2,0,0,2,0
9571,8,2,0,0,2,0
134884,5,5,0,0,5,0
134884,3,2,0,0,2,0
113324,1,1,0,0,1,0
169463,10,1,0,0,1,0
169463,7,4,0,0,4,0
169463,4,2,0,0,2,0
86006,4,4,0,0,4,0
232661,6,11,0,0,11,0
34381,10,1,0,0,1,0
34381,9,1,0,0,1,0
57834,9,1,0,0,1,0
10605,9,1,0,0,1,0
10605,8,7,0,0,7,0
10605,5,5,0,0,5,0
10605,4,3,0,0,3,0
10605,2,1,0,0,1,0
1453,10,1,0,0,1,0
1453,1,1,0,0,1,0
140973,6,8,0,0,8,0
140973,5,1,0,0,1,0
157675,10,1,0,0,1,0
157675,8,3,0,0,3,0
157675,7,7,0,0,7,0
157675,5,6,0,0,6,0
157675,4,9,0,0,9,0
157675,3,1,0,0,1,0
157675,1,1,0,0,1,0
162777,4,1,0,0,1,0
162777,1,1,0,0,1,0
165559,8,2,0,0,2,0
165559,5,9,0,0,9,0
211810,5,3,0,0,3,0
116806,1,1,0,0,1,0
229540,9,5,0,0,5,0
229540,7,5,0,0,5,0
229540,5,2,0,0,2,0
229540,4,1,0,0,1,0
229540,1,2,0,0,2,0
229957,10,1,0,0,1,0
229957,5,1,0,0,1,0
88005,10,2,0,0,2,0
88005,7,13,0,0,13,0
88005,5,5,0,0,5,0
88005,4,4,0,0,4,0
88005,1,1,0,0,1,0
12189,5,4,0,0,4,0
5930,10,3,0,0,3,0
5930,3,1,0,0,1,0
11756,10,3,0,0,3,0
11756,5,2,0,0,2,0
11756,4,1,0,0,1,0
11756,2,1,0,0,1,0
68187,9,5,0,0,5,0
68187,5,2,0,0,2,0
16018,10,1,0,0,1,0
31558,2,1,0,0,1,0
9860,10,3,0,0,3,0
4152,9,1,0,0,1,0
4152,8,2,0,0,2,0
31770,4,4,0,0,4,0
23402,10,1,0,0,1,0
23402,9,2,0,0,2,0
21412,9,2,0,0,2,0
21412,3,2,0,0,2,0
193696,9,5,0,0,5,0
193696,6,4,0,0,4,0
1076,10,1,0,0,1,0
1076,3,1,0,0,1,0
1812,8,1,0,0,1,0
17071,10,1,0,0,1,0
17071,8,1,0,0,1,0
182796,2,1,0,0,1,0
106836,9,1,0,0,1,0
106836,8,2,0,0,2,0
244274,10,2,0,0,2,0
244274,3,1,0,0,1,0
13333,2,1,0,0,1,0
41995,3,3,0,0,3,0
41995,2,2,0,0,2,0
262733,9,4,0,0,4,0
262733,8,4,0,0,4,0
262733,7,1,0,0,1,0
262733,5,1,0,0,1,0
262733,1,2,0,0,2,0
197705,1,1,0,0,1,0
232446,10,1,0,0,1,0
232446,6,9,0,0,9,0
232446,5,4,0,0,4,0
232446,3,1,0,0,1,0
229297,9,1,0,0,1,0
223767,9,3,0,0,3,0
223767,6,7,0,0,7,0
223767,2,1,0,0,1,0
9968,10,1,0,0,1,0
9968,4,2,0,0,2,0
10264,5,7,0,0,7,0
10264,3,1,0,0,1,0
10264,2,1,0,0,1,0
11370,6,1,0,0,1,0
194032,8,4,0,0,4,0
194032,3,3,0,0,3,0
1952,9,5,0,0,5,0
1952,7,10,0,0,10,0
7354,9,1,0,0,1,0
7354,8,4,0,0,4,0
7354,5,3,0,0,3,0
7354,4,1,0,0,1,0
224794,9,7,0,0,7,0
224794,4,1,0,0,1,0
161600,10,1,0,0,1,0
161600,9,3,0,0,3,0
161600,5,4,0,0,4,0
161600,4,1,0,0,1,0
161600,1,1,0,0,1,0
3512,9,1,0,0,1,0
3512,8,2,0,0,2,0
3512,2,1,0,0,1,0
4655,10,1,0,0,1,0
3238,10,1,0,0,1,0
3238,9,1,0,0,1,0
3238,8,4,0,0,4,0
3238,5,2,0,0,2,0
3238,3,1,0,0,1,0
204541,7,2,0,0,2,0
204541,5,2,0,0,2,0
204541,3,1,0,0,1,0
204541,1,1,0,0,1,0
7715,8,1,0,0,1,0
7715,5,6,0,0,6,0
19571,7,2,0,0,2,0
19571,6,2,0,0,2,0
19571,2,3,0,0,3,0
22227,10,1,0,0,1,0
22227,9,2,0,0,2,0
22227,4,1,0,0,1,0
3989,8,8,0,0,8,0
3989,2,1,0,0,1,0
30947,8,1,0,0,1,0
30947,7,1,0,0,1,0
30947,6,8,0,0,8,0
3524,2,2,0,0,2,0
8753,10,1,0,0,1,0
8753,3,2,0,0,2,0
8753,2,1,0,0,1,0
211962,1,1,0,0,1,0
120579,3,4,0,0,4,0
120579,1,1,0,0,1,0
235534,8,1,0,0,1,0
235534,7,2,0,0,2,0
47484,6,2,0,0,2,0
47484,1,1,0,0,1,0
184159,8,1,0,0,1,0
184159,6,1,0,0,1,0
184266,10,1,0,0,1,0
184266,3,1,0,0,1,0
232823,9,1,0,0,1,0
232823,5,1,0,0,1,0
232823,3,1,0,0,1,0
67628,7,2,0,0,2,0
27374,8,3,0,0,3,0
85165,5,2,0,0,2,0
85165,2,1,0,0,1,0
227254,5,5,0,0,5,0
227254,3,1,0,0,1,0
255255,10,5,0,0,5,0
255255,5,3,0,0,3,0
255255,3,1,0,0,1,0
29491,10,1,0,0,1,0
29491,1,1,0,0,1,0
205495,10,3,0,0,3,0
205495,8,4,0,0,4,0
205495,5,2,0,0,2,0
205495,4,7,0,0,7,0
194496,10,2,0,0,2,0
194496,5,8,0,0,8,0
194496,3,1,0,0,1,0
194496,2,2,0,0,2,0
194496,1,2,0,0,2,0
4345,6,4,0,0,4,0
5561,10,1,0,0,1,0
5561,3,1,0,0,1,0
166537,7,3,0,0,3,0
166537,2,1,0,0,1,0
39276,9,1,0,0,1,0
39276,8,1,0,0,1,0
39276,2,4,0,0,4,0
4298,9,2,0,0,2,0
162727,10,1,0,0,1,0
162727,9,2,0,0,2,0
4290,10,1,0,0,1,0
4290,6,5,0,0,5,0
4290,5,4,0,0,4,0
31421,4,1,0,0,1,0
31421,1,1,0,0,1,0
101660,9,2,0,0,2,0
101660,3,2,0,0,2,0
101660,2,3,0,0,3,0
101660,1,1,0,0,1,0
3538,7,1,0,0,1,0
189663,10,2,0,0,2,0
189663,5,1,0,0,1,0
13299,8,6,0,0,6,0
13299,1,1,0,0,1,0
66852,10,1,0,0,1,0
66852,2,2,0,0,2,0
117885,8,4,0,0,4,0
10361,10,1,0,0,1,0
10361,9,1,0,0,1,0
10361,5,4,0,0,4,0
14233,8,2,0,0,2,0
14233,3,1,0,0,1,0
171912,9,4,0,0,4,0
171912,3,3,0,0,3,0
160353,7,9,0,0,9,0
160353,3,3,0,0,3,0
11241,9,3,0,0,3,0
11241,4,2,0,0,2,0
204429,10,2,0,0,2,0
204429,9,3,0,0,3,0
204429,8,6,0,0,6,0
204429,7,8,0,0,8,0
204429,6,15,0,0,15,0
204429,5,4,0,0,4,0
204429,2,1,0,0,1,0
8409,10,1,0,0,1,0
8409,9,1,0,0,1,0
8409,4,2,0,0,2,0
8409,2,1,0,0,1,0
412,9,3,0,0,3,0
412,8,6,0,0,6,0
412,3,1,0,0,1,0
4875,10,2,0,0,2,0
4875,9,1,0,0,1,0
4875,4,1,0,0,1,0
4875,2,1,0,0,1,0
138682,5,2,0,0,2,0
138682,4,2,0,0,2,0
138682,3,2,0,0,2,0
113517,9,3,0,0,3,0
113517,3,1,0,0,1,0
113517,2,2,0,0,2,0
35661,3,2,0,0,2,0
35661,2,1,0,0,1,0
80972,10,1,0,0,1,0
80972,8,6,0,0,6,0
80972,7,3,0,0,3,0
80972,3,2,0,0,2,0
80972,1,1,0,0,1,0
17830,10,1,0,0,1,0
17830,8,5,0,0,5,0
40886,7,3,0,0,3,0
40886,2,2,0,0,2,0
130400,5,2,0,0,2,0
154244,2,2,0,0,2,0
821,9,1,0,0,1,0
821,3,3,0,0,3,0
821,1,1,0,0,1,0
7088,5,8,0,0,8,0
141467,10,2,0,0,2,0
141467,9,3,0,0,3,0
10898,10,2,0,0,2,0
10898,2,1,0,0,1,0
10898,1,1,0,0,1,0
792,9,1,0,0,1,0
792,7,7,0,0,7,0
39426,10,2,0,0,2,0
39426,5,1,0,0,1,0
39426,1,1,0,0,1,0
206938,9,1,0,0,1,0
206938,3,1,0,0,1,0
217177,9,3,0,0,3,0
217177,3,2,0,0,2,0
217177,2,1,0,0,1,0
7141,9,1,0,0,1,0
7141,5,4,0,0,4,0
7141,4,2,0,0,2,0
7141,1,1,0,0,1,0
224830,4,1,0,0,1,0
217671,3,3,0,0,3,0
7254,10,1,0,0,1,0
7254,4,1,0,0,1,0
7254,2,3,0,0,3,0
10785,1,2,0,0,2,0
17323,7,4,0,0,4,0
227316,7,6,0,0,6,0
227316,4,4,0,0,4,0
227316,2,1,0,0,1,0
227316,1,1,0,0,1,0
8923,5,3,0,0,3,0
8923,4,1,0,0,1,0
11085,9,1,0,0,1,0
11085,4,4,0,0,4,0
11085,3,2,0,0,2,0
17787,10,3,0,0,3,0
17787,7,6,0,0,6,0
17787,2,1,0,0,1,0
70922,2,1,0,0,1,0
29146,10,3,0,0,3,0
29146,6,10,0,0,10,0
156113,10,1,0,0,1,0
156113,9,1,0,0,1,0
156113,5,5,0,0,5,0
156113,4,3,0,0,3,0
156113,2,1,0,0,1,0
176916,5,1,0,0,1,0
176916,3,1,0,0,1,0
176916,1,1,0,0,1,0
5364,10,1,0,0,1,0
5364,5,4,0,0,4,0
40974,7,4,0,0,4,0
40974,5,12,0,0,12,0
40974,3,5,0,0,5,0
40974,2,1,0,0,1,0
216647,9,1,0,0,1,0
216647,7,5,0,0,5,0
216647,3,1,0,0,1,0
241266,4,3,0,0,3,0
6665,3,2,0,0,2,0
242753,6,2,0,0,2,0
242753,5,1,0,0,1,0
11293,10,3,0,0,3,0
11293,9,4,0,0,4,0
11293,2,1,0,0,1,0
132456,10,1,0,0,1,0
132456,7,7,0,0,7,0
132456,2,1,0,0,1,0
218489,7,1,0,0,1,0
218489,6,3,0,0,3,0
218489,5,2,0,0,2,0
218489,1,1,0,0,1,0
227813,8,6,0,0,6,0
227813,4,1,0,0,1,0
227813,3,1,0,0,1,0
5690,7,2,0,0,2,0
5690,5,13,0,0,13,0
5690,1,1,0,0,1,0
3472,6,8,0,0,8,0
3472,4,2,0,0,2,0
3472,3,1,0,0,1,0
3472,1,1,0,0,1,0
5692,6,7,0,0,7,0
148213,8,6,0,0,6,0
148213,1,1,0,0,1,0
64608,8,1,0,0,1,0
64608,7,2,0,0,2,0
64608,6,6,0,0,6,0
253215,6,8,0,0,8,0
253215,5,1,0,0,1,0
253215,4,2,0,0,2,0
246685,10,4,0,0,4,0
246685,8,8,0,0,8,0
246685,5,2,0,0,2,0
246685,3,2,0,0,2,0
116821,5,9,0,0,9,0
116821,3,7,0,0,7,0
116821,2,1,0,0,1,0
21188,10,1,0,0,1,0
15559,3,2,0,0,2,0
1871,7,4,0,0,4,0
1871,4,7,0,0,7,0
3502,10,1,0,0,1,0
3502,2,4,0,0,4,0
3610,7,3,0,0,3,0
3610,2,4,0,0,4,0
9248,9,2,0,0,2,0
9248,3,1,0,0,1,0
13944,2,3,0,0,3,0
13944,1,1,0,0,1,0
9705,8,1,0,0,1,0
9705,6,7,0,0,7,0
9705,1,3,0,0,3,0
20028,10,1,0,0,1,0
20028,9,1,0,0,1,0
20028,8,1,0,0,1,0
6333,10,2,0,0,2,0
6333,5,6,0,0,6,0
6333,2,2,0,0,2,0
262635,9,1,0,0,1,0
262635,8,5,0,0,5,0
262635,4,2,0,0,2,0
262635,2,1,0,0,1,0
179975,8,3,0,0,3,0
179975,7,5,0,0,5,0
179975,4,8,0,0,8,0
95503,9,3,0,0,3,0
95503,4,2,0,0,2,0
3239,7,3,0,0,3,0
3239,4,3,0,0,3,0
3239,2,1,0,0,1,0
231042,8,3,0,0,3,0
231042,2,1,0,0,1,0
6735,9,4,0,0,4,0
6735,3,1,0,0,1,0
6735,2,1,0,0,1,0
195476,6,10,0,0,10,0
195476,5,4,0,0,4,0
29278,3,1,0,0,1,0
29278,2,1,0,0,1,0
29278,1,1,0,0,1,0
155745,10,3,0,0,3,0
155745,9,1,0,0,1,0
155745,7,13,0,0,13,0
155745,6,8,0,0,8,0
155745,5,3,0,0,3,0
155745,4,1,0,0,1,0
8258,7,5,0,0,5,0
8258,5,1,0,0,1,0
8258,4,1,0,0,1,0
8258,3,1,0,0,1,0
19030,8,4,0,0,4,0
19030,3,1,0,0,1,0
19030,2,1,0,0,1,0
128672,10,1,0,0,1,0
128672,7,3,0,0,3,0
128672,6,4,0,0,4,0
128672,4,5,0,0,5,0
128672,1,3,0,0,3,0
172517,10,1,0,0,1,0
172517,9,1,0,0,1,0
172517,8,5,0,0,5,0
172517,5,4,0,0,4,0
172517,4,8,0,0,8,0
172517,2,1,0,0,1,0
24079,10,1,0,0,1,0
24079,9,1,0,0,1,0
24079,4,2,0,0,2,0
24079,2,1,0,0,1,0
183528,5,4,0,0,4,0
183528,3,1,0,0,1,0
183528,2,1,0,0,1,0
183528,1,1,0,0,1,0
6605,8,2,0,0,2,0
171090,8,1,0,0,1,0
171090,7,1,0,0,1,0
171090,4,5,0,0,5,0
162012,10,1,0,0,1,0
162012,8,5,0,0,5,0
162012,5,4,0,0,4,0
162012,4,1,0,0,1,0
162012,1,2,0,0,2,0
139963,9,1,0,0,1,0
139963,2,1,0,0,1,0
10822,5,3,0,0,3,0
10822,4,1,0,0,1,0
124918,10,1,0,0,1,0
124918,8,8,0,0,8,0
124918,5,2,0,0,2,0
124918,4,1,0,0,1,0
153107,3,2,0,0,2,0
153107,2,1,0,0,1,0
192731,10,1,0,0,1,0
192731,9,1,0,0,1,0
192731,8,5,0,0,5,0
192731,5,2,0,0,2,0
192731,4,2,0,0,2,0
192731,3,1,0,0,1,0
34195,10,1,0,0,1,0
34195,4,1,0,0,1,0
3047,10,1,0,0,1,0
3047,9,2,0,0,2,0
3047,4,6,0,0,6,0
74310,10,1,0,0,1,0
74310,8,4,0,0,4,0
74310,7,4,0,0,4,0
206087,4,3,0,0,3,0
30438,10,1,0,0,1,0
30438,9,3,0,0,3,0
30438,4,1,0,0,1,0
30438,3,1,0,0,1,0
202742,9,1,0,0,1,0
202742,8,4,0,0,4,0
202742,5,6,0,0,6,0
202742,4,9,0,0,9,0
202742,3,3,0,0,3,0
202742,1,2,0,0,2,0
233994,7,5,0,0,5,0
233994,4,5,0,0,5,0
229235,3,1,0,0,1,0
140743,10,1,0,0,1,0
140743,7,8,0,0,8,0
140743,5,3,0,0,3,0
140743,4,3,0,0,3,0
159501,6,5,0,0,5,0
159501,4,1,0,0,1,0
159501,2,1,0,0,1,0
159501,1,1,0,0,1,0
37849,8,1,0,0,1,0
37849,1,2,0,0,2,0
8675,9,1,0,0,1,0
8253,10,1,0,0,1,0
8253,8,1,0,0,1,0
8253,4,5,0,0,5,0
159333,5,3,0,0,3,0
7421,9,1,0,0,1,0
7421,8,2,0,0,2,0
7421,7,5,0,0,5,0
127258,10,1,0,0,1,0
127258,8,3,0,0,3,0
127258,4,1,0,0,1,0
113066,9,1,0,0,1,0
29286,4,2,0,0,2,0
165190,8,6,0,0,6,0
165190,2,1,0,0,1,0
14698,10,1,0,0,1,0
14698,5,5,0,0,5,0
26890,9,1,0,0,1,0
1715,9,1,0,0,1,0
1715,8,1,0,0,1,0
14814,10,1,0,0,1,0
6890,10,2,0,0,2,0
6890,5,6,0,0,6,0
187806,10,1,0,0,1,0
187806,8,4,0,0,4,0
187806,5,7,0,0,7,0
187806,4,4,0,0,4,0
12369,4,1,0,0,1,0
12139,10,3,0,0,3,0
41532,10,3,0,0,3,0
41532,9,1,0,0,1,0
41532,4,2,0,0,2,0
41532,2,1,0,0,1,0
128290,8,1,0,0,1,0
128290,3,3,0,0,3,0
5669,5,4,0,0,4,0
5669,2,1,0,0,1,0
224999,9,1,0,0,1,0
224999,3,1,0,0,1,0
6350,8,2,0,0,2,0
6350,4,6,0,0,6,0
52332,10,1,0,0,1,0
52332,9,1,0,0,1,0
52332,5,2,0,0,2,0
8676,8,1,0,0,1,0
8676,7,1,0,0,1,0
36228,8,2,0,0,2,0
36228,7,5,0,0,5,0
36228,1,3,0,0,3,0
7640,6,3,0,0,3,0
7640,3,1,0,0,1,0
29291,10,1,0,0,1,0
29291,3,1,0,0,1,0
29291,2,1,0,0,1,0
176634,9,4,0,0,4,0
176634,5,6,0,0,6,0
176634,4,3,0,0,3,0
176634,3,1,0,0,1,0
18044,4,1,0,0,1,0
197076,4,1,0,0,1,0
7519,9,1,0,0,1,0
7519,5,6,0,0,6,0
7519,2,6,0,0,6,0
203715,4,2,0,0,2,0
203715,3,1,0,0,1,0
29517,9,1,0,0,1,0
29517,7,9,0,0,9,0
29517,5,4,0,0,4,0
29517,1,2,0,0,2,0
163963,10,1,0,0,1,0
163963,9,1,0,0,1,0
118539,9,1,0,0,1,0
118539,4,3,0,0,3,0
94363,9,1,0,0,1,0
94363,2,1,0,0,1,0
16325,10,4,0,0,4,0
16325,6,3,0,0,3,0
177977,8,5,0,0,5,0
177977,6,7,0,0,7,0
177977,5,1,0,0,1,0
177977,1,2,0,0,2,0
249817,10,2,0,0,2,0
249817,5,1,0,0,1,0
249817,3,1,0,0,1,0
104798,9,3,0,0,3,0
104798,3,1,0,0,1,0
104798,2,1,0,0,1,0
23243,9,1,0,0,1,0
23243,7,2,0,0,2,0
179,2,1,0,0,1,0
97512,5,2,0,0,2,0
97512,2,1,0,0,1,0
15391,5,2,0,0,2,0
15391,3,1,0,0,1,0
15391,1,1,0,0,1,0
5512,10,1,0,0,1,0
145963,9,1,0,0,1,0
145963,8,1,0,0,1,0
145963,7,3,0,0,3,0
145963,3,4,0,0,4,0
145963,2,3,0,0,3,0
145963,1,1,0,0,1,0
9246,10,1,0,0,1,0
9246,9,1,0,0,1,0
9246,8,4,0,0,4,0
9246,4,2,0,0,2,0
9246,3,1,0,0,1,0
9246,1,1,0,0,1,0
26353,9,1,0,0,1,0
26353,7,9,0,0,9,0
26353,3,1,0,0,1,0
36985,3,1,0,0,1,0
36985,2,1,0,0,1,0
218722,10,1,0,0,1,0
218722,9,1,0,0,1,0
218722,8,3,0,0,3,0
218722,7,8,0,0,8,0
218722,6,9,0,0,9,0
218722,5,9,0,0,9,0
218722,4,7,0,0,7,0
218722,3,2,0,0,2,0
218722,1,2,0,0,2,0
345,10,1,0,0,1,0
345,4,1,0,0,1,0
86754,6,14,0,0,14,0
86754,4,2,0,0,2,0
17352,8,7,0,0,7,0
17352,4,2,0,0,2,0
17352,2,1,0,0,1,0
22338,8,1,0,0,1,0
22338,2,2,0,0,2,0
22338,1,2,0,0,2,0
76540,10,1,0,0,1,0
76540,8,2,0,0,2,0
10310,5,2,0,0,2,0
93679,9,3,0,0,3,0
93679,4,3,0,0,3,0
8618,1,1,0,0,1,0
6721,4,1,0,0,1,0
18913,10,1,0,0,1,0
18913,9,2,0,0,2,0
167465,10,2,0,0,2,0
167465,6,6,0,0,6,0
167465,1,1,0,0,1,0
12062,3,1,0,0,1,0
604,8,3,0,0,3,0
604,4,6,0,0,6,0
604,2,1,0,0,1,0
25081,9,1,0,0,1,0
25081,8,2,0,0,2,0
25081,7,2,0,0,2,0
25081,4,7,0,0,7,0
188198,8,4,0,0,4,0
188198,6,17,0,0,17,0
188198,4,4,0,0,4,0
188198,3,1,0,0,1,0
209809,7,9,0,0,9,0
209809,5,1,0,0,1,0
209809,1,1,0,0,1,0
10419,9,1,0,0,1,0
187000,10,1,0,0,1,0
187000,9,1,0,0,1,0
187000,8,6,0,0,6,0
187000,5,1,0,0,1,0
187000,3,3,0,0,3,0
11177,3,3,0,0,3,0
11177,2,2,0,0,2,0
2210,6,5,0,0,5,0
2210,4,3,0,0,3,0
2210,2,1,0,0,1,0
2756,4,3,0,0,3,0
11635,10,1,0,0,1,0
11635,3,1,0,0,1,0
150276,10,3,0,0,3,0
150276,3,3,0,0,3,0
150276,2,1,0,0,1,0
150276,1,3,0,0,3,0
40446,10,2,0,0,2,0
40446,4,2,0,0,2,0
137173,3,1,0,0,1,0
147112,9,3,0,0,3,0
147112,7,6,0,0,6,0
147112,2,1,0,0,1,0
183401,8,7,0,0,7,0
237551,6,5,0,0,5,0
237551,2,1,0,0,1,0
8354,10,1,0,0,1,0
8354,5,3,0,0,3,0
7187,2,1,0,0,1,0
957,7,9,0,0,9,0
35499,10,1,0,0,1,0
35499,9,2,0,0,2,0
27667,10,1,0,0,1,0
27667,8,1,0,0,1,0
229527,9,4,0,0,4,0
229527,6,9,0,0,9,0
229527,5,1,0,0,1,0
229527,4,2,0,0,2,0
116975,8,1,0,0,1,0
116975,3,4,0,0,4,0
116975,2,3,0,0,3,0
116975,1,1,0,0,1,0
203818,10,3,0,0,3,0
203818,1,1,0,0,1,0
21685,5,1,0,0,1,0
21685,4,1,0,0,1,0
21685,3,1,0,0,1,0
36234,9,1,0,0,1,0
56195,10,2,0,0,2,0
56195,2,1,0,0,1,0
930,8,2,0,0,2,0
930,3,1,0,0,1,0
930,2,1,0,0,1,0
243437,9,2,0,0,2,0
148330,10,1,0,0,1,0
148330,5,4,0,0,4,0
148330,4,2,0,0,2,0
47475,9,7,0,0,7,0
14708,6,4,0,0,4,0
14708,4,8,0,0,8,0
108079,10,1,0,0,1,0
6563,9,1,0,0,1,0
6563,3,2,0,0,2,0
40559,8,1,0,0,1,0
40559,7,2,0,0,2,0
40559,4,6,0,0,6,0
11972,9,1,0,0,1,0
11972,3,2,0,0,2,0
245090,8,2,0,0,2,0
245090,5,1,0,0,1,0
8537,5,1,0,0,1,0
8537,4,1,0,0,1,0
66611,9,1,0,0,1,0
66611,8,3,0,0,3,0
66611,4,2,0,0,2,0
156461,8,5,0,0,5,0
156461,6,8,0,0,8,0
156461,3,4,0,0,4,0
49050,10,4,0,0,4,0
49050,9,6,0,0,6,0
49050,8,10,0,0,10,0
49050,7,12,0,0,12,0
49050,5,4,0,0,4,0
49050,2,1,0,0,1,0
7026,9,1,0,0,1,0
7026,5,2,0,0,2,0
227599,9,1,0,0,1,0
227599,6,9,0,0,9,0
227599,5,5,0,0,5,0
227599,4,2,0,0,2,0
227599,3,1,0,0,1,0
227599,2,3,0,0,3,0
7129,10,3,0,0,3,0
7129,9,1,0,0,1,0
7129,4,2,0,0,2,0
223947,3,1,0,0,1,0
200836,9,3,0,0,3,0
200836,3,1,0,0,1,0
32280,10,3,0,0,3,0
32280,6,7,0,0,7,0
32280,4,3,0,0,3,0
32280,3,3,0,0,3,0
2361,9,1,0,0,1,0
2361,8,3,0,0,3,0
2361,5,10,0,0,10,0
2361,3,2,0,0,2,0
270633,8,3,0,0,3,0
270633,7,1,0,0,1,0
270633,5,1,0,0,1,0
270633,3,1,0,0,1,0
24125,7,2,0,0,2,0
22126,6,3,0,0,3,0
22126,5,1,0,0,1,0
22126,3,1,0,0,1,0
16112,7,4,0,0,4,0
1989,8,2,0,0,2,0
1989,1,4,0,0,4,0
25754,8,1,0,0,1,0
25754,7,1,0,0,1,0
25754,1,1,0,0,1,0
39530,10,1,0,0,1,0
39530,4,1,0,0,1,0
39530,3,1,0,0,1,0
260268,6,8,0,0,8,0
260268,1,3,0,0,3,0
8410,10,4,0,0,4,0
8410,9,4,0,0,4,0
8410,1,2,0,0,2,0
138945,6,5,0,0,5,0
138945,5,4,0,0,4,0
145068,9,3,0,0,3,0
145068,5,3,0,0,3,0
145068,4,2,0,0,2,0
145068,3,2,0,0,2,0
145068,1,2,0,0,2,0
8700,10,1,0,0,1,0
8700,6,12,0,0,12,0
8700,2,1,0,0,1,0
8700,1,1,0,0,1,0
18529,6,1,0,0,1,0
18529,5,1,0,0,1,0
18529,1,1,0,0,1,0
2014,8,2,0,0,2,0
2014,5,3,0,0,3,0
2014,4,4,0,0,4,0
43169,10,4,0,0,4,0
43169,9,5,0,0,5,0
43169,6,8,0,0,8,0
43169,5,4,0,0,4,0
116231,10,1,0,0,1,0
116231,8,12,0,0,12,0
116231,7,12,0,0,12,0
116231,6,10,0,0,10,0
116231,5,3,0,0,3,0
116231,1,1,0,0,1,0
127572,3,2,0,0,2,0
147427,4,1,0,0,1,0
5728,5,4,0,0,4,0
11284,10,2,0,0,2,0
11284,9,6,0,0,6,0
11284,6,7,0,0,7,0
11284,3,1,0,0,1,0
11284,2,1,0,0,1,0
6486,7,4,0,0,4,0
6486,6,7,0,0,7,0
192696,10,1,0,0,1,0
192696,9,2,0,0,2,0
192696,6,9,0,0,9,0
192696,3,3,0,0,3,0
192696,2,1,0,0,1,0
83228,10,1,0,0,1,0
83228,4,1,0,0,1,0
244738,10,2,0,0,2,0
244738,8,2,0,0,2,0
244738,4,1,0,0,1,0
4812,7,2,0,0,2,0
4812,2,2,0,0,2,0
3298,8,1,0,0,1,0
3298,4,4,0,0,4,0
264638,9,2,0,0,2,0
264638,5,2,0,0,2,0
264638,4,1,0,0,1,0
131496,9,6,0,0,6,0
131496,7,6,0,0,6,0
131496,4,3,0,0,3,0
210414,10,5,0,0,5,0
210414,9,2,0,0,2,0
210414,8,7,0,0,7,0
210414,6,6,0,0,6,0
210414,1,1,0,0,1,0
230966,5,2,0,0,2,0
230966,4,1,0,0,1,0
10245,7,5,0,0,5,0
10245,5,1,0,0,1,0
10245,1,2,0,0,2,0
195158,10,5,0,0,5,0
195158,5,4,0,0,4,0
195158,1,3,0,0,3,0
7366,10,1,0,0,1,0
7366,9,1,0,0,1,0
7366,3,1,0,0,1,0
3682,9,1,0,0,1,0
3682,1,1,0,0,1,0
12683,3,3,0,0,3,0
145400,6,10,0,0,10,0
148273,9,1,0,0,1,0
148273,7,6,0,0,6,0
148273,6,5,0,0,5,0
148273,5,5,0,0,5,0
3634,10,1,0,0,1,0
41068,6,2,0,0,2,0
41068,3,2,0,0,2,0
13361,9,1,0,0,1,0
13361,4,3,0,0,3,0
13361,1,1,0,0,1,0
260218,6,3,0,0,3,0
260218,5,1,0,0,1,0
260218,4,1,0,0,1,0
36650,8,3,0,0,3,0
36650,4,5,0,0,5,0
36650,1,1,0,0,1,0
94684,8,4,0,0,4,0
94684,7,6,0,0,6,0
94684,2,1,0,0,1,0
94684,1,2,0,0,2,0
11800,9,1,0,0,1,0
11800,2,1,0,0,1,0
129955,9,1,0,0,1,0
129955,8,2,0,0,2,0
129955,3,2,0,0,2,0
7558,10,2,0,0,2,0
7558,4,1,0,0,1,0
7558,3,1,0,0,1,0
194575,10,1,0,0,1,0
194575,8,5,0,0,5,0
194575,7,5,0,0,5,0
194575,6,7,0,0,7,0
194575,5,5,0,0,5,0
194575,4,6,0,0,6,0
194575,3,4,0,0,4,0
194575,2,3,0,0,3,0
194575,1,3,0,0,3,0
18885,7,8,0,0,8,0
25789,9,1,0,0,1,0
25789,8,1,0,0,1,0
25789,7,1,0,0,1,0
25789,6,3,0,0,3,0
223222,9,2,0,0,2,0
223222,8,3,0,0,3,0
223222,5,7,0,0,7,0
223222,4,2,0,0,2,0
223222,3,1,0,0,1,0
39587,7,9,0,0,9,0
39587,4,3,0,0,3,0
39587,2,1,0,0,1,0
11167,7,1,0,0,1,0
11167,1,1,0,0,1,0
18084,10,1,0,0,1,0
18084,8,9,0,0,9,0
18084,6,17,0,0,17,0
18084,4,1,0,0,1,0
6124,4,2,0,0,2,0
11131,10,1,0,0,1,0
11131,9,1,0,0,1,0
40609,9,2,0,0,2,0
40609,4,4,0,0,4,0
40609,3,1,0,0,1,0
40609,2,1,0,0,1,0
244196,10,2,0,0,2,0
244196,9,9,0,0,9,0
244196,7,9,0,0,9,0
244196,6,3,0,0,3,0
244196,5,1,0,0,1,0
244196,3,1,0,0,1,0
31615,10,1,0,0,1,0
69638,9,2,0,0,2,0
30021,10,1,0,0,1,0
30021,3,1,0,0,1,0
265524,10,1,0,0,1,0
265524,9,4,0,0,4,0
265524,6,5,0,0,5,0
265524,4,2,0,0,2,0
265524,2,1,0,0,1,0
14881,10,4,0,0,4,0
14881,4,2,0,0,2,0
264242,9,1,0,0,1,0
264242,6,18,0,0,18,0
264242,5,5,0,0,5,0
264242,4,1,0,0,1,0
143023,10,3,0,0,3,0
143023,5,1,0,0,1,0
5790,10,1,0,0,1,0
5790,8,3,0,0,3,0
5427,9,1,0,0,1,0
5427,7,1,0,0,1,0
4486,6,6,0,0,6,0
4486,3,1,0,0,1,0
20954,4,1,0,0,1,0
7063,9,1,0,0,1,0
7063,7,9,0,0,9,0
7063,1,1,0,0,1,0
150220,10,1,0,0,1,0
267378,10,3,0,0,3,0
267378,6,5,0,0,5,0
267378,1,1,0,0,1,0
8159,4,2,0,0,2,0
8159,1,1,0,0,1,0
196342,4,2,0,0,2,0
209741,9,2,0,0,2,0
209741,4,1,0,0,1,0
209741,1,1,0,0,1,0
3500,10,1,0,0,1,0
3500,9,1,0,0,1,0
3500,3,2,0,0,2,0
25045,9,2,0,0,2,0
86033,4,4,0,0,4,0
86033,3,1,0,0,1,0
86033,2,1,0,0,1,0
25665,9,1,0,0,1,0
188753,5,5,0,0,5,0
188753,4,2,0,0,2,0
188753,3,3,0,0,3,0
6620,8,1,0,0,1,0
130357,6,2,0,0,2,0
130357,2,1,0,0,1,0
130357,1,2,0,0,2,0
49096,10,3,0,0,3,0
49096,9,3,0,0,3,0
49096,4,1,0,0,1,0
212668,8,5,0,0,5,0
212668,2,2,0,0,2,0
3398,8,1,0,0,1,0
3398,7,4,0,0,4,0
3398,2,2,0,0,2,0
3398,1,1,0,0,1,0
9932,10,1,0,0,1,0
15109,8,4,0,0,4,0
15109,7,6,0,0,6,0
15109,6,15,0,0,15,0
15109,5,4,0,0,4,0
15109,3,4,0,0,4,0
10561,9,1,0,0,1,0
10561,4,2,0,0,2,0
32327,4,1,0,0,1,0
32327,3,1,0,0,1,0
47170,6,8,0,0,8,0
47170,5,4,0,0,4,0
47170,1,5,0,0,5,0
32415,9,3,0,0,3,0
32415,8,4,0,0,4,0
32415,7,5,0,0,5,0
32415,4,9,0,0,9,0
14471,10,1,0,0,1,0
14471,7,9,0,0,9,0
14471,2,1,0,0,1,0
14471,1,1,0,0,1,0
63901,8,1,0,0,1,0
63901,5,6,0,0,6,0
63901,2,3,0,0,3,0
13623,9,1,0,0,1,0
13623,8,2,0,0,2,0
13623,3,1,0,0,1,0
253372,7,7,0,0,7,0
253372,6,3,0,0,3,0
22344,9,1,0,0,1,0
22344,7,9,0,0,9,0
22344,5,5,0,0,5,0
5864,4,1,0,0,1,0
5864,3,1,0,0,1,0
2404,9,1,0,0,1,0
10230,9,4,0,0,4,0
10230,5,1,0,0,1,0
10230,4,1,0,0,1,0
1200,7,4,0,0,4,0
1200,3,3,0,0,3,0
176859,8,1,0,0,1,0
176859,7,7,0,0,7,0
176859,5,8,0,0,8,0
176859,4,2,0,0,2,0
176859,3,3,0,0,3,0
176859,2,1,0,0,1,0
1424,8,1,0,0,1,0
1424,6,5,0,0,5,0
11530,8,4,0,0,4,0
11530,6,4,0,0,4,0
11530,3,4,0,0,4,0
61319,5,2,0,0,2,0
61319,4,1,0,0,1,0
5194,4,4,0,0,4,0
5194,3,1,0,0,1,0
238329,9,1,0,0,1,0
238329,7,7,0,0,7,0
238329,4,4,0,0,4,0
238329,3,2,0,0,2,0
246015,9,1,0,0,1,0
184560,3,1,0,0,1,0
184560,1,1,0,0,1,0
11824,7,1,0,0,1,0
11824,4,14,0,0,14,0
65575,3,1,0,0,1,0
87428,9,1,0,0,1,0
87428,3,1,0,0,1,0
39007,10,1,0,0,1,0
39007,5,2,0,0,2,0
195842,5,1,0,0,1,0
195842,4,1,0,0,1,0
35481,10,1,0,0,1,0
35481,5,4,0,0,4,0
35481,3,1,0,0,1,0
26918,9,3,0,0,3,0
262566,2,1,0,0,1,0
234314,10,8,0,0,8,0
234314,9,3,0,0,3,0
234314,3,1,0,0,1,0
9973,10,1,0,0,1,0
9973,9,1,0,0,1,0
9973,4,3,0,0,3,0
9973,3,1,0,0,1,0
26560,8,4,0,0,4,0
21366,9,6,0,0,6,0
21366,8,2,0,0,2,0
21366,7,1,0,0,1,0
21366,6,2,0,0,2,0
21366,5,1,0,0,1,0
21366,3,1,0,0,1,0
87929,8,1,0,0,1,0
64331,10,1,0,0,1,0
64331,5,2,0,0,2,0
64331,4,1,0,0,1,0
64331,3,1,0,0,1,0
40943,4,2,0,0,2,0
107938,8,1,0,0,1,0
107938,7,8,0,0,8,0
107938,3,2,0,0,2,0
107938,2,2,0,0,2,0
8365,10,1,0,0,1,0
8365,4,3,0,0,3,0
152115,6,4,0,0,4,0
152115,5,1,0,0,1,0
152115,4,1,0,0,1,0
1090,7,1,0,0,1,0
39372,8,2,0,0,2,0
39372,7,3,0,0,3,0
39372,6,5,0,0,5,0
39372,4,9,0,0,9,0
33023,7,2,0,0,2,0
33023,5,9,0,0,9,0
27388,3,1,0,0,1,0
27388,2,1,0,0,1,0
257924,10,1,0,0,1,0
257924,6,7,0,0,7,0
257924,4,2,0,0,2,0
257924,2,1,0,0,1,0
9357,9,2,0,0,2,0
26855,9,6,0,0,6,0
9597,4,3,0,0,3,0
9597,3,3,0,0,3,0
6913,10,1,0,0,1,0
6913,9,1,0,0,1,0
8448,1,3,0,0,3,0
150971,3,1,0,0,1,0
172875,7,9,0,0,9,0
172875,2,1,0,0,1,0
5197,9,1,0,0,1,0
5197,3,1,0,0,1,0
824,8,1,0,0,1,0
824,3,2,0,0,2,0
14034,7,6,0,0,6,0
14034,2,1,0,0,1,0
8848,10,1,0,0,1,0
8848,8,6,0,0,6,0
8848,3,1,0,0,1,0
21437,9,1,0,0,1,0
21437,8,6,0,0,6,0
21437,4,2,0,0,2,0
21437,2,1,0,0,1,0
2493,8,1,0,0,1,0
2493,6,8,0,0,8,0
49394,10,5,0,0,5,0
49394,9,7,0,0,7,0
49394,5,1,0,0,1,0
201551,6,3,0,0,3,0
201551,1,1,0,0,1,0
8426,10,1,0,0,1,0
6771,4,2,0,0,2,0
33288,6,7,0,0,7,0
33288,3,6,0,0,6,0
33288,1,1,0,0,1,0
200593,7,13,0,0,13,0
200593,5,2,0,0,2,0
200593,4,2,0,0,2,0
130042,10,2,0,0,2,0
116970,8,4,0,0,4,0
116970,4,3,0,0,3,0
246355,10,5,0,0,5,0
246355,3,1,0,0,1,0
227527,10,2,0,0,2,0
227527,9,2,0,0,2,0
146299,7,2,0,0,2,0
146299,5,10,0,0,10,0
146299,4,4,0,0,4,0
146299,1,3,0,0,3,0
6744,9,1,0,0,1,0
6744,5,2,0,0,2,0
6744,3,2,0,0,2,0
28755,1,1,0,0,1,0
8356,3,1,0,0,1,0
258544,10,1,0,0,1,0
258544,5,3,0,0,3,0
258544,2,1,0,0,1,0
19044,10,1,0,0,1,0
19044,9,1,0,0,1,0
19044,3,1,0,0,1,0
257063,5,1,0,0,1,0
235494,6,2,0,0,2,0
235494,1,1,0,0,1,0
34403,5,2,0,0,2,0
34403,1,1,0,0,1,0
5933,5,7,0,0,7,0
5933,4,2,0,0,2,0
5933,3,1,0,0,1,0
78436,5,3,0,0,3,0
78436,3,3,0,0,3,0
17996,10,1,0,0,1,0
17996,8,14,0,0,14,0
17996,5,3,0,0,3,0
41310,3,1,0,0,1,0
41310,2,1,0,0,1,0
3686,10,1,0,0,1,0
3686,8,1,0,0,1,0
3686,7,2,0,0,2,0
3686,2,1,0,0,1,0
3686,1,1,0,0,1,0
145632,9,1,0,0,1,0
145632,8,3,0,0,3,0
145632,7,9,0,0,9,0
145632,1,1,0,0,1,0
4735,3,5,0,0,5,0
137331,8,4,0,0,4,0
137331,5,7,0,0,7,0
137331,4,5,0,0,5,0
137331,2,1,0,0,1,0
220843,9,1,0,0,1,0
220843,2,1,0,0,1,0
20135,8,1,0,0,1,0
20135,6,4,0,0,4,0
20135,5,9,0,0,9,0
20135,2,2,0,0,2,0
25469,7,3,0,0,3,0
25469,3,3,0,0,3,0
25469,2,1,0,0,1,0
42641,10,1,0,0,1,0
3144,3,1,0,0,1,0
7746,5,7,0,0,7,0
4574,10,1,0,0,1,0
4574,9,1,0,0,1,0
21577,1,1,0,0,1,0
42062,8,4,0,0,4,0
42062,7,3,0,0,3,0
136523,9,1,0,0,1,0
136523,8,3,0,0,3,0
136523,4,6,0,0,6,0
136523,3,1,0,0,1,0
136523,2,1,0,0,1,0
21488,10,1,0,0,1,0
39278,10,2,0,0,2,0
39278,6,1,0,0,1,0
39278,1,1,0,0,1,0
257964,7,13,0,0,13,0
257964,4,4,0,0,4,0
257964,3,2,0,0,2,0
257964,2,1,0,0,1,0
257964,1,1,0,0,1,0
114405,3,1,0,0,1,0
22203,6,4,0,0,4,0
22203,1,1,0,0,1,0
9913,10,3,0,0,3,0
9913,9,1,0,0,1,0
9913,4,2,0,0,2,0
5156,9,1,0,0,1,0
64431,9,2,0,0,2,0
64431,6,15,0,0,15,0
64431,4,4,0,0,4,0
130922,3,1,0,0,1,0
130922,2,1,0,0,1,0
130922,1,1,0,0,1,0
7752,6,3,0,0,3,0
8446,10,1,0,0,1,0
8446,4,4,0,0,4,0
8455,10,1,0,0,1,0
8455,8,1,0,0,1,0
8455,2,1,0,0,1,0
199766,10,2,0,0,2,0
199766,5,2,0,0,2,0
199766,4,1,0,0,1,0
199766,1,1,0,0,1,0
262273,4,1,0,0,1,0
262273,2,1,0,0,1,0
50356,5,3,0,0,3,0
50356,1,3,0,0,3,0
11235,9,1,0,0,1,0
11235,8,2,0,0,2,0
1120,7,7,0,0,7,0
1120,4,1,0,0,1,0
1120,2,1,0,0,1,0
73091,10,3,0,0,3,0
81486,9,1,0,0,1,0
81486,4,6,0,0,6,0
81486,2,1,0,0,1,0
81486,1,1,0,0,1,0
1550,10,1,0,0,1,0
14709,10,3,0,0,3,0
14709,5,2,0,0,2,0
101766,4,5,0,0,5,0
16802,8,3,0,0,3,0
16802,5,7,0,0,7,0
249746,9,8,0,0,8,0
249746,4,1,0,0,1,0
58139,8,1,0,0,1,0
58139,5,5,0,0,5,0
97329,10,2,0,0,2,0
97329,9,1,0,0,1,0
97329,4,1,0,0,1,0
97329,3,1,0,0,1,0
203381,10,4,0,0,4,0
203381,9,3,0,0,3,0
203381,7,13,0,0,13,0
203381,5,3,0,0,3,0
166972,8,1,0,0,1,0
166972,5,7,0,0,7,0
166972,3,2,0,0,2,0
209090,5,1,0,0,1,0
167466,8,2,0,0,2,0
167466,7,11,0,0,11,0
167466,5,7,0,0,7,0
167466,4,3,0,0,3,0
167466,3,1,0,0,1,0
2697,8,1,0,0,1,0
2697,4,5,0,0,5,0
192225,10,1,0,0,1,0
192225,8,3,0,0,3,0
192225,4,3,0,0,3,0
242630,9,4,0,0,4,0
242630,7,7,0,0,7,0
242630,6,3,0,0,3,0
242630,5,1,0,0,1,0
242630,3,1,0,0,1,0
26920,10,1,0,0,1,0
26920,9,1,0,0,1,0
26920,1,1,0,0,1,0
9471,9,1,0,0,1,0
9471,5,6,0,0,6,0
9471,3,3,0,0,3,0
9471,2,2,0,0,2,0
126069,5,2,0,0,2,0
126069,4,2,0,0,2,0
177061,10,1,0,0,1,0
177061,6,7,0,0,7,0
177061,4,2,0,0,2,0
177061,3,1,0,0,1,0
177061,1,1,0,0,1,0
121043,8,6,0,0,6,0
121043,4,1,0,0,1,0
121043,3,1,0,0,1,0
6367,7,1,0,0,1,0
25246,7,12,0,0,12,0
18341,6,1,0,0,1,0
18341,5,1,0,0,1,0
18341,1,1,0,0,1,0
158589,4,2,0,0,2,0
10820,7,5,0,0,5,0
10820,3,4,0,0,4,0
111841,10,1,0,0,1,0
111841,7,6,0,0,6,0
198991,10,1,0,0,1,0
198991,9,2,0,0,2,0
198991,4,3,0,0,3,0
184044,9,2,0,0,2,0
184044,8,2,0,0,2,0
184044,7,2,0,0,2,0
184044,1,1,0,0,1,0
104770,10,1,0,0,1,0
104770,9,1,0,0,1,0
104770,7,4,0,0,4,0
104770,2,2,0,0,2,0
104770,1,1,0,0,1,0
246310,6,8,0,0,8,0
246310,5,1,0,0,1,0
124598,4,1,0,0,1,0
22186,10,1,0,0,1,0
22186,9,3,0,0,3,0
22186,4,1,0,0,1,0
22186,3,1,0,0,1,0
5649,10,1,0,0,1,0
5649,1,1,0,0,1,0
13667,4,1,0,0,1,0
23999,9,3,0,0,3,0
16649,9,2,0,0,2,0
16649,3,2,0,0,2,0
203002,10,2,0,0,2,0
203002,9,2,0,0,2,0
203002,8,7,0,0,7,0
203002,7,5,0,0,5,0
203002,6,16,0,0,16,0
203002,5,6,0,0,6,0
203002,3,1,0,0,1,0
216367,10,2,0,0,2,0
216367,9,1,0,0,1,0
216367,7,15,0,0,15,0
216367,3,1,0,0,1,0
9633,1,1,0,0,1,0
6874,9,2,0,0,2,0
14715,10,2,0,0,2,0
14715,9,4,0,0,4,0
140995,6,6,0,0,6,0
140995,5,2,0,0,2,0
140995,4,1,0,0,1,0
140995,1,1,0,0,1,0
119525,9,1,0,0,1,0
119525,8,2,0,0,2,0
119525,3,1,0,0,1,0
4561,10,2,0,0,2,0
4561,8,2,0,0,2,0
4561,7,8,0,0,8,0
4561,4,3,0,0,3,0
4561,2,2,0,0,2,0
2391,7,4,0,0,4,0
204617,10,1,0,0,1,0
204617,8,1,0,0,1,0
204617,7,11,0,0,11,0
204617,5,4,0,0,4,0
204617,3,2,0,0,2,0
245206,10,1,0,0,1,0
245206,7,7,0,0,7,0
245206,6,8,0,0,8,0
245206,4,4,0,0,4,0
208801,5,3,0,0,3,0
200871,5,3,0,0,3,0
200871,3,1,0,0,1,0
200871,2,1,0,0,1,0
156118,8,2,0,0,2,0
156118,7,4,0,0,4,0
156118,5,4,0,0,4,0
11600,8,2,0,0,2,0
11600,4,4,0,0,4,0
11600,1,2,0,0,2,0
202025,9,2,0,0,2,0
202025,8,1,0,0,1,0
202025,3,2,0,0,2,0
255702,10,1,0,0,1,0
255702,4,3,0,0,3,0
169470,10,1,0,0,1,0
169470,9,1,0,0,1,0
169470,3,1,0,0,1,0
24447,9,1,0,0,1,0
24447,2,1,0,0,1,0
107703,10,1,0,0,1,0
187801,10,1,0,0,1,0
22464,10,1,0,0,1,0
9113,10,1,0,0,1,0
9113,3,1,0,0,1,0
67499,9,1,0,0,1,0
67499,8,2,0,0,2,0
67499,5,4,0,0,4,0
67499,4,3,0,0,3,0
67499,3,2,0,0,2,0
25104,9,1,0,0,1,0
25104,8,1,0,0,1,0
25104,6,12,0,0,12,0
25104,3,2,0,0,2,0
2283,10,1,0,0,1,0
2283,8,1,0,0,1,0
2283,7,2,0,0,2,0
203083,9,1,0,0,1,0
203083,8,10,0,0,10,0
172159,5,3,0,0,3,0
172159,2,1,0,0,1,0
8670,8,1,0,0,1,0
8670,4,6,0,0,6,0
8670,3,1,0,0,1,0
8670,2,1,0,0,1,0
136246,4,5,0,0,5,0
136246,3,1,0,0,1,0
34096,6,14,0,0,14,0
34096,5,9,0,0,9,0
34096,4,2,0,0,2,0
34096,3,1,0,0,1,0
1221,10,1,0,0,1,0
1221,8,2,0,0,2,0
1221,3,3,0,0,3,0
196634,1,1,0,0,1,0
5089,9,2,0,0,2,0
5089,8,2,0,0,2,0
3156,4,2,0,0,2,0
3156,3,2,0,0,2,0
5209,4,3,0,0,3,0
5209,1,2,0,0,2,0
810,2,1,0,0,1,0
184797,9,4,0,0,4,0
184797,6,9,0,0,9,0
184797,5,2,0,0,2,0
20131,3,2,0,0,2,0
6129,10,1,0,0,1,0
6129,9,1,0,0,1,0
6129,8,2,0,0,2,0
154180,9,1,0,0,1,0
154180,3,1,0,0,1,0
177995,10,1,0,0,1,0
177995,9,2,0,0,2,0
177995,5,1,0,0,1,0
177995,1,1,0,0,1,0
7693,9,1,0,0,1,0
7693,8,1,0,0,1,0
7693,7,1,0,0,1,0
7693,6,3,0,0,3,0
161543,3,1,0,0,1,0
161543,1,1,0,0,1,0
219348,10,3,0,0,3,0
219348,9,1,0,0,1,0
219348,5,5,0,0,5,0
219348,4,1,0,0,1,0
219348,2,1,0,0,1,0
103811,10,1,0,0,1,0
103811,8,3,0,0,3,0
103811,7,6,0,0,6,0
103811,6,11,0,0,11,0
103811,2,2,0,0,2,0
103811,1,1,0,0,1,0
5617,9,1,0,0,1,0
5617,7,3,0,0,3,0
4976,8,2,0,0,2,0
188968,10,1,0,0,1,0
19257,6,4,0,0,4,0
19257,3,1,0,0,1,0
18097,10,1,0,0,1,0
18097,9,1,0,0,1,0
18097,8,1,0,0,1,0
18097,5,7,0,0,7,0
18097,2,3,0,0,3,0
229243,9,1,0,0,1,0
229243,8,3,0,0,3,0
229243,7,6,0,0,6,0
229243,4,3,0,0,3,0
229243,3,2,0,0,2,0
168005,9,1,0,0,1,0
168005,8,1,0,0,1,0
168005,3,4,0,0,4,0
168005,2,1,0,0,1,0
18679,10,1,0,0,1,0
18679,8,2,0,0,2,0
40804,10,4,0,0,4,0
40804,4,2,0,0,2,0
40804,2,2,0,0,2,0
175868,10,1,0,0,1,0
175868,8,7,0,0,7,0
175868,7,11,0,0,11,0
175868,4,3,0,0,3,0
175868,1,1,0,0,1,0
153486,10,1,0,0,1,0
153486,5,1,0,0,1,0
153486,1,1,0,0,1,0
209506,9,1,0,0,1,0
209506,5,6,0,0,6,0
209506,4,2,0,0,2,0
192730,9,2,0,0,2,0
192730,8,3,0,0,3,0
192730,4,1,0,0,1,0
192730,3,1,0,0,1,0
10885,9,1,0,0,1,0
10885,1,1,0,0,1,0
3371,8,1,0,0,1,0
3371,3,5,0,0,5,0
3371,1,1,0,0,1,0
172729,8,1,0,0,1,0
172729,3,7,0,0,7,0
239189,8,4,0,0,4,0
239189,7,2,0,0,2,0
239189,2,2,0,0,2,0
153372,8,6,0,0,6,0
153372,6,8,0,0,8,0
153372,5,3,0,0,3,0
153372,3,4,0,0,4,0
95695,9,1,0,0,1,0
95695,7,4,0,0,4,0
95695,6,7,0,0,7,0
95695,3,4,0,0,4,0
111097,10,2,0,0,2,0
111097,7,5,0,0,5,0
111097,4,1,0,0,1,0
111097,3,3,0,0,3,0
43080,8,3,0,0,3,0
184664,6,9,0,0,9,0
184664,2,1,0,0,1,0
206666,10,3,0,0,3,0
206666,9,2,0,0,2,0
206666,5,2,0,0,2,0
206666,4,3,0,0,3,0
206666,1,1,0,0,1,0
234299,5,3,0,0,3,0
234299,4,1,0,0,1,0
234299,2,1,0,0,1,0
7986,4,2,0,0,2,0
132406,10,1,0,0,1,0
132406,9,1,0,0,1,0
132406,4,3,0,0,3,0
132406,2,1,0,0,1,0
16530,8,1,0,0,1,0
16530,1,6,0,0,6,0
611,9,1,0,0,1,0
611,3,1,0,0,1,0
9339,10,1,0,0,1,0
9339,7,10,0,0,10,0
9339,5,3,0,0,3,0
9339,3,1,0,0,1,0
16432,10,1,0,0,1,0
222424,4,3,0,0,3,0
222424,3,1,0,0,1,0
235513,10,1,0,0,1,0
235513,8,6,0,0,6,0
235513,7,4,0,0,4,0
235513,5,8,0,0,8,0
235513,4,2,0,0,2,0
146309,5,5,0,0,5,0
146309,4,4,0,0,4,0
146309,3,2,0,0,2,0
146309,2,2,0,0,2,0
146309,1,1,0,0,1,0
153484,10,1,0,0,1,0
153484,8,3,0,0,3,0
153484,4,4,0,0,4,0
153484,2,2,0,0,2,0
37142,10,1,0,0,1,0
37142,5,6,0,0,6,0
241490,8,2,0,0,2,0
191879,9,3,0,0,3,0
191879,7,5,0,0,5,0
191879,3,1,0,0,1,0
191879,1,1,0,0,1,0
145586,8,1,0,0,1,0
145586,5,2,0,0,2,0
145586,4,2,0,0,2,0
145586,3,1,0,0,1,0
4340,3,1,0,0,1,0
25248,7,2,0,0,2,0
25248,5,11,0,0,11,0
25248,3,2,0,0,2,0
25248,2,2,0,0,2,0
8457,10,1,0,0,1,0
8457,9,1,0,0,1,0
216631,10,2,0,0,2,0
216631,9,1,0,0,1,0
216631,8,1,0,0,1,0
216631,4,3,0,0,3,0
206068,7,14,0,0,14,0
206068,6,2,0,0,2,0
206068,5,2,0,0,2,0
206068,1,1,0,0,1,0
38836,7,8,0,0,8,0
38836,3,1,0,0,1,0
18536,4,2,0,0,2,0
18536,3,1,0,0,1,0
37392,4,2,0,0,2,0
1660,10,1,0,0,1,0
1660,8,1,0,0,1,0
1660,7,1,0,0,1,0
161126,7,2,0,0,2,0
12043,10,1,0,0,1,0
12043,5,6,0,0,6,0
12043,3,4,0,0,4,0
12043,2,2,0,0,2,0
12043,1,1,0,0,1,0
13672,7,1,0,0,1,0
13672,6,1,0,0,1,0
13672,5,6,0,0,6,0
13672,2,3,0,0,3,0
13672,1,3,0,0,3,0
245203,6,11,0,0,11,0
245203,2,2,0,0,2,0
257313,10,2,0,0,2,0
257313,6,7,0,0,7,0
257313,1,1,0,0,1,0
146262,9,2,0,0,2,0
146262,8,4,0,0,4,0
146262,5,5,0,0,5,0
146262,4,1,0,0,1,0
100798,10,4,0,0,4,0
100798,6,6,0,0,6,0
100798,5,3,0,0,3,0
100798,4,1,0,0,1,0
16760,9,1,0,0,1,0
16760,4,3,0,0,3,0
16760,3,1,0,0,1,0
11469,10,1,0,0,1,0
11469,9,1,0,0,1,0
15957,7,2,0,0,2,0
15957,4,1,0,0,1,0
178933,10,2,0,0,2,0
178933,8,4,0,0,4,0
178933,7,5,0,0,5,0
178933,2,1,0,0,1,0
201243,9,1,0,0,1,0
201243,7,3,0,0,3,0
201243,4,3,0,0,3,0
201243,3,2,0,0,2,0
5742,9,1,0,0,1,0
5742,8,3,0,0,3,0
5742,6,7,0,0,7,0
5742,2,1,0,0,1,0
5742,1,1,0,0,1,0
29107,10,1,0,0,1,0
29107,4,3,0,0,3,0
29107,2,1,0,0,1,0
15427,7,1,0,0,1,0
9607,8,1,0,0,1,0
9607,4,2,0,0,2,0
882,7,9,0,0,9,0
882,2,1,0,0,1,0
228550,9,3,0,0,3,0
228550,5,2,0,0,2,0
38562,10,8,0,0,8,0
38562,6,4,0,0,4,0
38562,5,1,0,0,1,0
38562,1,1,0,0,1,0
20694,2,3,0,0,3,0
20694,1,2,0,0,2,0
244817,10,1,0,0,1,0
244817,9,1,0,0,1,0
244817,8,7,0,0,7,0
244817,4,1,0,0,1,0
244817,2,1,0,0,1,0
248702,10,1,0,0,1,0
248702,9,4,0,0,4,0
248702,5,4,0,0,4,0
248702,4,2,0,0,2,0
10855,8,1,0,0,1,0
10855,4,1,0,0,1,0
10855,3,1,0,0,1,0
9489,5,2,0,0,2,0
9489,1,1,0,0,1,0
143459,3,2,0,0,2,0
18687,10,2,0,0,2,0
18687,9,4,0,0,4,0
18687,5,2,0,0,2,0
17239,5,1,0,0,1,0
224010,5,2,0,0,2,0
224010,4,5,0,0,5,0
224010,2,1,0,0,1,0
36639,9,1,0,0,1,0
7939,8,1,0,0,1,0
7939,3,1,0,0,1,0
11674,9,1,0,0,1,0
11674,4,1,0,0,1,0
11674,1,1,0,0,1,0
164010,9,2,0,0,2,0
164010,7,7,0,0,7,0
164010,5,2,0,0,2,0
164010,3,1,0,0,1,0
164010,2,1,0,0,1,0
15334,10,1,0,0,1,0
15334,3,1,0,0,1,0
15334,2,2,0,0,2,0
20379,9,3,0,0,3,0
20379,5,1,0,0,1,0
20379,1,1,0,0,1,0
102150,4,2,0,0,2,0
9835,10,1,0,0,1,0
9835,5,3,0,0,3,0
99696,10,3,0,0,3,0
99696,9,4,0,0,4,0
99696,2,1,0,0,1,0
6232,5,4,0,0,4,0
6232,2,2,0,0,2,0
6920,5,5,0,0,5,0
6920,3,1,0,0,1,0
6920,1,1,0,0,1,0
253608,2,1,0,0,1,0
213301,6,3,0,0,3,0
213301,3,2,0,0,2,0
249868,6,1,0,0,1,0
173240,9,1,0,0,1,0
173240,8,8,0,0,8,0
173240,7,8,0,0,8,0
173240,4,2,0,0,2,0
6417,5,7,0,0,7,0
6417,3,1,0,0,1,0
93271,7,5,0,0,5,0
93271,4,4,0,0,4,0
93271,3,1,0,0,1,0
93271,2,3,0,0,3,0
94456,9,1,0,0,1,0
94456,3,1,0,0,1,0
16030,4,1,0,0,1,0
8589,3,1,0,0,1,0
177014,7,1,0,0,1,0
177014,5,2,0,0,2,0
177014,3,1,0,0,1,0
177014,1,1,0,0,1,0
212883,9,1,0,0,1,0
212883,8,6,0,0,6,0
212883,4,2,0,0,2,0
212883,2,1,0,0,1,0
212883,1,1,0,0,1,0
6659,8,1,0,0,1,0
6659,7,1,0,0,1,0
6659,3,5,0,0,5,0
26956,4,1,0,0,1,0
26956,3,2,0,0,2,0
26956,2,1,0,0,1,0
3666,5,4,0,0,4,0
3666,3,1,0,0,1,0
208073,10,1,0,0,1,0
208073,9,3,0,0,3,0
208073,6,11,0,0,11,0
208073,2,2,0,0,2,0
3830,10,1,0,0,1,0
3830,7,3,0,0,3,0
3830,1,1,0,0,1,0
34374,3,1,0,0,1,0
167552,5,2,0,0,2,0
60280,10,2,0,0,2,0
60280,5,2,0,0,2,0
94633,7,5,0,0,5,0
94633,4,2,0,0,2,0
94633,2,1,0,0,1,0
94633,1,1,0,0,1,0
148973,3,4,0,0,4,0
148973,2,2,0,0,2,0
4897,3,1,0,0,1,0
36333,10,1,0,0,1,0
121790,8,4,0,0,4,0
121790,7,8,0,0,8,0
121790,4,1,0,0,1,0
121790,1,1,0,0,1,0
16723,8,1,0,0,1,0
16723,7,2,0,0,2,0
16723,6,9,0,0,9,0
16723,1,2,0,0,2,0
3760,8,5,0,0,5,0
3760,5,7,0,0,7,0
3760,4,3,0,0,3,0
3760,3,1,0,0,1,0
8743,4,1,0,0,1,0
99038,4,1,0,0,1,0
22380,8,3,0,0,3,0
22380,7,2,0,0,2,0
174688,10,2,0,0,2,0
174688,6,3,0,0,3,0
3719,7,3,0,0,3,0
257991,10,6,0,0,6,0
257991,4,2,0,0,2,0
6699,10,4,0,0,4,0
6699,5,4,0,0,4,0
6699,1,1,0,0,1,0
151603,9,1,0,0,1,0
151603,8,1,0,0,1,0
151603,5,10,0,0,10,0
151603,2,1,0,0,1,0
42660,2,1,0,0,1,0
181246,5,13,0,0,13,0
271321,6,6,0,0,6,0
271321,5,3,0,0,3,0
271321,4,2,0,0,2,0
12691,8,1,0,0,1,0
12691,6,1,0,0,1,0
11052,9,2,0,0,2,0
218923,9,1,0,0,1,0
218923,6,8,0,0,8,0
218923,5,3,0,0,3,0
218923,3,1,0,0,1,0
183883,10,1,0,0,1,0
183883,7,4,0,0,4,0
183883,6,11,0,0,11,0
183883,5,6,0,0,6,0
183883,3,1,0,0,1,0
224678,5,2,0,0,2,0
8382,10,2,0,0,2,0
8382,9,2,0,0,2,0
244946,6,1,0,0,1,0
98261,10,2,0,0,2,0
98261,9,1,0,0,1,0
98261,7,13,0,0,13,0
98261,5,3,0,0,3,0
8358,10,1,0,0,1,0
8358,5,1,0,0,1,0
6338,8,11,0,0,11,0
6338,4,1,0,0,1,0
6995,10,1,0,0,1,0
6995,4,2,0,0,2,0
6995,3,1,0,0,1,0
178177,8,5,0,0,5,0
178177,5,4,0,0,4,0
178177,3,1,0,0,1,0
188952,9,2,0,0,2,0
188952,5,3,0,0,3,0
188952,2,1,0,0,1,0
36905,10,1,0,0,1,0
36905,6,7,0,0,7,0
36905,5,6,0,0,6,0
36905,3,5,0,0,5,0
36905,1,1,0,0,1,0
7622,9,3,0,0,3,0
7622,3,1,0,0,1,0
22866,10,1,0,0,1,0
22866,5,12,0,0,12,0
22866,2,1,0,0,1,0
35466,10,2,0,0,2,0
35466,3,1,0,0,1,0
23970,10,3,0,0,3,0
23970,8,1,0,0,1,0
23970,2,2,0,0,2,0
8405,10,1,0,0,1,0
8405,4,2,0,0,2,0
8405,2,1,0,0,1,0
66276,9,1,0,0,1,0
66276,7,5,0,0,5,0
66276,6,10,0,0,10,0
66276,5,11,0,0,11,0
66276,3,2,0,0,2,0
66276,1,1,0,0,1,0
22176,10,2,0,0,2,0
22176,5,2,0,0,2,0
161682,5,1,0,0,1,0
40376,9,1,0,0,1,0
40376,8,2,0,0,2,0
40376,3,5,0,0,5,0
143085,4,1,0,0,1,0
143085,3,1,0,0,1,0
18945,9,2,0,0,2,0
18945,2,2,0,0,2,0
652,8,1,0,0,1,0
652,7,9,0,0,9,0
652,6,14,0,0,14,0
652,4,1,0,0,1,0
652,3,1,0,0,1,0
239082,6,11,0,0,11,0
239082,3,1,0,0,1,0
25991,10,1,0,0,1,0
25991,9,1,0,0,1,0
25991,2,1,0,0,1,0
19368,7,2,0,0,2,0
130823,2,2,0,0,2,0
21269,7,3,0,0,3,0
21269,4,1,0,0,1,0
21269,1,1,0,0,1,0
13837,10,2,0,0,2,0
26017,9,1,0,0,1,0
26017,8,1,0,0,1,0
26017,3,4,0,0,4,0
26017,1,1,0,0,1,0
223742,10,2,0,0,2,0
223742,9,2,0,0,2,0
223742,8,6,0,0,6,0
223742,5,6,0,0,6,0
223742,4,1,0,0,1,0
223742,2,1,0,0,1,0
2172,10,1,0,0,1,0
2172,8,3,0,0,3,0
2172,3,1,0,0,1,0
2172,2,1,0,0,1,0
4265,4,2,0,0,2,0
149035,1,1,0,0,1,0
162888,7,5,0,0,5,0
162888,6,1,0,0,1,0
162888,5,2,0,0,2,0
162888,4,4,0,0,4,0
162888,2,1,0,0,1,0
231575,5,1,0,0,1,0
231575,4,2,0,0,2,0
5492,3,1,0,0,1,0
136856,7,6,0,0,6,0
136856,5,9,0,0,9,0
136856,3,1,0,0,1,0
136856,2,2,0,0,2,0
8456,10,1,0,0,1,0
8456,8,2,0,0,2,0
203673,3,1,0,0,1,0
203673,2,1,0,0,1,0
147465,5,6,0,0,6,0
147465,4,2,0,0,2,0
6896,10,1,0,0,1,0
6896,7,11,0,0,11,0
6896,3,1,0,0,1,0
6896,2,1,0,0,1,0
141250,8,2,0,0,2,0
141250,7,3,0,0,3,0
141250,2,1,0,0,1,0
243697,5,1,0,0,1,0
243697,4,1,0,0,1,0
73361,5,2,0,0,2,0
181080,9,1,0,0,1,0
181080,8,1,0,0,1,0
181080,2,2,0,0,2,0
209716,6,9,0,0,9,0
209716,3,1,0,0,1,0
144420,9,2,0,0,2,0
144420,8,8,0,0,8,0
144420,7,7,0,0,7,0
144420,5,6,0,0,6,0
144420,4,3,0,0,3,0
144420,2,2,0,0,2,0
151468,9,1,0,0,1,0
151468,4,3,0,0,3,0
151468,1,2,0,0,2,0
12160,9,1,0,0,1,0
209748,8,6,0,0,6,0
209748,4,2,0,0,2,0
3108,9,1,0,0,1,0
3108,3,1,0,0,1,0
11421,10,1,0,0,1,0
11421,9,2,0,0,2,0
11421,3,2,0,0,2,0
5459,1,1,0,0,1,0
255970,10,2,0,0,2,0
255970,9,3,0,0,3,0
255970,6,11,0,0,11,0
255970,5,1,0,0,1,0
255970,2,1,0,0,1,0
138729,7,6,0,0,6,0
138729,4,1,0,0,1,0
138729,1,2,0,0,2,0
68504,4,2,0,0,2,0
68504,2,1,0,0,1,0
237800,6,7,0,0,7,0
237800,5,1,0,0,1,0
180595,9,1,0,0,1,0
180595,1,2,0,0,2,0
124761,5,5,0,0,5,0
124761,4,2,0,0,2,0
167238,9,1,0,0,1,0
167238,1,1,0,0,1,0
246814,10,2,0,0,2,0
246814,9,2,0,0,2,0
246814,6,11,0,0,11,0
246814,2,1,0,0,1,0
246814,1,2,0,0,2,0
9259,10,2,0,0,2,0
8221,10,1,0,0,1,0
8221,9,1,0,0,1,0
15238,3,2,0,0,2,0
177868,9,2,0,0,2,0
177868,5,4,0,0,4,0
177868,3,1,0,0,1,0
58672,9,2,0,0,2,0
58672,8,2,0,0,2,0
58672,7,3,0,0,3,0
58672,3,1,0,0,1,0
58672,1,1,0,0,1,0
15490,8,1,0,0,1,0
15490,7,2,0,0,2,0
15490,3,2,0,0,2,0
257089,10,3,0,0,3,0
257089,6,1,0,0,1,0
257089,5,1,0,0,1,0
257089,3,1,0,0,1,0
1925,8,1,0,0,1,0
225235,10,3,0,0,3,0
225235,9,4,0,0,4,0
225235,6,5,0,0,5,0
225235,5,2,0,0,2,0
58003,9,2,0,0,2,0
58003,7,10,0,0,10,0
58003,5,2,0,0,2,0
25994,4,1,0,0,1,0
21529,8,1,0,0,1,0
237174,6,3,0,0,3,0
237174,5,1,0,0,1,0
237174,4,1,0,0,1,0
32828,8,2,0,0,2,0
58375,8,1,0,0,1,0
3716,10,1,0,0,1,0
3716,9,2,0,0,2,0
3716,5,2,0,0,2,0
3716,2,1,0,0,1,0
92465,10,1,0,0,1,0
92465,8,10,0,0,10,0
92465,7,8,0,0,8,0
92465,6,10,0,0,10,0
92465,5,4,0,0,4,0
14377,4,1,0,0,1,0
14377,3,1,0,0,1,0
7947,9,1,0,0,1,0
7947,8,2,0,0,2,0
152848,3,1,0,0,1,0
164829,3,2,0,0,2,0
164829,2,1,0,0,1,0
198548,10,1,0,0,1,0
198548,9,1,0,0,1,0
2074,9,1,0,0,1,0
2074,8,1,0,0,1,0
2074,6,6,0,0,6,0
2074,3,4,0,0,4,0
2074,1,1,0,0,1,0
182168,9,1,0,0,1,0
182168,7,8,0,0,8,0
182168,5,8,0,0,8,0
182168,3,2,0,0,2,0
230995,7,7,0,0,7,0
230995,6,7,0,0,7,0
230995,5,8,0,0,8,0
230995,4,4,0,0,4,0
230995,3,3,0,0,3,0
239452,1,1,0,0,1,0
15542,7,6,0,0,6,0
15542,1,2,0,0,2,0
12243,8,1,0,0,1,0
12243,1,1,0,0,1,0
38418,8,1,0,0,1,0
38418,7,3,0,0,3,0
38418,6,9,0,0,9,0
38418,3,4,0,0,4,0
38418,1,1,0,0,1,0
20587,4,2,0,0,2,0
20587,2,1,0,0,1,0
2762,3,1,0,0,1,0
140939,9,2,0,0,2,0
5121,10,1,0,0,1,0
5121,7,2,0,0,2,0
5121,3,1,0,0,1,0
2370,8,1,0,0,1,0
2370,7,1,0,0,1,0
2370,2,2,0,0,2,0
75418,6,1,0,0,1,0
75418,1,1,0,0,1,0
141569,8,1,0,0,1,0
141569,6,7,0,0,7,0
180295,10,1,0,0,1,0
180295,9,2,0,0,2,0
180295,7,5,0,0,5,0
180295,3,2,0,0,2,0
275,2,1,0,0,1,0
2230,5,1,0,0,1,0
2230,4,1,0,0,1,0
2230,2,1,0,0,1,0
15380,8,1,0,0,1,0
15380,7,6,0,0,6,0
28301,7,7,0,0,7,0
28301,6,9,0,0,9,0
28301,5,10,0,0,10,0
28301,2,2,0,0,2,0
33383,4,6,0,0,6,0
19793,2,1,0,0,1,0
3486,7,3,0,0,3,0
34218,4,2,0,0,2,0
227318,7,6,0,0,6,0
227318,5,3,0,0,3,0
227318,3,1,0,0,1,0
227318,2,1,0,0,1,0
88957,10,1,0,0,1,0
88957,1,2,0,0,2,0
57422,3,3,0,0,3,0
57422,1,2,0,0,2,0
234383,7,3,0,0,3,0
42256,9,2,0,0,2,0
42256,5,2,0,0,2,0
7443,9,2,0,0,2,0
7443,8,2,0,0,2,0
7443,3,1,0,0,1,0
18647,10,1,0,0,1,0
18647,7,11,0,0,11,0
18647,3,2,0,0,2,0
120509,5,1,0,0,1,0
231152,10,1,0,0,1,0
217884,10,1,0,0,1,0
217884,1,1,0,0,1,0
1391,7,2,0,0,2,0
1391,3,2,0,0,2,0
64430,7,8,0,0,8,0
64430,5,4,0,0,4,0
38881,9,1,0,0,1,0
38881,1,1,0,0,1,0
5496,2,2,0,0,2,0
5496,1,1,0,0,1,0
168436,9,1,0,0,1,0
168436,8,3,0,0,3,0
168436,5,6,0,0,6,0
168436,4,2,0,0,2,0
26617,8,1,0,0,1,0
26617,2,1,0,0,1,0
224680,6,12,0,0,12,0
224680,5,6,0,0,6,0
224680,1,1,0,0,1,0
7566,10,3,0,0,3,0
158495,9,1,0,0,1,0
157995,9,1,0,0,1,0
157995,5,4,0,0,4,0
157995,3,1,0,0,1,0
8406,10,1,0,0,1,0
8406,8,3,0,0,3,0
8406,3,1,0,0,1,0
9263,10,1,0,0,1,0
9263,4,1,0,0,1,0
9263,2,1,0,0,1,0
9263,1,1,0,0,1,0
10776,5,3,0,0,3,0
10776,3,1,0,0,1,0
24698,6,1,0,0,1,0
181153,9,1,0,0,1,0
181153,5,4,0,0,4,0
181153,3,2,0,0,2,0
181153,2,3,0,0,3,0
225214,10,1,0,0,1,0
207602,6,5,0,0,5,0
207602,5,4,0,0,4,0
207602,3,1,0,0,1,0
207602,1,1,0,0,1,0
141042,7,9,0,0,9,0
141042,3,2,0,0,2,0
192201,3,1,0,0,1,0
212688,6,12,0,0,12,0
212688,5,4,0,0,4,0
212688,3,1,0,0,1,0
212688,2,1,0,0,1,0
212688,1,1,0,0,1,0
107680,9,2,0,0,2,0
107680,3,1,0,0,1,0
18199,3,2,0,0,2,0
204407,9,1,0,0,1,0
124160,7,5,0,0,5,0
124160,6,5,0,0,5,0
124160,4,1,0,0,1,0
114386,5,1,0,0,1,0
114386,2,1,0,0,1,0
23346,8,1,0,0,1,0
23346,6,7,0,0,7,0
23346,5,5,0,0,5,0
41189,7,1,0,0,1,0
41189,4,5,0,0,5,0
179228,9,1,0,0,1,0
179228,7,4,0,0,4,0
179228,2,1,0,0,1,0
192801,6,8,0,0,8,0
192801,5,5,0,0,5,0
192801,4,3,0,0,3,0
192801,3,3,0,0,3,0
192801,1,2,0,0,2,0
37491,5,1,0,0,1,0
45437,8,3,0,0,3,0
45437,2,2,0,0,2,0
231362,2,1,0,0,1,0
110864,9,1,0,0,1,0
110864,4,4,0,0,4,0
110864,3,2,0,0,2,0
110864,1,1,0,0,1,0
10593,8,2,0,0,2,0
10593,3,4,0,0,4,0
10593,2,1,0,0,1,0
135492,8,1,0,0,1,0
135492,5,5,0,0,5,0
135492,4,2,0,0,2,0
135492,3,5,0,0,5,0
135492,2,1,0,0,1,0
1355,4,1,0,0,1,0
1355,3,1,0,0,1,0
1355,2,1,0,0,1,0
259972,9,1,0,0,1,0
259972,6,11,0,0,11,0
259972,4,2,0,0,2,0
259972,3,2,0,0,2,0
259972,1,1,0,0,1,0
8178,10,1,0,0,1,0
8178,9,1,0,0,1,0
8178,2,1,0,0,1,0
3772,3,1,0,0,1,0
3772,2,1,0,0,1,0
8502,9,1,0,0,1,0
8502,3,1,0,0,1,0
8502,2,2,0,0,2,0
6774,9,2,0,0,2,0
3266,10,1,0,0,1,0
3266,8,1,0,0,1,0
3266,6,4,0,0,4,0
34091,8,2,0,0,2,0
34091,7,4,0,0,4,0
205156,9,2,0,0,2,0
205156,6,6,0,0,6,0
17041,5,2,0,0,2,0
17041,1,1,0,0,1,0
146014,10,2,0,0,2,0
146014,5,4,0,0,4,0
146014,4,2,0,0,2,0
146014,3,1,0,0,1,0
235760,9,1,0,0,1,0
235760,4,3,0,0,3,0
235760,3,1,0,0,1,0
235760,2,1,0,0,1,0
155412,4,2,0,0,2,0
124248,7,8,0,0,8,0
124248,6,2,0,0,2,0
124248,1,1,0,0,1,0
9845,10,1,0,0,1,0
9845,3,1,0,0,1,0
17644,10,1,0,0,1,0
17644,9,1,0,0,1,0
16830,10,1,0,0,1,0
16830,5,6,0,0,6,0
16830,3,2,0,0,2,0
64426,10,1,0,0,1,0
232827,5,2,0,0,2,0
5134,5,4,0,0,4,0
64064,8,2,0,0,2,0
64064,4,4,0,0,4,0
64064,3,1,0,0,1,0
64064,2,3,0,0,3,0
253318,2,1,0,0,1,0
192323,8,5,0,0,5,0
192323,7,14,0,0,14,0
192323,5,2,0,0,2,0
192323,4,2,0,0,2,0
182581,4,1,0,0,1,0
14539,8,1,0,0,1,0
4163,4,2,0,0,2,0
22182,9,4,0,0,4,0
22182,3,1,0,0,1,0
22182,2,1,0,0,1,0
27296,7,2,0,0,2,0
27296,3,7,0,0,7,0
27296,2,1,0,0,1,0
27296,1,2,0,0,2,0
15614,8,3,0,0,3,0
15614,7,11,0,0,11,0
15614,4,5,0,0,5,0
15614,3,2,0,0,2,0
3107,9,1,0,0,1,0
3107,7,5,0,0,5,0
20419,10,1,0,0,1,0
931,9,2,0,0,2,0
931,5,2,0,0,2,0
931,4,3,0,0,3,0
931,2,1,0,0,1,0
19036,7,7,0,0,7,0
14468,10,1,0,0,1,0
14468,9,1,0,0,1,0
14468,4,2,0,0,2,0
260942,9,1,0,0,1,0
260942,8,1,0,0,1,0
260942,4,2,0,0,2,0
260942,3,2,0,0,2,0
260942,2,1,0,0,1,0
260942,1,2,0,0,2,0
10757,10,1,0,0,1,0
10757,9,1,0,0,1,0
10757,7,7,0,0,7,0
184563,7,6,0,0,6,0
184563,1,1,0,0,1,0
19614,9,1,0,0,1,0
19614,6,2,0,0,2,0
19614,3,5,0,0,5,0
154526,7,4,0,0,4,0
154526,5,1,0,0,1,0
154526,1,1,0,0,1,0
199590,10,3,0,0,3,0
199590,8,5,0,0,5,0
199590,7,4,0,0,4,0
199590,3,2,0,0,2,0
199590,1,1,0,0,1,0
212288,9,1,0,0,1,0
212288,4,2,0,0,2,0
212288,3,2,0,0,2,0
212288,2,1,0,0,1,0
239982,6,5,0,0,5,0
239982,4,4,0,0,4,0
239982,3,1,0,0,1,0
42644,10,3,0,0,3,0
42644,9,1,0,0,1,0
42644,5,12,0,0,12,0
42644,4,3,0,0,3,0
42644,3,1,0,0,1,0
42644,2,1,0,0,1,0
10075,9,1,0,0,1,0
10075,8,4,0,0,4,0
10075,3,5,0,0,5,0
10075,1,1,0,0,1,0
8972,7,2,0,0,2,0
8972,1,2,0,0,2,0
160406,10,1,0,0,1,0
160406,3,4,0,0,4,0
150429,10,1,0,0,1,0
150429,9,2,0,0,2,0
12988,2,1,0,0,1,0
143588,6,10,0,0,10,0
143588,4,3,0,0,3,0
143588,2,1,0,0,1,0
10008,8,3,0,0,3,0
96440,10,10,0,0,10,0
96440,9,9,0,0,9,0
96440,8,6,0,0,6,0
96440,6,2,0,0,2,0
96440,5,1,0,0,1,0
96440,4,1,0,0,1,0
96440,2,1,0,0,1,0
4025,9,1,0,0,1,0
4025,7,3,0,0,3,0
4025,3,2,0,0,2,0
234452,9,5,0,0,5,0
234452,7,6,0,0,6,0
234452,4,1,0,0,1,0
234452,3,1,0,0,1,0
13094,9,2,0,0,2,0
13094,8,6,0,0,6,0
130388,7,4,0,0,4,0
130388,5,6,0,0,6,0
130388,1,1,0,0,1,0
5055,6,5,0,0,5,0
5055,3,1,0,0,1,0
3919,3,2,0,0,2,0
205667,10,1,0,0,1,0
205667,5,2,0,0,2,0
205667,3,2,0,0,2,0
4410,10,1,0,0,1,0
4410,8,1,0,0,1,0
4410,5,4,0,0,4,0
4410,2,3,0,0,3,0
16699,8,1,0,0,1,0
16699,6,16,0,0,16,0
16699,5,5,0,0,5,0
255696,10,1,0,0,1,0
255696,1,1,0,0,1,0
22980,7,1,0,0,1,0
22980,1,6,0,0,6,0
218996,6,4,0,0,4,0
218996,5,2,0,0,2,0
123506,9,1,0,0,1,0
123506,6,9,0,0,9,0
123506,2,3,0,0,3,0
123506,1,1,0,0,1,0
92838,7,10,0,0,10,0
92838,1,1,0,0,1,0
66047,3,3,0,0,3,0
66047,1,1,0,0,1,0
69,10,1,0,0,1,0
69,9,3,0,0,3,0
69,5,2,0,0,2,0
51401,5,3,0,0,3,0
51401,3,1,0,0,1,0
144874,4,1,0,0,1,0
186501,10,4,0,0,4,0
6706,8,6,0,0,6,0
6706,4,4,0,0,4,0
6706,3,1,0,0,1,0
6706,2,1,0,0,1,0
176557,4,2,0,0,2,0
176557,2,1,0,0,1,0
121195,8,2,0,0,2,0
121195,4,3,0,0,3,0
121195,3,3,0,0,3,0
210465,10,3,0,0,3,0
210465,9,1,0,0,1,0
210465,8,12,0,0,12,0
210465,5,2,0,0,2,0
210465,1,1,0,0,1,0
1750,9,1,0,0,1,0
1750,2,1,0,0,1,0
145390,6,2,0,0,2,0
26386,8,1,0,0,1,0
26386,7,2,0,0,2,0
26386,5,1,0,0,1,0
26386,2,1,0,0,1,0
11121,10,1,0,0,1,0
11121,9,1,0,0,1,0
11121,7,4,0,0,4,0
36993,10,1,0,0,1,0
36993,3,2,0,0,2,0
36993,1,1,0,0,1,0
107811,3,3,0,0,3,0
182062,8,4,0,0,4,0
182062,6,9,0,0,9,0
182062,3,4,0,0,4,0
182062,1,1,0,0,1,0
3233,2,1,0,0,1,0
16914,3,1,0,0,1,0
16914,2,1,0,0,1,0
198513,10,3,0,0,3,0
198513,7,2,0,0,2,0
206798,10,3,0,0,3,0
206798,8,10,0,0,10,0
206798,5,2,0,0,2,0
206798,1,1,0,0,1,0
11957,9,2,0,0,2,0
11957,5,2,0,0,2,0
7966,10,1,0,0,1,0
7966,6,7,0,0,7,0
7966,5,2,0,0,2,0
184780,5,3,0,0,3,0
5735,8,2,0,0,2,0
5735,7,3,0,0,3,0
5735,3,2,0,0,2,0
5735,1,1,0,0,1,0
18050,2,1,0,0,1,0
6720,10,1,0,0,1,0
6720,5,4,0,0,4,0
4650,5,2,0,0,2,0
4650,2,1,0,0,1,0
1268,4,5,0,0,5,0
158947,7,2,0,0,2,0
158947,5,9,0,0,9,0
158947,2,3,0,0,3,0
118294,9,1,0,0,1,0
118294,8,2,0,0,2,0
118294,4,6,0,0,6,0
118294,2,1,0,0,1,0
89386,9,3,0,0,3,0
89386,4,2,0,0,2,0
89386,1,1,0,0,1,0
11965,8,1,0,0,1,0
11965,7,6,0,0,6,0
11965,5,7,0,0,7,0
11965,3,2,0,0,2,0
5438,9,2,0,0,2,0
5438,5,6,0,0,6,0
30852,8,2,0,0,2,0
232981,10,3,0,0,3,0
232981,6,2,0,0,2,0
232981,4,1,0,0,1,0
13593,4,2,0,0,2,0
163062,10,1,0,0,1,0
163062,7,8,0,0,8,0
163062,4,2,0,0,2,0
17849,8,3,0,0,3,0
17849,1,1,0,0,1,0
217275,8,1,0,0,1,0
217275,7,7,0,0,7,0
217275,5,4,0,0,4,0
217275,4,4,0,0,4,0
5040,8,1,0,0,1,0
5040,6,2,0,0,2,0
5040,4,2,0,0,2,0
99044,1,1,0,0,1,0
73367,10,1,0,0,1,0
73367,7,5,0,0,5,0
73367,3,1,0,0,1,0
164279,4,1,0,0,1,0
164279,3,2,0,0,2,0
1318,4,2,0,0,2,0
17779,9,1,0,0,1,0
11399,10,1,0,0,1,0
38561,6,3,0,0,3,0
38561,1,2,0,0,2,0
10842,3,1,0,0,1,0
147892,9,1,0,0,1,0
147892,8,4,0,0,4,0
11888,10,1,0,0,1,0
11888,8,1,0,0,1,0
11888,5,9,0,0,9,0
11888,2,1,0,0,1,0
34590,9,1,0,0,1,0
34590,8,1,0,0,1,0
34590,6,11,0,0,11,0
34590,5,5,0,0,5,0
34590,4,3,0,0,3,0
34590,3,5,0,0,5,0
34590,2,3,0,0,3,0
34590,1,2,0,0,2,0
39998,10,1,0,0,1,0
39998,9,4,0,0,4,0
39998,3,1,0,0,1,0
69233,9,1,0,0,1,0
69233,8,8,0,0,8,0
69233,6,11,0,0,11,0
69233,4,2,0,0,2,0
111543,9,1,0,0,1,0
111543,4,2,0,0,2,0
111543,2,2,0,0,2,0
2103,9,1,0,0,1,0
2103,4,3,0,0,3,0
2103,3,1,0,0,1,0
179701,10,1,0,0,1,0
179701,8,2,0,0,2,0
179701,4,5,0,0,5,0
142043,2,1,0,0,1,0
148939,10,2,0,0,2,0
11714,8,1,0,0,1,0
11714,1,1,0,0,1,0
166300,7,2,0,0,2,0
166300,2,1,0,0,1,0
166300,1,1,0,0,1,0
15159,9,1,0,0,1,0
15159,5,3,0,0,3,0
15159,3,3,0,0,3,0
38828,10,2,0,0,2,0
38828,4,1,0,0,1,0
19513,7,1,0,0,1,0
19513,6,1,0,0,1,0
19513,5,4,0,0,4,0
19513,1,5,0,0,5,0
3338,8,5,0,0,5,0
3338,4,4,0,0,4,0
74312,5,1,0,0,1,0
74312,1,1,0,0,1,0
227163,10,2,0,0,2,0
227163,9,1,0,0,1,0
238883,7,3,0,0,3,0
238883,5,1,0,0,1,0
238883,4,6,0,0,6,0
128419,9,1,0,0,1,0
3650,10,1,0,0,1,0
3650,2,1,0,0,1,0
43167,10,1,0,0,1,0
43167,8,2,0,0,2,0
43167,7,6,0,0,6,0
43167,5,5,0,0,5,0
43167,4,5,0,0,5,0
43167,2,1,0,0,1,0
43167,1,1,0,0,1,0
9915,10,2,0,0,2,0
9915,9,1,0,0,1,0
132773,10,2,0,0,2,0
132773,9,1,0,0,1,0
132773,5,2,0,0,2,0
132773,4,1,0,0,1,0
256480,3,2,0,0,2,0
9790,10,1,0,0,1,0
9790,9,2,0,0,2,0
9790,5,4,0,0,4,0
166764,10,1,0,0,1,0
166764,5,10,0,0,10,0
166764,4,1,0,0,1,0
166764,3,1,0,0,1,0
166764,2,1,0,0,1,0
189615,8,4,0,0,4,0
189615,7,5,0,0,5,0
189615,6,10,0,0,10,0
189615,5,8,0,0,8,0
189615,3,3,0,0,3,0
189615,2,1,0,0,1,0
127989,4,1,0,0,1,0
57702,9,1,0,0,1,0
57702,8,2,0,0,2,0
57702,5,7,0,0,7,0
57702,3,4,0,0,4,0
23616,8,3,0,0,3,0
23616,5,8,0,0,8,0
23616,3,2,0,0,2,0
49391,9,5,0,0,5,0
49391,5,4,0,0,4,0
223669,10,2,0,0,2,0
223669,7,4,0,0,4,0
229319,9,2,0,0,2,0
229319,7,2,0,0,2,0
229319,2,1,0,0,1,0
24994,10,2,0,0,2,0
24994,9,1,0,0,1,0
24994,3,1,0,0,1,0
11512,9,2,0,0,2,0
11512,4,1,0,0,1,0
11512,1,1,0,0,1,0
31556,10,1,0,0,1,0
31556,5,4,0,0,4,0
85504,2,4,0,0,4,0
30000,7,6,0,0,6,0
30000,4,3,0,0,3,0
30000,3,1,0,0,1,0
234101,10,1,0,0,1,0
234101,5,1,0,0,1,0
2260,10,1,0,0,1,0
2260,4,4,0,0,4,0
2260,2,1,0,0,1,0
51008,8,2,0,0,2,0
51008,5,9,0,0,9,0
51008,4,3,0,0,3,0
34311,10,3,0,0,3,0
34311,5,3,0,0,3,0
34311,4,2,0,0,2,0
34311,2,1,0,0,1,0
2066,8,1,0,0,1,0
2066,3,4,0,0,4,0
12562,10,1,0,0,1,0
12562,4,2,0,0,2,0
12562,3,1,0,0,1,0
180257,10,3,0,0,3,0
180257,9,4,0,0,4,0
180257,5,8,0,0,8,0
180257,4,3,0,0,3,0
62374,5,5,0,0,5,0
234510,10,6,0,0,6,0
234510,9,6,0,0,6,0
234510,6,4,0,0,4,0
234510,2,1,0,0,1,0
234510,1,1,0,0,1,0
5057,10,1,0,0,1,0
5057,4,2,0,0,2,0
5057,3,1,0,0,1,0
176642,10,1,0,0,1,0
176642,9,1,0,0,1,0
176642,5,4,0,0,4,0
92777,9,1,0,0,1,0
3112,4,3,0,0,3,0
99949,5,2,0,0,2,0
88900,9,1,0,0,1,0
88900,3,2,0,0,2,0
88900,2,2,0,0,2,0
3492,9,2,0,0,2,0
3492,3,2,0,0,2,0
3492,1,1,0,0,1,0
25014,10,1,0,0,1,0
25014,9,2,0,0,2,0
25014,6,3,0,0,3,0
1820,9,2,0,0,2,0
1820,4,2,0,0,2,0
3909,2,2,0,0,2,0
26305,10,1,0,0,1,0
226,9,2,0,0,2,0
226,8,5,0,0,5,0
226,5,1,0,0,1,0
226,4,3,0,0,3,0
3999,9,1,0,0,1,0
3999,4,4,0,0,4,0
3999,2,1,0,0,1,0
32187,8,4,0,0,4,0
32187,5,5,0,0,5,0
193329,10,2,0,0,2,0
193329,8,5,0,0,5,0
193329,6,10,0,0,10,0
193329,5,6,0,0,6,0
193329,4,4,0,0,4,0
193329,3,5,0,0,5,0
193329,1,1,0,0,1,0
228373,10,1,0,0,1,0
8599,10,1,0,0,1,0
8599,6,4,0,0,4,0
235697,9,1,0,0,1,0
178984,2,1,0,0,1,0
18840,4,2,0,0,2,0
18840,3,3,0,0,3,0
74311,10,2,0,0,2,0
74311,9,4,0,0,4,0
190828,10,1,0,0,1,0
190828,8,8,0,0,8,0
190828,5,1,0,0,1,0
190828,4,1,0,0,1,0
124760,5,5,0,0,5,0
124760,4,1,0,0,1,0
3849,9,1,0,0,1,0
3849,5,9,0,0,9,0
10808,8,1,0,0,1,0
10808,7,1,0,0,1,0
10808,6,6,0,0,6,0
10808,5,9,0,0,9,0
18104,1,1,0,0,1,0
65061,5,1,0,0,1,0
65061,2,1,0,0,1,0
9115,9,1,0,0,1,0
9115,7,4,0,0,4,0
9115,6,6,0,0,6,0
9115,5,11,0,0,11,0
9115,1,1,0,0,1,0
9736,10,4,0,0,4,0
9736,9,1,0,0,1,0
101519,7,4,0,0,4,0
101519,5,7,0,0,7,0
101519,2,1,0,0,1,0
101519,1,1,0,0,1,0
2871,9,1,0,0,1,0
2871,3,1,0,0,1,0
257994,10,4,0,0,4,0
257994,9,2,0,0,2,0
257994,8,3,0,0,3,0
257994,5,2,0,0,2,0
257994,4,1,0,0,1,0
257994,3,3,0,0,3,0
11124,10,1,0,0,1,0
11124,4,1,0,0,1,0
6983,5,6,0,0,6,0
6983,4,2,0,0,2,0
6983,2,1,0,0,1,0
2765,8,2,0,0,2,0
18472,10,2,0,0,2,0
15049,9,5,0,0,5,0
15049,6,3,0,0,3,0
194986,5,1,0,0,1,0
194986,1,1,0,0,1,0
130043,10,1,0,0,1,0
130043,4,1,0,0,1,0
170472,7,2,0,0,2,0
170472,1,1,0,0,1,0
13290,4,1,0,0,1,0
1365,4,2,0,0,2,0
1365,3,1,0,0,1,0
243694,6,5,0,0,5,0
243694,4,3,0,0,3,0
11215,3,2,0,0,2,0
11683,10,1,0,0,1,0
11683,7,2,0,0,2,0
19304,10,1,0,0,1,0
25950,7,2,0,0,2,0
25950,1,1,0,0,1,0
199800,10,1,0,0,1,0
199800,8,3,0,0,3,0
199800,7,9,0,0,9,0
199800,4,2,0,0,2,0
8001,4,2,0,0,2,0
8001,2,1,0,0,1,0
12049,9,2,0,0,2,0
12049,6,4,0,0,4,0
12049,5,2,0,0,2,0
206851,7,1,0,0,1,0
2863,5,3,0,0,3,0
225932,10,1,0,0,1,0
225932,7,5,0,0,5,0
225932,6,2,0,0,2,0
8888,10,1,0,0,1,0
8888,9,1,0,0,1,0
8888,1,1,0,0,1,0
130520,9,1,0,0,1,0
3612,10,3,0,0,3,0
108459,5,5,0,0,5,0
108459,4,1,0,0,1,0
150797,10,4,0,0,4,0
150797,9,3,0,0,3,0
150797,5,1,0,0,1,0
241478,6,7,0,0,7,0
241478,5,2,0,0,2,0
110511,7,2,0,0,2,0
99992,10,1,0,0,1,0
97747,8,6,0,0,6,0
97747,7,9,0,0,9,0
97747,6,6,0,0,6,0
39549,8,2,0,0,2,0
93134,8,3,0,0,3,0
93134,5,5,0,0,5,0
93134,2,1,0,0,1,0
40388,10,1,0,0,1,0
40388,7,10,0,0,10,0
40388,3,3,0,0,3,0
10511,10,1,0,0,1,0
10511,8,1,0,0,1,0
10511,3,2,0,0,2,0
105305,10,1,0,0,1,0
105305,9,2,0,0,2,0
211168,8,3,0,0,3,0
211168,3,2,0,0,2,0
211168,2,3,0,0,3,0
73233,10,2,0,0,2,0
10257,10,1,0,0,1,0
10257,3,2,0,0,2,0
210181,9,1,0,0,1,0
210181,8,3,0,0,3,0
210181,5,6,0,0,6,0
210181,1,1,0,0,1,0
8419,10,2,0,0,2,0
28109,4,1,0,0,1,0
11115,8,1,0,0,1,0
129038,8,11,0,0,11,0
129038,6,4,0,0,4,0
129038,4,1,0,0,1,0
129038,1,1,0,0,1,0
6524,7,5,0,0,5,0
4259,10,1,0,0,1,0
31298,8,4,0,0,4,0
31298,5,3,0,0,3,0
31298,4,6,0,0,6,0
7711,4,2,0,0,2,0
4677,10,2,0,0,2,0
4677,9,1,0,0,1,0
4677,4,2,0,0,2,0
4677,3,1,0,0,1,0
21915,5,2,0,0,2,0
202245,8,10,0,0,10,0
202245,6,2,0,0,2,0
202245,5,2,0,0,2,0
202245,4,1,0,0,1,0
202245,3,1,0,0,1,0
172484,6,5,0,0,5,0
172484,5,1,0,0,1,0
172484,4,2,0,0,2,0
172484,1,1,0,0,1,0
18584,5,7,0,0,7,0
18584,4,1,0,0,1,0
18584,3,1,0,0,1,0
156930,7,2,0,0,2,0
156930,6,5,0,0,5,0
156930,3,1,0,0,1,0
156930,2,2,0,0,2,0
137910,4,3,0,0,3,0
137910,2,1,0,0,1,0
137910,1,1,0,0,1,0
3844,3,1,0,0,1,0
247860,6,1,0,0,1,0
247860,4,4,0,0,4,0
247860,3,1,0,0,1,0
104029,4,4,0,0,4,0
25313,10,2,0,0,2,0
25313,7,7,0,0,7,0
25313,2,1,0,0,1,0
25313,1,1,0,0,1,0
26700,8,1,0,0,1,0
26700,3,4,0,0,4,0
26700,2,2,0,0,2,0
176918,9,1,0,0,1,0
176918,8,4,0,0,4,0
176918,7,3,0,0,3,0
176918,4,3,0,0,3,0
176918,3,2,0,0,2,0
176918,2,2,0,0,2,0
38991,8,2,0,0,2,0
38991,2,1,0,0,1,0
2776,9,2,0,0,2,0
2776,8,4,0,0,4,0
2776,7,2,0,0,2,0
132785,10,1,0,0,1,0
132785,9,1,0,0,1,0
132785,8,2,0,0,2,0
132785,5,3,0,0,3,0
132785,3,3,0,0,3,0
132785,2,1,0,0,1,0
5893,5,4,0,0,4,0
29386,1,1,0,0,1,0
26306,4,1,0,0,1,0
224992,8,3,0,0,3,0
224992,5,5,0,0,5,0
224992,4,1,0,0,1,0
224992,3,1,0,0,1,0
259551,10,2,0,0,2,0
259551,7,9,0,0,9,0
40352,9,2,0,0,2,0
40352,5,4,0,0,4,0
40352,4,1,0,0,1,0
253607,7,5,0,0,5,0
253607,6,3,0,0,3,0
144993,4,1,0,0,1,0
144993,3,1,0,0,1,0
144993,1,1,0,0,1,0
244725,10,3,0,0,3,0
244725,3,2,0,0,2,0
10625,8,1,0,0,1,0
10625,7,2,0,0,2,0
194976,10,2,0,0,2,0
194976,6,3,0,0,3,0
194976,5,1,0,0,1,0
194976,1,1,0,0,1,0
203195,10,2,0,0,2,0
203195,9,5,0,0,5,0
203195,4,2,0,0,2,0
203195,3,1,0,0,1,0
203195,1,1,0,0,1,0
34207,9,3,0,0,3,0
34207,5,1,0,0,1,0
34207,4,2,0,0,2,0
17073,4,1,0,0,1,0
42897,5,1,0,0,1,0
8454,10,1,0,0,1,0
8245,10,2,0,0,2,0
8245,9,1,0,0,1,0
149129,10,3,0,0,3,0
149129,9,4,0,0,4,0
149129,5,2,0,0,2,0
149129,4,1,0,0,1,0
149129,3,1,0,0,1,0
6478,5,3,0,0,3,0
27480,6,4,0,0,4,0
27480,1,1,0,0,1,0
267735,9,7,0,0,7,0
267735,7,18,0,0,18,0
267735,6,7,0,0,7,0
267735,5,2,0,0,2,0
2793,8,3,0,0,3,0
2793,5,5,0,0,5,0
14275,7,1,0,0,1,0
182955,10,3,0,0,3,0
182955,6,7,0,0,7,0
227563,6,3,0,0,3,0
227563,5,1,0,0,1,0
227563,2,1,0,0,1,0
231872,3,2,0,0,2,0
12436,8,1,0,0,1,0
12436,7,1,0,0,1,0
12436,2,1,0,0,1,0
185456,6,5,0,0,5,0
221367,9,3,0,0,3,0
32361,8,1,0,0,1,0
32361,7,2,0,0,2,0
32361,4,12,0,0,12,0
32361,3,6,0,0,6,0
32361,2,4,0,0,4,0
32361,1,1,0,0,1,0
512,10,2,0,0,2,0
247576,10,1,0,0,1,0
247576,8,5,0,0,5,0
247576,2,1,0,0,1,0
247576,1,1,0,0,1,0
110962,7,2,0,0,2,0
110962,5,4,0,0,4,0
110962,4,4,0,0,4,0
110962,1,5,0,0,5,0
220443,7,8,0,0,8,0
220443,3,2,0,0,2,0
10105,4,9,0,0,9,0
10105,3,3,0,0,3,0
10105,1,4,0,0,4,0
227026,9,5,0,0,5,0
227026,8,4,0,0,4,0
227026,4,1,0,0,1,0
18736,8,1,0,0,1,0
18736,6,6,0,0,6,0
11125,9,1,0,0,1,0
231748,7,10,0,0,10,0
248830,7,5,0,0,5,0
248830,6,2,0,0,2,0
248830,4,1,0,0,1,0
248830,3,1,0,0,1,0
18083,10,1,0,0,1,0
18083,8,9,0,0,9,0
18083,6,10,0,0,10,0
18083,5,4,0,0,4,0
18083,2,1,0,0,1,0
258636,10,1,0,0,1,0
258636,9,3,0,0,3,0
258636,8,10,0,0,10,0
258636,5,2,0,0,2,0
258636,3,1,0,0,1,0
225740,3,1,0,0,1,0
67251,10,4,0,0,4,0
67251,9,1,0,0,1,0
67251,7,9,0,0,9,0
67251,6,2,0,0,2,0
67251,5,3,0,0,3,0
63379,4,1,0,0,1,0
63379,3,4,0,0,4,0
218615,9,2,0,0,2,0
218615,8,3,0,0,3,0
218615,4,2,0,0,2,0
4740,10,3,0,0,3,0
4740,8,4,0,0,4,0
4740,4,1,0,0,1,0
4740,3,2,0,0,2,0
259393,6,4,0,0,4,0
147616,9,1,0,0,1,0
147616,4,1,0,0,1,0
170583,10,3,0,0,3,0
220124,10,2,0,0,2,0
220124,5,5,0,0,5,0
220124,1,1,0,0,1,0
137156,4,5,0,0,5,0
137156,1,1,0,0,1,0
3687,8,1,0,0,1,0
84609,10,2,0,0,2,0
84609,4,1,0,0,1,0
84609,2,1,0,0,1,0
96564,5,2,0,0,2,0
9350,4,1,0,0,1,0
138015,9,3,0,0,3,0
138015,1,1,0,0,1,0
2209,10,1,0,0,1,0
5899,8,1,0,0,1,0
5899,3,3,0,0,3,0
13918,8,2,0,0,2,0
170954,8,1,0,0,1,0
170954,7,1,0,0,1,0
231331,9,2,0,0,2,0
231331,7,4,0,0,4,0
231331,4,2,0,0,2,0
231331,3,1,0,0,1,0
231331,1,1,0,0,1,0
18657,7,1,0,0,1,0
41428,9,3,0,0,3,0
41428,4,1,0,0,1,0
165471,10,1,0,0,1,0
165471,9,1,0,0,1,0
165471,5,4,0,0,4,0
165471,3,1,0,0,1,0
256701,4,2,0,0,2,0
256701,3,1,0,0,1,0
256701,2,1,0,0,1,0
256701,1,1,0,0,1,0
1415,7,1,0,0,1,0
1415,2,4,0,0,4,0
164202,8,9,0,0,9,0
164202,5,5,0,0,5,0
164202,4,5,0,0,5,0
169768,5,4,0,0,4,0
169768,3,1,0,0,1,0
169768,2,1,0,0,1,0
169768,1,1,0,0,1,0
154482,10,2,0,0,2,0
154482,7,3,0,0,3,0
154482,2,4,0,0,4,0
154482,1,5,0,0,5,0
155577,10,2,0,0,2,0
155577,7,9,0,0,9,0
155577,4,1,0,0,1,0
155577,3,2,0,0,2,0
155577,1,2,0,0,2,0
7368,10,1,0,0,1,0
7368,3,1,0,0,1,0
11179,6,7,0,0,7,0
11179,5,1,0,0,1,0
11179,4,1,0,0,1,0
192496,7,8,0,0,8,0
192496,6,10,0,0,10,0
68201,5,2,0,0,2,0
258160,6,7,0,0,7,0
258160,1,1,0,0,1,0
6042,10,1,0,0,1,0
6042,9,4,0,0,4,0
6042,1,1,0,0,1,0
40766,1,1,0,0,1,0
138670,7,7,0,0,7,0
138670,6,2,0,0,2,0
138670,5,1,0,0,1,0
198142,10,2,0,0,2,0
198142,9,1,0,0,1,0
198142,7,6,0,0,6,0
198142,4,2,0,0,2,0
198142,1,1,0,0,1,0
69676,7,4,0,0,4,0
69676,5,3,0,0,3,0
69676,3,7,0,0,7,0
69676,2,2,0,0,2,0
69676,1,6,0,0,6,0
4971,4,3,0,0,3,0
4971,3,1,0,0,1,0
235927,10,2,0,0,2,0
235927,9,1,0,0,1,0
235927,4,3,0,0,3,0
235927,3,1,0,0,1,0
10268,8,5,0,0,5,0
174218,7,4,0,0,4,0
174218,2,1,0,0,1,0
16466,3,1,0,0,1,0
16466,1,1,0,0,1,0
136606,8,13,0,0,13,0
136606,6,2,0,0,2,0
136606,1,1,0,0,1,0
23456,8,2,0,0,2,0
23456,7,2,0,0,2,0
23456,2,2,0,0,2,0
23456,1,2,0,0,2,0
13488,8,1,0,0,1,0
2845,6,9,0,0,9,0
2845,2,2,0,0,2,0
7604,10,2,0,0,2,0
7604,5,7,0,0,7,0
7604,3,4,0,0,4,0
71899,8,3,0,0,3,0
71899,3,4,0,0,4,0
71899,2,1,0,0,1,0
71899,1,1,0,0,1,0
165578,8,1,0,0,1,0
165578,5,6,0,0,6,0
165578,3,6,0,0,6,0
40774,3,1,0,0,1,0
7102,9,1,0,0,1,0
7102,4,4,0,0,4,0
139177,10,7,0,0,7,0
139177,3,1,0,0,1,0
139177,2,2,0,0,2,0
2832,8,1,0,0,1,0
2832,7,3,0,0,3,0
2832,3,2,0,0,2,0
2832,1,1,0,0,1,0
39193,6,13,0,0,13,0
27939,5,3,0,0,3,0
27939,3,2,0,0,2,0
27939,2,1,0,0,1,0
10742,4,2,0,0,2,0
10742,2,1,0,0,1,0
1977,4,5,0,0,5,0
220721,10,1,0,0,1,0
220721,9,5,0,0,5,0
220721,8,2,0,0,2,0
220721,5,5,0,0,5,0
33418,10,1,0,0,1,0
33418,2,1,0,0,1,0
6789,10,1,0,0,1,0
6789,7,6,0,0,6,0
6789,6,8,0,0,8,0
6789,3,7,0,0,7,0
140961,9,1,0,0,1,0
140961,4,3,0,0,3,0
140961,3,1,0,0,1,0
8049,1,1,0,0,1,0
35163,9,2,0,0,2,0
35163,8,3,0,0,3,0
35163,4,1,0,0,1,0
35163,3,3,0,0,3,0
110525,8,1,0,0,1,0
110525,3,1,0,0,1,0
103687,10,1,0,0,1,0
103687,8,2,0,0,2,0
103687,3,2,0,0,2,0
4237,10,3,0,0,3,0
4237,2,1,0,0,1,0
2390,9,2,0,0,2,0
2390,8,1,0,0,1,0
2390,4,3,0,0,3,0
2390,3,5,0,0,5,0
2390,2,1,0,0,1,0
7631,3,3,0,0,3,0
7631,2,2,0,0,2,0
7071,9,4,0,0,4,0
7948,10,2,0,0,2,0
7948,3,1,0,0,1,0
28553,5,5,0,0,5,0
4537,9,1,0,0,1,0
4537,5,7,0,0,7,0
4537,4,2,0,0,2,0
36380,5,12,0,0,12,0
36380,3,5,0,0,5,0
9861,10,1,0,0,1,0
9861,9,1,0,0,1,0
9861,5,7,0,0,7,0
9861,4,3,0,0,3,0
8210,10,2,0,0,2,0
8210,7,1,0,0,1,0
8210,1,2,0,0,2,0
183344,5,2,0,0,2,0
183344,3,2,0,0,2,0
162915,7,5,0,0,5,0
162915,5,3,0,0,3,0
162915,3,4,0,0,4,0
162915,2,3,0,0,3,0
11562,10,1,0,0,1,0
11562,7,10,0,0,10,0
11562,3,1,0,0,1,0
131164,5,5,0,0,5,0
131164,2,1,0,0,1,0
20642,5,4,0,0,4,0
149611,8,1,0,0,1,0
149611,6,10,0,0,10,0
224108,6,8,0,0,8,0
224108,5,1,0,0,1,0
224108,3,1,0,0,1,0
124838,8,9,0,0,9,0
124838,7,4,0,0,4,0
124838,6,1,0,0,1,0
124838,1,1,0,0,1,0
9398,8,5,0,0,5,0
9398,2,2,0,0,2,0
148628,10,1,0,0,1,0
148628,2,2,0,0,2,0
147423,8,2,0,0,2,0
2068,8,1,0,0,1,0
3842,7,3,0,0,3,0
3842,4,6,0,0,6,0
3842,3,4,0,0,4,0
37490,7,4,0,0,4,0
37490,6,7,0,0,7,0
37490,4,3,0,0,3,0
8484,9,1,0,0,1,0
8484,7,1,0,0,1,0
8484,4,5,0,0,5,0
8484,2,2,0,0,2,0
238721,10,2,0,0,2,0
238721,8,6,0,0,6,0
238721,3,1,0,0,1,0
34291,9,1,0,0,1,0
34291,7,6,0,0,6,0
34291,6,12,0,0,12,0
34291,5,9,0,0,9,0
34291,3,1,0,0,1,0
1994,7,3,0,0,3,0
18907,10,2,0,0,2,0
18907,9,1,0,0,1,0
18907,8,1,0,0,1,0
10813,8,2,0,0,2,0
10813,7,2,0,0,2,0
10813,2,1,0,0,1,0
23081,9,4,0,0,4,0
23081,7,8,0,0,8,0
23081,2,1,0,0,1,0
150978,8,2,0,0,2,0
150978,7,3,0,0,3,0
150978,4,6,0,0,6,0
150978,3,2,0,0,2,0
3669,10,3,0,0,3,0
3669,9,1,0,0,1,0
220987,6,4,0,0,4,0
153710,10,2,0,0,2,0
153710,3,4,0,0,4,0
3354,3,2,0,0,2,0
3354,2,2,0,0,2,0
154585,4,3,0,0,3,0
154585,3,2,0,0,2,0
8388,3,1,0,0,1,0
260233,9,1,0,0,1,0
260233,5,7,0,0,7,0
260233,4,2,0,0,2,0
260233,2,1,0,0,1,0
260233,1,2,0,0,2,0
10154,10,1,0,0,1,0
10154,3,1,0,0,1,0
10154,2,1,0,0,1,0
5030,10,3,0,0,3,0
5030,6,6,0,0,6,0
5030,2,1,0,0,1,0
5030,1,1,0,0,1,0
117891,8,4,0,0,4,0
117891,5,9,0,0,9,0
11253,2,1,0,0,1,0
11253,1,1,0,0,1,0
170511,9,2,0,0,2,0
170511,3,1,0,0,1,0
170511,2,1,0,0,1,0
19909,6,2,0,0,2,0
189833,7,7,0,0,7,0
189833,4,4,0,0,4,0
60210,10,3,0,0,3,0
60210,9,1,0,0,1,0
60210,7,4,0,0,4,0
60210,4,8,0,0,8,0
10543,10,3,0,0,3,0
10543,9,1,0,0,1,0
10543,4,3,0,0,3,0
3129,2,1,0,0,1,0
3129,1,2,0,0,2,0
1913,8,2,0,0,2,0
1913,3,1,0,0,1,0
1913,2,1,0,0,1,0
11601,10,1,0,0,1,0
57183,4,2,0,0,2,0
57183,3,2,0,0,2,0
166156,7,2,0,0,2,0
166156,5,3,0,0,3,0
166156,3,1,0,0,1,0
166156,2,2,0,0,2,0
141679,8,2,0,0,2,0
9474,9,1,0,0,1,0
9901,10,1,0,0,1,0
9901,8,2,0,0,2,0
9901,7,8,0,0,8,0
265381,9,4,0,0,4,0
265381,8,9,0,0,9,0
265381,5,2,0,0,2,0
265381,3,1,0,0,1,0
22257,9,1,0,0,1,0
22257,8,4,0,0,4,0
22257,7,8,0,0,8,0
22257,5,7,0,0,7,0
22257,3,1,0,0,1,0
25229,10,3,0,0,3,0
25229,8,1,0,0,1,0
25229,2,2,0,0,2,0
4621,9,2,0,0,2,0
10175,9,1,0,0,1,0
10175,8,4,0,0,4,0
10175,7,3,0,0,3,0
10175,3,1,0,0,1,0
4248,9,1,0,0,1,0
6678,9,1,0,0,1,0
183197,9,2,0,0,2,0
183197,7,5,0,0,5,0
183197,5,5,0,0,5,0
4614,8,2,0,0,2,0
4614,7,2,0,0,2,0
4614,4,1,0,0,1,0
4614,2,2,0,0,2,0
5067,8,1,0,0,1,0
5067,4,3,0,0,3,0
230065,8,2,0,0,2,0
230065,2,2,0,0,2,0
203019,7,5,0,0,5,0
203019,6,8,0,0,8,0
203019,5,7,0,0,7,0
203019,4,5,0,0,5,0
142829,5,1,0,0,1,0
142829,3,1,0,0,1,0
82037,9,1,0,0,1,0
82037,5,8,0,0,8,0
24325,9,1,0,0,1,0
24325,7,5,0,0,5,0
2315,4,6,0,0,6,0
157061,8,5,0,0,5,0
157061,7,7,0,0,7,0
157061,6,9,0,0,9,0
157061,4,4,0,0,4,0
157061,2,1,0,0,1,0
3356,8,2,0,0,2,0
3356,2,1,0,0,1,0
177572,8,5,0,0,5,0
177572,3,2,0,0,2,0
177572,2,1,0,0,1,0
148442,10,1,0,0,1,0
148442,8,1,0,0,1,0
148442,7,9,0,0,9,0
148442,6,10,0,0,10,0
148442,5,7,0,0,7,0
13072,7,5,0,0,5,0
13072,5,6,0,0,6,0
40966,10,1,0,0,1,0
40966,7,3,0,0,3,0
40966,4,7,0,0,7,0
2730,10,1,0,0,1,0
1793,3,1,0,0,1,0
239116,8,7,0,0,7,0
239116,7,6,0,0,6,0
239116,5,4,0,0,4,0
234378,9,5,0,0,5,0
234378,8,7,0,0,7,0
234378,7,9,0,0,9,0
234378,5,2,0,0,2,0
234378,3,2,0,0,2,0
104239,9,1,0,0,1,0
104239,5,5,0,0,5,0
4433,9,1,0,0,1,0
4433,8,1,0,0,1,0
4433,7,1,0,0,1,0
4433,2,1,0,0,1,0
167589,9,1,0,0,1,0
167589,7,2,0,0,2,0
167589,6,11,0,0,11,0
167589,5,9,0,0,9,0
167589,4,8,0,0,8,0
167589,3,3,0,0,3,0
167589,1,2,0,0,2,0
165189,8,1,0,0,1,0
165189,7,4,0,0,4,0
165189,6,9,0,0,9,0
165189,5,7,0,0,7,0
165189,4,5,0,0,5,0
165189,2,2,0,0,2,0
165189,1,2,0,0,2,0
33414,3,1,0,0,1,0
4559,1,1,0,0,1,0
179322,10,1,0,0,1,0
179322,1,1,0,0,1,0
4267,7,4,0,0,4,0
9385,10,1,0,0,1,0
9385,2,2,0,0,2,0
28699,8,2,0,0,2,0
28699,3,3,0,0,3,0
3915,9,1,0,0,1,0
3915,7,2,0,0,2,0
3915,2,2,0,0,2,0
7006,8,1,0,0,1,0
7006,4,2,0,0,2,0
244433,8,7,0,0,7,0
244433,4,1,0,0,1,0
244433,2,1,0,0,1,0
20899,10,1,0,0,1,0
20899,5,4,0,0,4,0
20899,4,1,0,0,1,0
24137,9,1,0,0,1,0
24137,7,3,0,0,3,0
24137,5,7,0,0,7,0
24137,2,1,0,0,1,0
200188,7,9,0,0,9,0
200188,2,4,0,0,4,0
3503,7,2,0,0,2,0
217863,7,6,0,0,6,0
217863,6,9,0,0,9,0
217863,3,3,0,0,3,0
232267,10,1,0,0,1,0
33595,6,4,0,0,4,0
33595,5,1,0,0,1,0
7827,8,1,0,0,1,0
7827,5,5,0,0,5,0
7827,3,1,0,0,1,0
7827,1,2,0,0,2,0
5059,10,2,0,0,2,0
5059,4,2,0,0,2,0
38826,10,2,0,0,2,0
38826,9,1,0,0,1,0
38826,8,4,0,0,4,0
38826,3,1,0,0,1,0
38826,2,1,0,0,1,0
37267,10,1,0,0,1,0
37267,5,2,0,0,2,0
37267,3,2,0,0,2,0
4957,9,1,0,0,1,0
4957,4,1,0,0,1,0
4957,3,1,0,0,1,0
4957,2,1,0,0,1,0
11764,10,1,0,0,1,0
167580,1,1,0,0,1,0
6936,2,1,0,0,1,0
9854,10,3,0,0,3,0
9854,6,5,0,0,5,0
97248,10,2,0,0,2,0
97248,9,2,0,0,2,0
97248,1,1,0,0,1,0
3384,10,1,0,0,1,0
3384,4,3,0,0,3,0
3384,3,2,0,0,2,0
3384,1,1,0,0,1,0
192023,10,2,0,0,2,0
257372,9,1,0,0,1,0
257372,3,1,0,0,1,0
257372,2,1,0,0,1,0
27852,9,1,0,0,1,0
27852,8,5,0,0,5,0
27852,4,1,0,0,1,0
5361,9,1,0,0,1,0
5361,8,1,0,0,1,0
213787,8,1,0,0,1,0
20203,8,2,0,0,2,0
20203,7,2,0,0,2,0
20203,2,1,0,0,1,0
94486,5,9,0,0,9,0
94486,2,2,0,0,2,0
96157,5,2,0,0,2,0
86443,9,1,0,0,1,0
86443,8,1,0,0,1,0
86443,7,3,0,0,3,0
27675,8,1,0,0,1,0
27675,7,2,0,0,2,0
27675,1,1,0,0,1,0
28176,7,3,0,0,3,0
28176,2,1,0,0,1,0
28176,1,1,0,0,1,0
8538,10,1,0,0,1,0
8538,5,1,0,0,1,0
8538,4,1,0,0,1,0
11763,9,1,0,0,1,0
11763,5,2,0,0,2,0
11763,4,1,0,0,1,0
11763,1,1,0,0,1,0
176633,10,3,0,0,3,0
176633,5,3,0,0,3,0
176633,4,1,0,0,1,0
35312,2,1,0,0,1,0
31604,10,1,0,0,1,0
31604,4,3,0,0,3,0
3402,3,1,0,0,1,0
3402,1,1,0,0,1,0
176400,7,3,0,0,3,0
176400,4,2,0,0,2,0
37592,10,2,0,0,2,0
37592,7,5,0,0,5,0
37592,6,1,0,0,1,0
129952,7,10,0,0,10,0
12519,10,1,0,0,1,0
12519,8,2,0,0,2,0
12519,7,9,0,0,9,0
12519,6,8,0,0,8,0
20306,6,7,0,0,7,0
20306,2,2,0,0,2,0
20306,1,2,0,0,2,0
8100,8,2,0,0,2,0
8100,7,3,0,0,3,0
8100,6,8,0,0,8,0
8100,4,5,0,0,5,0
99062,1,1,0,0,1,0
230548,7,12,0,0,12,0
230548,6,6,0,0,6,0
230548,5,3,0,0,3,0
230548,4,1,0,0,1,0
230081,1,1,0,0,1,0
132322,5,2,0,0,2,0
132322,4,2,0,0,2,0
132322,2,1,0,0,1,0
157254,1,1,0,0,1,0
8168,10,1,0,0,1,0
8168,9,1,0,0,1,0
8168,3,2,0,0,2,0
154841,10,1,0,0,1,0
154841,5,7,0,0,7,0
154841,3,1,0,0,1,0
172510,8,3,0,0,3,0
172510,5,7,0,0,7,0
172510,4,1,0,0,1,0
138064,10,1,0,0,1,0
451,8,6,0,0,6,0
451,5,3,0,0,3,0
451,3,1,0,0,1,0
145275,2,2,0,0,2,0
198984,8,5,0,0,5,0
198984,6,5,0,0,5,0
198984,4,3,0,0,3,0
198984,1,1,0,0,1,0
9547,7,2,0,0,2,0
9547,6,3,0,0,3,0
9547,3,3,0,0,3,0
9547,1,1,0,0,1,0
10188,5,3,0,0,3,0
10188,1,1,0,0,1,0
31557,10,1,0,0,1,0
175313,10,1,0,0,1,0
175313,9,5,0,0,5,0
175313,7,8,0,0,8,0
175313,5,4,0,0,4,0
175313,2,1,0,0,1,0
10258,10,2,0,0,2,0
10258,8,1,0,0,1,0
10258,5,8,0,0,8,0
10258,4,2,0,0,2,0
16617,10,1,0,0,1,0
16617,8,3,0,0,3,0
16617,5,3,0,0,3,0
16617,1,1,0,0,1,0
116737,10,2,0,0,2,0
145274,9,1,0,0,1,0
87748,10,1,0,0,1,0
87748,7,3,0,0,3,0
87748,3,6,0,0,6,0
5564,9,1,0,0,1,0
201971,7,5,0,0,5,0
201971,5,3,0,0,3,0
201971,4,5,0,0,5,0
201971,3,3,0,0,3,0
201971,1,1,0,0,1,0
12479,10,1,0,0,1,0
12479,7,9,0,0,9,0
3268,8,1,0,0,1,0
3268,3,2,0,0,2,0
8429,10,1,0,0,1,0
38825,8,4,0,0,4,0
26163,8,1,0,0,1,0
26163,1,1,0,0,1,0
11347,8,2,0,0,2,0
195180,8,7,0,0,7,0
253862,4,4,0,0,4,0
253862,3,2,0,0,2,0
14117,10,1,0,0,1,0
14117,9,1,0,0,1,0
14117,3,1,0,0,1,0
13742,4,1,0,0,1,0
217431,10,2,0,0,2,0
217431,5,1,0,0,1,0
85992,8,2,0,0,2,0
85992,6,10,0,0,10,0
85992,2,2,0,0,2,0
3468,9,3,0,0,3,0
3468,3,2,0,0,2,0
3468,1,2,0,0,2,0
36687,5,3,0,0,3,0
36332,10,3,0,0,3,0
36332,9,2,0,0,2,0
36332,3,2,0,0,2,0
145764,10,4,0,0,4,0
145764,8,1,0,0,1,0
145764,7,3,0,0,3,0
145764,5,8,0,0,8,0
145764,4,1,0,0,1,0
145764,2,4,0,0,4,0
192500,10,1,0,0,1,0
192500,8,4,0,0,4,0
192500,5,3,0,0,3,0
192500,4,1,0,0,1,0
218993,9,1,0,0,1,0
218993,4,1,0,0,1,0
218993,2,1,0,0,1,0
165926,7,5,0,0,5,0
165926,5,6,0,0,6,0
165926,1,1,0,0,1,0
8279,10,2,0,0,2,0
8279,9,2,0,0,2,0
8279,3,2,0,0,2,0
12169,9,1,0,0,1,0
12169,4,2,0,0,2,0
12169,2,1,0,0,1,0
16875,5,4,0,0,4,0
16875,2,1,0,0,1,0
6965,10,1,0,0,1,0
6965,8,2,0,0,2,0
6965,7,3,0,0,3,0
6965,5,5,0,0,5,0
6965,1,1,0,0,1,0
6397,4,4,0,0,4,0
6397,1,1,0,0,1,0
13786,10,3,0,0,3,0
13786,9,3,0,0,3,0
13786,6,6,0,0,6,0
13786,2,3,0,0,3,0
13832,3,1,0,0,1,0
5638,10,2,0,0,2,0
5638,9,3,0,0,3,0
5638,3,2,0,0,2,0
5638,2,4,0,0,4,0
5638,1,3,0,0,3,0
180202,5,3,0,0,3,0
180202,4,2,0,0,2,0
4181,6,7,0,0,7,0
4181,3,2,0,0,2,0
161743,9,1,0,0,1,0
161743,8,2,0,0,2,0
246129,9,4,0,0,4,0
41529,10,5,0,0,5,0
41529,9,2,0,0,2,0
41529,2,4,0,0,4,0
3349,4,1,0,0,1,0
3349,3,2,0,0,2,0
11483,10,1,0,0,1,0
100015,10,2,0,0,2,0
100015,6,5,0,0,5,0
3188,5,5,0,0,5,0
164339,8,1,0,0,1,0
164339,7,5,0,0,5,0
207713,10,2,0,0,2,0
207713,2,1,0,0,1,0
162677,10,1,0,0,1,0
2609,4,1,0,0,1,0
262370,10,3,0,0,3,0
262370,8,6,0,0,6,0
262370,7,8,0,0,8,0
262370,6,11,0,0,11,0
262370,3,1,0,0,1,0
32598,9,1,0,0,1,0
32598,4,1,0,0,1,0
185246,5,6,0,0,6,0
185246,4,1,0,0,1,0
185246,2,1,0,0,1,0
4303,10,1,0,0,1,0
4303,2,2,0,0,2,0
252165,5,1,0,0,1,0
184247,5,4,0,0,4,0
184247,2,1,0,0,1,0
254341,9,1,0,0,1,0
254341,5,7,0,0,7,0
254341,4,4,0,0,4,0
254341,3,1,0,0,1,0
20834,10,2,0,0,2,0
20834,5,4,0,0,4,0
20834,4,1,0,0,1,0
150143,7,5,0,0,5,0
150143,4,1,0,0,1,0
150143,3,1,0,0,1,0
150143,1,1,0,0,1,0
231477,10,1,0,0,1,0
231477,6,3,0,0,3,0
231477,4,3,0,0,3,0
231477,2,1,0,0,1,0
94958,9,1,0,0,1,0
94958,8,2,0,0,2,0
94958,7,2,0,0,2,0
94958,5,6,0,0,6,0
94958,4,6,0,0,6,0
94958,3,5,0,0,5,0
94958,2,1,0,0,1,0
125461,6,4,0,0,4,0
125461,5,8,0,0,8,0
125461,3,6,0,0,6,0
22354,8,1,0,0,1,0
22354,6,5,0,0,5,0
22354,5,9,0,0,9,0
22354,2,1,0,0,1,0
130304,7,5,0,0,5,0
130304,5,1,0,0,1,0
130304,3,1,0,0,1,0
130304,1,1,0,0,1,0
5031,7,1,0,0,1,0
5031,1,1,0,0,1,0
147852,10,2,0,0,2,0
147852,8,5,0,0,5,0
147852,6,8,0,0,8,0
147852,5,2,0,0,2,0
147852,4,1,0,0,1,0
147852,3,2,0,0,2,0
7040,10,1,0,0,1,0
7040,4,2,0,0,2,0
19456,7,1,0,0,1,0
19456,2,1,0,0,1,0
63433,9,3,0,0,3,0
63433,8,8,0,0,8,0
63433,4,1,0,0,1,0
1079,4,2,0,0,2,0
238360,10,2,0,0,2,0
238360,8,7,0,0,7,0
238360,7,7,0,0,7,0
238360,5,2,0,0,2,0
238360,4,1,0,0,1,0
238360,2,1,0,0,1,0
4012,10,2,0,0,2,0
4012,4,1,0,0,1,0
4012,2,1,0,0,1,0
34866,8,1,0,0,1,0
34866,3,3,0,0,3,0
113456,9,1,0,0,1,0
113456,5,3,0,0,3,0
113456,4,2,0,0,2,0
113456,1,1,0,0,1,0
209659,6,1,0,0,1,0
18870,4,1,0,0,1,0
177750,10,1,0,0,1,0
177750,9,1,0,0,1,0
177750,8,3,0,0,3,0
12856,4,2,0,0,2,0
12856,3,1,0,0,1,0
12856,2,2,0,0,2,0
8746,10,2,0,0,2,0
8746,9,1,0,0,1,0
37847,10,1,0,0,1,0
3205,9,1,0,0,1,0
3205,7,1,0,0,1,0
3205,4,7,0,0,7,0
3205,3,3,0,0,3,0
3205,2,3,0,0,3,0
17146,10,1,0,0,1,0
17146,4,1,0,0,1,0
25223,5,5,0,0,5,0
25223,4,4,0,0,4,0
25223,3,1,0,0,1,0
25223,2,1,0,0,1,0
25223,1,1,0,0,1,0
9016,7,2,0,0,2,0
198060,6,11,0,0,11,0
198060,5,4,0,0,4,0
198060,3,1,0,0,1,0
59309,9,2,0,0,2,0
59309,3,2,0,0,2,0
183481,9,2,0,0,2,0
183481,8,3,0,0,3,0
183481,7,7,0,0,7,0
183481,5,4,0,0,4,0
229369,7,8,0,0,8,0
229369,6,10,0,0,10,0
229369,5,4,0,0,4,0
229369,3,2,0,0,2,0
229369,2,1,0,0,1,0
229369,1,1,0,0,1,0
164542,9,1,0,0,1,0
164542,4,2,0,0,2,0
203661,9,1,0,0,1,0
203661,8,3,0,0,3,0
203661,3,1,0,0,1,0
203661,1,1,0,0,1,0
3918,10,2,0,0,2,0
3918,8,1,0,0,1,0
271896,6,1,0,0,1,0
271896,4,3,0,0,3,0
271896,2,1,0,0,1,0
15009,8,3,0,0,3,0
15009,7,1,0,0,1,0
15009,4,9,0,0,9,0
15009,3,2,0,0,2,0
15009,2,1,0,0,1,0
3946,10,1,0,0,1,0
3946,4,3,0,0,3,0
3946,3,3,0,0,3,0
17649,10,2,0,0,2,0
17649,6,6,0,0,6,0
17649,5,3,0,0,3,0
17649,4,1,0,0,1,0
17649,3,1,0,0,1,0
34310,10,1,0,0,1,0
34310,9,1,0,0,1,0
34310,8,6,0,0,6,0
256960,6,2,0,0,2,0
198517,1,2,0,0,2,0
229640,10,4,0,0,4,0
229640,9,1,0,0,1,0
229640,7,7,0,0,7,0
229640,4,1,0,0,1,0
229640,2,1,0,0,1,0
159570,10,1,0,0,1,0
159570,9,1,0,0,1,0
159570,8,4,0,0,4,0
159570,4,6,0,0,6,0
6990,7,2,0,0,2,0
6990,6,8,0,0,8,0
14374,8,1,0,0,1,0
14374,2,1,0,0,1,0
103640,8,1,0,0,1,0
103640,4,7,0,0,7,0
103640,3,3,0,0,3,0
10971,6,2,0,0,2,0
819,9,2,0,0,2,0
231196,9,3,0,0,3,0
231196,8,6,0,0,6,0
231196,7,7,0,0,7,0
231196,5,5,0,0,5,0
231196,1,1,0,0,1,0
8046,3,2,0,0,2,0
193131,10,5,0,0,5,0
193131,9,4,0,0,4,0
193131,6,5,0,0,5,0
193131,3,1,0,0,1,0
193131,1,1,0,0,1,0
15112,10,1,0,0,1,0
15112,2,1,0,0,1,0
131684,9,1,0,0,1,0
131684,2,1,0,0,1,0
6684,7,2,0,0,2,0
5688,6,7,0,0,7,0
5688,2,1,0,0,1,0
5688,1,2,0,0,2,0
220630,10,2,0,0,2,0
220630,7,12,0,0,12,0
220630,5,1,0,0,1,0
220630,4,1,0,0,1,0
220630,1,1,0,0,1,0
206083,10,2,0,0,2,0
206083,5,4,0,0,4,0
206083,1,1,0,0,1,0
118688,6,1,0,0,1,0
118688,5,2,0,0,2,0
118688,4,1,0,0,1,0
118688,1,1,0,0,1,0
1029,5,2,0,0,2,0
209578,4,3,0,0,3,0
209578,3,2,0,0,2,0
14082,10,2,0,0,2,0
160868,10,1,0,0,1,0
160868,5,6,0,0,6,0
160868,4,1,0,0,1,0
182915,5,1,0,0,1,0
85899,10,2,0,0,2,0
85899,6,4,0,0,4,0
131346,7,11,0,0,11,0
131346,5,4,0,0,4,0
131346,4,4,0,0,4,0
131346,3,1,0,0,1,0
152359,8,3,0,0,3,0
152359,5,2,0,0,2,0
152359,4,1,0,0,1,0
152359,2,1,0,0,1,0
160273,10,1,0,0,1,0
160273,8,1,0,0,1,0
160273,7,3,0,0,3,0
160273,3,1,0,0,1,0
160273,1,2,0,0,2,0
120924,10,1,0,0,1,0
120924,8,4,0,0,4,0
120924,5,8,0,0,8,0
120924,4,2,0,0,2,0
120924,3,1,0,0,1,0
120924,2,1,0,0,1,0
13716,10,1,0,0,1,0
13716,4,3,0,0,3,0
41190,8,2,0,0,2,0
41190,4,2,0,0,2,0
41190,1,1,0,0,1,0
5922,10,1,0,0,1,0
5922,8,1,0,0,1,0
5922,5,6,0,0,6,0
34933,9,1,0,0,1,0
136092,7,4,0,0,4,0
136092,2,3,0,0,3,0
1983,8,1,0,0,1,0
1983,4,2,0,0,2,0
185813,4,1,0,0,1,0
207905,10,4,0,0,4,0
207905,9,1,0,0,1,0
207905,8,2,0,0,2,0
207905,6,8,0,0,8,0
207905,5,4,0,0,4,0
207905,3,1,0,0,1,0
207905,1,1,0,0,1,0
35654,7,3,0,0,3,0
35654,6,2,0,0,2,0
35654,4,1,0,0,1,0
35654,1,1,0,0,1,0
223762,5,6,0,0,6,0
223762,4,1,0,0,1,0
223762,3,4,0,0,4,0
223762,2,1,0,0,1,0
223327,10,2,0,0,2,0
223327,3,1,0,0,1,0
231972,9,2,0,0,2,0
231972,6,1,0,0,1,0
231972,1,1,0,0,1,0
69544,3,3,0,0,3,0
69544,2,2,0,0,2,0
57865,4,1,0,0,1,0
57865,2,1,0,0,1,0
2935,10,1,0,0,1,0
2935,8,1,0,0,1,0
2935,3,3,0,0,3,0
2935,2,1,0,0,1,0
8560,5,7,0,0,7,0
8560,3,2,0,0,2,0
8560,2,1,0,0,1,0
4426,10,1,0,0,1,0
4426,8,4,0,0,4,0
4426,3,2,0,0,2,0
4426,1,3,0,0,3,0
4038,9,1,0,0,1,0
4038,1,1,0,0,1,0
7526,8,6,0,0,6,0
7526,3,1,0,0,1,0
879,9,1,0,0,1,0
879,2,1,0,0,1,0
98475,9,3,0,0,3,0
98475,4,1,0,0,1,0
150623,7,8,0,0,8,0
150623,6,6,0,0,6,0
150623,5,3,0,0,3,0
150623,4,2,0,0,2,0
12478,10,2,0,0,2,0
12478,4,1,0,0,1,0
1665,2,1,0,0,1,0
213834,5,1,0,0,1,0
213834,4,3,0,0,3,0
213834,3,2,0,0,2,0
7921,4,1,0,0,1,0
7921,3,1,0,0,1,0
8201,4,1,0,0,1,0
8201,3,1,0,0,1,0
8201,2,1,0,0,1,0
151334,5,3,0,0,3,0
151334,4,2,0,0,2,0
151334,1,1,0,0,1,0
5859,10,1,0,0,1,0
5859,1,1,0,0,1,0
175418,9,1,0,0,1,0
175418,8,2,0,0,2,0
175418,5,1,0,0,1,0
175418,4,1,0,0,1,0
175418,1,1,0,0,1,0
206464,10,2,0,0,2,0
206464,9,3,0,0,3,0
206464,1,1,0,0,1,0
208377,10,1,0,0,1,0
208377,7,4,0,0,4,0
208377,6,5,0,0,5,0
208377,3,2,0,0,2,0
208377,1,1,0,0,1,0
36299,9,1,0,0,1,0
168055,10,2,0,0,2,0
168055,9,1,0,0,1,0
168055,8,4,0,0,4,0
168055,7,3,0,0,3,0
168055,2,1,0,0,1,0
14474,10,1,0,0,1,0
14474,3,1,0,0,1,0
19381,1,1,0,0,1,0
151448,10,5,0,0,5,0
151448,6,3,0,0,3,0
151448,5,2,0,0,2,0
151448,4,2,0,0,2,0
163310,4,1,0,0,1,0
12784,7,1,0,0,1,0
12784,5,6,0,0,6,0
12784,3,6,0,0,6,0
12784,2,1,0,0,1,0
12784,1,4,0,0,4,0
141594,8,3,0,0,3,0
141594,1,1,0,0,1,0
34713,9,1,0,0,1,0
26067,5,7,0,0,7,0
26067,3,3,0,0,3,0
7799,10,1,0,0,1,0
7799,9,2,0,0,2,0
7799,5,1,0,0,1,0
91448,8,1,0,0,1,0
91448,7,3,0,0,3,0
91448,3,2,0,0,2,0
91448,2,1,0,0,1,0
13863,9,1,0,0,1,0
13863,6,2,0,0,2,0
13863,3,2,0,0,2,0
131914,3,5,0,0,5,0
8353,10,1,0,0,1,0
8353,9,1,0,0,1,0
8353,5,2,0,0,2,0
227425,10,2,0,0,2,0
227425,9,1,0,0,1,0
227425,8,2,0,0,2,0
227425,5,5,0,0,5,0
227425,4,1,0,0,1,0
227425,2,1,0,0,1,0
34296,2,1,0,0,1,0
219666,5,1,0,0,1,0
3329,8,2,0,0,2,0
3329,7,2,0,0,2,0
3329,1,1,0,0,1,0
630,9,3,0,0,3,0
630,5,1,0,0,1,0
630,1,1,0,0,1,0
2782,7,2,0,0,2,0
2782,3,1,0,0,1,0
103039,3,1,0,0,1,0
102750,10,1,0,0,1,0
102750,9,1,0,0,1,0
102750,7,5,0,0,5,0
102750,3,1,0,0,1,0
32264,5,8,0,0,8,0
32264,3,8,0,0,8,0
32264,2,4,0,0,4,0
197321,5,1,0,0,1,0
197321,2,1,0,0,1,0
197321,1,1,0,0,1,0
139780,10,1,0,0,1,0
139780,8,4,0,0,4,0
139780,5,5,0,0,5,0
139780,2,1,0,0,1,0
120618,10,1,0,0,1,0
120618,7,4,0,0,4,0
120618,4,4,0,0,4,0
120618,2,1,0,0,1,0
42227,10,1,0,0,1,0
42227,5,4,0,0,4,0
42227,4,2,0,0,2,0
42227,3,2,0,0,2,0
42227,1,1,0,0,1,0
31820,8,2,0,0,2,0
31820,7,4,0,0,4,0
31820,3,2,0,0,2,0
87681,10,1,0,0,1,0
87681,6,10,0,0,10,0
87681,4,4,0,0,4,0
87681,3,1,0,0,1,0
87681,2,2,0,0,2,0
87681,1,2,0,0,2,0
9152,10,3,0,0,3,0
9152,3,1,0,0,1,0
165640,10,2,0,0,2,0
165640,6,2,0,0,2,0
165640,2,1,0,0,1,0
162571,9,1,0,0,1,0
162571,7,1,0,0,1,0
40433,10,1,0,0,1,0
40433,8,2,0,0,2,0
40433,7,2,0,0,2,0
40433,3,2,0,0,2,0
114284,9,1,0,0,1,0
114284,6,7,0,0,7,0
114284,4,4,0,0,4,0
114284,3,3,0,0,3,0
114284,2,2,0,0,2,0
114284,1,2,0,0,2,0
245222,9,1,0,0,1,0
245222,3,2,0,0,2,0
66517,3,1,0,0,1,0
41611,6,2,0,0,2,0
41611,5,1,0,0,1,0
41611,4,1,0,0,1,0
20112,5,2,0,0,2,0
20112,4,4,0,0,4,0
20112,3,1,0,0,1,0
20112,2,1,0,0,1,0
8966,8,1,0,0,1,0
8966,7,2,0,0,2,0
8966,4,1,0,0,1,0
27359,9,3,0,0,3,0
27359,5,2,0,0,2,0
13879,9,1,0,0,1,0
13879,8,1,0,0,1,0
12520,10,2,0,0,2,0
12520,5,2,0,0,2,0
221982,6,9,0,0,9,0
221982,5,1,0,0,1,0
221982,1,1,0,0,1,0
235899,9,1,0,0,1,0
235899,7,8,0,0,8,0
235899,5,2,0,0,2,0
235899,4,3,0,0,3,0
235899,3,1,0,0,1,0
235899,1,1,0,0,1,0
2306,9,1,0,0,1,0
2306,1,1,0,0,1,0
8724,5,2,0,0,2,0
8724,4,1,0,0,1,0
215521,7,3,0,0,3,0
215521,6,1,0,0,1,0
215521,5,2,0,0,2,0
215521,4,1,0,0,1,0
2378,7,1,0,0,1,0
52626,8,3,0,0,3,0
52626,7,6,0,0,6,0
52626,5,7,0,0,7,0
52626,2,2,0,0,2,0
150216,2,4,0,0,4,0
150216,1,1,0,0,1,0
185769,7,4,0,0,4,0
185769,6,5,0,0,5,0
185769,5,1,0,0,1,0
185769,4,3,0,0,3,0
185769,1,1,0,0,1,0
165584,9,1,0,0,1,0
165584,7,5,0,0,5,0
165584,5,7,0,0,7,0
165584,2,1,0,0,1,0
30838,8,2,0,0,2,0
30838,6,13,0,0,13,0
30838,3,2,0,0,2,0
15958,10,1,0,0,1,0
15958,8,3,0,0,3,0
15958,2,1,0,0,1,0
151005,9,2,0,0,2,0
151005,8,3,0,0,3,0
151005,7,3,0,0,3,0
151005,4,2,0,0,2,0
151005,1,3,0,0,3,0
6907,10,2,0,0,2,0
109786,9,1,0,0,1,0
109786,5,2,0,0,2,0
240175,10,1,0,0,1,0
240175,7,8,0,0,8,0
5137,9,1,0,0,1,0
5137,3,1,0,0,1,0
5137,2,1,0,0,1,0
102676,9,3,0,0,3,0
11855,10,1,0,0,1,0
11855,9,1,0,0,1,0
148534,8,2,0,0,2,0
148534,7,3,0,0,3,0
148534,6,17,0,0,17,0
9581,8,1,0,0,1,0
9581,7,1,0,0,1,0
9581,3,4,0,0,4,0
218007,6,1,0,0,1,0
10345,7,4,0,0,4,0
10345,2,2,0,0,2,0
7802,10,1,0,0,1,0
7802,7,4,0,0,4,0
7802,6,5,0,0,5,0
7802,3,1,0,0,1,0
7802,2,1,0,0,1,0
7802,1,1,0,0,1,0
1688,6,9,0,0,9,0
220980,5,3,0,0,3,0
220980,4,2,0,0,2,0
220980,3,1,0,0,1,0
137354,8,1,0,0,1,0
137354,2,1,0,0,1,0
137354,1,1,0,0,1,0
2320,8,5,0,0,5,0
2320,5,5,0,0,5,0
6386,9,1,0,0,1,0
6386,8,1,0,0,1,0
6386,7,3,0,0,3,0
6386,3,4,0,0,4,0
6386,2,1,0,0,1,0
149459,5,5,0,0,5,0
51199,10,3,0,0,3,0
51199,9,4,0,0,4,0
51199,8,9,0,0,9,0
21447,8,5,0,0,5,0
21447,2,1,0,0,1,0
12455,10,1,0,0,1,0
153916,1,1,0,0,1,0
2664,9,1,0,0,1,0
2664,8,1,0,0,1,0
37741,9,8,0,0,8,0
37741,8,6,0,0,6,0
37741,7,6,0,0,6,0
37741,6,2,0,0,2,0
37741,1,1,0,0,1,0
14040,10,1,0,0,1,0
14040,8,1,0,0,1,0
14040,4,4,0,0,4,0
14040,3,4,0,0,4,0
132145,9,4,0,0,4,0
132145,7,3,0,0,3,0
132145,4,7,0,0,7,0
132145,3,1,0,0,1,0
132145,1,1,0,0,1,0
10631,2,1,0,0,1,0
226237,7,1,0,0,1,0
226237,5,1,0,0,1,0
12054,5,2,0,0,2,0
12054,1,1,0,0,1,0
256708,8,3,0,0,3,0
256708,7,1,0,0,1,0
128910,1,1,0,0,1,0
207335,9,3,0,0,3,0
207335,7,9,0,0,9,0
207335,6,7,0,0,7,0
207335,5,2,0,0,2,0
207335,3,1,0,0,1,0
207335,1,1,0,0,1,0
19001,5,4,0,0,4,0
5216,10,1,0,0,1,0
5216,5,7,0,0,7,0
5216,2,2,0,0,2,0
144412,8,9,0,0,9,0
144412,6,7,0,0,7,0
144412,3,1,0,0,1,0
144412,2,1,0,0,1,0
202674,5,3,0,0,3,0
11112,9,1,0,0,1,0
11112,7,2,0,0,2,0
11112,3,2,0,0,2,0
328,8,2,0,0,2,0
328,6,9,0,0,9,0
66197,9,1,0,0,1,0
66197,8,6,0,0,6,0
66197,3,2,0,0,2,0
5863,10,1,0,0,1,0
12496,10,2,0,0,2,0
12496,8,1,0,0,1,0
7140,10,2,0,0,2,0
7140,9,1,0,0,1,0
7140,6,10,0,0,10,0
7140,5,7,0,0,7,0
7140,4,3,0,0,3,0
182540,10,2,0,0,2,0
182540,9,1,0,0,1,0
182540,6,7,0,0,7,0
182540,4,4,0,0,4,0
182540,3,2,0,0,2,0
182540,1,1,0,0,1,0
26244,8,3,0,0,3,0
26244,5,9,0,0,9,0
180746,10,3,0,0,3,0
180746,8,3,0,0,3,0
180746,7,3,0,0,3,0
180746,5,8,0,0,8,0
180746,3,2,0,0,2,0
180746,2,4,0,0,4,0
76994,9,2,0,0,2,0
179304,10,4,0,0,4,0
179304,9,3,0,0,3,0
179304,4,1,0,0,1,0
179304,3,1,0,0,1,0
179304,2,1,0,0,1,0
16332,9,2,0,0,2,0
16332,6,3,0,0,3,0
16332,5,3,0,0,3,0
16332,2,2,0,0,2,0
191999,9,2,0,0,2,0
191999,8,5,0,0,5,0
4625,10,1,0,0,1,0
4625,3,2,0,0,2,0
3649,5,9,0,0,9,0
3649,4,3,0,0,3,0
153168,3,3,0,0,3,0
17298,9,1,0,0,1,0
182409,2,1,0,0,1,0
2558,9,1,0,0,1,0
2558,8,1,0,0,1,0
11320,9,1,0,0,1,0
11320,8,2,0,0,2,0
11320,5,4,0,0,4,0
11320,4,1,0,0,1,0
11320,3,1,0,0,1,0
2497,8,1,0,0,1,0
75644,1,1,0,0,1,0
27007,9,2,0,0,2,0
27007,5,1,0,0,1,0
27007,4,3,0,0,3,0
34890,4,1,0,0,1,0
18828,9,1,0,0,1,0
18828,8,1,0,0,1,0
18828,7,1,0,0,1,0
126749,9,1,0,0,1,0
126749,8,2,0,0,2,0
37370,10,1,0,0,1,0
225653,10,2,0,0,2,0
225653,9,1,0,0,1,0
225653,7,6,0,0,6,0
225653,5,3,0,0,3,0
225653,4,6,0,0,6,0
225653,3,5,0,0,5,0
225653,2,2,0,0,2,0
17836,8,5,0,0,5,0
17836,6,9,0,0,9,0
17836,5,3,0,0,3,0
17836,4,2,0,0,2,0
17836,1,3,0,0,3,0
256334,5,3,0,0,3,0
256334,2,2,0,0,2,0
256334,1,1,0,0,1,0
164201,9,1,0,0,1,0
164201,6,11,0,0,11,0
164201,5,4,0,0,4,0
164201,1,1,0,0,1,0
16455,10,1,0,0,1,0
224979,6,5,0,0,5,0
224979,4,1,0,0,1,0
224979,3,2,0,0,2,0
131477,2,2,0,0,2,0
240423,10,1,0,0,1,0
240423,8,1,0,0,1,0
240423,7,7,0,0,7,0
240423,5,6,0,0,6,0
240423,3,2,0,0,2,0
240423,2,2,0,0,2,0
240423,1,1,0,0,1,0
13818,9,1,0,0,1,0
13818,8,6,0,0,6,0
13818,5,8,0,0,8,0
13818,3,1,0,0,1,0
146747,9,1,0,0,1,0
146747,6,12,0,0,12,0
146747,5,2,0,0,2,0
187673,10,1,0,0,1,0
187673,9,2,0,0,2,0
187673,8,11,0,0,11,0
187673,5,1,0,0,1,0
9094,10,1,0,0,1,0
9094,8,2,0,0,2,0
9094,5,4,0,0,4,0
9094,2,1,0,0,1,0
9094,1,1,0,0,1,0
31585,8,2,0,0,2,0
31585,6,11,0,0,11,0
31585,4,7,0,0,7,0
31585,3,2,0,0,2,0
150530,7,9,0,0,9,0
150530,5,3,0,0,3,0
48867,10,1,0,0,1,0
48867,8,1,0,0,1,0
48867,4,5,0,0,5,0
48867,3,3,0,0,3,0
48867,2,1,0,0,1,0
129668,9,1,0,0,1,0
129668,5,1,0,0,1,0
26157,6,8,0,0,8,0
26157,4,6,0,0,6,0
26157,3,2,0,0,2,0
3892,10,1,0,0,1,0
3892,5,2,0,0,2,0
3892,4,2,0,0,2,0
20139,8,1,0,0,1,0
20139,5,7,0,0,7,0
20139,2,2,0,0,2,0
2657,7,5,0,0,5,0
2657,4,1,0,0,1,0
2657,3,2,0,0,2,0
32601,9,2,0,0,2,0
32601,6,8,0,0,8,0
32601,5,6,0,0,6,0
32601,4,5,0,0,5,0
9083,10,1,0,0,1,0
9083,8,3,0,0,3,0
9083,4,2,0,0,2,0
190064,10,1,0,0,1,0
190064,7,5,0,0,5,0
190064,5,3,0,0,3,0
190064,4,1,0,0,1,0
190064,3,3,0,0,3,0
190064,1,1,0,0,1,0
67630,10,1,0,0,1,0
67630,8,1,0,0,1,0
224122,10,1,0,0,1,0
224122,2,1,0,0,1,0
6675,9,1,0,0,1,0
166183,9,4,0,0,4,0
166183,5,1,0,0,1,0
166183,1,1,0,0,1,0
133246,5,7,0,0,7,0
133246,1,1,0,0,1,0
1191,9,1,0,0,1,0
1191,7,1,0,0,1,0
8740,9,1,0,0,1,0
8740,5,5,0,0,5,0
8740,4,3,0,0,3,0
8740,3,2,0,0,2,0
165711,9,1,0,0,1,0
165711,8,2,0,0,2,0
165711,7,4,0,0,4,0
165711,6,11,0,0,11,0
166371,7,6,0,0,6,0
166371,3,4,0,0,4,0
166371,2,1,0,0,1,0
201502,6,6,0,0,6,0
201502,4,10,0,0,10,0
201502,3,7,0,0,7,0
184337,10,1,0,0,1,0
184337,9,1,0,0,1,0
184337,3,1,0,0,1,0
184337,2,1,0,0,1,0
236332,7,1,0,0,1,0
9816,10,1,0,0,1,0
113332,10,1,0,0,1,0
113332,8,4,0,0,4,0
113332,4,1,0,0,1,0
113332,2,2,0,0,2,0
232210,10,2,0,0,2,0
232210,7,7,0,0,7,0
232210,5,1,0,0,1,0
5618,6,1,0,0,1,0
5618,1,1,0,0,1,0
165828,10,2,0,0,2,0
165828,9,3,0,0,3,0
165828,6,4,0,0,4,0
165828,5,6,0,0,6,0
165828,2,1,0,0,1,0
1427,3,1,0,0,1,0
1427,1,1,0,0,1,0
7683,10,1,0,0,1,0
7683,9,3,0,0,3,0
7683,7,4,0,0,4,0
7683,6,13,0,0,13,0
7683,4,2,0,0,2,0
7683,2,1,0,0,1,0
33541,10,2,0,0,2,0
136265,8,1,0,0,1,0
136265,4,1,0,0,1,0
136265,2,1,0,0,1,0
136265,1,1,0,0,1,0
165651,8,3,0,0,3,0
165651,7,7,0,0,7,0
165651,5,5,0,0,5,0
165651,4,6,0,0,6,0
165651,3,2,0,0,2,0
165651,2,1,0,0,1,0
23605,9,2,0,0,2,0
23605,5,2,0,0,2,0
4627,10,1,0,0,1,0
4627,4,4,0,0,4,0
38763,10,2,0,0,2,0
38763,4,2,0,0,2,0
38763,3,1,0,0,1,0
17195,10,1,0,0,1,0
17195,8,4,0,0,4,0
148211,9,3,0,0,3,0
148211,5,1,0,0,1,0
11433,10,1,0,0,1,0
11433,9,1,0,0,1,0
11433,5,1,0,0,1,0
11433,4,2,0,0,2,0
11433,3,1,0,0,1,0
192320,9,1,0,0,1,0
192320,6,9,0,0,9,0
192320,5,2,0,0,2,0
192320,1,1,0,0,1,0
185244,4,2,0,0,2,0
123495,9,1,0,0,1,0
123495,2,1,0,0,1,0
183472,8,1,0,0,1,0
183472,6,6,0,0,6,0
183472,5,8,0,0,8,0
183472,3,6,0,0,6,0
171540,9,2,0,0,2,0
171540,8,4,0,0,4,0
171540,4,3,0,0,3,0
171540,3,2,0,0,2,0
171540,2,1,0,0,1,0
48154,9,1,0,0,1,0
48154,5,5,0,0,5,0
48154,3,1,0,0,1,0
48154,2,1,0,0,1,0
48154,1,1,0,0,1,0
7762,9,1,0,0,1,0
7762,4,4,0,0,4,0
180339,9,1,0,0,1,0
180339,3,2,0,0,2,0
32324,9,3,0,0,3,0
32324,8,1,0,0,1,0
154274,9,2,0,0,2,0
154274,7,11,0,0,11,0
154274,3,1,0,0,1,0
164091,6,9,0,0,9,0
164091,5,4,0,0,4,0
164091,4,1,0,0,1,0
216695,9,1,0,0,1,0
216695,8,1,0,0,1,0
216695,7,7,0,0,7,0
216695,5,5,0,0,5,0
216695,3,2,0,0,2,0
66533,8,7,0,0,7,0
5743,5,2,0,0,2,0
5743,3,1,0,0,1,0
6880,10,1,0,0,1,0
6880,7,2,0,0,2,0
6880,3,1,0,0,1,0
2341,3,1,0,0,1,0
15852,6,3,0,0,3,0
10537,8,3,0,0,3,0
10537,7,2,0,0,2,0
131448,9,1,0,0,1,0
131448,8,1,0,0,1,0
131448,5,5,0,0,5,0
228310,9,2,0,0,2,0
228310,5,4,0,0,4,0
228310,4,1,0,0,1,0
9989,9,1,0,0,1,0
9989,8,2,0,0,2,0
9989,4,3,0,0,3,0
202723,10,2,0,0,2,0
202723,9,2,0,0,2,0
202723,4,2,0,0,2,0
202723,2,1,0,0,1,0
220440,6,4,0,0,4,0
122961,10,1,0,0,1,0
122961,5,1,0,0,1,0
122961,4,2,0,0,2,0
99881,9,2,0,0,2,0
99881,8,2,0,0,2,0
99881,6,11,0,0,11,0
99881,5,4,0,0,4,0
99881,3,1,0,0,1,0
37997,5,3,0,0,3,0
37997,4,1,0,0,1,0
37997,2,2,0,0,2,0
37997,1,1,0,0,1,0
188204,10,2,0,0,2,0
188204,8,2,0,0,2,0
188204,7,6,0,0,6,0
188204,5,3,0,0,3,0
188204,1,1,0,0,1,0
21716,9,1,0,0,1,0
21716,4,3,0,0,3,0
21716,3,2,0,0,2,0
5794,10,1,0,0,1,0
5794,2,1,0,0,1,0
196220,4,1,0,0,1,0
196220,1,1,0,0,1,0
114228,8,4,0,0,4,0
114228,3,1,0,0,1,0
114228,1,1,0,0,1,0
18600,5,2,0,0,2,0
1975,6,11,0,0,11,0
1975,4,3,0,0,3,0
1975,3,3,0,0,3,0
151215,8,1,0,0,1,0
151215,4,1,0,0,1,0
151215,2,1,0,0,1,0
238510,5,5,0,0,5,0
238510,4,2,0,0,2,0
153496,10,1,0,0,1,0
153496,9,2,0,0,2,0
153496,8,1,0,0,1,0
153496,7,9,0,0,9,0
153496,6,9,0,0,9,0
153496,5,3,0,0,3,0
133104,10,2,0,0,2,0
133104,9,1,0,0,1,0
133104,6,10,0,0,10,0
133104,4,4,0,0,4,0
133104,3,1,0,0,1,0
9843,10,1,0,0,1,0
9843,5,5,0,0,5,0
1343,9,1,0,0,1,0
1343,3,1,0,0,1,0
3198,6,6,0,0,6,0
3198,5,9,0,0,9,0
3198,2,1,0,0,1,0
13989,8,1,0,0,1,0
13989,7,4,0,0,4,0
13989,2,2,0,0,2,0
226757,9,4,0,0,4,0
226757,8,3,0,0,3,0
226757,7,5,0,0,5,0
226757,5,2,0,0,2,0
7931,10,2,0,0,2,0
7931,6,9,0,0,9,0
7931,4,2,0,0,2,0
30164,9,1,0,0,1,0
133886,10,1,0,0,1,0
133886,8,2,0,0,2,0
173121,10,1,0,0,1,0
173121,8,6,0,0,6,0
173121,7,15,0,0,15,0
173121,4,1,0,0,1,0
73251,8,4,0,0,4,0
73251,1,1,0,0,1,0
253568,10,1,0,0,1,0
253568,4,1,0,0,1,0
30111,10,1,0,0,1,0
203401,7,12,0,0,12,0
203401,1,1,0,0,1,0
19498,10,1,0,0,1,0
19498,7,5,0,0,5,0
19498,4,6,0,0,6,0
19498,3,1,0,0,1,0
128001,7,3,0,0,3,0
128001,3,4,0,0,4,0
27982,10,1,0,0,1,0
27982,8,1,0,0,1,0
27982,3,1,0,0,1,0
92186,10,1,0,0,1,0
92186,9,2,0,0,2,0
91513,9,2,0,0,2,0
91513,8,2,0,0,2,0
91513,4,3,0,0,3,0
203560,1,1,0,0,1,0
174943,9,4,0,0,4,0
174943,8,4,0,0,4,0
174943,7,10,0,0,10,0
174943,6,3,0,0,3,0
174943,3,1,0,0,1,0
174943,2,1,0,0,1,0
141107,8,2,0,0,2,0
141107,7,8,0,0,8,0
141107,5,6,0,0,6,0
141107,4,5,0,0,5,0
157053,9,1,0,0,1,0
157053,5,1,0,0,1,0
157053,4,1,0,0,1,0
203710,4,1,0,0,1,0
203710,1,1,0,0,1,0
23389,3,4,0,0,4,0
142981,10,1,0,0,1,0
142981,9,1,0,0,1,0
220258,6,2,0,0,2,0
220258,5,1,0,0,1,0
220258,3,1,0,0,1,0
20610,10,1,0,0,1,0
20610,5,2,0,0,2,0
141681,2,1,0,0,1,0
16746,9,1,0,0,1,0
16746,8,3,0,0,3,0
16746,2,1,0,0,1,0
16746,1,1,0,0,1,0
28253,10,2,0,0,2,0
11116,10,1,0,0,1,0
122873,7,5,0,0,5,0
122873,6,12,0,0,12,0
122873,4,2,0,0,2,0
122873,2,2,0,0,2,0
194075,8,1,0,0,1,0
194075,4,4,0,0,4,0
194075,2,1,0,0,1,0
194075,1,1,0,0,1,0
4010,5,4,0,0,4,0
4010,4,1,0,0,1,0
4010,1,1,0,0,1,0
102346,9,2,0,0,2,0
102346,3,1,0,0,1,0
31453,10,1,0,0,1,0
31453,4,2,0,0,2,0
18690,9,5,0,0,5,0
18690,3,1,0,0,1,0
176826,10,3,0,0,3,0
176826,9,3,0,0,3,0
5789,4,5,0,0,5,0
5789,2,1,0,0,1,0
235014,9,7,0,0,7,0
235014,7,6,0,0,6,0
235014,6,1,0,0,1,0
235014,2,1,0,0,1,0
235014,1,1,0,0,1,0
14746,10,1,0,0,1,0
7156,8,1,0,0,1,0
7156,7,3,0,0,3,0
7156,5,11,0,0,11,0
7156,2,2,0,0,2,0
762,10,1,0,0,1,0
762,8,1,0,0,1,0
762,3,1,0,0,1,0
145206,5,2,0,0,2,0
145206,4,1,0,0,1,0
87926,9,4,0,0,4,0
87926,1,1,0,0,1,0
211485,5,4,0,0,4,0
211485,4,2,0,0,2,0
211485,3,1,0,0,1,0
211485,1,1,0,0,1,0
9133,10,1,0,0,1,0
9133,4,1,0,0,1,0
9133,1,1,0,0,1,0
17926,5,3,0,0,3,0
37731,10,1,0,0,1,0
37731,7,3,0,0,3,0
37731,2,1,0,0,1,0
110598,9,1,0,0,1,0
110598,5,6,0,0,6,0
110598,4,7,0,0,7,0
110598,3,3,0,0,3,0
271785,10,3,0,0,3,0
271785,7,6,0,0,6,0
271785,5,4,0,0,4,0
271785,4,3,0,0,3,0
26204,7,1,0,0,1,0
26204,4,6,0,0,6,0
26204,2,4,0,0,4,0
26204,1,1,0,0,1,0
3884,10,1,0,0,1,0
14360,1,1,0,0,1,0
9578,10,1,0,0,1,0
9578,8,1,0,0,1,0
9578,3,1,0,0,1,0
9578,2,2,0,0,2,0
10893,3,1,0,0,1,0
215532,8,3,0,0,3,0
215532,7,5,0,0,5,0
215532,5,3,0,0,3,0
215532,4,7,0,0,7,0
11689,7,4,0,0,4,0
11689,4,2,0,0,2,0
161869,10,1,0,0,1,0
161869,9,1,0,0,1,0
161869,8,2,0,0,2,0
161869,3,1,0,0,1,0
161869,1,1,0,0,1,0
15683,4,1,0,0,1,0
161553,8,2,0,0,2,0
161553,7,2,0,0,2,0
161553,3,2,0,0,2,0
161553,2,2,0,0,2,0
161553,1,1,0,0,1,0
22999,2,1,0,0,1,0
3330,6,5,0,0,5,0
3330,5,5,0,0,5,0
193792,10,2,0,0,2,0
193792,7,6,0,0,6,0
242325,10,1,0,0,1,0
242325,9,2,0,0,2,0
242325,7,11,0,0,11,0
242325,4,2,0,0,2,0
40803,4,2,0,0,2,0
251153,10,1,0,0,1,0
251153,9,6,0,0,6,0
251153,5,2,0,0,2,0
129625,10,2,0,0,2,0
129625,9,1,0,0,1,0
129625,8,4,0,0,4,0
129625,7,9,0,0,9,0
129625,6,11,0,0,11,0
129625,5,6,0,0,6,0
129625,4,1,0,0,1,0
240002,10,3,0,0,3,0
240002,9,2,0,0,2,0
240002,5,2,0,0,2,0
240002,3,1,0,0,1,0
118697,9,3,0,0,3,0
118697,8,3,0,0,3,0
118697,6,13,0,0,13,0
118697,5,3,0,0,3,0
118697,4,1,0,0,1,0
118697,2,2,0,0,2,0
193240,1,1,0,0,1,0
7541,10,1,0,0,1,0
7541,9,1,0,0,1,0
7541,8,4,0,0,4,0
7541,4,2,0,0,2,0
8691,7,4,0,0,4,0
8691,6,4,0,0,4,0
8691,3,3,0,0,3,0
8691,2,1,0,0,1,0
156927,10,2,0,0,2,0
156927,3,1,0,0,1,0
156927,1,1,0,0,1,0
14128,10,1,0,0,1,0
6245,8,2,0,0,2,0
6245,6,2,0,0,2,0
6245,4,8,0,0,8,0
204397,6,3,0,0,3,0
204397,3,1,0,0,1,0
261321,5,1,0,0,1,0
73243,10,1,0,0,1,0
272409,9,5,0,0,5,0
272409,7,1,0,0,1,0
272409,6,1,0,0,1,0
221122,4,1,0,0,1,0
67891,9,1,0,0,1,0
67891,4,1,0,0,1,0
236881,5,4,0,0,4,0
7977,10,1,0,0,1,0
7977,9,2,0,0,2,0
7977,8,1,0,0,1,0
7977,4,4,0,0,4,0
205263,10,1,0,0,1,0
205263,3,2,0,0,2,0
529,7,11,0,0,11,0
529,6,13,0,0,13,0
529,4,2,0,0,2,0
146728,10,1,0,0,1,0
146728,7,5,0,0,5,0
146728,1,1,0,0,1,0
9863,8,6,0,0,6,0
9863,4,1,0,0,1,0
9863,3,1,0,0,1,0
7964,10,1,0,0,1,0
7964,8,2,0,0,2,0
7964,1,1,0,0,1,0
193141,10,1,0,0,1,0
193141,3,5,0,0,5,0
3325,5,2,0,0,2,0
3325,3,1,0,0,1,0
8749,10,2,0,0,2,0
8749,9,1,0,0,1,0
263918,7,5,0,0,5,0
263918,6,3,0,0,3,0
156023,10,1,0,0,1,0
156023,3,1,0,0,1,0
4596,8,2,0,0,2,0
4596,7,3,0,0,3,0
4596,4,7,0,0,7,0
4596,2,4,0,0,4,0
5295,10,2,0,0,2,0
5295,7,3,0,0,3,0
5295,3,1,0,0,1,0
112811,9,1,0,0,1,0
112811,8,2,0,0,2,0
196256,7,8,0,0,8,0
196256,5,3,0,0,3,0
16562,8,2,0,0,2,0
16562,6,3,0,0,3,0
16562,2,3,0,0,3,0
16562,1,1,0,0,1,0
9512,10,1,0,0,1,0
9512,3,1,0,0,1,0
9512,1,1,0,0,1,0
11563,10,1,0,0,1,0
11563,8,2,0,0,2,0
11563,4,2,0,0,2,0
11563,3,1,0,0,1,0
28879,8,6,0,0,6,0
28879,7,9,0,0,9,0
28879,5,1,0,0,1,0
28879,3,1,0,0,1,0
29268,7,1,0,0,1,0
29268,5,12,0,0,12,0
29268,4,5,0,0,5,0
29268,3,2,0,0,2,0
29268,2,1,0,0,1,0
2783,8,1,0,0,1,0
2783,7,2,0,0,2,0
29018,4,5,0,0,5,0
29018,3,2,0,0,2,0
2788,1,1,0,0,1,0
98371,7,1,0,0,1,0
98371,1,1,0,0,1,0
12491,8,1,0,0,1,0
12491,7,2,0,0,2,0
12491,2,1,0,0,1,0
6228,10,1,0,0,1,0
6228,7,3,0,0,3,0
13935,5,5,0,0,5,0
13935,1,3,0,0,3,0
241590,10,8,0,0,8,0
241590,9,1,0,0,1,0
241590,7,3,0,0,3,0
241590,5,1,0,0,1,0
241590,4,3,0,0,3,0
20732,10,2,0,0,2,0
20732,9,2,0,0,2,0
20732,8,3,0,0,3,0
20732,4,1,0,0,1,0
20732,3,2,0,0,2,0
20732,1,1,0,0,1,0
85468,10,1,0,0,1,0
85468,9,2,0,0,2,0
85468,6,6,0,0,6,0
85468,5,5,0,0,5,0
85468,1,1,0,0,1,0
136283,9,1,0,0,1,0
136283,8,8,0,0,8,0
136283,4,2,0,0,2,0
136283,3,1,0,0,1,0
236114,8,1,0,0,1,0
236114,7,7,0,0,7,0
236114,4,1,0,0,1,0
236114,2,1,0,0,1,0
88925,9,1,0,0,1,0
88925,7,9,0,0,9,0
88925,6,6,0,0,6,0
88925,5,5,0,0,5,0
88925,1,1,0,0,1,0
4441,4,4,0,0,4,0
4441,2,1,0,0,1,0
4441,1,3,0,0,3,0
8364,4,4,0,0,4,0
115370,10,4,0,0,4,0
115370,7,7,0,0,7,0
44715,9,1,0,0,1,0
44715,2,1,0,0,1,0
126464,9,1,0,0,1,0
126464,8,2,0,0,2,0
126464,7,3,0,0,3,0
126464,4,4,0,0,4,0
11510,10,1,0,0,1,0
11510,9,3,0,0,3,0
11510,6,7,0,0,7,0
415,9,2,0,0,2,0
415,8,5,0,0,5,0
415,7,5,0,0,5,0
164428,6,4,0,0,4,0
164428,5,3,0,0,3,0
164428,4,2,0,0,2,0
164428,1,1,0,0,1,0
34938,7,6,0,0,6,0
34938,3,2,0,0,2,0
8359,1,1,0,0,1,0
40653,10,1,0,0,1,0
40653,4,1,0,0,1,0
40653,1,1,0,0,1,0
138746,4,4,0,0,4,0
138746,2,2,0,0,2,0
138746,1,2,0,0,2,0
12870,10,1,0,0,1,0
7611,8,1,0,0,1,0
7611,3,4,0,0,4,0
7611,2,1,0,0,1,0
7611,1,1,0,0,1,0
19725,9,1,0,0,1,0
19725,4,2,0,0,2,0
4912,8,1,0,0,1,0
4912,5,11,0,0,11,0
4912,4,4,0,0,4,0
103016,8,7,0,0,7,0
103016,4,2,0,0,2,0
2547,7,2,0,0,2,0
56244,9,1,0,0,1,0
56244,3,2,0,0,2,0
43110,9,1,0,0,1,0
43110,8,12,0,0,12,0
257307,10,4,0,0,4,0
257307,9,2,0,0,2,0
257307,8,3,0,0,3,0
257307,6,3,0,0,3,0
257307,4,2,0,0,2,0
16314,9,1,0,0,1,0
16314,7,4,0,0,4,0
16314,6,12,0,0,12,0
16314,5,6,0,0,6,0
16314,3,2,0,0,2,0
16314,2,1,0,0,1,0
194966,8,4,0,0,4,0
194966,5,1,0,0,1,0
194966,4,1,0,0,1,0
194966,3,1,0,0,1,0
194966,1,1,0,0,1,0
69347,9,2,0,0,2,0
5174,8,3,0,0,3,0
5174,5,7,0,0,7,0
5174,4,4,0,0,4,0
5174,3,1,0,0,1,0
24373,9,1,0,0,1,0
12111,5,2,0,0,2,0
3045,4,6,0,0,6,0
39527,10,3,0,0,3,0
21861,8,1,0,0,1,0
5934,10,2,0,0,2,0
5934,4,2,0,0,2,0
5934,2,1,0,0,1,0
94371,9,1,0,0,1,0
94371,1,1,0,0,1,0
10783,9,1,0,0,1,0
10783,4,2,0,0,2,0
202617,6,2,0,0,2,0
202617,5,1,0,0,1,0
202617,1,1,0,0,1,0
192233,5,3,0,0,3,0
192233,4,2,0,0,2,0
192233,2,2,0,0,2,0
149705,6,1,0,0,1,0
149705,1,1,0,0,1,0
20710,10,1,0,0,1,0
20710,6,3,0,0,3,0
151070,8,2,0,0,2,0
151070,6,1,0,0,1,0
151070,5,1,0,0,1,0
151070,1,1,0,0,1,0
7920,4,1,0,0,1,0
7920,2,1,0,0,1,0
42882,9,1,0,0,1,0
15819,4,1,0,0,1,0
15819,2,2,0,0,2,0
15819,1,1,0,0,1,0
7837,8,2,0,0,2,0
11642,10,2,0,0,2,0
11642,8,1,0,0,1,0
11642,3,1,0,0,1,0
11642,1,1,0,0,1,0
200314,8,4,0,0,4,0
200314,6,3,0,0,3,0
200314,5,2,0,0,2,0
200314,3,2,0,0,2,0
200314,1,1,0,0,1,0
163957,7,6,0,0,6,0
163957,5,1,0,0,1,0
163957,1,1,0,0,1,0
33782,9,1,0,0,1,0
33782,8,5,0,0,5,0
33782,7,6,0,0,6,0
33782,4,4,0,0,4,0
33782,2,2,0,0,2,0
167827,10,1,0,0,1,0
167827,8,2,0,0,2,0
167827,5,5,0,0,5,0
167827,4,4,0,0,4,0
167827,3,2,0,0,2,0
167827,1,1,0,0,1,0
94073,7,2,0,0,2,0
94073,3,2,0,0,2,0
94073,1,1,0,0,1,0
11737,10,1,0,0,1,0
11737,6,4,0,0,4,0
3826,4,1,0,0,1,0
15430,10,2,0,0,2,0
15430,9,1,0,0,1,0
15430,5,4,0,0,4,0
165888,5,4,0,0,4,0
12269,1,1,0,0,1,0
16158,9,2,0,0,2,0
16158,8,2,0,0,2,0
16158,6,3,0,0,3,0
16158,2,1,0,0,1,0
3557,9,1,0,0,1,0
3557,5,7,0,0,7,0
3557,3,1,0,0,1,0
14765,7,6,0,0,6,0
171126,9,1,0,0,1,0
171126,8,3,0,0,3,0
171126,5,4,0,0,4,0
171126,4,2,0,0,2,0
171126,2,1,0,0,1,0
14514,2,1,0,0,1,0
149814,10,1,0,0,1,0
147039,10,4,0,0,4,0
147039,7,5,0,0,5,0
147039,5,4,0,0,4,0
40171,4,2,0,0,2,0
40171,3,1,0,0,1,0
117815,9,1,0,0,1,0
117815,6,7,0,0,7,0
117815,5,5,0,0,5,0
117815,1,1,0,0,1,0
29019,8,2,0,0,2,0
29019,7,5,0,0,5,0
6883,10,1,0,0,1,0
6883,8,1,0,0,1,0
6883,5,5,0,0,5,0
6883,2,1,0,0,1,0
6883,1,2,0,0,2,0
170608,6,1,0,0,1,0
170608,5,1,0,0,1,0
6574,4,5,0,0,5,0
6574,2,1,0,0,1,0
192237,4,2,0,0,2,0
192237,3,1,0,0,1,0
2319,10,1,0,0,1,0
2319,9,2,0,0,2,0
13800,10,3,0,0,3,0
13800,5,2,0,0,2,0
13800,4,1,0,0,1,0
13800,2,1,0,0,1,0
21807,9,1,0,0,1,0
21807,7,2,0,0,2,0
21807,3,3,0,0,3,0
41604,9,2,0,0,2,0
67041,10,1,0,0,1,0
67041,8,3,0,0,3,0
67041,7,5,0,0,5,0
67041,5,2,0,0,2,0
67041,4,8,0,0,8,0
67041,3,1,0,0,1,0
67041,2,1,0,0,1,0
6681,8,1,0,0,1,0
6681,7,1,0,0,1,0
174556,6,2,0,0,2,0
174556,1,1,0,0,1,0
6412,8,1,0,0,1,0
6412,1,2,0,0,2,0
8619,1,2,0,0,2,0
8723,5,1,0,0,1,0
8723,4,1,0,0,1,0
9418,10,1,0,0,1,0
9418,9,1,0,0,1,0
9418,5,2,0,0,2,0
9418,4,4,0,0,4,0
157942,9,2,0,0,2,0
157942,5,3,0,0,3,0
157942,2,4,0,0,4,0
157942,1,1,0,0,1,0
181089,8,2,0,0,2,0
181089,5,5,0,0,5,0
181089,3,2,0,0,2,0
12030,10,1,0,0,1,0
12030,8,2,0,0,2,0
95705,7,1,0,0,1,0
95705,3,3,0,0,3,0
95705,2,2,0,0,2,0
95705,1,2,0,0,2,0
152247,8,1,0,0,1,0
152247,7,4,0,0,4,0
152247,6,13,0,0,13,0
152247,4,2,0,0,2,0
188530,9,5,0,0,5,0
188530,6,5,0,0,5,0
188530,5,1,0,0,1,0
188530,4,3,0,0,3,0
188530,3,1,0,0,1,0
18205,7,5,0,0,5,0
18205,6,3,0,0,3,0
18205,5,1,0,0,1,0
18205,4,1,0,0,1,0
11534,10,1,0,0,1,0
11534,8,3,0,0,3,0
11534,4,1,0,0,1,0
127590,6,9,0,0,9,0
127590,5,7,0,0,7,0
127590,4,2,0,0,2,0
127590,3,1,0,0,1,0
127590,2,3,0,0,3,0
30281,6,1,0,0,1,0
30281,5,4,0,0,4,0
30281,4,2,0,0,2,0
143250,9,1,0,0,1,0
143250,4,1,0,0,1,0
143250,1,1,0,0,1,0
175689,10,1,0,0,1,0
175689,5,2,0,0,2,0
175689,4,1,0,0,1,0
3240,10,2,0,0,2,0
3240,9,1,0,0,1,0
3240,3,1,0,0,1,0
154931,10,1,0,0,1,0
154931,6,6,0,0,6,0
118713,9,1,0,0,1,0
118713,8,1,0,0,1,0
118713,7,8,0,0,8,0
118713,4,1,0,0,1,0
118713,1,2,0,0,2,0
13440,10,2,0,0,2,0
13440,9,1,0,0,1,0
208583,9,1,0,0,1,0
208583,7,3,0,0,3,0
208583,5,9,0,0,9,0
208583,2,1,0,0,1,0
135801,8,1,0,0,1,0
135801,6,3,0,0,3,0
220642,10,2,0,0,2,0
220642,9,3,0,0,3,0
220642,5,4,0,0,4,0
220642,2,3,0,0,3,0
6839,2,1,0,0,1,0
2111,9,1,0,0,1,0
2111,8,4,0,0,4,0
2111,6,12,0,0,12,0
2111,4,1,0,0,1,0
2111,3,1,0,0,1,0
5165,4,4,0,0,4,0
212401,6,3,0,0,3,0
172550,10,2,0,0,2,0
172550,5,2,0,0,2,0
172550,4,5,0,0,5,0
254613,9,2,0,0,2,0
254613,5,3,0,0,3,0
254613,4,1,0,0,1,0
254613,2,1,0,0,1,0
254613,1,1,0,0,1,0
21141,9,1,0,0,1,0
21141,1,2,0,0,2,0
103573,9,1,0,0,1,0
103573,8,2,0,0,2,0
103573,7,1,0,0,1,0
103573,6,8,0,0,8,0
103573,5,3,0,0,3,0
244716,9,2,0,0,2,0
244716,8,6,0,0,6,0
244716,5,2,0,0,2,0
244716,4,1,0,0,1,0
247778,10,1,0,0,1,0
233033,5,2,0,0,2,0
8847,7,5,0,0,5,0
172707,7,4,0,0,4,0
172707,5,2,0,0,2,0
172707,4,5,0,0,5,0
172707,3,4,0,0,4,0
258070,7,7,0,0,7,0
258070,6,7,0,0,7,0
258070,4,1,0,0,1,0
16471,10,1,0,0,1,0
16471,8,1,0,0,1,0
16471,5,4,0,0,4,0
190015,10,1,0,0,1,0
190015,4,1,0,0,1,0
190015,1,1,0,0,1,0
4903,7,1,0,0,1,0
56208,5,2,0,0,2,0
191657,10,2,0,0,2,0
191657,9,1,0,0,1,0
191657,4,1,0,0,1,0
191657,3,1,0,0,1,0
191657,1,1,0,0,1,0
9111,5,1,0,0,1,0
246571,10,2,0,0,2,0
246571,6,5,0,0,5,0
11552,5,3,0,0,3,0
11552,4,2,0,0,2,0
5084,8,2,0,0,2,0
152824,5,2,0,0,2,0
152824,4,1,0,0,1,0
152824,2,1,0,0,1,0
9846,10,3,0,0,3,0
9846,9,2,0,0,2,0
234657,9,4,0,0,4,0
234657,8,5,0,0,5,0
234657,5,2,0,0,2,0
234657,4,2,0,0,2,0
234657,3,1,0,0,1,0
171258,9,3,0,0,3,0
166991,6,3,0,0,3,0
166991,4,1,0,0,1,0
166991,3,2,0,0,2,0
166991,1,1,0,0,1,0
582,8,2,0,0,2,0
582,7,4,0,0,4,0
582,3,2,0,0,2,0
5226,10,1,0,0,1,0
5226,9,1,0,0,1,0
5226,5,1,0,0,1,0
38141,6,2,0,0,2,0
38141,2,1,0,0,1,0
28053,9,1,0,0,1,0
28053,8,1,0,0,1,0
28053,2,1,0,0,1,0
153980,8,1,0,0,1,0
153980,3,2,0,0,2,0
9785,7,4,0,0,4,0
9785,1,2,0,0,2,0
36674,5,2,0,0,2,0
36674,1,1,0,0,1,0
17520,10,1,0,0,1,0
17520,2,2,0,0,2,0
4295,10,1,0,0,1,0
4295,9,1,0,0,1,0
4295,5,3,0,0,3,0
4295,3,1,0,0,1,0
3983,9,1,0,0,1,0
3983,8,5,0,0,5,0
3983,5,5,0,0,5,0
3983,4,4,0,0,4,0
209053,5,1,0,0,1,0
209053,4,2,0,0,2,0
238915,9,3,0,0,3,0
238915,6,8,0,0,8,0
238915,2,2,0,0,2,0
251642,10,2,0,0,2,0
251642,9,1,0,0,1,0
251642,7,6,0,0,6,0
251642,5,4,0,0,4,0
176663,10,2,0,0,2,0
176663,7,7,0,0,7,0
6713,10,3,0,0,3,0
6713,6,5,0,0,5,0
6713,5,5,0,0,5,0
6713,1,2,0,0,2,0
213260,9,5,0,0,5,0
213260,8,3,0,0,3,0
213260,6,7,0,0,7,0
213260,4,3,0,0,3,0
213260,2,1,0,0,1,0
191288,10,2,0,0,2,0
191288,5,1,0,0,1,0
3863,10,1,0,0,1,0
3863,8,1,0,0,1,0
3863,7,5,0,0,5,0
3863,3,3,0,0,3,0
73232,10,1,0,0,1,0
73232,5,3,0,0,3,0
73232,4,2,0,0,2,0
39279,10,1,0,0,1,0
87829,8,4,0,0,4,0
87829,7,5,0,0,5,0
87829,5,5,0,0,5,0
87829,4,2,0,0,2,0
87829,2,1,0,0,1,0
201668,10,3,0,0,3,0
201668,9,1,0,0,1,0
201668,1,1,0,0,1,0
144337,8,1,0,0,1,0
144337,7,6,0,0,6,0
144337,4,5,0,0,5,0
41587,9,1,0,0,1,0
41587,8,1,0,0,1,0
41587,5,5,0,0,5,0
41587,4,2,0,0,2,0
41587,2,1,0,0,1,0
242312,7,1,0,0,1,0
17005,2,1,0,0,1,0
17005,1,1,0,0,1,0
2705,5,2,0,0,2,0
15520,10,1,0,0,1,0
7447,1,1,0,0,1,0
88045,10,1,0,0,1,0
88045,9,1,0,0,1,0
88045,1,1,0,0,1,0
147824,9,1,0,0,1,0
147824,8,1,0,0,1,0
147824,7,7,0,0,7,0
147824,4,4,0,0,4,0
266444,10,1,0,0,1,0
266444,9,4,0,0,4,0
266444,7,16,0,0,16,0
266444,6,4,0,0,4,0
266444,5,2,0,0,2,0
153478,10,2,0,0,2,0
153478,9,1,0,0,1,0
153478,7,7,0,0,7,0
153478,6,15,0,0,15,0
153478,3,1,0,0,1,0
8600,9,1,0,0,1,0
8600,2,1,0,0,1,0
189489,9,2,0,0,2,0
189489,7,2,0,0,2,0
189489,6,6,0,0,6,0
189489,5,3,0,0,3,0
189489,1,3,0,0,3,0
14299,8,3,0,0,3,0
14299,5,3,0,0,3,0
191916,5,2,0,0,2,0
140153,9,1,0,0,1,0
140153,3,1,0,0,1,0
140153,2,1,0,0,1,0
140153,1,1,0,0,1,0
13363,9,2,0,0,2,0
3916,5,2,0,0,2,0
3916,4,2,0,0,2,0
3916,2,3,0,0,3,0
121324,8,2,0,0,2,0
139894,2,3,0,0,3,0
139894,1,1,0,0,1,0
186208,6,4,0,0,4,0
186208,5,3,0,0,3,0
186208,2,1,0,0,1,0
67629,6,3,0,0,3,0
67629,2,1,0,0,1,0
67629,1,3,0,0,3,0
4280,9,1,0,0,1,0
4280,8,1,0,0,1,0
4280,2,2,0,0,2,0
112557,5,2,0,0,2,0
15497,10,1,0,0,1,0
15497,9,1,0,0,1,0
15497,3,7,0,0,7,0
4611,8,3,0,0,3,0
4611,6,10,0,0,10,0
4611,4,2,0,0,2,0
39089,4,1,0,0,1,0
39089,3,1,0,0,1,0
9569,9,1,0,0,1,0
19186,10,1,0,0,1,0
19186,5,1,0,0,1,0
24388,7,3,0,0,3,0
24388,4,3,0,0,3,0
24388,2,2,0,0,2,0
18248,10,2,0,0,2,0
18248,4,1,0,0,1,0
265912,10,4,0,0,4,0
265912,9,1,0,0,1,0
265912,8,8,0,0,8,0
265912,5,5,0,0,5,0
265912,4,1,0,0,1,0
265912,3,1,0,0,1,0
265912,2,1,0,0,1,0
27339,9,2,0,0,2,0
27339,5,3,0,0,3,0
27339,4,4,0,0,4,0
27339,3,1,0,0,1,0
167718,10,1,0,0,1,0
167718,9,1,0,0,1,0
167718,8,6,0,0,6,0
167718,6,13,0,0,13,0
167718,5,2,0,0,2,0
167718,3,1,0,0,1,0
167718,2,3,0,0,3,0
26786,7,6,0,0,6,0
26786,5,2,0,0,2,0
26786,4,2,0,0,2,0
26786,3,1,0,0,1,0
245325,10,1,0,0,1,0
245325,9,1,0,0,1,0
245325,7,5,0,0,5,0
161528,9,7,0,0,7,0
161528,8,8,0,0,8,0
161528,6,2,0,0,2,0
161528,4,2,0,0,2,0
32086,6,9,0,0,9,0
32086,3,1,0,0,1,0
40938,3,2,0,0,2,0
16085,6,2,0,0,2,0
16085,5,1,0,0,1,0
16085,4,1,0,0,1,0
11551,5,3,0,0,3,0
11551,4,4,0,0,4,0
11551,3,1,0,0,1,0
11551,1,1,0,0,1,0
10626,9,1,0,0,1,0
10626,1,4,0,0,4,0
217827,10,2,0,0,2,0
217827,9,2,0,0,2,0
217827,8,3,0,0,3,0
217827,3,2,0,0,2,0
217827,2,1,0,0,1,0
137366,10,1,0,0,1,0
137366,8,2,0,0,2,0
137366,7,4,0,0,4,0
137366,4,8,0,0,8,0
137366,3,5,0,0,5,0
137366,1,2,0,0,2,0
256381,6,1,0,0,1,0
106560,7,2,0,0,2,0
106560,5,1,0,0,1,0
106560,4,1,0,0,1,0
106560,1,1,0,0,1,0
219312,5,3,0,0,3,0
219312,2,1,0,0,1,0
255013,10,1,0,0,1,0
255013,9,1,0,0,1,0
255013,4,1,0,0,1,0
238636,6,2,0,0,2,0
238636,5,1,0,0,1,0
238636,4,1,0,0,1,0
186461,10,1,0,0,1,0
186461,4,2,0,0,2,0
186461,2,1,0,0,1,0
186461,1,1,0,0,1,0
17967,10,2,0,0,2,0
17967,5,1,0,0,1,0
205865,9,1,0,0,1,0
205865,8,2,0,0,2,0
205865,7,4,0,0,4,0
205865,3,1,0,0,1,0
22329,5,2,0,0,2,0
22329,4,1,0,0,1,0
163263,10,2,0,0,2,0
163263,5,2,0,0,2,0
33779,8,1,0,0,1,0
33779,4,5,0,0,5,0
30896,9,2,0,0,2,0
30896,5,5,0,0,5,0
30896,4,1,0,0,1,0
30896,2,1,0,0,1,0
172118,7,6,0,0,6,0
172118,6,6,0,0,6,0
172118,4,1,0,0,1,0
172118,3,1,0,0,1,0
172118,2,1,0,0,1,0
172118,1,2,0,0,2,0
2933,9,1,0,0,1,0
2933,7,1,0,0,1,0
2933,4,3,0,0,3,0
905,9,1,0,0,1,0
905,8,1,0,0,1,0
905,3,2,0,0,2,0
905,1,1,0,0,1,0
32946,10,1,0,0,1,0
32946,2,1,0,0,1,0
8621,8,1,0,0,1,0
8621,7,1,0,0,1,0
8621,5,4,0,0,4,0
10462,1,1,0,0,1,0
187383,5,1,0,0,1,0
187383,4,3,0,0,3,0
187383,3,2,0,0,2,0
143073,10,2,0,0,2,0
143073,9,3,0,0,3,0
143073,8,6,0,0,6,0
143073,7,11,0,0,11,0
143073,5,3,0,0,3,0
9118,10,1,0,0,1,0
9118,7,1,0,0,1,0
9118,6,3,0,0,3,0
6109,10,1,0,0,1,0
6109,9,1,0,0,1,0
6109,7,3,0,0,3,0
6109,5,7,0,0,7,0
6109,3,1,0,0,1,0
6109,2,1,0,0,1,0
6109,1,2,0,0,2,0
11441,10,2,0,0,2,0
11441,9,1,0,0,1,0
11441,4,2,0,0,2,0
11441,1,2,0,0,2,0
73241,3,2,0,0,2,0
175845,5,1,0,0,1,0
10038,10,1,0,0,1,0
10038,4,1,0,0,1,0
206516,9,2,0,0,2,0
206516,2,1,0,0,1,0
3342,7,3,0,0,3,0
3342,6,6,0,0,6,0
3342,5,2,0,0,2,0
23723,8,1,0,0,1,0
23723,3,2,0,0,2,0
113518,9,1,0,0,1,0
113518,4,1,0,0,1,0
9844,10,1,0,0,1,0
9844,8,4,0,0,4,0
9844,5,7,0,0,7,0
9844,4,2,0,0,2,0
9844,3,1,0,0,1,0
21967,9,1,0,0,1,0
21967,8,1,0,0,1,0
21967,7,3,0,0,3,0
21967,5,9,0,0,9,0
21967,1,1,0,0,1,0
189902,5,2,0,0,2,0
189902,4,2,0,0,2,0
189902,3,1,0,0,1,0
16380,8,1,0,0,1,0
16380,7,1,0,0,1,0
16380,5,7,0,0,7,0
16380,4,4,0,0,4,0
16380,3,8,0,0,8,0
11925,5,2,0,0,2,0
11925,4,1,0,0,1,0
7956,9,2,0,0,2,0
7956,7,8,0,0,8,0
5666,10,1,0,0,1,0
5666,3,2,0,0,2,0
29117,7,1,0,0,1,0
29117,5,5,0,0,5,0
29117,2,1,0,0,1,0
5000,4,2,0,0,2,0
5000,3,1,0,0,1,0
5000,2,2,0,0,2,0
197633,9,2,0,0,2,0
197633,7,5,0,0,5,0
197633,6,1,0,0,1,0
154472,7,4,0,0,4,0
154472,5,2,0,0,2,0
154472,1,1,0,0,1,0
197377,6,1,0,0,1,0
197377,1,1,0,0,1,0
232358,10,3,0,0,3,0
232358,6,5,0,0,5,0
232358,5,3,0,0,3,0
232358,4,3,0,0,3,0
168082,3,1,0,0,1,0
19676,10,3,0,0,3,0
19676,9,2,0,0,2,0
19676,7,4,0,0,4,0
19676,6,9,0,0,9,0
19676,3,1,0,0,1,0
10574,7,3,0,0,3,0
231019,10,2,0,0,2,0
231019,6,2,0,0,2,0
231019,3,1,0,0,1,0
231019,1,1,0,0,1,0
178266,5,1,0,0,1,0
131379,6,1,0,0,1,0
131379,5,2,0,0,2,0
131379,1,1,0,0,1,0
5885,7,2,0,0,2,0
5885,1,1,0,0,1,0
13106,8,1,0,0,1,0
15563,6,6,0,0,6,0
15563,3,1,0,0,1,0
15563,2,3,0,0,3,0
14021,9,1,0,0,1,0
14021,5,6,0,0,6,0
19361,8,1,0,0,1,0
19361,5,3,0,0,3,0
19361,4,2,0,0,2,0
19361,1,1,0,0,1,0
5679,8,2,0,0,2,0
5679,5,3,0,0,3,0
18163,7,2,0,0,2,0
256911,5,1,0,0,1,0
256911,4,3,0,0,3,0
256911,2,1,0,0,1,0
16450,9,2,0,0,2,0
259525,10,3,0,0,3,0
259525,4,3,0,0,3,0
37307,5,1,0,0,1,0
37307,4,1,0,0,1,0
37307,3,1,0,0,1,0
200407,8,3,0,0,3,0
200407,6,10,0,0,10,0
200407,4,1,0,0,1,0
200407,3,2,0,0,2,0
73574,1,1,0,0,1,0
9010,8,4,0,0,4,0
9010,3,1,0,0,1,0
34129,9,1,0,0,1,0
34129,8,1,0,0,1,0
34129,7,1,0,0,1,0
34129,5,2,0,0,2,0
73589,10,2,0,0,2,0
73589,5,1,0,0,1,0
2650,4,6,0,0,6,0
2650,3,3,0,0,3,0
2650,2,1,0,0,1,0
11751,9,1,0,0,1,0
11751,4,2,0,0,2,0
11751,3,1,0,0,1,0
11751,1,1,0,0,1,0
127093,9,2,0,0,2,0
127093,7,10,0,0,10,0
191201,5,1,0,0,1,0
191201,1,1,0,0,1,0
148668,9,1,0,0,1,0
19432,8,2,0,0,2,0
19432,2,1,0,0,1,0
29138,10,1,0,0,1,0
29138,8,4,0,0,4,0
29138,7,5,0,0,5,0
29138,5,4,0,0,4,0
29138,4,1,0,0,1,0
29138,3,2,0,0,2,0
29138,1,1,0,0,1,0
258512,7,4,0,0,4,0
258512,4,1,0,0,1,0
258512,2,1,0,0,1,0
258512,1,1,0,0,1,0
90460,10,2,0,0,2,0
90460,9,4,0,0,4,0
90460,8,1,0,0,1,0
90460,7,3,0,0,3,0
90460,3,2,0,0,2,0
90460,2,1,0,0,1,0
265684,8,7,0,0,7,0
164808,4,1,0,0,1,0
164808,2,1,0,0,1,0
7318,10,1,0,0,1,0
7318,4,1,0,0,1,0
168236,10,1,0,0,1,0
168236,8,2,0,0,2,0
168236,3,1,0,0,1,0
168236,2,3,0,0,3,0
76362,7,1,0,0,1,0
85429,4,3,0,0,3,0
85429,2,1,0,0,1,0
231837,8,3,0,0,3,0
231837,3,3,0,0,3,0
231837,2,1,0,0,1,0
9847,10,2,0,0,2,0
9847,8,3,0,0,3,0
9847,1,1,0,0,1,0
151892,5,1,0,0,1,0
151892,4,1,0,0,1,0
19763,9,1,0,0,1,0
19763,8,2,0,0,2,0
19763,3,1,0,0,1,0
19763,2,1,0,0,1,0
8452,10,1,0,0,1,0
8452,7,1,0,0,1,0
8452,4,3,0,0,3,0
8452,3,4,0,0,4,0
27227,9,1,0,0,1,0
27227,8,7,0,0,7,0
27227,7,6,0,0,6,0
27227,5,2,0,0,2,0
27227,1,1,0,0,1,0
201560,9,3,0,0,3,0
201560,1,2,0,0,2,0
148117,10,1,0,0,1,0
148117,4,1,0,0,1,0
148117,2,1,0,0,1,0
6153,9,1,0,0,1,0
6153,8,2,0,0,2,0
6153,2,2,0,0,2,0
69904,10,1,0,0,1,0
69904,9,1,0,0,1,0
69904,2,2,0,0,2,0
20833,7,3,0,0,3,0
20833,2,1,0,0,1,0
20833,1,1,0,0,1,0
5539,4,5,0,0,5,0
32794,3,2,0,0,2,0
32794,2,3,0,0,3,0
145653,4,1,0,0,1,0
145653,3,1,0,0,1,0
145653,2,1,0,0,1,0
22259,9,1,0,0,1,0
37401,9,2,0,0,2,0
37401,8,2,0,0,2,0
37401,7,5,0,0,5,0
37401,3,2,0,0,2,0
1638,6,8,0,0,8,0
1638,3,3,0,0,3,0
209773,5,2,0,0,2,0
802,10,1,0,0,1,0
802,4,3,0,0,3,0
9204,10,2,0,0,2,0
9204,2,1,0,0,1,0
2012,7,2,0,0,2,0
2012,5,5,0,0,5,0
2012,3,8,0,0,8,0
2012,2,1,0,0,1,0
2996,8,6,0,0,6,0
2996,7,2,0,0,2,0
33086,2,1,0,0,1,0
21257,6,4,0,0,4,0
21257,5,4,0,0,4,0
19442,10,2,0,0,2,0
19442,8,2,0,0,2,0
19442,7,6,0,0,6,0
19442,5,9,0,0,9,0
19442,4,1,0,0,1,0
110336,10,1,0,0,1,0
110336,5,1,0,0,1,0
242742,7,3,0,0,3,0
242742,5,6,0,0,6,0
242742,2,1,0,0,1,0
22595,7,5,0,0,5,0
22595,6,8,0,0,8,0
22595,5,8,0,0,8,0
22595,2,1,0,0,1,0
11924,3,1,0,0,1,0
176523,7,3,0,0,3,0
176523,5,3,0,0,3,0
176523,4,3,0,0,3,0
176523,1,1,0,0,1,0
7536,10,1,0,0,1,0
7536,9,1,0,0,1,0
7536,7,3,0,0,3,0
7536,4,1,0,0,1,0
116849,10,1,0,0,1,0
116849,8,6,0,0,6,0
116849,7,7,0,0,7,0
116849,6,9,0,0,9,0
116849,5,5,0,0,5,0
116849,4,1,0,0,1,0
116849,3,3,0,0,3,0
192268,10,1,0,0,1,0
255478,10,1,0,0,1,0
255478,9,3,0,0,3,0
255478,7,5,0,0,5,0
255478,5,5,0,0,5,0
255478,2,1,0,0,1,0
167850,9,1,0,0,1,0
167850,8,1,0,0,1,0
167850,7,2,0,0,2,0
167850,6,7,0,0,7,0
167850,4,5,0,0,5,0
167850,1,2,0,0,2,0
161765,5,1,0,0,1,0
161765,1,1,0,0,1,0
111426,8,1,0,0,1,0
111426,5,7,0,0,7,0
111426,3,1,0,0,1,0
111426,2,1,0,0,1,0
8330,10,1,0,0,1,0
8330,6,9,0,0,9,0
8330,4,1,0,0,1,0
24379,7,2,0,0,2,0
160871,9,1,0,0,1,0
160871,5,1,0,0,1,0
67627,9,1,0,0,1,0
67627,8,1,0,0,1,0
67627,6,1,0,0,1,0
67627,5,7,0,0,7,0
67627,4,4,0,0,4,0
150424,9,1,0,0,1,0
150424,1,1,0,0,1,0
226619,10,3,0,0,3,0
226619,8,3,0,0,3,0
226619,4,2,0,0,2,0
155582,7,2,0,0,2,0
155582,4,1,0,0,1,0
3827,2,1,0,0,1,0
10348,10,3,0,0,3,0
10348,8,1,0,0,1,0
10348,5,6,0,0,6,0
10348,4,1,0,0,1,0
139975,8,1,0,0,1,0
139975,7,4,0,0,4,0
139975,5,7,0,0,7,0
139975,4,4,0,0,4,0
141577,10,1,0,0,1,0
141577,9,2,0,0,2,0
141577,8,4,0,0,4,0
141577,7,9,0,0,9,0
141577,6,8,0,0,8,0
141577,5,4,0,0,4,0
141577,4,3,0,0,3,0
141577,3,1,0,0,1,0
171500,1,1,0,0,1,0
3689,8,1,0,0,1,0
201458,10,5,0,0,5,0
201458,8,5,0,0,5,0
201458,4,1,0,0,1,0
95589,8,2,0,0,2,0
95589,7,3,0,0,3,0
170676,10,3,0,0,3,0
170676,9,1,0,0,1,0
170676,7,4,0,0,4,0
170676,5,2,0,0,2,0
170676,4,1,0,0,1,0
170676,3,4,0,0,4,0
170676,2,1,0,0,1,0
170676,1,1,0,0,1,0
166390,5,4,0,0,4,0
166390,3,2,0,0,2,0
166390,2,1,0,0,1,0
236861,7,2,0,0,2,0
236861,6,1,0,0,1,0
167349,10,10,0,0,10,0
167349,9,8,0,0,8,0
167349,8,3,0,0,3,0
167349,7,4,0,0,4,0
167349,6,1,0,0,1,0
167349,4,1,0,0,1,0
167349,1,5,0,0,5,0
84454,9,1,0,0,1,0
84454,7,7,0,0,7,0
84454,6,9,0,0,9,0
84454,5,4,0,0,4,0
84454,4,2,0,0,2,0
10570,10,1,0,0,1,0
27981,2,3,0,0,3,0
21435,8,2,0,0,2,0
86174,4,3,0,0,3,0
86174,3,2,0,0,2,0
86849,10,1,0,0,1,0
86849,6,7,0,0,7,0
86849,5,1,0,0,1,0
86849,4,2,0,0,2,0
86849,1,1,0,0,1,0
64896,8,4,0,0,4,0
64896,7,8,0,0,8,0
64896,6,10,0,0,10,0
64896,5,1,0,0,1,0
25526,8,1,0,0,1,0
25526,7,5,0,0,5,0
25526,3,2,0,0,2,0
25526,2,2,0,0,2,0
9070,5,6,0,0,6,0
9070,4,3,0,0,3,0
9853,10,1,0,0,1,0
9853,8,5,0,0,5,0
9853,4,1,0,0,1,0
8360,10,4,0,0,4,0
8360,7,1,0,0,1,0
8360,1,1,0,0,1,0
9013,8,1,0,0,1,0
9013,7,3,0,0,3,0
9013,4,5,0,0,5,0
29119,8,2,0,0,2,0
29119,7,1,0,0,1,0
29119,5,8,0,0,8,0
100374,5,3,0,0,3,0
41712,9,1,0,0,1,0
41712,8,5,0,0,5,0
41712,7,10,0,0,10,0
41712,5,5,0,0,5,0
41712,4,3,0,0,3,0
41712,2,1,0,0,1,0
12146,5,1,0,0,1,0
12146,3,1,0,0,1,0
224590,9,2,0,0,2,0
224590,6,4,0,0,4,0
224590,5,3,0,0,3,0
64570,6,2,0,0,2,0
64570,2,1,0,0,1,0
64570,1,1,0,0,1,0
26563,8,1,0,0,1,0
26563,7,3,0,0,3,0
26563,5,8,0,0,8,0
26563,2,3,0,0,3,0
26563,1,1,0,0,1,0
873,10,1,0,0,1,0
873,8,2,0,0,2,0
873,5,4,0,0,4,0
256151,10,3,0,0,3,0
256151,9,3,0,0,3,0
256151,8,3,0,0,3,0
256151,4,1,0,0,1,0
256151,3,1,0,0,1,0
256151,2,2,0,0,2,0
9454,5,9,0,0,9,0
51505,7,4,0,0,4,0
51505,3,2,0,0,2,0
9033,2,1,0,0,1,0
37497,5,3,0,0,3,0
37497,2,1,0,0,1,0
73230,9,1,0,0,1,0
13936,7,4,0,0,4,0
13936,6,1,0,0,1,0
13936,4,1,0,0,1,0
29879,3,1,0,0,1,0
24857,8,2,0,0,2,0
270109,10,7,0,0,7,0
270109,6,1,0,0,1,0
67339,9,5,0,0,5,0
67339,7,4,0,0,4,0
67339,6,5,0,0,5,0
67339,5,1,0,0,1,0
174491,10,1,0,0,1,0
174491,7,10,0,0,10,0
255293,7,9,0,0,9,0
255293,6,5,0,0,5,0
166977,9,1,0,0,1,0
166977,6,3,0,0,3,0
166977,5,1,0,0,1,0
54604,7,5,0,0,5,0
54604,3,1,0,0,1,0
240142,6,2,0,0,2,0
240142,5,1,0,0,1,0
240142,3,2,0,0,2,0
3829,8,1,0,0,1,0
25448,10,2,0,0,2,0
25448,9,1,0,0,1,0
25448,4,1,0,0,1,0
64438,10,1,0,0,1,0
64438,4,4,0,0,4,0
64438,1,1,0,0,1,0
4042,8,3,0,0,3,0
4042,7,2,0,0,2,0
4042,2,1,0,0,1,0
4042,1,2,0,0,2,0
148115,8,3,0,0,3,0
148115,6,5,0,0,5,0
148115,2,2,0,0,2,0
225449,10,1,0,0,1,0
182276,10,2,0,0,2,0
182276,9,2,0,0,2,0
182276,8,1,0,0,1,0
182276,6,11,0,0,11,0
182276,4,1,0,0,1,0
182276,3,1,0,0,1,0
182276,2,1,0,0,1,0
208093,1,1,0,0,1,0
181083,9,2,0,0,2,0
181083,5,4,0,0,4,0
181083,4,1,0,0,1,0
2889,9,1,0,0,1,0
182634,9,3,0,0,3,0
31508,1,1,0,0,1,0
159410,4,2,0,0,2,0
159410,3,1,0,0,1,0
203215,4,1,0,0,1,0
168900,5,2,0,0,2,0
168900,4,1,0,0,1,0
168900,3,1,0,0,1,0
1093,8,2,0,0,2,0
1093,7,3,0,0,3,0
1093,5,3,0,0,3,0
1093,4,4,0,0,4,0
6630,7,4,0,0,4,0
6630,4,7,0,0,7,0
6630,3,2,0,0,2,0
235249,8,6,0,0,6,0
235249,7,7,0,0,7,0
235249,6,2,0,0,2,0
235249,5,3,0,0,3,0
235249,4,2,0,0,2,0
235249,2,1,0,0,1,0
10394,6,2,0,0,2,0
10394,5,4,0,0,4,0
10394,4,2,0,0,2,0
4586,3,2,0,0,2,0
4586,2,1,0,0,1,0
4586,1,1,0,0,1,0
101872,5,1,0,0,1,0
101872,3,1,0,0,1,0
101872,1,2,0,0,2,0
34655,8,2,0,0,2,0
5224,9,1,0,0,1,0
5224,4,1,0,0,1,0
215389,10,3,0,0,3,0
215389,5,3,0,0,3,0
215389,3,1,0,0,1,0
215389,2,1,0,0,1,0
183400,10,1,0,0,1,0
183400,9,2,0,0,2,0
20533,10,1,0,0,1,0
20533,9,1,0,0,1,0
20533,8,5,0,0,5,0
20533,4,1,0,0,1,0
17738,9,1,0,0,1,0
17738,4,2,0,0,2,0
17738,2,1,0,0,1,0
17738,1,1,0,0,1,0
11027,10,1,0,0,1,0
11027,4,1,0,0,1,0
1935,10,1,0,0,1,0
1935,7,2,0,0,2,0
1935,1,1,0,0,1,0
10917,8,1,0,0,1,0
10917,3,2,0,0,2,0
10917,2,1,0,0,1,0
234104,9,5,0,0,5,0
234104,8,4,0,0,4,0
234104,6,2,0,0,2,0
234104,5,1,0,0,1,0
234104,3,1,0,0,1,0
225909,10,1,0,0,1,0
10584,10,2,0,0,2,0
10584,1,1,0,0,1,0
3951,9,1,0,0,1,0
237585,6,2,0,0,2,0
237585,5,1,0,0,1,0
237585,4,4,0,0,4,0
237585,3,2,0,0,2,0
237585,2,1,0,0,1,0
154728,9,2,0,0,2,0
154728,8,3,0,0,3,0
154728,3,2,0,0,2,0
9110,8,1,0,0,1,0
9110,7,3,0,0,3,0
9110,4,2,0,0,2,0
16457,10,1,0,0,1,0
16457,9,2,0,0,2,0
16457,6,1,0,0,1,0
16457,5,1,0,0,1,0
160545,7,5,0,0,5,0
160545,5,3,0,0,3,0
160545,4,4,0,0,4,0
160545,3,1,0,0,1,0
160545,2,1,0,0,1,0
7186,7,4,0,0,4,0
7186,3,3,0,0,3,0
7186,1,1,0,0,1,0
12218,6,6,0,0,6,0
12218,5,2,0,0,2,0
12218,3,1,0,0,1,0
92879,10,1,0,0,1,0
92879,3,2,0,0,2,0
189427,6,3,0,0,3,0
189427,1,1,0,0,1,0
106969,9,5,0,0,5,0
106969,5,1,0,0,1,0
41955,8,2,0,0,2,0
41955,5,7,0,0,7,0
41955,3,2,0,0,2,0
235940,6,10,0,0,10,0
235940,4,5,0,0,5,0
235940,2,1,0,0,1,0
189123,5,1,0,0,1,0
189123,1,2,0,0,2,0
254585,5,1,0,0,1,0
254585,4,1,0,0,1,0
19971,5,7,0,0,7,0
19971,4,2,0,0,2,0
19971,3,3,0,0,3,0
126159,7,4,0,0,4,0
126159,2,1,0,0,1,0
220597,6,4,0,0,4,0
220597,5,2,0,0,2,0
220597,4,1,0,0,1,0
220597,3,2,0,0,2,0
220597,2,1,0,0,1,0
16474,4,1,0,0,1,0
16474,3,1,0,0,1,0
19696,8,4,0,0,4,0
19696,7,1,0,0,1,0
19696,4,3,0,0,3,0
19696,3,1,0,0,1,0
19696,2,1,0,0,1,0
209320,5,2,0,0,2,0
209320,4,1,0,0,1,0
209320,1,1,0,0,1,0
53,7,4,0,0,4,0
53,4,4,0,0,4,0
53,3,1,0,0,1,0
14343,9,1,0,0,1,0
14343,8,1,0,0,1,0
14343,3,1,0,0,1,0
14343,2,1,0,0,1,0
180147,10,2,0,0,2,0
180147,8,1,0,0,1,0
180147,7,4,0,0,4,0
181889,10,2,0,0,2,0
181889,7,6,0,0,6,0
122711,7,2,0,0,2,0
136563,8,1,0,0,1,0
136563,4,2,0,0,2,0
242818,9,2,0,0,2,0
242818,4,1,0,0,1,0
242818,3,1,0,0,1,0
242818,1,1,0,0,1,0
12129,9,5,0,0,5,0
12129,6,8,0,0,8,0
12129,4,1,0,0,1,0
20774,6,2,0,0,2,0
20774,4,2,0,0,2,0
9805,8,1,0,0,1,0
9805,7,4,0,0,4,0
9805,2,3,0,0,3,0
20989,8,2,0,0,2,0
20989,1,1,0,0,1,0
218577,7,5,0,0,5,0
218577,4,3,0,0,3,0
218577,2,1,0,0,1,0
218577,1,1,0,0,1,0
5210,4,1,0,0,1,0
5210,3,1,0,0,1,0
5210,2,1,0,0,1,0
14077,9,2,0,0,2,0
14077,3,1,0,0,1,0
230130,10,4,0,0,4,0
230130,7,6,0,0,6,0
230130,6,1,0,0,1,0
230130,5,3,0,0,3,0
35167,8,6,0,0,6,0
35167,6,7,0,0,7,0
58396,8,2,0,0,2,0
58396,7,4,0,0,4,0
58396,5,6,0,0,6,0
88872,7,2,0,0,2,0
88872,5,7,0,0,7,0
88872,4,4,0,0,4,0
88872,1,1,0,0,1,0
5644,7,1,0,0,1,0
5644,4,2,0,0,2,0
5644,1,2,0,0,2,0
122809,7,7,0,0,7,0
122809,6,1,0,0,1,0
122809,1,1,0,0,1,0
127434,9,2,0,0,2,0
127434,5,3,0,0,3,0
4285,10,1,0,0,1,0
1019,8,6,0,0,6,0
1019,7,8,0,0,8,0
1019,5,1,0,0,1,0
1019,4,2,0,0,2,0
143841,4,2,0,0,2,0
143841,2,1,0,0,1,0
6625,5,2,0,0,2,0
11561,10,1,0,0,1,0
11561,1,1,0,0,1,0
146765,10,2,0,0,2,0
146765,8,2,0,0,2,0
146765,5,6,0,0,6,0
39431,6,7,0,0,7,0
39431,2,3,0,0,3,0
8400,9,1,0,0,1,0
8400,8,1,0,0,1,0
8400,7,2,0,0,2,0
8400,6,5,0,0,5,0
199247,10,1,0,0,1,0
199247,9,1,0,0,1,0
199247,8,2,0,0,2,0
199247,7,2,0,0,2,0
199247,3,5,0,0,5,0
199247,2,4,0,0,4,0
199247,1,1,0,0,1,0
2634,10,1,0,0,1,0
2634,9,2,0,0,2,0
2634,8,3,0,0,3,0
2634,5,3,0,0,3,0
2634,3,1,0,0,1,0
16632,8,1,0,0,1,0
260786,9,6,0,0,6,0
260786,6,4,0,0,4,0
260786,5,2,0,0,2,0
260786,1,1,0,0,1,0
4560,8,1,0,0,1,0
66245,10,2,0,0,2,0
66245,8,1,0,0,1,0
66245,7,8,0,0,8,0
66245,5,6,0,0,6,0
66245,2,1,0,0,1,0
131126,10,1,0,0,1,0
131126,9,1,0,0,1,0
131126,8,2,0,0,2,0
131126,4,1,0,0,1,0
131126,3,2,0,0,2,0
179581,7,6,0,0,6,0
179581,6,2,0,0,2,0
179581,4,2,0,0,2,0
179581,1,1,0,0,1,0
3096,4,1,0,0,1,0
3096,2,1,0,0,1,0
4634,8,2,0,0,2,0
4634,4,2,0,0,2,0
4634,3,1,0,0,1,0
4634,1,6,0,0,6,0
148049,8,3,0,0,3,0
148049,3,1,0,0,1,0
160494,10,1,0,0,1,0
617,9,1,0,0,1,0
617,4,5,0,0,5,0
37718,5,2,0,0,2,0
37718,4,1,0,0,1,0
17909,10,1,0,0,1,0
17909,8,2,0,0,2,0
17909,6,8,0,0,8,0
17909,4,5,0,0,5,0
17909,1,1,0,0,1,0
43799,9,1,0,0,1,0
43799,8,2,0,0,2,0
260277,8,5,0,0,5,0
260277,5,2,0,0,2,0
19647,6,10,0,0,10,0
19647,4,1,0,0,1,0
19647,3,2,0,0,2,0
19647,2,2,0,0,2,0
19647,1,1,0,0,1,0
11739,9,1,0,0,1,0
11739,7,1,0,0,1,0
11739,6,3,0,0,3,0
184900,8,3,0,0,3,0
184900,4,3,0,0,3,0
27857,4,2,0,0,2,0
8514,10,2,0,0,2,0
8514,2,1,0,0,1,0
19534,10,1,0,0,1,0
19534,8,1,0,0,1,0
87280,7,2,0,0,2,0
87280,4,7,0,0,7,0
87280,2,2,0,0,2,0
26841,9,1,0,0,1,0
26841,8,1,0,0,1,0
26841,7,4,0,0,4,0
26841,5,4,0,0,4,0
14696,8,1,0,0,1,0
1277,9,1,0,0,1,0
1277,3,1,0,0,1,0
204671,5,3,0,0,3,0
204671,4,1,0,0,1,0
204671,1,1,0,0,1,0
7471,3,2,0,0,2,0
186141,9,1,0,0,1,0
186141,7,5,0,0,5,0
186141,2,1,0,0,1,0
151801,10,1,0,0,1,0
151801,7,8,0,0,8,0
151801,5,5,0,0,5,0
10270,9,2,0,0,2,0
10270,8,1,0,0,1,0
10270,1,2,0,0,2,0
85076,1,1,0,0,1,0
9496,8,4,0,0,4,0
9496,4,1,0,0,1,0
9496,3,2,0,0,2,0
186947,5,4,0,0,4,0
209033,9,3,0,0,3,0
209033,8,9,0,0,9,0
209033,6,6,0,0,6,0
209033,4,3,0,0,3,0
209033,2,1,0,0,1,0
10090,7,1,0,0,1,0
10090,5,5,0,0,5,0
10090,3,1,0,0,1,0
10090,2,2,0,0,2,0
10090,1,1,0,0,1,0
12506,10,1,0,0,1,0
12506,9,2,0,0,2,0
12506,5,3,0,0,3,0
35482,2,2,0,0,2,0
226426,5,7,0,0,7,0
43486,3,1,0,0,1,0
11641,8,1,0,0,1,0
11641,3,3,0,0,3,0
9320,9,1,0,0,1,0
9320,7,1,0,0,1,0
9320,2,3,0,0,3,0
223330,8,4,0,0,4,0
223330,4,2,0,0,2,0
223330,3,1,0,0,1,0
220367,6,4,0,0,4,0
220367,5,1,0,0,1,0
185383,9,1,0,0,1,0
17576,3,4,0,0,4,0
17576,2,1,0,0,1,0
153807,7,7,0,0,7,0
153807,6,8,0,0,8,0
153807,3,1,0,0,1,0
32224,5,2,0,0,2,0
31235,10,2,0,0,2,0
31235,9,1,0,0,1,0
31235,8,2,0,0,2,0
31235,7,2,0,0,2,0
31235,1,1,0,0,1,0
35658,8,1,0,0,1,0
136116,8,1,0,0,1,0
136116,7,3,0,0,3,0
136116,6,6,0,0,6,0
136116,3,4,0,0,4,0
136116,2,4,0,0,4,0
136116,1,1,0,0,1,0
663,8,1,0,0,1,0
663,7,2,0,0,2,0
663,5,4,0,0,4,0
663,2,2,0,0,2,0
2513,8,1,0,0,1,0
2513,4,7,0,0,7,0
2513,1,1,0,0,1,0
24042,10,1,0,0,1,0
24042,8,2,0,0,2,0
24042,2,1,0,0,1,0
255633,6,5,0,0,5,0
225800,10,1,0,0,1,0
225800,5,3,0,0,3,0
225800,3,1,0,0,1,0
225800,1,1,0,0,1,0
93493,10,1,0,0,1,0
93493,8,2,0,0,2,0
93493,4,2,0,0,2,0
217268,9,2,0,0,2,0
217268,7,7,0,0,7,0
217268,5,3,0,0,3,0
217268,4,1,0,0,1,0
217268,3,2,0,0,2,0
217268,1,1,0,0,1,0
190115,10,2,0,0,2,0
190115,1,1,0,0,1,0
19425,7,6,0,0,6,0
6152,8,1,0,0,1,0
2724,7,1,0,0,1,0
17159,7,1,0,0,1,0
17159,6,8,0,0,8,0
17159,5,7,0,0,7,0
17159,3,2,0,0,2,0
228419,10,2,0,0,2,0
228419,9,2,0,0,2,0
228419,8,8,0,0,8,0
228419,7,7,0,0,7,0
228419,6,5,0,0,5,0
228419,5,4,0,0,4,0
228419,2,1,0,0,1,0
6672,10,1,0,0,1,0
6672,9,2,0,0,2,0
6672,5,2,0,0,2,0
6672,3,1,0,0,1,0
201144,4,1,0,0,1,0
201144,2,1,0,0,1,0
143745,6,1,0,0,1,0
143745,1,1,0,0,1,0
196234,7,4,0,0,4,0
13916,9,1,0,0,1,0
13916,1,1,0,0,1,0
193681,9,1,0,0,1,0
193681,7,5,0,0,5,0
193681,3,1,0,0,1,0
10432,7,2,0,0,2,0
10432,5,5,0,0,5,0
10432,4,8,0,0,8,0
2731,4,2,0,0,2,0
4081,3,1,0,0,1,0
4081,1,1,0,0,1,0
73360,8,2,0,0,2,0
73360,7,5,0,0,5,0
73360,4,1,0,0,1,0
73360,2,1,0,0,1,0
257674,9,1,0,0,1,0
257674,5,3,0,0,3,0
257674,4,1,0,0,1,0
3473,3,1,0,0,1,0
3473,2,3,0,0,3,0
201012,6,10,0,0,10,0
201012,5,5,0,0,5,0
201012,3,1,0,0,1,0
140859,8,11,0,0,11,0
140859,4,2,0,0,2,0
140859,2,1,0,0,1,0
147472,4,2,0,0,2,0
11473,9,1,0,0,1,0
11473,3,1,0,0,1,0
65197,9,1,0,0,1,0
65197,8,3,0,0,3,0
65197,7,1,0,0,1,0
65197,5,5,0,0,5,0
65197,4,3,0,0,3,0
65197,2,3,0,0,3,0
57767,8,2,0,0,2,0
57767,4,1,0,0,1,0
228687,8,2,0,0,2,0
228687,5,5,0,0,5,0
228687,2,1,0,0,1,0
262341,10,4,0,0,4,0
262341,7,7,0,0,7,0
262341,6,7,0,0,7,0
262341,4,1,0,0,1,0
262341,3,2,0,0,2,0
24109,7,1,0,0,1,0
24109,5,3,0,0,3,0
24109,3,1,0,0,1,0
86040,1,1,0,0,1,0
136244,7,5,0,0,5,0
136244,2,1,0,0,1,0
173372,7,11,0,0,11,0
173372,6,11,0,0,11,0
173372,5,3,0,0,3,0
40006,9,1,0,0,1,0
40006,5,4,0,0,4,0
40006,4,1,0,0,1,0
25302,10,2,0,0,2,0
25461,8,2,0,0,2,0
25461,3,1,0,0,1,0
177002,8,9,0,0,9,0
177002,2,1,0,0,1,0
18562,4,6,0,0,6,0
124264,7,4,0,0,4,0
124264,5,5,0,0,5,0
124264,1,1,0,0,1,0
164975,9,7,0,0,7,0
164975,8,3,0,0,3,0
164975,5,1,0,0,1,0
164975,1,1,0,0,1,0
121813,5,4,0,0,4,0
246508,9,3,0,0,3,0
246508,6,2,0,0,2,0
246508,5,4,0,0,4,0
246508,4,1,0,0,1,0
118537,9,2,0,0,2,0
118537,2,1,0,0,1,0
77454,10,1,0,0,1,0
77454,8,2,0,0,2,0
205496,8,3,0,0,3,0
205496,4,1,0,0,1,0
233080,5,1,0,0,1,0
233080,4,2,0,0,2,0
233080,1,1,0,0,1,0
180340,4,1,0,0,1,0
180340,3,1,0,0,1,0
215796,10,2,0,0,2,0
215796,9,1,0,0,1,0
215796,7,5,0,0,5,0
215796,4,1,0,0,1,0
215796,1,1,0,0,1,0
15483,10,1,0,0,1,0
15483,9,1,0,0,1,0
81263,7,5,0,0,5,0
81263,5,8,0,0,8,0
81263,2,1,0,0,1,0
19916,7,3,0,0,3,0
19916,3,2,0,0,2,0
19916,2,1,0,0,1,0
201048,9,2,0,0,2,0
201048,5,4,0,0,4,0
201048,3,1,0,0,1,0
10354,7,4,0,0,4,0
10354,5,3,0,0,3,0
99166,10,1,0,0,1,0
28068,9,1,0,0,1,0
28068,8,4,0,0,4,0
28068,3,2,0,0,2,0
28068,1,1,0,0,1,0
134769,5,1,0,0,1,0
134769,4,1,0,0,1,0
134769,1,1,0,0,1,0
200959,5,1,0,0,1,0
200959,1,1,0,0,1,0
154327,9,3,0,0,3,0
58861,9,1,0,0,1,0
58861,8,3,0,0,3,0
58861,6,5,0,0,5,0
58861,5,4,0,0,4,0
58861,2,1,0,0,1,0
236827,10,1,0,0,1,0
236827,9,1,0,0,1,0
236827,8,5,0,0,5,0
236827,7,6,0,0,6,0
236827,6,9,0,0,9,0
236827,5,4,0,0,4,0
236827,4,1,0,0,1,0
236827,3,1,0,0,1,0
236827,1,1,0,0,1,0
116735,4,1,0,0,1,0
116735,3,1,0,0,1,0
171742,6,1,0,0,1,0
171742,1,1,0,0,1,0
102698,9,1,0,0,1,0
102698,7,6,0,0,6,0
102698,4,1,0,0,1,0
102698,1,1,0,0,1,0
11208,8,1,0,0,1,0
11208,2,1,0,0,1,0
145587,9,1,0,0,1,0
145587,8,3,0,0,3,0
145587,4,1,0,0,1,0
2033,6,2,0,0,2,0
2033,2,3,0,0,3,0
2033,1,1,0,0,1,0
196953,8,1,0,0,1,0
196953,6,7,0,0,7,0
196953,2,1,0,0,1,0
116194,9,1,0,0,1,0
116194,8,5,0,0,5,0
116194,5,2,0,0,2,0
116194,4,1,0,0,1,0
210350,4,2,0,0,2,0
210350,3,1,0,0,1,0
10368,4,4,0,0,4,0
10368,3,2,0,0,2,0
10368,2,1,0,0,1,0
231215,7,7,0,0,7,0
231215,4,1,0,0,1,0
231215,1,1,0,0,1,0
30456,9,1,0,0,1,0
30456,6,3,0,0,3,0
30456,3,5,0,0,5,0
15676,10,1,0,0,1,0
15676,3,1,0,0,1,0
17821,7,2,0,0,2,0
17821,1,1,0,0,1,0
36604,10,2,0,0,2,0
36604,4,1,0,0,1,0
36604,3,1,0,0,1,0
57239,10,1,0,0,1,0
57239,3,2,0,0,2,0
19633,7,1,0,0,1,0
222913,10,1,0,0,1,0
222913,6,7,0,0,7,0
222913,4,1,0,0,1,0
161206,10,1,0,0,1,0
161206,9,3,0,0,3,0
161206,8,1,0,0,1,0
161206,7,3,0,0,3,0
161206,6,7,0,0,7,0
161206,5,6,0,0,6,0
161206,4,3,0,0,3,0
161206,2,3,0,0,3,0
161206,1,2,0,0,2,0
36538,9,1,0,0,1,0
36538,8,3,0,0,3,0
36538,3,1,0,0,1,0
36538,1,1,0,0,1,0
4508,7,2,0,0,2,0
4508,3,2,0,0,2,0
4508,2,1,0,0,1,0
158163,8,9,0,0,9,0
158163,7,8,0,0,8,0
158163,5,4,0,0,4,0
158163,3,1,0,0,1,0
254322,10,2,0,0,2,0
254322,9,6,0,0,6,0
254322,7,1,0,0,1,0
9018,9,1,0,0,1,0
231574,7,7,0,0,7,0
231574,6,3,0,0,3,0
131812,10,4,0,0,4,0
131812,9,4,0,0,4,0
131812,8,6,0,0,6,0
131812,6,5,0,0,5,0
131812,3,1,0,0,1,0
231035,10,3,0,0,3,0
231035,3,1,0,0,1,0
209322,10,3,0,0,3,0
209322,6,5,0,0,5,0
209322,3,1,0,0,1,0
209322,1,1,0,0,1,0
160537,4,4,0,0,4,0
160537,2,1,0,0,1,0
5819,9,1,0,0,1,0
55999,9,1,0,0,1,0
55999,4,1,0,0,1,0
55999,3,1,0,0,1,0
9076,8,4,0,0,4,0
9076,1,1,0,0,1,0
270677,9,3,0,0,3,0
270677,8,5,0,0,5,0
270677,7,7,0,0,7,0
270677,6,14,0,0,14,0
270677,5,2,0,0,2,0
270677,4,1,0,0,1,0
42259,4,3,0,0,3,0
42259,2,1,0,0,1,0
230976,7,4,0,0,4,0
28292,9,1,0,0,1,0
28292,8,3,0,0,3,0
28292,1,1,0,0,1,0
4383,9,1,0,0,1,0
4383,8,1,0,0,1,0
4383,7,3,0,0,3,0
4383,4,4,0,0,4,0
4383,3,3,0,0,3,0
4383,1,1,0,0,1,0
73536,10,1,0,0,1,0
73536,9,2,0,0,2,0
73536,7,12,0,0,12,0
73536,5,3,0,0,3,0
6526,8,1,0,0,1,0
6526,4,2,0,0,2,0
6526,3,1,0,0,1,0
15432,9,2,0,0,2,0
15432,5,4,0,0,4,0
975,9,2,0,0,2,0
975,3,3,0,0,3,0
37854,8,2,0,0,2,0
37854,6,11,0,0,11,0
37854,5,5,0,0,5,0
152985,9,1,0,0,1,0
152985,6,7,0,0,7,0
152985,5,2,0,0,2,0
152985,4,1,0,0,1,0
7060,9,1,0,0,1,0
7060,1,1,0,0,1,0
12281,10,1,0,0,1,0
12281,8,1,0,0,1,0
12281,5,6,0,0,6,0
12281,2,1,0,0,1,0
12281,1,1,0,0,1,0
191512,10,2,0,0,2,0
191512,5,2,0,0,2,0
191512,4,4,0,0,4,0
191512,2,1,0,0,1,0
10392,10,1,0,0,1,0
10392,8,1,0,0,1,0
10392,7,4,0,0,4,0
10392,5,5,0,0,5,0
10392,4,1,0,0,1,0
10392,2,1,0,0,1,0
90002,5,2,0,0,2,0
75445,8,4,0,0,4,0
75445,4,1,0,0,1,0
75445,3,1,0,0,1,0
75445,2,2,0,0,2,0
170609,9,2,0,0,2,0
170609,8,1,0,0,1,0
170609,5,10,0,0,10,0
85948,9,1,0,0,1,0
85948,5,7,0,0,7,0
27127,10,1,0,0,1,0
157593,9,1,0,0,1,0
157593,7,1,0,0,1,0
157593,5,5,0,0,5,0
157593,2,2,0,0,2,0
3335,5,5,0,0,5,0
3335,4,2,0,0,2,0
3335,3,3,0,0,3,0
3335,2,1,0,0,1,0
36250,2,1,0,0,1,0
27460,8,2,0,0,2,0
164059,9,3,0,0,3,0
164059,6,1,0,0,1,0
164059,1,1,0,0,1,0
6687,9,1,0,0,1,0
6687,2,1,0,0,1,0
51367,7,5,0,0,5,0
51367,5,4,0,0,4,0
51367,3,1,0,0,1,0
51367,2,1,0,0,1,0
232385,9,2,0,0,2,0
232385,6,4,0,0,4,0
232385,4,1,0,0,1,0
232385,3,1,0,0,1,0
232385,2,1,0,0,1,0
27876,9,3,0,0,3,0
27876,6,6,0,0,6,0
27876,4,3,0,0,3,0
27876,3,1,0,0,1,0
27876,2,2,0,0,2,0
234977,5,5,0,0,5,0
234977,4,3,0,0,3,0
234977,3,1,0,0,1,0
12943,3,1,0,0,1,0
12943,1,2,0,0,2,0
140626,9,1,0,0,1,0
140626,5,2,0,0,2,0
259069,8,5,0,0,5,0
259069,7,11,0,0,11,0
259069,6,9,0,0,9,0
259069,5,2,0,0,2,0
177807,7,6,0,0,6,0
177807,5,2,0,0,2,0
177807,4,3,0,0,3,0
129465,9,1,0,0,1,0
129465,8,4,0,0,4,0
129465,7,6,0,0,6,0
129465,5,5,0,0,5,0
129465,4,3,0,0,3,0
129465,3,1,0,0,1,0
69815,10,1,0,0,1,0
69815,5,1,0,0,1,0
8644,10,1,0,0,1,0
8644,4,2,0,0,2,0
8644,1,1,0,0,1,0
775,8,2,0,0,2,0
775,5,4,0,0,4,0
775,3,1,0,0,1,0
40072,7,5,0,0,5,0
40072,4,3,0,0,3,0
40072,2,1,0,0,1,0
88881,8,1,0,0,1,0
88881,6,5,0,0,5,0
242589,9,2,0,0,2,0
242589,6,2,0,0,2,0
242589,3,1,0,0,1,0
38824,10,1,0,0,1,0
38824,8,2,0,0,2,0
38824,4,1,0,0,1,0
2991,8,1,0,0,1,0
2991,5,5,0,0,5,0
2550,9,1,0,0,1,0
2550,7,4,0,0,4,0
2550,6,5,0,0,5,0
2550,3,1,0,0,1,0
23212,8,3,0,0,3,0
15164,9,1,0,0,1,0
15164,6,8,0,0,8,0
15164,5,4,0,0,4,0
84247,3,1,0,0,1,0
6981,7,1,0,0,1,0
6981,1,2,0,0,2,0
3447,7,1,0,0,1,0
3447,5,6,0,0,6,0
3447,2,1,0,0,1,0
262114,7,2,0,0,2,0
262114,1,1,0,0,1,0
18732,9,2,0,0,2,0
18732,8,5,0,0,5,0
197551,9,1,0,0,1,0
197551,8,5,0,0,5,0
197551,7,7,0,0,7,0
197551,5,3,0,0,3,0
197551,2,1,0,0,1,0
14146,8,1,0,0,1,0
14146,7,1,0,0,1,0
14146,1,2,0,0,2,0
587,9,2,0,0,2,0
587,5,3,0,0,3,0
587,2,1,0,0,1,0
16440,10,1,0,0,1,0
16440,9,1,0,0,1,0
16440,3,2,0,0,2,0
16440,2,2,0,0,2,0
23596,8,3,0,0,3,0
23596,4,1,0,0,1,0
183511,8,4,0,0,4,0
183511,5,1,0,0,1,0
183511,1,1,0,0,1,0
39545,7,7,0,0,7,0
40350,7,1,0,0,1,0
40350,5,2,0,0,2,0
231273,9,1,0,0,1,0
231273,8,2,0,0,2,0
231273,6,12,0,0,12,0
231273,2,1,0,0,1,0
195696,10,1,0,0,1,0
195696,7,1,0,0,1,0
195696,4,3,0,0,3,0
195696,3,1,0,0,1,0
90092,9,3,0,0,3,0
90092,8,2,0,0,2,0
90092,6,12,0,0,12,0
90092,5,5,0,0,5,0
90092,4,1,0,0,1,0
225689,8,1,0,0,1,0
225689,7,3,0,0,3,0
225689,5,1,0,0,1,0
225689,4,1,0,0,1,0
34825,7,3,0,0,3,0
34825,2,1,0,0,1,0
9759,3,1,0,0,1,0
9759,2,1,0,0,1,0
32789,7,2,0,0,2,0
32789,6,7,0,0,7,0
32789,4,7,0,0,7,0
32789,3,3,0,0,3,0
32789,1,4,0,0,4,0
36232,9,1,0,0,1,0
36232,1,2,0,0,2,0
133423,7,1,0,0,1,0
133423,6,6,0,0,6,0
133423,2,1,0,0,1,0
175924,5,4,0,0,4,0
175924,4,1,0,0,1,0
175924,2,1,0,0,1,0
162070,10,1,0,0,1,0
162070,8,2,0,0,2,0
162070,7,4,0,0,4,0
162070,5,4,0,0,4,0
162070,4,2,0,0,2,0
162070,2,1,0,0,1,0
162070,1,1,0,0,1,0
208340,1,1,0,0,1,0
251213,9,1,0,0,1,0
251213,5,1,0,0,1,0
20647,7,1,0,0,1,0
91664,7,2,0,0,2,0
91664,3,2,0,0,2,0
10275,7,2,0,0,2,0
10275,5,8,0,0,8,0
10275,3,2,0,0,2,0
5411,5,5,0,0,5,0
5411,3,1,0,0,1,0
169077,7,5,0,0,5,0
169077,6,9,0,0,9,0
169077,4,3,0,0,3,0
14116,3,2,0,0,2,0
250963,10,3,0,0,3,0
250963,9,2,0,0,2,0
250963,5,2,0,0,2,0
250963,1,1,0,0,1,0
123399,9,2,0,0,2,0
123399,4,1,0,0,1,0
233501,9,2,0,0,2,0
233501,3,1,0,0,1,0
5282,9,1,0,0,1,0
5282,1,1,0,0,1,0
10266,7,6,0,0,6,0
10266,4,2,0,0,2,0
87871,10,1,0,0,1,0
87871,6,7,0,0,7,0
87871,4,6,0,0,6,0
87871,3,3,0,0,3,0
87871,2,1,0,0,1,0
137637,10,1,0,0,1,0
175735,6,8,0,0,8,0
175735,3,1,0,0,1,0
144374,10,2,0,0,2,0
144374,5,7,0,0,7,0
144374,3,2,0,0,2,0
144374,2,2,0,0,2,0
942,8,3,0,0,3,0
942,4,4,0,0,4,0
942,2,1,0,0,1,0
6892,10,1,0,0,1,0
6892,9,1,0,0,1,0
6892,8,1,0,0,1,0
6892,6,2,0,0,2,0
6892,2,2,0,0,2,0
7194,5,2,0,0,2,0
7194,3,3,0,0,3,0
7194,1,1,0,0,1,0
208419,8,1,0,0,1,0
208419,6,8,0,0,8,0
208419,5,2,0,0,2,0
208419,3,1,0,0,1,0
208419,2,1,0,0,1,0
256999,10,5,0,0,5,0
256999,9,2,0,0,2,0
256999,8,1,0,0,1,0
256999,7,2,0,0,2,0
256999,5,1,0,0,1,0
162295,10,1,0,0,1,0
162295,8,4,0,0,4,0
162295,6,7,0,0,7,0
162295,5,3,0,0,3,0
162295,4,3,0,0,3,0
162295,3,1,0,0,1,0
16973,9,1,0,0,1,0
16973,7,1,0,0,1,0
16973,5,5,0,0,5,0
16973,4,7,0,0,7,0
232351,8,1,0,0,1,0
232351,7,5,0,0,5,0
232351,6,2,0,0,2,0
232351,1,1,0,0,1,0
28017,10,1,0,0,1,0
28017,8,7,0,0,7,0
28017,4,1,0,0,1,0
28017,2,1,0,0,1,0
14196,10,3,0,0,3,0
14196,6,5,0,0,5,0
14196,4,1,0,0,1,0
14196,3,1,0,0,1,0
6221,10,1,0,0,1,0
4392,9,1,0,0,1,0
4392,7,7,0,0,7,0
187769,10,1,0,0,1,0
8960,10,2,0,0,2,0
8960,5,2,0,0,2,0
17579,8,1,0,0,1,0
22801,8,1,0,0,1,0
22801,7,1,0,0,1,0
16389,4,2,0,0,2,0
73238,10,1,0,0,1,0
73238,6,7,0,0,7,0
73238,5,3,0,0,3,0
188930,7,4,0,0,4,0
188930,6,7,0,0,7,0
188930,4,8,0,0,8,0
188930,3,4,0,0,4,0
188930,2,2,0,0,2,0
193103,1,1,0,0,1,0
23818,6,3,0,0,3,0
23818,5,1,0,0,1,0
43043,7,1,0,0,1,0
43043,3,4,0,0,4,0
43043,2,1,0,0,1,0
9784,5,4,0,0,4,0
9784,2,1,0,0,1,0
20708,10,1,0,0,1,0
20708,2,1,0,0,1,0
252315,7,4,0,0,4,0
252315,5,1,0,0,1,0
2549,4,6,0,0,6,0
2549,2,1,0,0,1,0
199497,7,7,0,0,7,0
199497,6,6,0,0,6,0
199497,4,2,0,0,2,0
199497,2,1,0,0,1,0
211882,9,1,0,0,1,0
211882,8,2,0,0,2,0
211882,4,2,0,0,2,0
22289,8,2,0,0,2,0
22289,4,6,0,0,6,0
22289,3,4,0,0,4,0
22289,1,1,0,0,1,0
221208,9,1,0,0,1,0
221208,8,1,0,0,1,0
221208,5,3,0,0,3,0
179628,7,1,0,0,1,0
179628,4,4,0,0,4,0
179628,2,3,0,0,3,0
16272,10,1,0,0,1,0
16272,4,2,0,0,2,0
230864,8,1,0,0,1,0
230864,7,3,0,0,3,0
230864,5,2,0,0,2,0
230864,2,1,0,0,1,0
230864,1,2,0,0,2,0
21124,7,1,0,0,1,0
21124,2,1,0,0,1,0
199401,8,3,0,0,3,0
199401,7,3,0,0,3,0
199401,5,6,0,0,6,0
199401,2,1,0,0,1,0
19000,7,1,0,0,1,0
19000,6,5,0,0,5,0
19000,2,1,0,0,1,0
19000,1,1,0,0,1,0
15462,3,1,0,0,1,0
15462,1,1,0,0,1,0
206202,5,1,0,0,1,0
206202,4,1,0,0,1,0
206202,3,1,0,0,1,0
206202,1,1,0,0,1,0
1802,8,3,0,0,3,0
1802,3,3,0,0,3,0
1802,2,2,0,0,2,0
99227,9,1,0,0,1,0
99227,5,2,0,0,2,0
99227,4,4,0,0,4,0
107029,7,3,0,0,3,0
110434,6,7,0,0,7,0
110434,2,3,0,0,3,0
6851,10,1,0,0,1,0
6851,6,4,0,0,4,0
6851,2,1,0,0,1,0
6851,1,2,0,0,2,0
24020,8,2,0,0,2,0
24020,5,3,0,0,3,0
24020,4,2,0,0,2,0
29419,3,1,0,0,1,0
165470,4,10,0,0,10,0
240096,6,1,0,0,1,0
240096,5,1,0,0,1,0
240096,3,1,0,0,1,0
8349,1,1,0,0,1,0
202516,9,1,0,0,1,0
202516,8,5,0,0,5,0
202516,7,5,0,0,5,0
202516,6,9,0,0,9,0
202516,4,1,0,0,1,0
202516,1,1,0,0,1,0
98350,6,6,0,0,6,0
13132,8,1,0,0,1,0
13132,1,1,0,0,1,0
109070,10,3,0,0,3,0
109070,6,1,0,0,1,0
109070,5,2,0,0,2,0
109070,4,1,0,0,1,0
33169,10,1,0,0,1,0
33169,8,1,0,0,1,0
33169,7,1,0,0,1,0
33169,6,5,0,0,5,0
33169,5,6,0,0,6,0
12238,7,2,0,0,2,0
12238,6,4,0,0,4,0
88554,10,1,0,0,1,0
88554,8,1,0,0,1,0
88554,6,4,0,0,4,0
182400,9,1,0,0,1,0
182400,4,1,0,0,1,0
182400,2,1,0,0,1,0
136712,9,1,0,0,1,0
136712,8,2,0,0,2,0
136712,4,2,0,0,2,0
67112,10,1,0,0,1,0
67112,9,1,0,0,1,0
67112,6,5,0,0,5,0
67112,4,1,0,0,1,0
67112,2,1,0,0,1,0
15998,8,3,0,0,3,0
15998,6,15,0,0,15,0
15998,5,3,0,0,3,0
15998,4,1,0,0,1,0
240223,9,1,0,0,1,0
240223,8,2,0,0,2,0
240223,7,3,0,0,3,0
240223,6,7,0,0,7,0
240223,5,7,0,0,7,0
240223,4,3,0,0,3,0
240223,3,1,0,0,1,0
240223,2,2,0,0,2,0
240223,1,4,0,0,4,0
248385,8,5,0,0,5,0
248385,7,11,0,0,11,0
248385,6,7,0,0,7,0
248385,5,1,0,0,1,0
248385,4,2,0,0,2,0
248385,3,1,0,0,1,0
72566,10,1,0,0,1,0
72566,7,5,0,0,5,0
72566,6,8,0,0,8,0
72566,5,5,0,0,5,0
72566,2,3,0,0,3,0
72566,1,1,0,0,1,0
676,9,1,0,0,1,0
676,3,3,0,0,3,0
15175,10,1,0,0,1,0
8102,9,1,0,0,1,0
8102,5,4,0,0,4,0
8102,4,2,0,0,2,0
90735,8,2,0,0,2,0
90735,7,3,0,0,3,0
90735,3,2,0,0,2,0
241083,10,1,0,0,1,0
241083,6,7,0,0,7,0
241083,5,6,0,0,6,0
241083,3,1,0,0,1,0
241083,2,1,0,0,1,0
228328,9,2,0,0,2,0
228328,6,2,0,0,2,0
228328,3,1,0,0,1,0
37127,9,1,0,0,1,0
37127,8,3,0,0,3,0
37127,7,2,0,0,2,0
37127,2,1,0,0,1,0
143070,7,2,0,0,2,0
34383,8,3,0,0,3,0
34383,4,3,0,0,3,0
34383,3,2,0,0,2,0
34383,2,1,0,0,1,0
2097,9,1,0,0,1,0
2097,1,1,0,0,1,0
267314,9,3,0,0,3,0
267314,6,3,0,0,3,0
168077,10,1,0,0,1,0
168077,7,7,0,0,7,0
168077,6,4,0,0,4,0
5266,9,1,0,0,1,0
5266,3,2,0,0,2,0
5266,2,1,0,0,1,0
220827,9,1,0,0,1,0
220827,7,2,0,0,2,0
220827,6,1,0,0,1,0
220827,2,1,0,0,1,0
220827,1,1,0,0,1,0
5011,8,1,0,0,1,0
129969,8,2,0,0,2,0
129969,6,7,0,0,7,0
129969,5,2,0,0,2,0
129969,4,1,0,0,1,0
245904,10,1,0,0,1,0
245904,9,3,0,0,3,0
2030,10,1,0,0,1,0
2030,8,2,0,0,2,0
135732,8,11,0,0,11,0
135732,7,4,0,0,4,0
135732,6,3,0,0,3,0
135732,5,2,0,0,2,0
14422,10,1,0,0,1,0
14422,8,1,0,0,1,0
14422,7,2,0,0,2,0
14422,5,3,0,0,3,0
15877,10,1,0,0,1,0
15877,6,12,0,0,12,0
253319,9,1,0,0,1,0
14013,9,1,0,0,1,0
14013,4,1,0,0,1,0
14013,2,1,0,0,1,0
12662,10,1,0,0,1,0
12662,5,3,0,0,3,0
1546,6,1,0,0,1,0
1546,5,4,0,0,4,0
16975,10,1,0,0,1,0
16975,9,2,0,0,2,0
16975,7,2,0,0,2,0
16975,2,1,0,0,1,0
236577,7,8,0,0,8,0
236577,5,1,0,0,1,0
236577,3,1,0,0,1,0
206074,8,8,0,0,8,0
206074,6,3,0,0,3,0
206074,5,1,0,0,1,0
206074,1,1,0,0,1,0
218074,10,1,0,0,1,0
218074,7,4,0,0,4,0
218074,6,7,0,0,7,0
218074,1,1,0,0,1,0
1752,8,1,0,0,1,0
1752,3,1,0,0,1,0
15828,9,1,0,0,1,0
15828,5,7,0,0,7,0
15828,4,6,0,0,6,0
15828,3,2,0,0,2,0
6809,10,1,0,0,1,0
6809,8,2,0,0,2,0
6809,4,1,0,0,1,0
228742,9,1,0,0,1,0
228742,7,4,0,0,4,0
228742,5,2,0,0,2,0
152822,8,2,0,0,2,0
152822,2,1,0,0,1,0
152822,1,1,0,0,1,0
153319,9,1,0,0,1,0
153319,3,1,0,0,1,0
153319,1,1,0,0,1,0
8188,5,3,0,0,3,0
8188,3,2,0,0,2,0
8188,2,1,0,0,1,0
164022,1,1,0,0,1,0
151467,8,1,0,0,1,0
151467,7,4,0,0,4,0
151467,5,3,0,0,3,0
151467,3,1,0,0,1,0
151467,1,1,0,0,1,0
59650,5,2,0,0,2,0
59650,2,1,0,0,1,0
230246,9,1,0,0,1,0
230246,5,1,0,0,1,0
230246,1,1,0,0,1,0
130626,8,2,0,0,2,0
130626,1,1,0,0,1,0
11402,10,1,0,0,1,0
11402,8,1,0,0,1,0
11402,3,1,0,0,1,0
93867,10,1,0,0,1,0
93867,4,1,0,0,1,0
117558,7,3,0,0,3,0
117558,6,3,0,0,3,0
257076,10,1,0,0,1,0
257076,9,1,0,0,1,0
257076,8,7,0,0,7,0
257076,7,5,0,0,5,0
257076,6,7,0,0,7,0
257076,5,3,0,0,3,0
257076,4,3,0,0,3,0
257076,3,1,0,0,1,0
257076,2,1,0,0,1,0
257076,1,1,0,0,1,0
244502,10,5,0,0,5,0
244502,5,1,0,0,1,0
243343,5,1,0,0,1,0
243343,2,2,0,0,2,0
195149,6,3,0,0,3,0
195149,5,1,0,0,1,0
195149,1,2,0,0,2,0
3788,8,2,0,0,2,0
3788,3,2,0,0,2,0
122820,6,8,0,0,8,0
122820,5,7,0,0,7,0
122820,3,1,0,0,1,0
4695,3,2,0,0,2,0
4695,2,1,0,0,1,0
35813,4,1,0,0,1,0
35813,1,1,0,0,1,0
237927,7,6,0,0,6,0
237927,6,6,0,0,6,0
13024,3,1,0,0,1,0
13024,2,1,0,0,1,0
247643,9,3,0,0,3,0
247643,7,9,0,0,9,0
247643,5,2,0,0,2,0
247643,4,1,0,0,1,0
250396,6,2,0,0,2,0
220848,8,4,0,0,4,0
220848,5,1,0,0,1,0
220848,3,1,0,0,1,0
220848,1,1,0,0,1,0
21,8,3,0,0,3,0
171430,2,1,0,0,1,0
3039,10,1,0,0,1,0
3039,9,1,0,0,1,0
3039,8,3,0,0,3,0
12584,9,1,0,0,1,0
12584,6,12,0,0,12,0
12584,4,4,0,0,4,0
12584,2,1,0,0,1,0
254634,10,1,0,0,1,0
254634,5,2,0,0,2,0
4738,9,1,0,0,1,0
4738,8,1,0,0,1,0
4738,4,1,0,0,1,0
4738,2,1,0,0,1,0
4999,7,3,0,0,3,0
4999,3,1,0,0,1,0
248641,7,1,0,0,1,0
248641,6,1,0,0,1,0
248641,4,2,0,0,2,0
23724,10,2,0,0,2,0
23724,9,1,0,0,1,0
23724,6,7,0,0,7,0
23724,5,1,0,0,1,0
23724,4,1,0,0,1,0
166215,4,2,0,0,2,0
2101,10,2,0,0,2,0
2101,8,1,0,0,1,0
2101,7,1,0,0,1,0
2101,5,8,0,0,8,0
2101,2,1,0,0,1,0
5926,10,1,0,0,1,0
14625,8,2,0,0,2,0
14625,4,3,0,0,3,0
14625,3,1,0,0,1,0
14625,2,1,0,0,1,0
145765,10,1,0,0,1,0
135794,10,1,0,0,1,0
135794,5,2,0,0,2,0
222291,6,2,0,0,2,0
32450,4,3,0,0,3,0
32450,3,1,0,0,1,0
109732,8,2,0,0,2,0
109732,5,4,0,0,4,0
109732,1,1,0,0,1,0
5540,7,2,0,0,2,0
5540,6,6,0,0,6,0
5540,1,1,0,0,1,0
4972,8,1,0,0,1,0
4972,1,1,0,0,1,0
12557,4,3,0,0,3,0
12133,10,1,0,0,1,0
12133,8,1,0,0,1,0
12133,5,4,0,0,4,0
12133,4,1,0,0,1,0
12133,2,2,0,0,2,0
1862,8,2,0,0,2,0
1862,4,3,0,0,3,0
1862,3,4,0,0,4,0
1862,2,1,0,0,1,0
238506,10,3,0,0,3,0
238506,9,2,0,0,2,0
8043,10,2,0,0,2,0
8043,4,1,0,0,1,0
9156,10,1,0,0,1,0
9156,8,1,0,0,1,0
9156,7,8,0,0,8,0
9156,4,2,0,0,2,0
9156,3,1,0,0,1,0
90930,5,3,0,0,3,0
90930,4,2,0,0,2,0
90930,3,2,0,0,2,0
90930,2,2,0,0,2,0
90930,1,2,0,0,2,0
256742,8,8,0,0,8,0
256742,7,4,0,0,4,0
256742,6,3,0,0,3,0
256742,4,2,0,0,2,0
192245,9,1,0,0,1,0
192245,8,1,0,0,1,0
192245,4,4,0,0,4,0
192245,3,1,0,0,1,0
6146,10,1,0,0,1,0
6146,9,2,0,0,2,0
244039,6,6,0,0,6,0
244039,5,2,0,0,2,0
10459,9,1,0,0,1,0
8950,4,1,0,0,1,0
108100,8,2,0,0,2,0
108100,5,4,0,0,4,0
108100,4,4,0,0,4,0
12743,9,1,0,0,1,0
12743,8,4,0,0,4,0
10611,10,2,0,0,2,0
10611,4,1,0,0,1,0
237834,9,1,0,0,1,0
237834,8,4,0,0,4,0
237834,5,1,0,0,1,0
237834,4,1,0,0,1,0
13316,10,2,0,0,2,0
13316,9,2,0,0,2,0
13316,5,2,0,0,2,0
13316,4,1,0,0,1,0
13316,1,1,0,0,1,0
12718,5,1,0,0,1,0
12718,1,1,0,0,1,0
3628,8,2,0,0,2,0
3628,4,4,0,0,4,0
3628,3,1,0,0,1,0
8902,8,8,0,0,8,0
8902,4,1,0,0,1,0
11466,7,2,0,0,2,0
11466,4,2,0,0,2,0
153501,8,5,0,0,5,0
153501,7,4,0,0,4,0
153501,3,1,0,0,1,0
209667,8,2,0,0,2,0
55686,10,1,0,0,1,0
55686,9,1,0,0,1,0
55686,7,5,0,0,5,0
55686,5,2,0,0,2,0
55686,1,1,0,0,1,0
84017,5,2,0,0,2,0
10809,4,1,0,0,1,0
9272,8,2,0,0,2,0
9272,4,3,0,0,3,0
9272,3,3,0,0,3,0
13392,8,1,0,0,1,0
13392,5,9,0,0,9,0
13392,2,1,0,0,1,0
8256,8,1,0,0,1,0
8256,5,2,0,0,2,0
